Episode	Time	Reward	Score	Highest	L	U	R	D	Steps
0	2.5s (+2.5s)	1308	1308	128	25	38	40	39	142
1	3.6s (+0.4s)	1316	1316	128	24	38	43	30	135
2	4.1s (+0.4s)	1352	1352	128	27	41	32	40	140
3	4.6s (+0.4s)	1156	1156	128	29	31	38	28	126
4	5.1s (+0.3s)	1032	1032	128	25	33	28	26	112
5	5.6s (+0.4s)	1244	1244	128	17	38	46	32	133
6	6.4s (+0.7s)	2780	2780	256	28	81	75	43	227
7	7.0s (+0.5s)	1680	1680	128	20	63	57	31	171
8	7.4s (+0.3s)	728	728	64	12	36	29	19	96
9	7.8s (+0.2s)	552	552	64	9	27	26	15	77
10	8.3s (+0.4s)	1140	1140	128	16	46	41	17	120
11	8.9s (+0.5s)	1436	1436	128	17	60	56	15	148
12	9.4s (+0.4s)	1272	1272	128	16	53	45	14	128
13	9.7s (+0.3s)	724	724	64	16	35	35	13	99
14	10.0s (+0.2s)	460	460	32	11	25	23	11	70
15	10.7s (+0.6s)	2052	2052	128	28	74	71	18	191
16	11.4s (+0.5s)	2072	2072	128	17	85	76	18	196
17	11.8s (+0.3s)	896	896	64	12	53	33	12	110
18	12.2s (+0.3s)	940	940	64	8	46	49	13	116
19	13.1s (+0.8s)	3060	3060	256	20	119	98	13	250
20	13.9s (+0.6s)	2552	2552	256	25	105	75	14	219
21	14.3s (+0.3s)	820	820	64	5	58	38	6	107
22	14.7s (+0.3s)	708	708	64	5	46	34	7	92
23	15.1s (+0.3s)	1032	1032	64	13	68	33	9	123
24	15.9s (+0.6s)	2064	2064	256	12	92	60	10	174
25	16.6s (+0.6s)	1716	1716	128	20	87	57	6	170
26	17.6s (+0.9s)	4740	4740	512	25	190	109	6	330
27	18.1s (+0.3s)	912	912	128	8	61	26	4	99
28	18.7s (+0.6s)	2588	2588	256	13	132	65	8	218
29	19.4s (+0.6s)	1912	1912	128	8	122	65	3	198
30	20.1s (+0.6s)	2056	2056	128	14	107	77	7	205
31	20.8s (+0.6s)	2212	2212	256	11	113	61	5	190
32	21.8s (+0.8s)	2292	2292	128	13	122	79	4	218
33	22.2s (+0.4s)	908	908	64	2	56	49	6	113
34	22.8s (+0.5s)	1592	1592	128	12	85	65	7	169
35	23.6s (+0.7s)	2464	2464	128	21	123	78	6	228
36	24.4s (+0.6s)	2016	2016	128	12	113	66	6	197
37	25.3s (+0.8s)	2112	2112	128	19	112	64	5	200
38	25.8s (+0.4s)	1144	1144	64	12	73	43	6	134
39	26.7s (+0.8s)	3308	3308	256	23	157	94	4	278
40	27.3s (+0.5s)	1364	1364	128	10	85	54	3	152
41	28.0s (+0.5s)	1540	1540	128	13	107	42	2	164
42	28.8s (+0.7s)	2940	2940	256	19	153	67	7	246
43	29.4s (+0.4s)	1320	1320	128	10	96	34	1	141
44	30.1s (+0.6s)	2056	2056	128	14	134	40	3	191
45	30.6s (+0.6s)	1904	1904	128	14	127	45	1	187
46	31.0s (+0.3s)	692	692	64	8	59	22	2	91
47	31.8s (+0.7s)	2740	2740	256	17	167	46	2	232
48	32.5s (+0.5s)	1432	1432	64	11	113	37	1	162
49	33.7s (+1.1s)	4448	4448	256	43	232	90	1	366
50	34.6s (+0.8s)	2956	2956	256	15	181	49	1	246
51	35.3s (+0.7s)	2480	2480	128	29	158	44	1	232
52	36.0s (+0.7s)	2904	2904	256	34	174	42	3	253
53	37.1s (+0.9s)	3308	3308	256	50	197	43	2	292
54	37.8s (+0.6s)	1744	1744	128	24	130	20	2	176
55	39.4s (+1.5s)	7268	7268	512	115	340	75	1	531
56	40.5s (+0.9s)	3788	3788	256	46	216	50	0	312
57	41.8s (+1.1s)	4548	4548	256	54	274	50	1	379
58	42.6s (+0.7s)	2712	2712	256	38	169	27	0	234
59	43.3s (+0.5s)	1720	1720	128	25	126	25	0	176
60	44.0s (+0.7s)	2512	2512	128	36	159	41	0	236
61	44.9s (+0.8s)	3284	3284	256	34	196	43	1	274
62	45.7s (+0.7s)	2684	2684	256	21	174	38	2	235
63	46.5s (+0.6s)	2360	2360	128	21	136	61	1	219
64	47.2s (+0.7s)	2908	2908	256	13	169	55	1	238
65	48.2s (+0.9s)	3564	3564	256	18	204	78	2	302
66	48.9s (+0.6s)	1952	1952	128	10	145	44	0	199
67	49.9s (+0.9s)	3504	3504	256	22	192	81	1	296
68	50.6s (+0.5s)	1508	1508	64	12	110	45	1	168
69	51.0s (+0.3s)	704	704	64	3	69	27	0	99
70	51.5s (+0.5s)	1808	1808	128	11	126	49	0	186
71	52.4s (+0.8s)	3296	3296	256	15	200	64	0	279
72	53.5s (+0.9s)	4072	4072	256	44	215	71	1	331
73	54.1s (+0.4s)	1304	1304	128	25	106	11	0	142
74	54.5s (+0.4s)	1524	1524	128	31	118	11	0	160
75	55.5s (+0.8s)	3532	3532	256	79	202	16	0	297
76	56.2s (+0.5s)	1848	1848	128	41	138	10	0	189
77	56.8s (+0.5s)	1512	1512	128	43	107	9	0	159
78	57.1s (+0.2s)	572	572	64	12	66	0	0	78
79	58.4s (+1.2s)	6104	6104	512	124	259	21	0	404
80	59.3s (+0.7s)	2880	2880	256	63	178	10	0	251
81	59.9s (+0.5s)	1788	1788	128	52	118	12	0	182
82	60.7s (+0.6s)	2624	2624	256	50	166	6	0	222
83	61.1s (+0.3s)	992	992	128	11	89	6	1	107
84	61.6s (+0.5s)	1500	1500	128	39	109	11	0	159
85	62.3s (+0.7s)	3100	3100	256	53	197	10	0	260
86	63.4s (+0.9s)	3800	3800	256	85	205	15	0	305
87	64.3s (+0.8s)	3292	3292	256	60	202	13	0	275
88	65.4s (+1.0s)	4244	4244	256	89	245	17	0	351
89	66.1s (+0.5s)	1712	1712	128	47	114	8	0	169
90	67.4s (+1.3s)	6280	6280	512	120	300	24	0	444
91	68.6s (+1.0s)	4260	4260	256	98	230	16	0	344
92	69.2s (+0.5s)	1680	1680	128	46	117	8	0	171
93	69.8s (+0.6s)	2252	2252	128	59	136	13	0	208
94	70.8s (+0.8s)	3288	3288	256	64	196	11	2	273
95	71.8s (+0.9s)	3696	3696	256	85	204	16	0	305
96	72.8s (+1.0s)	4168	4168	256	101	213	21	2	337
97	73.5s (+0.6s)	1924	1924	128	54	133	12	0	199
98	74.1s (+0.6s)	2408	2408	256	59	140	7	0	206
99	75.0s (+0.7s)	2968	2968	256	64	178	11	0	253
Episode	Time	Reward	Score	Highest	L	U	R	D	Steps
100	75.9s (+0.9s)	3576	3576	256	83	205	13	0	301
101	76.6s (+0.5s)	1732	1732	128	45	132	3	0	180
102	77.4s (+0.7s)	2736	2736	256	52	168	11	0	231
103	77.9s (+0.4s)	1448	1448	128	37	105	6	0	148
104	79.0s (+1.0s)	4356	4356	256	94	246	23	0	363
105	79.7s (+0.5s)	1764	1764	128	47	121	8	1	177
106	80.5s (+0.7s)	2904	2904	256	80	160	9	1	250
107	81.4s (+0.8s)	3392	3392	256	78	199	10	1	288
108	82.3s (+0.8s)	3396	3396	256	62	213	9	0	284
109	82.9s (+0.4s)	1152	1152	64	33	97	4	1	135
110	83.5s (+0.6s)	2072	2072	128	61	138	9	0	208
111	84.0s (+0.5s)	1640	1640	128	38	121	7	0	166
112	84.9s (+0.8s)	3440	3440	256	71	195	14	1	281
113	85.8s (+0.7s)	3000	3000	256	60	184	6	0	250
114	86.5s (+0.7s)	2704	2704	256	46	177	7	0	230
115	87.2s (+0.6s)	2552	2552	256	50	153	7	0	210
116	88.2s (+0.8s)	3324	3324	256	73	190	15	0	278
117	88.6s (+0.5s)	1472	1472	128	32	119	6	0	157
118	89.6s (+0.8s)	3476	3476	256	71	206	9	2	288
119	90.5s (+0.9s)	3864	3864	256	71	225	19	2	317
120	91.4s (+0.7s)	3068	3068	256	53	186	11	3	253
121	92.0s (+0.6s)	2028	2028	128	63	129	9	4	205
122	92.7s (+0.6s)	2492	2492	256	46	158	6	5	215
123	93.6s (+0.8s)	3244	3244	256	58	206	4	6	274
124	94.2s (+0.6s)	2564	2564	256	55	153	3	7	218
125	95.0s (+0.7s)	2940	2940	256	55	179	3	9	246
126	95.7s (+0.7s)	2780	2780	256	54	179	1	4	238
127	96.6s (+0.9s)	3936	3936	256	78	232	3	6	319
128	97.3s (+0.5s)	1832	1832	128	34	147	1	10	192
129	97.9s (+0.5s)	1708	1708	128	31	134	2	5	172
130	99.0s (+0.9s)	3952	3952	256	73	237	3	14	327
131	100s (+0.9s)	3712	3712	256	65	216	1	15	297
132	101s (+0.5s)	1608	1608	128	43	117	3	6	169
133	101s (+0.4s)	1140	1140	128	33	83	4	4	124
134	102s (+0.7s)	2676	2676	256	47	171	8	3	229
135	102s (+0.6s)	2520	2520	256	45	158	4	4	211
136	103s (+0.6s)	2568	2568	256	50	149	10	4	213
137	105s (+1.3s)	5880	5880	512	105	289	21	6	421
138	105s (+0.5s)	1824	1824	128	53	117	13	2	185
139	106s (+1.0s)	4220	4220	256	80	252	10	5	347
140	107s (+0.6s)	2600	2600	256	58	151	8	3	220
141	108s (+0.6s)	2348	2348	256	41	144	6	4	195
142	108s (+0.3s)	784	784	64	32	63	6	1	102
143	110s (+1.2s)	5716	5716	512	92	281	14	6	393
144	110s (+0.4s)	1208	1208	128	34	93	4	3	134
145	111s (+0.6s)	2580	2580	256	50	156	5	4	215
146	111s (+0.4s)	1276	1276	128	31	95	5	1	132
147	112s (+0.4s)	1180	1180	128	27	98	3	0	128
148	112s (+0.4s)	1412	1412	128	42	100	5	2	149
149	113s (+0.6s)	2560	2560	256	53	155	12	0	220
150	114s (+0.7s)	2676	2676	256	60	154	11	3	228
151	114s (+0.6s)	2208	2208	256	34	151	7	0	192
152	115s (+0.4s)	908	908	64	27	86	5	0	118
153	116s (+0.8s)	3532	3532	256	84	194	13	0	291
154	116s (+0.4s)	1316	1316	128	31	106	6	1	144
155	117s (+0.8s)	3408	3408	256	66	203	12	2	283
156	118s (+0.2s)	604	604	64	16	59	2	2	79
157	118s (+0.5s)	1716	1716	128	42	129	7	2	180
158	119s (+0.7s)	3036	3036	256	52	181	10	1	244
159	120s (+0.5s)	1520	1520	128	35	120	8	0	163
160	120s (+0.3s)	944	944	64	25	85	3	4	117
161	121s (+0.5s)	1492	1492	128	33	118	2	4	157
162	121s (+0.8s)	2580	2580	256	35	170	2	7	214
163	122s (+0.5s)	1600	1600	128	36	113	4	5	158
164	123s (+0.5s)	1744	1744	128	33	137	3	3	176
165	123s (+0.5s)	1480	1480	128	37	110	7	1	155
166	124s (+0.8s)	3220	3220	256	64	189	10	0	263
167	125s (+0.5s)	1768	1768	128	34	144	4	0	182
168	125s (+0.5s)	1568	1568	128	43	105	7	0	155
169	126s (+0.4s)	1388	1388	128	43	102	8	0	153
170	126s (+0.6s)	1916	1916	128	38	153	6	0	197
171	127s (+1.0s)	4092	4092	256	85	232	13	0	330
172	128s (+1.1s)	5544	5544	512	105	266	18	0	389
173	129s (+0.3s)	800	800	64	30	73	4	0	107
174	130s (+0.8s)	3240	3240	256	59	200	14	0	273
175	130s (+0.6s)	2384	2384	256	43	154	6	1	204
176	131s (+1.0s)	4064	4064	256	79	236	24	0	339
177	132s (+0.5s)	1780	1780	128	52	118	9	1	180
178	132s (+0.3s)	768	768	64	30	67	6	0	103
179	133s (+0.3s)	1064	1064	128	18	93	5	0	116
180	134s (+0.8s)	3200	3200	256	66	189	10	0	265
181	135s (+0.7s)	2936	2936	256	52	202	6	0	260
182	135s (+0.4s)	1184	1184	128	23	98	7	0	128
183	136s (+0.7s)	2968	2968	256	58	184	11	0	253
184	137s (+0.9s)	3964	3964	256	79	231	15	0	325
185	138s (+0.7s)	3048	3048	256	65	182	10	0	257
186	138s (+0.5s)	1888	1888	128	40	130	8	0	178
187	139s (+0.7s)	2504	2504	128	52	173	12	0	237
188	140s (+0.5s)	2172	2172	256	35	143	0	6	184
189	140s (+0.3s)	1020	1020	128	28	85	0	3	116
190	141s (+0.3s)	1120	1120	128	20	94	0	5	119
191	141s (+0.3s)	868	868	64	17	82	0	4	103
192	142s (+0.6s)	2608	2608	256	48	161	0	8	217
193	142s (+0.4s)	1348	1348	128	28	106	0	5	139
194	143s (+0.4s)	972	972	64	20	93	0	6	119
195	143s (+0.3s)	620	620	32	21	69	0	5	95
196	144s (+0.7s)	2824	2824	256	65	159	10	0	234
197	144s (+0.4s)	1168	1168	128	37	81	6	0	124
198	145s (+0.6s)	1828	1828	128	45	143	3	0	191
199	145s (+0.7s)	3116	3116	256	77	162	14	1	254
Episode	Time	Reward	Score	Highest	L	U	R	D	Steps
200	146s (+0.6s)	2516	2516	256	47	154	6	0	207
201	147s (+0.6s)	2460	2460	256	46	155	9	0	210
202	148s (+0.8s)	3292	3292	256	74	198	9	0	281
203	149s (+0.9s)	3604	3604	256	70	221	13	0	304
204	150s (+0.8s)	3152	3152	256	56	204	8	0	268
205	150s (+0.5s)	1856	1856	128	51	127	8	1	187
206	151s (+0.5s)	1780	1780	128	45	127	8	1	181
207	152s (+1.0s)	4264	4264	256	97	239	15	0	351
208	153s (+0.9s)	3832	3832	256	91	212	22	0	325
209	153s (+0.4s)	1180	1180	128	25	102	1	0	128
210	154s (+0.8s)	3712	3712	256	84	187	19	0	290
211	155s (+0.3s)	1136	1136	128	29	87	6	0	122
212	155s (+0.5s)	2056	2056	128	53	128	9	0	190
213	156s (+0.8s)	3488	3488	256	77	202	12	0	291
214	157s (+1.3s)	6348	6348	512	117	302	27	0	446
215	158s (+0.8s)	3256	3256	256	65	195	16	0	276
216	159s (+0.6s)	2428	2428	256	49	150	8	0	207
217	160s (+0.7s)	2744	2744	256	64	157	14	0	235
218	161s (+0.7s)	2740	2740	256	45	178	10	0	233
219	161s (+0.8s)	3380	3380	256	73	197	11	0	281
220	162s (+0.7s)	2856	2856	256	47	187	13	0	247
221	163s (+0.5s)	1564	1564	128	48	106	8	0	162
222	164s (+1.1s)	4356	4356	256	89	258	20	0	367
223	165s (+0.5s)	1780	1780	128	45	126	9	0	180
224	165s (+0.6s)	1952	1952	128	50	145	6	0	201
225	166s (+0.8s)	3332	3332	256	67	204	13	0	284
226	167s (+0.7s)	2920	2920	256	57	178	7	0	242
227	168s (+0.5s)	1892	1892	128	48	137	6	0	191
228	169s (+0.9s)	3908	3908	256	91	210	16	0	317
229	169s (+0.5s)	1736	1736	128	44	129	8	0	181
230	169s (+0.3s)	812	812	64	32	64	7	0	103
231	170s (+0.5s)	1520	1520	128	43	113	6	0	162
232	171s (+1.4s)	6776	6776	512	133	332	27	0	492
233	172s (+0.3s)	740	740	64	15	80	2	1	98
234	172s (+0.2s)	652	652	64	21	63	2	0	86
235	173s (+1.1s)	4544	4544	256	93	265	19	0	377
236	174s (+0.4s)	1156	1156	64	31	101	4	0	136
237	174s (+0.5s)	1608	1608	128	51	108	10	0	169
238	175s (+0.5s)	1616	1616	128	45	120	6	0	171
239	176s (+0.7s)	2800	2800	256	68	163	12	0	243
240	177s (+0.8s)	3368	3368	256	74	195	9	0	278
241	177s (+0.5s)	1608	1608	128	54	109	6	0	169
242	178s (+0.7s)	2504	2504	128	49	178	9	1	237
243	179s (+0.8s)	3176	3176	256	62	190	9	0	261
244	180s (+0.9s)	3904	3904	256	72	228	15	0	315
245	180s (+0.5s)	1900	1900	128	54	133	6	0	193
246	181s (+0.4s)	1320	1320	128	34	106	5	0	145
247	182s (+1.1s)	5856	5856	512	110	277	17	0	404
248	183s (+0.8s)	3472	3472	256	73	193	20	1	287
249	184s (+0.6s)	2344	2344	128	61	138	17	0	216
250	185s (+0.8s)	3172	3172	256	71	183	13	1	268
251	185s (+0.8s)	3364	3364	256	62	205	14	0	281
252	186s (+0.7s)	2912	2912	256	62	184	8	0	254
253	187s (+0.6s)	2036	2036	128	49	142	9	0	200
254	188s (+0.8s)	3532	3532	256	73	207	0	17	297
255	189s (+0.9s)	4112	4112	256	64	248	0	20	332
256	189s (+0.6s)	2524	2524	256	48	163	0	7	218
257	190s (+0.3s)	736	736	64	16	79	0	2	97
258	190s (+0.5s)	1800	1800	128	37	140	0	8	185
259	191s (+0.6s)	2380	2380	256	41	152	10	0	203
260	191s (+0.3s)	872	872	64	27	80	6	0	113
261	192s (+0.6s)	2344	2344	256	45	142	8	0	195
262	192s (+0.4s)	1040	1040	64	22	99	0	4	125
263	193s (+0.5s)	2032	2032	128	47	140	1	11	199
264	194s (+0.9s)	3916	3916	256	63	232	0	20	315
265	194s (+0.6s)	1900	1900	128	49	135	9	0	193
266	195s (+0.2s)	504	504	64	14	55	4	0	73
267	196s (+1.4s)	6744	6744	512	129	329	32	1	491
268	197s (+0.5s)	1856	1856	128	46	133	8	0	187
269	197s (+0.3s)	708	708	64	15	75	0	5	95
270	198s (+0.5s)	1860	1860	128	35	146	0	8	189
271	198s (+0.8s)	3256	3256	256	55	213	8	0	276
272	199s (+0.4s)	1488	1488	128	35	115	5	0	155
273	200s (+0.8s)	3424	3424	256	79	191	16	0	286
274	201s (+0.7s)	2992	2992	256	62	179	8	0	249
275	201s (+0.5s)	1956	1956	128	43	135	14	0	192
276	202s (+0.4s)	1012	1012	64	35	85	2	0	122
277	202s (+0.8s)	3220	3220	256	62	198	8	0	268
278	203s (+0.6s)	2512	2512	256	55	158	7	0	220
279	204s (+0.6s)	2436	2436	256	48	148	8	1	205
280	204s (+0.6s)	1920	1920	128	51	138	9	0	198
281	205s (+0.9s)	3944	3944	256	81	226	13	0	320
282	206s (+0.5s)	1564	1564	128	46	113	6	0	165
283	207s (+1.0s)	4036	4036	256	97	225	16	0	338
284	208s (+0.5s)	1680	1680	128	29	132	10	1	172
285	208s (+0.5s)	2284	2284	256	45	135	9	0	189
286	209s (+0.9s)	3708	3708	256	74	220	16	0	310
287	210s (+0.4s)	1240	1240	128	29	103	6	0	138
288	210s (+0.4s)	1152	1152	128	30	87	7	0	124
289	211s (+0.6s)	1948	1948	128	66	117	12	0	195
290	211s (+0.3s)	756	756	64	21	73	5	0	99
291	211s (+0.5s)	1580	1580	128	41	110	8	0	159
292	212s (+0.4s)	1476	1476	128	35	114	4	0	153
293	213s (+1.0s)	4328	4328	256	97	242	17	0	356
294	214s (+0.7s)	2908	2908	256	58	184	11	0	253
295	214s (+0.4s)	1468	1468	128	33	113	6	0	152
296	215s (+0.6s)	2628	2628	256	37	173	0	12	222
297	216s (+0.6s)	1988	1988	128	42	160	0	8	210
298	216s (+0.8s)	3212	3212	256	51	210	0	9	270
299	217s (+0.2s)	472	472	64	14	51	0	4	69
Episode	Time	Reward	Score	Highest	L	U	R	D	Steps
300	217s (+0.4s)	1156	1156	64	27	103	0	6	136
301	218s (+0.4s)	1312	1312	128	26	106	0	3	135
302	219s (+1.0s)	4424	4424	256	70	280	0	15	365
303	220s (+0.8s)	3340	3340	256	54	204	0	14	272
304	220s (+0.2s)	612	612	64	14	67	0	2	83
305	221s (+0.7s)	2732	2732	256	44	178	12	0	234
306	221s (+0.5s)	1584	1584	64	44	114	10	0	168
307	222s (+0.8s)	3540	3540	256	83	200	16	0	299
308	223s (+0.8s)	3380	3380	256	77	180	25	0	282
309	224s (+0.4s)	1388	1388	128	32	105	9	1	147
310	224s (+0.5s)	1568	1568	128	39	121	10	0	170
311	225s (+0.7s)	2916	2916	256	69	174	12	0	255
312	226s (+1.0s)	4452	4452	256	94	263	15	0	372
313	227s (+0.5s)	1732	1732	128	45	123	5	0	173
314	227s (+0.4s)	1268	1268	128	27	105	5	0	137
315	228s (+0.3s)	620	620	32	30	59	1	0	90
316	228s (+0.6s)	2724	2724	256	53	170	6	0	229
317	229s (+0.4s)	1468	1468	128	27	119	6	0	152
318	230s (+0.6s)	2268	2268	256	46	146	6	0	198
319	230s (+0.7s)	2880	2880	256	57	174	12	0	243
320	231s (+0.5s)	1496	1496	128	35	113	10	0	158
321	231s (+0.7s)	2792	2792	256	72	157	12	0	241
322	232s (+0.6s)	2164	2164	128	66	140	9	1	216
323	233s (+0.4s)	1460	1460	128	39	105	9	0	153
324	234s (+1.1s)	5524	5524	512	94	272	22	1	389
325	235s (+0.8s)	3348	3348	256	80	188	15	0	283
326	236s (+1.0s)	4304	4304	256	83	254	18	0	355
327	236s (+0.6s)	2704	2704	256	44	176	0	5	225
328	237s (+0.5s)	1640	1640	128	23	140	0	4	167
329	238s (+0.8s)	3440	3440	256	54	221	0	16	291
330	239s (+0.5s)	2252	2252	256	33	140	0	9	182
331	239s (+0.3s)	732	732	64	17	71	0	5	93
332	240s (+0.8s)	3520	3520	256	100	175	19	0	294
333	240s (+0.5s)	1788	1788	128	39	137	6	0	182
334	241s (+0.6s)	2500	2500	256	50	150	8	0	208
335	242s (+0.5s)	2304	2304	256	40	145	6	0	191
336	242s (+0.7s)	2808	2808	256	63	170	12	0	245
337	243s (+0.5s)	1688	1688	128	40	124	9	0	173
338	243s (+0.4s)	1564	1564	128	36	117	6	0	159
339	244s (+0.4s)	1220	1220	128	34	93	6	0	133
340	244s (+0.4s)	1304	1304	64	56	83	6	0	145
341	245s (+0.4s)	1348	1348	128	27	106	4	1	138
342	246s (+0.9s)	4732	4732	512	89	224	14	0	327
343	247s (+1.3s)	6460	6460	512	112	321	24	0	457
344	248s (+0.8s)	3208	3208	256	62	192	11	0	265
345	249s (+0.7s)	2856	2856	256	58	180	11	0	249
346	249s (+0.8s)	3504	3504	256	74	208	13	1	296
347	250s (+0.6s)	2056	2056	128	54	140	11	0	205
348	251s (+0.8s)	3144	3144	256	63	187	12	2	264
349	252s (+0.8s)	3244	3244	256	67	188	12	1	268
350	253s (+0.8s)	3284	3284	256	86	169	14	0	269
351	253s (+0.6s)	2544	2544	256	40	166	7	0	213
352	254s (+0.5s)	1836	1836	128	47	135	5	0	187
353	255s (+0.9s)	3912	3912	256	93	207	18	0	318
354	255s (+0.5s)	1852	1852	128	45	137	8	0	190
355	256s (+0.8s)	3260	3260	256	83	168	20	0	271
356	257s (+0.9s)	3900	3900	256	66	241	11	0	318
357	258s (+0.4s)	1392	1392	128	28	110	5	0	143
358	259s (+0.8s)	3504	3504	256	66	210	14	0	290
359	259s (+0.7s)	2556	2556	128	56	166	13	0	235
360	260s (+0.7s)	2660	2660	128	63	177	16	0	256
361	261s (+0.8s)	3208	3208	256	63	186	15	1	265
362	261s (+0.4s)	1380	1380	128	34	103	1	5	143
363	262s (+0.4s)	1236	1236	128	30	101	0	6	137
364	262s (+0.6s)	1872	1872	128	44	141	0	12	197
365	263s (+0.8s)	3172	3172	256	63	184	0	14	261
366	264s (+0.9s)	3860	3860	256	70	233	0	13	316
367	265s (+0.5s)	1984	1984	128	39	132	0	9	180
368	266s (+1.0s)	4040	4040	256	81	233	18	0	332
369	266s (+0.5s)	1624	1624	128	34	123	4	0	161
370	268s (+1.1s)	5736	5736	512	108	282	15	0	405
371	269s (+0.9s)	3948	3948	256	75	238	13	0	326
372	269s (+0.3s)	784	784	64	23	75	5	0	103
373	270s (+0.7s)	2864	2864	256	58	166	12	0	236
374	271s (+0.8s)	3464	3464	256	68	207	14	0	289
375	271s (+0.5s)	1772	1772	128	43	126	9	0	178
376	272s (+0.5s)	1740	1740	128	38	126	11	0	175
377	273s (+0.6s)	1896	1896	128	42	145	6	0	193
378	273s (+0.7s)	2748	2748	256	50	175	9	0	234
379	274s (+0.6s)	2484	2484	256	54	147	9	2	212
380	274s (+0.4s)	1372	1372	128	31	108	5	0	144
381	275s (+0.6s)	2396	2396	256	47	150	8	0	205
382	275s (+0.4s)	1240	1240	64	36	100	6	0	142
383	276s (+0.4s)	1456	1456	128	32	114	5	0	151
384	277s (+0.6s)	2500	2500	256	50	159	8	0	217
385	277s (+0.3s)	1128	1128	128	24	91	0	4	119
386	278s (+0.8s)	3416	3416	256	59	212	0	11	282
387	278s (+0.4s)	1152	1152	64	27	103	0	7	137
388	279s (+0.7s)	2544	2544	128	45	177	0	11	233
389	279s (+0.5s)	1804	1804	128	28	153	0	5	186
390	280s (+0.5s)	1568	1568	128	33	124	0	7	164
391	281s (+0.7s)	3080	3080	256	65	174	17	0	256
392	282s (+1.0s)	4408	4408	256	97	241	17	0	355
393	283s (+0.8s)	3488	3488	256	72	198	21	0	291
394	283s (+0.3s)	868	868	64	26	82	5	0	113
395	284s (+0.6s)	2536	2536	256	51	158	11	0	220
396	285s (+1.1s)	5620	5620	512	84	297	12	0	393
397	285s (+0.3s)	736	736	64	29	64	4	0	97
398	286s (+0.8s)	2828	2828	128	89	158	17	0	264
399	286s (+0.7s)	2748	2748	256	54	170	10	0	234
Episode	Time	Reward	Score	Highest	L	U	R	D	Steps
400	287s (+0.7s)	2472	2472	128	64	152	13	0	229
401	288s (+0.5s)	1796	1796	128	43	133	8	0	184
402	288s (+0.6s)	1916	1916	128	47	145	5	0	197
403	289s (+0.6s)	2536	2536	256	61	159	5	0	225
404	289s (+0.2s)	468	468	64	14	52	1	0	67
405	290s (+0.5s)	1608	1608	128	37	125	7	0	169
406	290s (+0.7s)	3028	3028	256	61	178	10	0	249
407	291s (+0.9s)	3860	3860	256	93	205	18	0	316
408	292s (+0.8s)	3060	3060	256	49	202	9	0	260
409	293s (+1.0s)	4040	4040	256	69	244	0	20	333
410	294s (+0.5s)	1548	1548	128	35	128	0	3	166
411	294s (+0.4s)	1340	1340	128	21	109	0	7	137
412	295s (+0.9s)	3700	3700	256	57	242	0	9	308
413	296s (+0.7s)	3108	3108	256	54	191	0	13	258
414	297s (+0.5s)	1656	1656	128	31	139	0	6	176
415	297s (+0.5s)	2208	2208	256	27	154	0	7	188
416	298s (+0.5s)	1752	1752	128	37	133	0	8	178
417	298s (+0.5s)	1744	1744	128	32	137	0	7	176
418	299s (+0.5s)	2116	2116	256	30	144	0	7	181
419	299s (+0.6s)	2308	2308	256	34	149	0	8	191
420	300s (+1.0s)	3972	3972	256	70	243	0	18	331
421	301s (+0.9s)	3856	3856	256	65	234	0	11	310
422	302s (+0.6s)	2224	2224	128	41	158	0	12	211
423	302s (+0.2s)	576	576	64	8	67	0	4	79
424	303s (+0.8s)	3508	3508	256	62	221	0	8	291
425	303s (+0.4s)	1404	1404	128	40	100	6	0	146
426	304s (+0.8s)	3304	3304	256	78	185	14	0	277
427	305s (+0.7s)	2796	2796	256	54	177	11	0	242
428	306s (+0.9s)	3856	3856	256	92	204	19	0	315
429	307s (+0.9s)	3672	3672	256	82	208	16	0	306
430	308s (+0.7s)	3088	3088	256	61	182	11	2	256
431	308s (+0.2s)	404	404	32	13	52	3	0	68
432	309s (+0.7s)	2944	2944	256	66	178	14	1	259
433	309s (+0.5s)	1516	1516	128	32	120	11	0	163
434	310s (+0.7s)	3072	3072	256	73	182	13	0	268
435	311s (+0.4s)	1288	1288	64	34	99	9	0	142
436	311s (+0.4s)	1344	1344	128	26	109	6	0	141
437	311s (+0.4s)	1352	1352	128	23	116	0	0	139
438	312s (+0.7s)	2672	2672	256	50	178	7	0	235
439	313s (+1.3s)	6356	6356	512	111	311	26	0	448
440	314s (+0.4s)	1184	1184	128	36	87	5	0	128
441	314s (+0.5s)	1636	1636	128	43	127	5	0	175
442	316s (+1.0s)	4272	4272	256	89	241	17	0	347
443	316s (+0.5s)	1956	1956	256	24	136	4	0	164
444	316s (+0.4s)	1188	1188	64	40	95	4	0	139
445	317s (+0.9s)	3612	3612	256	76	213	16	0	305
446	318s (+0.5s)	1596	1596	128	52	107	7	0	166
447	319s (+1.2s)	4144	4144	256	88	235	15	0	338
448	320s (+1.2s)	5848	5848	512	98	300	18	0	416
449	321s (+0.4s)	1332	1332	128	32	98	9	0	139
450	322s (+0.9s)	3752	3752	256	88	209	16	0	313
451	323s (+0.9s)	4064	4064	256	80	239	16	0	335
452	324s (+0.5s)	1792	1792	128	32	146	5	0	183
453	324s (+0.4s)	1400	1400	128	38	97	8	0	143
454	324s (+0.4s)	1440	1440	128	36	104	9	0	149
455	325s (+0.3s)	728	728	64	17	75	0	3	95
456	325s (+0.4s)	1200	1200	128	37	92	0	4	133
457	326s (+0.5s)	1688	1688	128	41	119	0	4	164
458	326s (+0.7s)	2676	2676	256	43	187	0	8	238
459	327s (+0.8s)	3244	3244	256	55	199	0	16	270
460	328s (+0.7s)	2512	2512	128	52	175	12	0	239
461	329s (+0.7s)	3132	3132	256	59	191	12	0	262
462	329s (+0.5s)	1784	1784	128	54	118	10	0	182
463	330s (+0.5s)	1672	1672	128	38	125	7	0	170
464	331s (+0.7s)	2752	2752	256	58	167	12	0	237
465	331s (+0.4s)	1316	1316	128	40	96	8	0	144
466	332s (+0.9s)	4752	4752	512	71	242	0	20	333
467	332s (+0.5s)	1784	1784	128	37	139	0	5	181
468	333s (+0.7s)	2796	2796	256	60	168	0	10	238
469	334s (+0.4s)	1152	1152	64	31	95	0	6	132
470	334s (+0.5s)	1620	1620	128	37	126	0	9	172
471	335s (+0.8s)	3536	3536	256	64	215	0	15	294
472	336s (+0.7s)	2932	2932	256	61	187	11	0	259
473	336s (+0.4s)	1428	1428	128	26	116	4	0	146
474	337s (+0.5s)	1652	1652	128	42	117	6	0	165
475	337s (+0.3s)	1060	1060	128	18	92	5	0	115
476	337s (+0.4s)	1280	1280	128	32	98	6	0	136
477	338s (+0.6s)	1932	1932	128	53	143	5	0	201
478	339s (+0.5s)	1816	1816	128	40	139	0	5	184
479	339s (+0.8s)	3108	3108	256	51	189	0	18	258
480	340s (+0.4s)	1040	1040	64	25	94	0	6	125
481	340s (+0.7s)	2880	2880	256	47	181	0	12	240
482	342s (+1.1s)	5456	5456	512	73	293	0	14	380
483	343s (+0.7s)	2976	2976	256	51	191	0	7	249
484	343s (+0.7s)	3140	3140	256	53	192	0	14	259
485	344s (+0.5s)	1444	1444	128	33	121	0	6	160
486	345s (+1.0s)	4364	4364	256	106	239	16	0	361
487	346s (+0.6s)	2612	2612	256	51	169	7	1	228
488	346s (+0.4s)	1200	1200	128	26	101	5	0	132
489	347s (+0.6s)	2268	2268	128	60	143	11	1	215
490	347s (+0.5s)	1548	1548	128	40	121	5	0	166
491	348s (+0.5s)	1732	1732	128	52	119	9	0	180
492	348s (+0.4s)	1212	1212	64	43	99	3	0	145
493	349s (+0.5s)	1492	1492	128	32	118	6	0	156
494	349s (+0.4s)	1212	1212	64	42	97	6	0	145
495	350s (+0.8s)	3720	3720	256	65	222	10	0	297
496	350s (+0.3s)	1080	1080	128	26	86	6	0	118
497	351s (+0.9s)	3812	3812	256	69	214	0	22	305
498	352s (+0.7s)	2968	2968	256	55	177	0	18	250
499	353s (+0.6s)	2168	2168	128	42	155	0	10	207
Episode	Time	Reward	Score	Highest	L	U	R	D	Steps
500	353s (+0.7s)	2864	2864	256	41	199	0	14	254
501	354s (+0.5s)	1788	1788	128	44	132	0	6	182
502	355s (+1.2s)	3928	3928	256	69	240	0	19	328
503	356s (+0.6s)	2444	2444	256	48	152	0	11	211
504	357s (+1.0s)	4152	4152	256	71	260	0	14	345
505	358s (+0.5s)	1804	1804	128	33	145	0	9	187
506	359s (+0.9s)	3800	3800	256	60	245	0	11	316
507	359s (+0.5s)	1628	1628	128	33	130	0	7	170
508	360s (+0.7s)	2616	2616	256	53	167	0	9	229
509	360s (+0.7s)	3192	3192	256	52	201	0	9	262
510	361s (+0.7s)	3092	3092	256	72	174	12	0	258
511	361s (+0.3s)	736	736	64	21	73	3	0	97
512	362s (+0.6s)	2108	2108	128	54	131	8	0	193
513	363s (+0.8s)	3672	3672	256	78	204	14	0	296
514	363s (+0.3s)	780	780	64	29	68	6	0	103
515	364s (+0.4s)	1284	1284	128	24	107	1	0	132
516	365s (+0.9s)	4008	4008	256	93	219	13	0	325
517	365s (+0.8s)	3284	3284	256	65	201	11	0	277
518	366s (+0.4s)	1348	1348	128	28	101	5	0	134
519	366s (+0.6s)	1896	1896	128	55	130	7	0	192
520	367s (+0.4s)	1324	1324	128	31	107	8	0	146
521	367s (+0.6s)	1940	1940	128	55	141	7	0	203
522	368s (+0.3s)	748	748	64	31	63	5	0	99
523	369s (+0.9s)	3976	3976	256	83	221	17	0	321
524	370s (+1.3s)	6604	6604	512	117	327	33	0	477
525	371s (+0.4s)	1188	1188	128	22	105	3	0	130
526	371s (+0.6s)	2464	2464	256	39	168	5	0	212
527	372s (+0.6s)	2432	2432	256	58	142	9	0	209
528	373s (+0.8s)	3352	3352	256	54	218	12	0	284
529	373s (+0.5s)	1776	1776	128	36	140	0	7	183
530	374s (+0.6s)	2624	2624	256	47	166	0	7	220
531	375s (+0.7s)	2972	2972	256	49	190	0	13	252
532	376s (+0.6s)	2496	2496	256	42	166	0	8	216
533	376s (+0.5s)	1516	1516	128	32	124	0	2	158
534	377s (+0.5s)	1784	1784	128	38	138	0	9	185
535	377s (+0.6s)	2052	2052	128	44	150	0	7	201
536	378s (+0.8s)	3332	3332	256	55	213	0	12	280
537	378s (+0.3s)	696	696	64	14	77	0	2	93
538	379s (+0.5s)	1700	1700	128	25	140	0	5	170
539	380s (+1.0s)	4312	4312	256	101	241	16	0	358
540	380s (+0.3s)	1088	1088	128	32	85	5	0	122
541	381s (+0.5s)	1860	1860	128	50	131	11	0	192
542	382s (+1.0s)	4028	4028	256	87	236	13	0	336
543	383s (+0.7s)	2784	2784	256	47	185	11	0	243
544	383s (+0.5s)	1820	1820	128	44	134	9	0	187
545	384s (+0.5s)	1796	1796	128	44	135	5	0	184
546	385s (+0.7s)	2696	2696	256	56	167	5	0	228
547	385s (+0.5s)	2104	2104	256	47	125	6	0	178
548	386s (+1.0s)	4292	4292	256	97	246	15	0	358
549	387s (+0.8s)	3380	3380	256	70	200	11	0	281
550	387s (+0.3s)	728	728	64	17	76	5	1	99
551	388s (+0.5s)	1628	1628	128	31	128	8	0	167
552	388s (+0.7s)	2928	2928	256	49	199	10	0	258
553	390s (+1.1s)	4716	4716	256	108	266	25	0	399
554	391s (+0.9s)	3964	3964	256	74	236	15	0	325
555	391s (+0.2s)	608	608	64	18	63	2	0	83
556	392s (+0.6s)	1884	1884	128	46	136	7	0	189
557	392s (+0.8s)	2988	2988	256	67	190	11	0	268
558	393s (+0.7s)	2620	2620	256	49	171	10	0	230
559	394s (+0.6s)	2264	2264	128	50	159	7	1	217
560	394s (+0.3s)	800	800	64	32	67	3	0	102
561	394s (+0.5s)	1764	1764	128	31	147	3	0	181
562	395s (+0.4s)	1324	1324	128	35	106	6	0	147
563	396s (+1.0s)	4920	4920	512	85	243	15	0	343
564	397s (+0.5s)	2028	2028	256	27	137	4	0	168
565	397s (+0.5s)	1656	1656	128	47	111	8	0	166
566	398s (+0.6s)	2292	2292	128	63	146	10	0	219
567	398s (+0.6s)	1932	1932	128	50	143	8	0	201
568	399s (+0.5s)	1580	1580	128	36	122	4	0	162
569	399s (+0.7s)	2792	2792	256	78	153	14	0	245
570	400s (+0.6s)	2232	2232	128	54	146	8	0	208
571	401s (+0.5s)	1836	1836	128	43	144	2	0	189
572	401s (+0.5s)	1520	1520	128	43	110	10	0	163
573	402s (+0.8s)	3488	3488	256	90	179	21	1	291
574	403s (+0.7s)	3036	3036	256	69	174	11	0	254
575	403s (+0.6s)	2264	2264	128	60	140	13	0	213
576	404s (+0.4s)	1376	1376	128	33	109	3	0	145
577	404s (+0.5s)	1784	1784	128	49	128	5	0	182
578	405s (+0.7s)	3020	3020	256	71	159	15	0	245
579	406s (+0.7s)	2728	2728	256	58	164	9	0	231
580	406s (+0.4s)	1292	1292	128	27	108	4	1	140
581	406s (+0.3s)	812	812	64	25	73	6	0	104
582	407s (+0.5s)	1872	1872	128	52	128	11	0	191
583	408s (+0.6s)	2120	2120	128	44	154	11	0	209
584	408s (+0.5s)	1816	1816	128	35	147	5	1	188
585	409s (+0.5s)	1960	1960	128	44	138	11	0	193
586	409s (+0.3s)	920	920	64	30	86	5	0	121
587	410s (+0.7s)	2524	2524	128	81	143	14	0	238
588	410s (+0.4s)	1272	1272	128	30	96	4	0	130
589	411s (+0.8s)	3192	3192	256	60	193	12	0	265
590	412s (+0.7s)	3104	3104	256	73	170	13	0	256
591	413s (+1.0s)	4312	4312	256	94	248	14	0	356
592	413s (+0.6s)	2256	2256	256	41	142	10	0	193
593	414s (+0.7s)	2928	2928	256	75	160	13	0	248
594	415s (+0.4s)	1408	1408	128	26	109	5	1	141
595	415s (+0.5s)	1508	1508	128	36	116	8	0	160
596	416s (+0.9s)	3604	3604	256	74	214	14	1	303
597	417s (+0.7s)	2476	2476	128	62	159	12	1	234
598	418s (+0.9s)	3840	3840	256	83	213	16	0	312
599	419s (+1.0s)	4188	4188	256	88	238	16	0	342
Episode	Time	Reward	Score	Highest	L	U	R	D	Steps
600	419s (+0.6s)	2276	2276	128	65	143	11	0	219
601	420s (+0.7s)	3176	3176	256	54	196	12	0	262
602	421s (+0.9s)	3840	3840	256	100	212	14	0	326
603	422s (+0.9s)	3960	3960	256	74	233	17	0	324
604	423s (+0.8s)	3480	3480	256	78	196	15	0	289
605	424s (+0.7s)	2756	2756	128	76	162	16	2	256
606	424s (+0.4s)	1548	1548	128	34	115	8	0	157
607	425s (+0.4s)	1476	1476	128	35	115	4	0	154
608	425s (+0.4s)	1496	1496	128	39	115	4	0	158
609	426s (+0.7s)	2812	2812	256	54	180	11	1	246
610	426s (+0.3s)	784	784	64	17	89	2	0	108
611	427s (+0.5s)	1832	1832	128	50	124	8	0	182
612	427s (+0.3s)	796	796	64	20	78	6	0	104
613	428s (+0.5s)	1824	1824	128	57	116	11	0	184
614	429s (+0.8s)	3436	3436	256	68	210	12	0	290
615	430s (+0.9s)	3608	3608	256	85	203	15	1	304
616	430s (+0.3s)	848	848	64	23	76	9	0	108
617	430s (+0.6s)	2352	2352	256	43	147	0	8	198
618	431s (+0.2s)	648	648	64	15	65	0	4	84
619	431s (+0.5s)	1772	1772	128	34	141	0	4	179
620	432s (+0.5s)	1504	1504	128	28	124	0	7	159
621	433s (+0.7s)	2612	2612	256	41	174	0	14	229
622	433s (+0.6s)	2036	2036	128	45	142	0	11	198
623	434s (+0.7s)	2600	2600	256	47	180	0	4	231
624	434s (+0.3s)	984	984	64	21	91	0	5	117
625	435s (+0.4s)	1380	1380	128	30	107	0	8	145
626	435s (+0.3s)	900	900	64	23	83	4	0	110
627	436s (+0.7s)	3016	3016	256	63	173	13	0	249
628	436s (+0.5s)	1676	1676	128	40	125	6	0	171
629	437s (+0.9s)	3768	3768	256	103	205	16	0	324
630	438s (+0.7s)	2884	2884	256	63	163	12	0	238
631	438s (+0.7s)	2500	2500	128	60	164	12	0	236
632	439s (+0.3s)	664	664	64	15	72	1	0	88
633	440s (+0.7s)	2844	2844	256	73	161	15	1	250
634	440s (+0.6s)	2496	2496	256	62	145	8	0	215
635	441s (+0.5s)	1752	1752	128	47	125	6	0	178
636	441s (+0.7s)	2676	2676	256	62	170	6	1	239
637	443s (+1.3s)	6212	6212	512	116	302	21	0	439
638	443s (+0.6s)	2236	2236	128	56	141	11	0	208
639	444s (+0.9s)	3552	3552	256	70	215	17	0	302
640	445s (+0.4s)	1356	1356	128	24	120	0	0	144
641	445s (+0.5s)	1692	1692	128	56	108	10	0	174
642	446s (+0.5s)	1772	1772	128	47	125	10	0	182
643	447s (+0.7s)	3100	3100	256	65	180	15	0	260
644	447s (+0.5s)	1364	1364	128	31	102	8	1	142
645	448s (+0.5s)	1108	1108	64	25	96	8	0	129
646	448s (+0.7s)	2744	2744	256	61	171	9	0	241
647	449s (+0.4s)	1376	1376	128	30	108	6	0	144
648	450s (+0.8s)	3028	3028	256	72	166	23	0	261
649	450s (+0.6s)	2556	2556	256	47	156	12	0	215
650	451s (+0.8s)	3504	3504	256	76	203	16	0	295
651	452s (+0.7s)	2924	2924	256	43	205	9	0	257
652	453s (+0.7s)	2952	2952	256	58	181	3	0	242
653	454s (+0.9s)	2748	2748	256	45	179	11	0	235
654	454s (+0.6s)	1812	1812	128	42	139	0	7	188
655	455s (+0.7s)	2632	2632	256	48	164	0	11	223
656	456s (+0.5s)	1808	1808	128	31	144	0	6	181
657	456s (+0.7s)	3044	3044	256	59	173	14	0	246
658	457s (+0.5s)	1792	1792	128	47	112	10	0	169
659	457s (+0.6s)	1968	1968	128	53	132	11	0	196
660	458s (+0.3s)	960	960	64	34	82	3	0	119
661	458s (+0.8s)	3476	3476	256	89	183	17	0	289
662	459s (+0.9s)	3424	3424	256	65	212	11	0	288
663	460s (+0.5s)	1456	1456	128	24	126	3	0	153
664	461s (+0.7s)	2744	2744	256	60	158	14	1	233
665	461s (+0.6s)	1992	1992	128	49	143	8	0	200
666	461s (+0.2s)	408	408	64	11	46	1	0	58
667	462s (+0.7s)	2788	2788	256	39	190	0	12	241
668	463s (+0.6s)	2468	2468	256	47	157	0	9	213
669	463s (+0.5s)	1596	1596	128	35	119	0	6	160
670	464s (+0.6s)	2532	2532	256	37	176	0	7	220
671	464s (+0.5s)	1592	1592	128	41	118	0	7	166
672	465s (+0.4s)	1456	1456	128	23	125	0	5	153
673	466s (+0.8s)	3108	3108	256	75	178	14	1	268
674	466s (+0.4s)	1372	1372	64	38	103	10	0	151
675	467s (+0.8s)	2936	2936	256	61	189	10	0	260
676	467s (+0.6s)	1956	1956	128	49	146	7	0	202
677	468s (+0.6s)	2480	2480	256	47	156	9	0	212
678	469s (+0.5s)	1812	1812	128	61	113	10	0	184
679	469s (+0.6s)	2784	2784	256	55	158	12	0	225
680	470s (+0.5s)	2128	2128	128	45	139	12	0	196
681	471s (+1.3s)	6472	6472	512	119	312	29	0	460
682	472s (+0.6s)	2616	2616	256	36	180	3	0	219
683	473s (+0.5s)	1828	1828	128	46	128	11	0	185
684	474s (+0.9s)	3700	3700	256	63	228	17	0	308
685	474s (+0.7s)	2820	2820	256	59	173	9	0	241
686	475s (+0.4s)	1296	1296	128	38	93	9	0	140
687	475s (+0.4s)	1392	1392	128	26	114	3	0	143
688	476s (+0.7s)	2400	2400	128	82	129	17	0	228
689	476s (+0.6s)	2440	2440	128	54	165	8	0	227
690	477s (+0.3s)	1028	1028	64	32	83	7	0	122
691	478s (+1.0s)	4120	4120	256	66	251	19	0	336
692	478s (+0.7s)	3092	3092	256	58	194	8	1	261
693	479s (+0.5s)	1608	1608	128	41	121	6	1	169
694	480s (+0.6s)	1948	1948	128	55	136	8	1	200
695	480s (+1.0s)	3876	3876	256	92	226	17	0	335
696	481s (+0.7s)	2960	2960	256	61	176	9	1	247
697	482s (+0.5s)	1868	1868	128	48	133	9	0	190
698	482s (+0.6s)	2732	2732	256	60	152	6	0	218
699	483s (+0.5s)	1912	1912	128	31	152	7	0	190
Episode	Time	Reward	Score	Highest	L	U	R	D	Steps
700	484s (+0.7s)	2816	2816	256	57	179	6	0	242
701	484s (+0.4s)	1356	1356	128	40	103	7	0	150
702	485s (+0.7s)	2920	2920	256	51	190	15	0	256
703	486s (+0.6s)	2572	2572	256	51	163	8	0	222
704	487s (+1.0s)	4304	4304	256	94	234	22	0	350
705	487s (+0.6s)	2528	2528	256	57	152	10	0	219
706	488s (+0.5s)	1900	1900	128	43	129	8	0	180
707	488s (+0.4s)	1440	1440	128	34	111	4	1	150
708	489s (+0.5s)	1916	1916	128	47	134	10	0	191
709	490s (+0.9s)	3860	3860	256	78	225	13	0	316
710	491s (+1.0s)	4124	4124	256	91	221	19	0	331
711	491s (+0.4s)	1244	1244	64	43	92	8	0	143
712	492s (+0.5s)	1920	1920	128	49	141	8	0	198
713	492s (+0.7s)	2780	2780	256	41	190	0	11	242
714	493s (+0.8s)	3240	3240	256	55	204	0	14	273
715	494s (+0.4s)	1440	1440	128	29	110	0	10	149
716	494s (+0.5s)	1752	1752	128	31	137	0	10	178
717	495s (+0.5s)	1744	1744	128	32	137	0	7	176
718	495s (+0.2s)	504	504	32	15	55	0	6	76
719	496s (+0.8s)	3504	3504	256	66	213	15	0	294
720	496s (+0.4s)	1424	1424	128	26	112	8	0	146
721	497s (+0.6s)	2376	2376	256	52	140	10	0	202
722	497s (+0.4s)	1176	1176	128	29	93	5	0	127
723	498s (+0.5s)	1596	1596	128	41	120	5	0	166
724	498s (+0.3s)	868	868	64	26	83	3	0	112
725	499s (+1.0s)	4200	4200	256	83	248	14	0	345
726	500s (+0.9s)	3532	3532	256	66	219	12	0	297
727	501s (+1.0s)	4420	4420	256	93	246	23	1	363
728	502s (+0.6s)	1904	1904	128	51	133	10	0	194
729	503s (+1.1s)	5516	5516	512	80	294	19	0	393
730	504s (+0.7s)	2820	2820	256	60	174	13	0	247
731	504s (+0.5s)	1788	1788	128	46	128	7	1	182
732	505s (+1.0s)	5392	5392	512	106	244	18	1	369
733	506s (+0.4s)	1308	1308	128	31	108	4	0	143
734	506s (+0.4s)	1424	1424	128	21	119	5	1	146
735	507s (+0.8s)	3228	3228	256	61	197	12	0	270
736	508s (+0.8s)	3372	3372	256	67	200	10	2	279
737	509s (+0.7s)	2916	2916	256	67	176	12	0	255
738	510s (+0.9s)	4632	4632	512	76	229	15	0	320
739	511s (+1.0s)	4144	4144	256	82	248	13	0	343
740	511s (+0.9s)	3612	3612	256	76	206	19	1	302
741	512s (+0.8s)	3360	3360	256	81	173	21	0	275
742	513s (+0.6s)	2668	2668	256	64	145	11	0	220
743	514s (+0.8s)	3412	3412	256	83	188	13	0	284
744	515s (+1.0s)	4228	4228	256	97	229	22	0	348
745	515s (+0.5s)	1760	1760	128	40	132	7	0	179
746	516s (+0.5s)	1616	1616	128	34	130	7	0	171
747	517s (+0.9s)	3728	3728	256	88	213	17	0	318
748	517s (+0.5s)	1776	1776	128	40	134	5	0	179
749	518s (+0.6s)	2308	2308	128	64	147	13	0	224
750	519s (+1.0s)	4296	4296	256	124	210	19	0	353
751	520s (+0.8s)	3460	3460	256	76	195	14	1	286
752	521s (+1.0s)	5264	5264	512	67	285	16	0	368
753	522s (+0.5s)	1792	1792	128	43	126	0	14	183
754	523s (+0.8s)	3072	3072	256	74	177	15	0	266
755	523s (+0.4s)	1060	1060	64	24	98	5	1	128
756	524s (+0.7s)	3116	3116	256	57	196	10	0	263
757	524s (+0.5s)	1784	1784	128	48	112	10	1	171
758	525s (+0.4s)	1388	1388	128	37	99	0	7	143
759	526s (+0.9s)	3912	3912	256	74	225	0	18	317
760	526s (+0.5s)	1852	1852	128	41	138	0	6	185
761	527s (+0.8s)	3368	3368	256	74	197	17	0	288
762	528s (+1.1s)	4640	4640	256	115	252	22	0	389
763	529s (+0.5s)	1772	1772	128	42	128	8	0	178
764	529s (+0.7s)	2768	2768	256	53	174	9	0	236
765	530s (+0.6s)	1956	1956	128	67	124	6	0	197
766	530s (+0.4s)	1380	1380	128	34	105	6	0	145
767	531s (+0.8s)	3176	3176	256	66	186	10	0	262
768	532s (+0.6s)	1928	1928	128	44	149	7	0	200
769	532s (+0.5s)	1904	1904	128	57	119	9	0	185
770	533s (+0.5s)	1784	1784	128	41	134	6	0	181
771	533s (+0.6s)	2484	2484	256	57	141	14	0	212
772	534s (+0.8s)	3308	3308	256	67	201	11	0	279
773	535s (+1.0s)	4088	4088	256	86	239	14	0	339
774	536s (+0.8s)	3316	3316	256	63	197	20	0	280
775	537s (+0.8s)	3380	3380	256	70	201	10	0	281
776	538s (+0.9s)	4188	4188	256	81	238	18	0	337
777	538s (+0.5s)	1632	1632	128	34	124	7	0	165
778	539s (+0.7s)	2876	2876	256	57	166	12	1	236
779	540s (+0.7s)	3116	3116	256	66	190	7	0	263
780	540s (+0.5s)	1748	1748	128	45	123	8	0	176
781	541s (+0.4s)	1552	1552	128	39	113	5	0	157
782	542s (+0.9s)	3876	3876	256	106	198	23	0	327
783	542s (+0.4s)	1484	1484	128	47	99	9	0	155
784	543s (+0.6s)	2352	2352	256	54	141	3	0	198
785	543s (+0.6s)	2492	2492	256	52	154	9	0	215
786	543s (+0.3s)	704	704	64	11	78	2	0	91
787	544s (+0.6s)	2468	2468	256	40	152	0	12	204
788	545s (+0.5s)	1756	1756	128	36	135	0	8	179
789	545s (+0.5s)	1500	1500	128	41	112	6	0	159
790	546s (+0.6s)	2456	2456	256	42	153	0	15	210
791	546s (+0.8s)	3068	3068	256	57	192	0	12	261
792	547s (+0.9s)	3580	3580	256	80	202	15	0	297
793	548s (+0.7s)	2700	2700	256	74	146	14	0	234
794	549s (+1.0s)	4360	4360	256	98	248	17	1	364
795	550s (+0.4s)	1344	1344	128	25	112	3	0	140
796	550s (+0.3s)	804	804	64	30	73	4	1	108
797	550s (+0.5s)	1852	1852	128	56	126	6	0	188
798	552s (+1.3s)	6412	6412	512	114	321	22	0	457
799	553s (+0.9s)	3672	3672	256	97	208	10	0	315
Episode	Time	Reward	Score	Highest	L	U	R	D	Steps
800	553s (+0.4s)	1320	1320	128	30	103	6	0	139
801	554s (+0.6s)	2404	2404	256	44	151	9	0	204
802	555s (+1.0s)	4388	4388	256	93	233	25	0	351
803	555s (+0.5s)	1840	1840	128	46	135	9	0	190
804	556s (+0.7s)	2856	2856	256	58	178	9	0	245
805	557s (+0.7s)	2888	2888	256	53	187	12	1	253
806	558s (+1.0s)	4280	4280	256	73	259	16	0	348
807	558s (+0.6s)	2456	2456	256	56	148	7	0	211
808	559s (+0.8s)	3452	3452	256	75	190	19	0	284
809	560s (+0.6s)	1816	1816	128	37	145	7	0	189
810	560s (+0.4s)	1444	1444	128	33	109	8	0	150
811	561s (+0.5s)	1648	1648	128	39	113	12	0	164
812	561s (+0.6s)	2492	2492	256	45	166	8	0	219
813	562s (+0.5s)	1648	1648	128	40	122	7	0	169
814	563s (+0.8s)	3524	3524	256	74	196	12	0	282
815	564s (+1.2s)	5760	5760	512	98	294	18	1	411
816	565s (+0.8s)	3364	3364	256	80	180	18	0	278
817	565s (+0.4s)	1176	1176	64	35	99	7	0	141
818	566s (+0.4s)	1404	1404	128	29	112	7	0	148
819	566s (+0.7s)	2744	2744	256	61	153	19	1	234
820	567s (+0.7s)	2956	2956	256	43	193	0	11	247
821	567s (+0.3s)	1112	1112	128	25	89	0	3	117
822	568s (+0.5s)	1800	1800	128	42	137	0	6	185
823	569s (+0.6s)	2268	2268	128	36	167	0	8	211
824	569s (+0.8s)	3260	3260	256	81	176	14	0	271
825	570s (+0.5s)	1704	1704	128	33	141	4	0	178
826	571s (+0.9s)	3868	3868	256	85	202	23	0	310
827	572s (+0.8s)	3536	3536	256	74	208	16	0	298
828	573s (+1.0s)	4908	4908	512	101	232	19	1	353
829	573s (+0.7s)	2860	2860	256	54	171	11	0	236
830	574s (+0.7s)	2908	2908	256	84	158	11	0	253
831	575s (+0.9s)	3512	3512	256	62	223	12	1	298
832	576s (+0.9s)	3620	3620	256	72	214	16	0	302
833	577s (+0.7s)	2708	2708	256	47	177	12	0	236
834	578s (+1.0s)	4588	4588	256	100	254	20	0	374
835	578s (+0.2s)	340	340	32	10	50	2	0	62
836	578s (+0.3s)	868	868	64	23	85	5	0	113
837	579s (+0.8s)	3304	3304	256	67	199	11	0	277
838	580s (+0.4s)	1360	1360	128	36	110	4	1	151
839	580s (+0.3s)	700	700	64	31	57	5	0	93
840	580s (+0.2s)	564	564	64	13	62	2	0	77
841	581s (+0.8s)	3332	3332	256	65	199	11	0	275
842	582s (+1.0s)	4200	4200	256	82	240	19	0	341
843	583s (+0.9s)	3988	3988	256	87	233	11	0	331
844	584s (+0.8s)	3396	3396	256	72	209	9	0	290
845	585s (+1.3s)	6620	6620	512	113	314	23	1	451
846	586s (+0.8s)	3496	3496	256	69	212	12	0	293
847	587s (+0.3s)	660	660	64	21	66	4	0	91
848	588s (+1.0s)	4272	4272	256	89	249	15	0	353
849	588s (+0.5s)	1692	1692	128	53	126	6	0	185
850	589s (+0.9s)	3516	3516	256	62	220	0	15	297
851	590s (+0.9s)	3872	3872	256	69	245	0	15	329
852	591s (+0.3s)	1124	1124	128	15	102	0	3	120
853	591s (+0.5s)	1792	1792	128	38	138	0	7	183
854	592s (+0.6s)	1964	1964	128	47	141	7	0	195
855	592s (+0.4s)	1444	1444	128	27	121	5	0	153
856	593s (+0.4s)	1184	1184	64	39	97	6	1	143
857	593s (+0.5s)	1820	1820	128	51	120	12	0	183
858	594s (+0.7s)	2784	2784	256	62	171	7	0	240
859	594s (+0.4s)	1540	1540	128	41	104	7	1	153
860	595s (+0.8s)	3324	3324	256	75	198	9	0	282
861	596s (+0.6s)	2776	2776	256	47	171	9	0	227
862	596s (+0.7s)	2660	2660	256	60	159	13	0	232
863	597s (+0.7s)	2800	2800	256	51	184	5	0	240
864	598s (+0.5s)	1488	1488	128	28	125	3	0	156
865	598s (+0.7s)	2876	2876	256	81	160	9	0	250
866	599s (+0.3s)	1204	1204	128	34	84	6	0	124
867	599s (+0.5s)	1604	1604	128	38	124	6	0	168
868	600s (+0.5s)	1884	1884	128	51	125	10	0	186
869	600s (+0.4s)	932	932	64	27	91	5	0	123
870	601s (+0.8s)	3412	3412	256	68	206	15	0	289
871	602s (+0.8s)	3252	3252	256	68	198	9	1	276
872	602s (+0.4s)	1144	1144	128	21	97	5	0	123
873	603s (+0.7s)	2888	2888	256	63	176	14	0	253
874	603s (+0.3s)	664	664	64	23	60	8	0	91
875	604s (+0.7s)	2916	2916	256	41	213	0	5	259
876	604s (+0.3s)	1036	1036	64	16	95	0	7	118
877	604s (+0.4s)	1416	1416	128	29	116	0	5	150
878	605s (+0.2s)	316	316	32	11	41	0	3	55
879	605s (+0.4s)	1220	1220	64	35	106	0	6	147
880	606s (+0.4s)	1432	1432	128	23	116	0	8	147
881	606s (+0.7s)	3100	3100	256	45	199	0	12	256
882	607s (+1.1s)	4540	4540	256	73	285	0	19	377
883	608s (+0.6s)	2412	2412	256	44	155	8	0	207
884	609s (+0.5s)	1608	1608	128	42	115	6	0	163
885	610s (+1.1s)	4352	4352	256	108	238	21	0	367
886	610s (+0.4s)	1180	1180	64	42	87	8	1	138
887	611s (+0.7s)	2928	2928	256	49	183	12	0	244
888	612s (+0.9s)	3952	3952	256	79	226	16	1	322
889	613s (+0.8s)	3232	3232	256	57	204	10	0	271
890	613s (+0.3s)	744	744	64	17	78	3	0	98
891	613s (+0.6s)	2292	2292	256	41	149	7	0	197
892	614s (+0.8s)	3452	3452	256	78	200	12	0	290
893	615s (+0.8s)	3316	3316	256	74	186	15	0	275
894	616s (+0.6s)	1876	1876	128	36	149	8	0	193
895	616s (+0.7s)	2616	2616	256	52	168	9	0	229
896	617s (+0.7s)	2888	2888	256	70	165	14	0	249
897	617s (+0.3s)	1028	1028	128	24	85	3	0	112
898	618s (+0.8s)	3164	3164	256	68	191	14	0	273
899	619s (+0.7s)	2920	2920	256	56	179	7	0	242
Episode	Time	Reward	Score	Highest	L	U	R	D	Steps
900	620s (+0.8s)	3292	3292	256	92	175	22	0	289
901	621s (+0.9s)	3876	3876	256	89	221	14	0	324
902	621s (+0.4s)	1032	1032	64	40	86	6	0	132
903	621s (+0.5s)	1756	1756	128	56	118	5	0	179
904	622s (+0.5s)	1780	1780	128	35	133	12	0	180
905	623s (+0.6s)	2524	2524	256	33	169	7	0	209
906	623s (+0.5s)	1504	1504	128	37	117	6	0	160
907	624s (+0.8s)	3360	3360	256	63	214	8	1	286
908	625s (+0.8s)	3508	3508	256	82	197	17	0	296
909	625s (+0.6s)	1908	1908	128	45	144	7	0	196
910	626s (+0.7s)	3184	3184	256	65	186	10	0	261
911	627s (+0.5s)	1632	1632	128	41	114	8	0	163
912	627s (+0.6s)	2380	2380	256	53	142	8	0	203
913	628s (+0.5s)	1828	1828	128	52	122	11	0	185
914	628s (+0.6s)	2492	2492	256	49	160	6	0	215
915	629s (+0.7s)	2744	2744	256	71	150	13	0	234
916	630s (+0.9s)	3832	3832	256	80	218	15	0	313
917	630s (+0.3s)	600	600	32	27	57	6	0	90
918	631s (+0.7s)	3212	3212	256	67	188	15	0	270
919	631s (+0.5s)	2312	2312	256	51	133	0	8	192
920	632s (+0.3s)	856	856	64	21	84	0	5	110
921	633s (+0.8s)	3448	3448	256	66	209	0	7	282
922	633s (+0.8s)	3404	3404	256	60	204	0	17	281
923	634s (+0.4s)	1176	1176	128	30	93	0	7	130
924	634s (+0.6s)	2464	2464	256	40	160	0	9	209
925	635s (+0.8s)	3252	3252	256	65	193	0	13	271
926	636s (+0.6s)	1900	1900	128	43	140	0	10	193
927	637s (+1.0s)	4324	4324	256	89	250	20	0	359
928	637s (+0.4s)	1364	1364	128	26	108	7	0	141
929	638s (+1.1s)	4636	4636	256	124	237	19	0	380
930	639s (+0.5s)	1444	1444	64	34	124	6	0	164
931	639s (+0.6s)	2180	2180	128	46	153	5	0	204
932	640s (+0.7s)	3104	3104	256	56	188	0	13	257
933	641s (+0.5s)	1764	1764	128	37	135	0	8	180
934	642s (+0.8s)	3556	3556	256	54	229	0	10	293
935	642s (+0.9s)	3532	3532	256	78	202	17	0	297
936	643s (+0.8s)	3316	3316	256	68	197	10	0	275
937	644s (+0.8s)	3472	3472	256	79	193	14	0	286
938	644s (+0.3s)	800	800	64	25	77	5	0	107
939	645s (+0.8s)	3336	3336	256	60	198	14	0	272
940	646s (+0.5s)	1872	1872	128	54	125	12	0	191
941	646s (+0.3s)	684	684	64	20	69	6	0	95
942	647s (+0.6s)	2384	2384	128	57	152	14	0	223
943	647s (+0.7s)	2356	2356	128	72	157	14	0	243
944	648s (+0.5s)	1664	1664	128	39	123	8	0	170
945	648s (+0.3s)	1160	1160	128	21	101	4	0	126
946	649s (+0.8s)	3568	3568	256	72	209	14	0	295
947	649s (+0.3s)	996	996	64	19	92	0	7	118
948	650s (+0.7s)	2660	2660	256	40	186	0	9	235
949	650s (+0.4s)	1464	1464	128	27	116	0	5	148
950	651s (+0.6s)	2552	2552	256	50	163	0	8	221
951	652s (+0.6s)	2428	2428	128	48	170	0	11	229
952	653s (+0.8s)	3336	3336	256	54	211	0	16	281
953	653s (+0.4s)	1492	1492	128	31	118	0	4	153
954	654s (+0.5s)	1716	1716	128	36	133	0	5	174
955	654s (+0.4s)	1072	1072	64	30	95	0	6	131
956	655s (+0.5s)	1600	1600	128	31	123	0	13	167
957	655s (+0.8s)	3096	3096	256	85	163	14	0	262
958	656s (+0.3s)	584	584	32	28	58	3	1	90
959	656s (+0.3s)	1104	1104	128	24	94	0	0	118
960	657s (+0.5s)	1912	1912	128	52	124	11	0	187
961	657s (+0.5s)	1620	1620	128	40	109	13	0	162
962	658s (+0.7s)	2972	2972	256	66	167	11	0	244
963	659s (+0.8s)	3344	3344	256	64	209	9	0	282
964	659s (+0.7s)	3196	3196	256	64	193	10	0	267
965	660s (+0.8s)	3472	3472	256	85	187	15	0	287
966	661s (+0.4s)	1492	1492	128	44	105	7	0	156
967	661s (+0.3s)	852	852	64	25	78	7	0	110
968	662s (+0.9s)	3780	3780	256	97	198	21	0	316
969	662s (+0.3s)	804	804	64	25	78	5	0	108
970	663s (+0.8s)	3284	3284	256	66	193	13	0	272
971	664s (+1.0s)	4200	4200	256	90	239	16	0	345
972	665s (+0.7s)	2736	2736	128	78	163	16	0	257
973	666s (+0.8s)	3336	3336	256	65	201	13	1	280
974	666s (+0.9s)	3584	3584	256	66	224	13	0	303
975	667s (+0.4s)	1488	1488	128	41	106	9	0	156
976	668s (+1.0s)	4352	4352	256	101	241	20	0	362
977	669s (+0.7s)	2968	2968	256	61	178	14	0	253
978	669s (+0.3s)	856	856	64	29	75	7	0	111
979	670s (+0.4s)	1444	1444	128	52	90	7	0	149
980	670s (+0.4s)	1408	1408	128	28	111	4	0	143
981	670s (+0.4s)	932	932	64	26	93	5	0	124
982	671s (+0.6s)	2404	2404	256	38	161	3	0	202
983	671s (+0.4s)	1544	1544	128	42	111	6	0	159
984	672s (+0.4s)	1212	1212	64	26	107	6	0	139
985	672s (+0.5s)	1528	1528	128	39	115	7	0	161
986	673s (+0.4s)	1428	1428	128	32	109	0	5	146
987	673s (+0.2s)	648	648	64	14	69	0	2	85
988	673s (+0.2s)	588	588	64	14	64	0	3	81
989	674s (+0.3s)	748	748	64	20	75	0	5	100
990	674s (+0.3s)	976	976	64	18	89	0	8	115
991	675s (+0.5s)	1876	1876	128	50	131	12	0	193
992	676s (+0.9s)	3624	3624	256	90	205	13	1	309
993	677s (+0.9s)	3884	3884	256	69	244	16	1	330
994	677s (+0.4s)	1276	1276	128	34	92	8	1	135
995	678s (+0.9s)	3964	3964	256	84	222	20	0	326
996	679s (+0.9s)	3952	3952	256	83	233	10	0	326
997	680s (+0.8s)	3080	3080	256	60	194	11	0	265
998	681s (+1.1s)	5508	5508	512	104	266	22	0	392
999	682s (+0.5s)	1768	1768	128	35	140	6	0	181
Episode	Time	Reward	Score	Highest	L	U	R	D	Steps
1000	683s (+1.0s)	3880	3880	256	91	235	14	0	340
1001	683s (+0.7s)	3116	3116	256	63	180	16	0	259
1002	684s (+0.9s)	3984	3984	256	82	230	16	0	328
1003	685s (+1.0s)	4992	4992	512	104	223	21	1	349
1004	686s (+0.3s)	996	996	64	29	81	8	0	118
1005	687s (+0.9s)	3592	3592	256	78	208	15	0	301
1006	687s (+0.4s)	1476	1476	128	38	108	7	0	153
1007	688s (+0.8s)	3412	3412	256	87	187	14	0	288
1008	688s (+0.4s)	1200	1200	128	27	94	7	0	128
1009	689s (+0.7s)	3020	3020	256	59	175	11	0	245
1010	690s (+0.6s)	2756	2756	256	50	162	12	0	224
1011	690s (+0.5s)	1504	1504	128	35	115	9	0	159
1012	691s (+0.5s)	1764	1764	128	42	134	5	0	181
1013	692s (+0.8s)	3356	3356	256	81	183	17	0	281
1014	692s (+0.9s)	3576	3576	256	74	220	9	0	303
1015	693s (+0.8s)	3248	3248	256	52	213	10	0	275
1016	694s (+0.5s)	1828	1828	128	44	143	4	0	191
1017	694s (+0.5s)	1692	1692	128	46	114	10	0	170
1018	695s (+0.7s)	2900	2900	256	64	185	7	0	256
1019	696s (+0.8s)	3440	3440	256	75	198	17	1	291
1020	696s (+0.6s)	1980	1980	128	62	131	9	0	202
1021	697s (+0.5s)	1764	1764	128	54	119	8	0	181
1022	698s (+0.7s)	2648	2648	256	55	171	6	0	232
1023	699s (+1.1s)	5512	5512	512	100	269	24	0	393
1024	699s (+0.7s)	3024	3024	256	52	188	11	0	251
1025	700s (+0.6s)	2800	2800	256	49	168	11	0	228
1026	701s (+1.0s)	4652	4652	256	112	225	22	1	360
1027	702s (+0.5s)	1836	1836	128	50	131	6	0	187
1028	702s (+0.4s)	1412	1412	128	33	110	6	0	149
1029	703s (+0.8s)	3284	3284	256	84	181	14	0	279
1030	704s (+0.8s)	2996	2996	128	76	179	12	0	267
1031	704s (+0.5s)	1800	1800	128	44	133	7	0	184
1032	705s (+0.8s)	3156	3156	256	61	193	13	1	268
1033	706s (+0.9s)	3588	3588	256	83	208	12	0	303
1034	707s (+0.9s)	4888	4888	512	92	226	15	1	334
1035	708s (+0.6s)	2204	2204	128	70	131	9	0	210
1036	708s (+0.4s)	1492	1492	128	40	113	4	0	157
1037	709s (+0.6s)	2064	2064	128	56	140	7	0	203
1038	710s (+0.7s)	2404	2404	128	64	155	9	0	228
1039	710s (+0.5s)	1608	1608	128	44	119	6	1	170
1040	711s (+0.6s)	1896	1896	128	47	137	9	0	193
1041	711s (+0.8s)	3488	3488	256	70	208	14	0	292
1042	712s (+0.5s)	1652	1652	128	51	117	7	0	175
1043	713s (+1.3s)	6220	6220	512	129	287	24	1	441
1044	714s (+0.7s)	3032	3032	256	67	177	9	0	253
1045	715s (+0.8s)	3252	3252	256	58	208	10	0	276
1046	716s (+0.6s)	2436	2436	256	46	154	6	0	206
1047	716s (+0.5s)	1792	1792	128	51	129	9	0	189
1048	717s (+0.7s)	2796	2796	256	67	159	16	0	242
1049	717s (+0.5s)	1796	1796	128	41	132	11	0	184
1050	718s (+1.0s)	4012	4012	256	87	227	23	0	337
1051	719s (+0.6s)	2536	2536	256	38	168	9	0	215
1052	720s (+0.7s)	2776	2776	256	56	174	6	0	236
1053	720s (+0.5s)	1668	1668	128	43	118	11	0	172
1054	721s (+0.5s)	1532	1532	128	37	119	6	0	162
1055	721s (+0.7s)	2544	2544	128	56	167	12	0	235
1056	722s (+0.5s)	1900	1900	128	39	145	9	0	193
1057	722s (+0.5s)	1620	1620	128	37	119	12	1	169
1058	723s (+0.9s)	3572	3572	256	69	225	13	0	307
1059	724s (+0.4s)	1204	1204	64	29	104	2	0	135
1060	724s (+0.7s)	3196	3196	256	74	171	21	0	266
1061	725s (+0.8s)	3460	3460	256	63	216	10	0	289
1062	726s (+0.4s)	1444	1444	128	31	109	8	0	148
1063	726s (+0.5s)	1656	1656	128	53	108	10	0	171
1064	727s (+0.7s)	3096	3096	256	63	181	10	0	254
1065	727s (+0.6s)	2024	2024	128	55	131	8	0	194
1066	728s (+0.7s)	2568	2568	128	74	155	17	2	248
1067	729s (+0.7s)	2824	2824	256	65	174	9	0	248
1068	730s (+0.7s)	2916	2916	256	68	177	10	0	255
1069	730s (+0.5s)	1608	1608	128	37	114	8	0	159
1070	731s (+0.8s)	4052	4052	256	76	217	12	2	307
1071	732s (+0.8s)	3348	3348	256	65	207	11	0	283
1072	732s (+0.3s)	928	928	64	27	84	2	0	113
1073	733s (+0.6s)	2508	2508	256	43	163	0	3	209
1074	733s (+0.7s)	2808	2808	256	47	192	0	6	245
1075	734s (+0.7s)	2972	2972	256	46	186	0	11	243
1076	734s (+0.4s)	1008	1008	64	23	93	0	7	123
1077	735s (+0.5s)	1756	1756	128	29	139	0	6	174
1078	736s (+0.9s)	3920	3920	256	75	233	1	11	320
1079	737s (+0.7s)	3000	3000	256	59	168	0	13	240
1080	737s (+0.7s)	2916	2916	256	57	190	0	9	256
1081	738s (+0.3s)	788	788	64	23	78	0	5	106
1082	739s (+1.1s)	5444	5444	512	78	285	0	19	382
1083	740s (+0.7s)	2928	2928	256	66	182	0	10	258
1084	740s (+0.3s)	1060	1060	64	21	96	0	6	123
1085	741s (+0.9s)	3616	3616	256	67	231	0	9	307
1086	742s (+0.8s)	3616	3616	256	68	212	0	13	293
1087	742s (+0.3s)	872	872	64	35	73	6	0	114
1088	743s (+0.6s)	2396	2396	128	57	150	19	0	226
1089	744s (+1.0s)	4516	4516	256	93	263	15	0	371
1090	745s (+0.4s)	1292	1292	128	19	116	4	0	139
1091	745s (+0.6s)	1996	1996	128	48	146	12	0	206
1092	746s (+0.4s)	1500	1500	128	40	112	6	0	158
1093	747s (+1.0s)	5096	5096	512	95	248	17	1	361
1094	748s (+0.9s)	3872	3872	256	95	203	14	0	312
1095	748s (+0.5s)	1756	1756	128	47	124	7	0	178
1096	749s (+0.8s)	3428	3428	256	70	202	15	1	288
1097	750s (+1.0s)	4172	4172	256	100	223	16	0	339
1098	751s (+0.6s)	2564	2564	256	48	159	6	0	213
1099	751s (+0.7s)	2752	2752	256	62	159	15	0	236
Episode	Time	Reward	Score	Highest	L	U	R	D	Steps
1100	752s (+0.3s)	1068	1068	128	34	78	4	0	116
1101	752s (+0.6s)	2364	2364	256	38	152	7	0	197
1102	753s (+0.8s)	3208	3208	256	61	192	16	0	269
1103	753s (+0.3s)	752	752	64	17	77	6	0	100
1104	754s (+0.7s)	3208	3208	256	76	174	14	1	265
1105	754s (+0.6s)	1936	1936	128	42	151	9	0	202
1106	755s (+0.5s)	1796	1796	128	33	144	7	0	184
1107	756s (+0.6s)	2464	2464	256	47	156	9	0	212
1108	756s (+0.3s)	792	792	64	34	61	10	0	105
1109	757s (+1.0s)	4284	4284	256	84	251	14	0	349
1110	758s (+0.8s)	3484	3484	256	74	202	15	0	291
1111	758s (+0.3s)	752	752	64	29	65	7	0	101
1112	759s (+0.8s)	3508	3508	256	67	210	14	0	291
1113	760s (+0.7s)	2748	2748	256	59	164	12	0	235
1114	760s (+0.4s)	1316	1316	128	20	112	0	3	135
1115	760s (+0.3s)	972	972	64	24	92	0	2	118
1116	761s (+0.6s)	1832	1832	128	34	150	0	9	193
1117	761s (+0.4s)	1056	1056	64	20	102	0	6	128
1118	762s (+0.8s)	3372	3372	256	64	214	0	11	289
1119	763s (+0.5s)	1664	1664	128	33	140	0	5	178
1120	764s (+0.8s)	3704	3704	256	63	228	0	11	302
1121	764s (+0.7s)	2468	2468	128	47	182	0	11	240
1122	765s (+0.5s)	1612	1612	128	44	121	2	0	167
1123	765s (+0.4s)	1512	1512	128	37	117	3	0	157
1124	766s (+0.6s)	1908	1908	128	62	123	10	0	195
1125	767s (+0.8s)	3584	3584	256	100	188	17	0	305
1126	767s (+0.6s)	2276	2276	128	62	148	8	1	219
1127	768s (+0.4s)	1336	1336	64	44	96	10	0	150
1128	768s (+0.5s)	1564	1564	128	35	119	8	0	162
1129	769s (+0.5s)	2088	2088	256	43	123	7	0	173
1130	769s (+0.5s)	1768	1768	128	45	124	9	0	178
1131	770s (+0.7s)	2744	2744	256	47	173	0	13	233
1132	770s (+0.5s)	1932	1932	128	42	134	0	11	187
1133	771s (+0.6s)	2416	2416	256	46	151	0	8	205
1134	771s (+0.5s)	1584	1584	128	35	118	5	0	158
1135	772s (+0.6s)	2632	2632	256	56	156	7	0	219
1136	773s (+1.2s)	5832	5832	512	91	305	19	2	417
1137	774s (+0.8s)	3132	3132	256	74	180	15	0	269
1138	775s (+0.6s)	2348	2348	256	37	156	6	0	199
1139	775s (+0.6s)	1920	1920	128	49	141	8	0	198
1140	776s (+0.4s)	1076	1076	64	34	85	10	0	129
1141	776s (+0.4s)	1356	1356	128	34	102	4	0	140
1142	777s (+0.6s)	2324	2324	256	55	139	12	0	206
1143	777s (+0.3s)	896	896	64	30	78	7	0	115
1144	778s (+0.5s)	1552	1552	128	26	130	4	0	160
1145	778s (+0.6s)	2592	2592	256	53	150	10	1	214
1146	779s (+0.4s)	1464	1464	128	39	109	6	0	154
1147	780s (+0.9s)	3972	3972	256	74	234	16	0	324
1148	780s (+0.3s)	1136	1136	128	32	84	6	0	122
1149	781s (+0.6s)	2368	2368	256	35	164	6	0	205
1150	781s (+0.7s)	3252	3252	256	77	181	13	1	272
1151	782s (+0.7s)	3084	3084	256	57	186	12	0	255
1152	783s (+0.7s)	2848	2848	256	79	162	8	1	250
1153	783s (+0.5s)	1640	1640	128	44	115	7	0	166
1154	784s (+0.5s)	1608	1608	128	48	112	9	0	169
1155	784s (+0.4s)	1324	1324	128	41	99	3	0	143
1156	785s (+0.9s)	4060	4060	256	82	234	17	0	333
1157	786s (+0.6s)	2240	2240	128	58	155	10	0	223
1158	786s (+0.7s)	3012	3012	256	55	182	11	0	248
1159	788s (+1.2s)	6032	6032	512	104	308	22	1	435
1160	788s (+0.6s)	2596	2596	256	50	158	10	0	218
1161	789s (+0.5s)	2116	2116	256	39	131	9	0	179
1162	789s (+0.3s)	904	904	64	33	80	4	0	117
1163	790s (+0.6s)	2512	2512	256	49	154	10	0	213
1164	790s (+0.5s)	1676	1676	128	49	114	8	0	171
1165	791s (+0.3s)	916	916	64	23	83	5	0	111
1166	791s (+0.6s)	2548	2548	256	49	165	4	0	218
1167	792s (+0.2s)	580	580	64	9	70	0	1	80
1168	792s (+0.4s)	1376	1376	128	23	116	0	6	145
1169	793s (+0.7s)	3068	3068	256	53	199	0	7	259
1170	793s (+0.2s)	652	652	64	12	72	0	2	86
1171	794s (+0.8s)	3644	3644	256	58	221	0	16	295
1172	795s (+0.6s)	2644	2644	256	42	180	0	3	225
1173	795s (+0.5s)	1832	1832	128	36	140	0	12	188
1174	796s (+0.5s)	1604	1604	128	30	129	0	9	168
1175	796s (+0.6s)	2588	2588	256	52	160	0	10	222
1176	797s (+0.8s)	3416	3416	256	65	205	0	15	285
1177	798s (+0.7s)	2784	2784	256	51	176	0	12	239
1178	799s (+1.3s)	6564	6564	512	137	319	23	0	479
1179	800s (+0.8s)	3556	3556	256	73	206	10	0	289
1180	801s (+0.9s)	3768	3768	256	74	220	14	0	308
1181	801s (+0.3s)	884	884	64	20	83	4	0	107
1182	802s (+0.5s)	1816	1816	128	37	144	7	0	188
1183	803s (+0.9s)	3856	3856	256	104	199	20	0	323
1184	804s (+0.4s)	1424	1424	128	29	115	2	0	146
1185	804s (+0.6s)	2472	2472	256	49	155	6	0	210
1186	805s (+0.6s)	2244	2244	128	56	151	4	1	212
1187	805s (+0.4s)	1384	1384	128	38	99	6	0	143
1188	806s (+0.6s)	2500	2500	256	47	163	6	0	216
1189	806s (+0.6s)	2472	2472	128	67	151	11	1	230
1190	807s (+0.9s)	3800	3800	256	72	233	11	0	316
1191	808s (+0.6s)	1984	1984	128	53	149	7	0	209
1192	809s (+0.9s)	3564	3564	256	75	214	13	0	302
1193	809s (+0.4s)	1020	1020	64	33	83	6	1	123
1194	810s (+0.7s)	2776	2776	256	61	165	10	1	237
1195	811s (+0.7s)	2768	2768	256	44	186	6	0	236
1196	811s (+0.4s)	1432	1432	128	40	100	7	0	147
1197	812s (+0.6s)	2544	2544	256	38	171	8	0	217
1198	812s (+0.6s)	2728	2728	256	60	159	12	0	231
1199	813s (+0.8s)	3448	3448	256	66	210	12	0	288
Episode	Time	Reward	Score	Highest	L	U	R	D	Steps
1200	814s (+0.7s)	3116	3116	256	76	172	11	1	260
1201	815s (+0.9s)	3660	3660	256	95	194	14	0	303
1202	815s (+0.7s)	2776	2776	256	59	166	13	0	238
1203	816s (+0.4s)	1444	1444	128	36	108	7	0	151
1204	816s (+0.5s)	1524	1524	128	28	125	5	0	158
1205	817s (+0.4s)	1060	1060	64	32	93	4	0	129
1206	817s (+0.5s)	1584	1584	128	35	123	6	0	164
1207	818s (+0.4s)	1480	1480	128	33	112	0	10	155
1208	818s (+0.7s)	3116	3116	256	46	196	0	10	252
1209	819s (+0.7s)	2908	2908	256	45	191	0	7	243
1210	820s (+0.6s)	2840	2840	256	50	174	0	8	232
1211	820s (+0.5s)	1688	1688	128	48	116	10	0	174
1212	820s (+0.4s)	1296	1296	128	31	99	5	0	135
1213	821s (+0.3s)	788	788	64	25	78	3	0	106
1214	821s (+0.5s)	1720	1720	128	42	119	0	10	171
1215	822s (+1.1s)	4396	4396	256	97	251	21	0	369
1216	823s (+0.7s)	2904	2904	256	62	176	14	0	252
1217	824s (+0.8s)	3240	3240	256	82	177	14	0	273
1218	824s (+0.4s)	1344	1344	128	39	95	7	0	141
1219	825s (+0.9s)	3908	3908	256	82	224	11	0	317
1220	826s (+1.3s)	6188	6188	512	106	314	19	0	439
1221	827s (+0.8s)	3320	3320	256	79	180	18	0	277
1222	828s (+0.6s)	2468	2468	256	51	152	8	0	211
1223	828s (+0.4s)	1484	1484	128	32	119	4	0	155
1224	829s (+0.5s)	1784	1784	128	43	132	6	0	181
1225	829s (+0.6s)	2460	2460	256	44	159	8	0	211
1226	830s (+0.4s)	1440	1440	128	32	112	5	0	149
1227	831s (+0.7s)	2904	2904	256	69	173	10	0	252
1228	831s (+0.3s)	904	904	64	25	78	5	0	108
1229	832s (+0.9s)	3620	3620	256	77	220	15	0	312
1230	832s (+0.5s)	1728	1728	128	48	112	11	1	172
1231	833s (+0.6s)	2536	2536	256	64	135	14	1	214
1232	834s (+0.8s)	3408	3408	256	59	212	12	0	283
1233	834s (+0.7s)	2700	2700	256	62	157	9	0	228
1234	835s (+0.7s)	2924	2924	256	53	192	12	0	257
1235	836s (+0.8s)	3272	3272	256	63	195	15	0	273
1236	837s (+0.8s)	3352	3352	256	74	186	17	1	278
1237	837s (+0.7s)	2780	2780	256	53	176	9	1	239
1238	838s (+0.8s)	3424	3424	256	63	214	10	0	287
1239	839s (+0.5s)	1608	1608	128	37	119	6	0	162
1240	839s (+0.8s)	3452	3452	256	74	198	14	1	287
1241	840s (+0.7s)	2900	2900	256	58	184	9	0	251
1242	841s (+0.7s)	2796	2796	256	56	175	10	0	241
1243	842s (+0.6s)	2532	2532	256	48	162	10	0	220
1244	842s (+0.9s)	3968	3968	256	73	231	13	0	317
1245	843s (+0.6s)	2460	2460	256	43	154	12	0	209
1246	844s (+1.1s)	5472	5472	512	104	259	25	0	388
1247	845s (+0.5s)	1704	1704	128	53	110	8	0	171
1248	846s (+0.7s)	3228	3228	256	69	188	13	0	270
1249	846s (+0.6s)	2504	2504	256	45	162	11	0	218
1250	847s (+1.1s)	5676	5676	512	110	273	19	0	402
1251	848s (+0.7s)	2920	2920	256	66	181	9	0	256
1252	849s (+0.5s)	1748	1748	128	36	132	5	0	173
1253	849s (+0.5s)	1644	1644	128	34	125	4	1	164
1254	850s (+0.5s)	1608	1608	128	32	124	7	1	164
1255	850s (+0.5s)	1656	1656	128	44	114	12	0	170
1256	851s (+0.8s)	3332	3332	256	64	193	13	0	270
1257	852s (+0.9s)	3976	3976	256	89	223	16	0	328
1258	853s (+0.8s)	3344	3344	256	60	213	9	0	282
1259	853s (+0.7s)	2896	2896	256	57	185	8	0	250
1260	854s (+0.4s)	1016	1016	64	30	87	6	0	123
1261	854s (+0.2s)	464	464	32	16	58	2	0	76
1262	855s (+0.5s)	1544	1544	128	45	114	6	0	165
1263	855s (+0.3s)	1080	1080	128	22	90	0	3	115
1264	855s (+0.4s)	1516	1516	128	45	106	0	6	157
1265	856s (+0.7s)	2788	2788	256	55	175	0	11	241
1266	857s (+0.7s)	2772	2772	256	44	187	0	7	238
1267	857s (+0.6s)	2048	2048	128	47	140	0	12	199
1268	858s (+0.8s)	3668	3668	256	83	200	17	0	300
1269	859s (+0.8s)	3352	3352	256	70	207	7	0	284
1270	859s (+0.3s)	676	676	64	14	77	2	0	93
1271	860s (+1.0s)	4284	4284	256	91	246	19	0	356
1272	861s (+0.3s)	1008	1008	128	14	89	5	0	108
1273	861s (+0.6s)	2072	2072	128	49	145	11	0	205
1274	862s (+0.5s)	1564	1564	128	46	111	6	0	163
1275	862s (+0.6s)	2508	2508	256	50	159	9	0	218
1276	863s (+0.3s)	860	860	64	27	77	7	0	111
1277	863s (+0.5s)	1612	1612	128	40	115	5	0	160
1278	864s (+0.8s)	3672	3672	256	74	213	13	1	301
1279	865s (+0.4s)	1464	1464	128	41	100	10	0	151
1280	865s (+0.5s)	1804	1804	128	44	134	8	0	186
1281	866s (+1.1s)	5316	5316	512	96	258	21	1	376
1282	867s (+0.5s)	1684	1684	128	46	118	9	0	173
1283	868s (+0.7s)	3008	3008	256	60	177	11	0	248
1284	868s (+0.8s)	3272	3272	256	65	192	13	0	270
1285	869s (+0.5s)	1876	1876	128	51	132	9	0	192
1286	870s (+0.8s)	3384	3384	256	71	203	8	0	282
1287	870s (+0.8s)	3248	3248	256	67	195	12	0	274
1288	871s (+0.8s)	3508	3508	256	87	190	18	1	296
1289	872s (+0.9s)	3756	3756	256	101	197	16	0	314
1290	873s (+0.4s)	1356	1356	128	30	98	6	0	134
1291	873s (+0.6s)	1960	1960	128	65	131	7	0	203
1292	874s (+0.6s)	2324	2324	128	61	150	12	0	223
1293	874s (+0.4s)	1496	1496	128	37	113	6	1	157
1294	875s (+0.8s)	3280	3280	256	65	198	13	0	276
1295	876s (+0.5s)	1536	1536	128	35	126	6	0	167
1296	876s (+0.3s)	1032	1032	128	23	83	6	0	112
1297	876s (+0.3s)	1164	1164	128	25	94	0	5	124
1298	877s (+0.8s)	3328	3328	256	59	205	0	15	279
1299	878s (+0.6s)	2444	2444	256	44	155	0	9	208
Episode	Time	Reward	Score	Highest	L	U	R	D	Steps
1300	878s (+0.4s)	1048	1048	64	29	91	0	6	126
1301	879s (+0.6s)	2612	2612	256	51	159	0	9	219
1302	879s (+0.4s)	1392	1392	128	22	123	0	3	148
1303	880s (+1.0s)	4832	4832	512	73	253	1	9	336
1304	881s (+1.0s)	4140	4140	256	65	261	0	16	342
1305	882s (+0.4s)	1132	1132	64	26	109	0	5	140
1306	882s (+0.8s)	3212	3212	256	45	212	0	9	266
1307	883s (+0.6s)	2556	2556	256	40	166	0	14	220
1308	883s (+0.4s)	1272	1272	128	19	103	0	7	129
1309	884s (+0.4s)	952	952	64	36	83	5	0	124
1310	884s (+0.4s)	1424	1424	128	34	108	3	0	145
1311	885s (+0.4s)	1436	1436	128	41	98	9	0	148
1312	885s (+0.8s)	3332	3332	256	67	195	17	0	279
1313	886s (+0.5s)	1588	1588	128	33	129	6	0	168
1314	887s (+0.7s)	2940	2940	256	68	178	10	0	256
1315	887s (+0.6s)	2524	2524	128	62	152	16	1	231
1316	888s (+0.7s)	2920	2920	256	54	179	9	1	243
1317	888s (+0.6s)	2492	2492	256	48	155	11	0	214
1318	889s (+0.7s)	3116	3116	256	65	169	19	0	253
1319	890s (+0.5s)	1596	1596	128	34	125	8	0	167
1320	890s (+0.7s)	2844	2844	256	70	160	16	0	246
1321	891s (+0.7s)	2856	2856	256	61	171	13	0	245
1322	892s (+0.6s)	2816	2816	256	60	154	12	0	226
1323	892s (+0.9s)	3596	3596	256	85	208	15	0	308
1324	893s (+0.5s)	2208	2208	256	39	145	8	0	192
1325	894s (+0.5s)	1536	1536	128	40	118	4	0	162
1326	894s (+0.3s)	892	892	128	14	77	0	3	94
1327	895s (+0.7s)	2672	2672	128	56	181	0	10	247
1328	896s (+0.9s)	3964	3964	256	59	248	0	18	325
1329	896s (+0.5s)	1744	1744	128	30	141	0	10	181
1330	897s (+0.7s)	3164	3164	256	68	182	8	1	259
1331	897s (+0.4s)	1112	1112	64	30	98	2	0	130
1332	898s (+0.7s)	3068	3068	256	59	179	14	0	252
1333	898s (+0.5s)	2084	2084	128	49	141	7	0	197
1334	899s (+0.6s)	2168	2168	128	54	138	9	0	201
1335	900s (+0.5s)	2000	2000	128	51	131	10	0	192
1336	900s (+0.7s)	2776	2776	256	67	157	10	0	234
1337	901s (+0.7s)	3024	3024	256	80	158	13	0	251
1338	902s (+1.0s)	5236	5236	512	98	250	19	0	367
1339	902s (+0.4s)	1148	1148	64	33	98	3	0	134
1340	903s (+0.5s)	1788	1788	128	44	126	12	0	182
1341	904s (+0.9s)	3764	3764	256	78	209	15	0	302
1342	905s (+0.8s)	3552	3552	256	78	194	22	2	296
1343	905s (+0.5s)	1800	1800	128	43	135	6	0	184
1344	906s (+1.0s)	5352	5352	512	98	256	16	1	371
1345	907s (+0.3s)	1012	1012	128	30	74	3	0	107
1346	907s (+0.6s)	2420	2420	256	56	137	9	0	202
1347	908s (+0.6s)	2548	2548	256	59	145	13	0	217
1348	909s (+1.2s)	5768	5768	512	107	283	18	0	408
1349	910s (+0.5s)	1796	1796	128	59	115	11	0	185
1350	910s (+0.8s)	3468	3468	256	93	187	11	0	291
1351	911s (+0.3s)	684	684	64	19	71	3	0	93
1352	911s (+0.3s)	964	964	128	17	84	5	0	106
1353	912s (+1.0s)	5068	5068	512	84	260	18	0	362
1354	913s (+0.6s)	2080	2080	128	43	142	7	0	192
1355	914s (+1.2s)	5624	5624	512	127	260	17	0	404
1356	915s (+0.7s)	2832	2832	256	65	173	12	0	250
1357	915s (+0.5s)	1628	1628	128	32	136	0	6	174
1358	916s (+0.7s)	2800	2800	256	59	173	0	11	243
1359	916s (+0.5s)	1900	1900	128	46	142	4	1	193
1360	917s (+0.6s)	1932	1932	128	46	147	8	0	201
1361	918s (+1.2s)	5824	5824	512	133	266	18	0	417
1362	918s (+0.4s)	1388	1388	128	39	100	9	0	148
1363	919s (+0.9s)	3860	3860	256	75	222	19	0	316
1364	920s (+0.6s)	2108	2108	128	45	149	12	0	206
1365	920s (+0.4s)	1492	1492	128	32	117	8	0	157
1366	921s (+0.5s)	1688	1688	128	35	132	6	0	173
1367	922s (+0.7s)	3092	3092	256	58	185	14	0	257
1368	922s (+0.5s)	1816	1816	128	47	133	8	0	188
1369	923s (+0.7s)	3128	3128	256	49	191	0	14	254
1370	924s (+0.7s)	2948	2948	256	45	206	0	8	259
1371	924s (+0.7s)	2968	2968	256	56	179	0	9	244
1372	925s (+0.6s)	2344	2344	256	38	150	0	9	197
1373	925s (+0.2s)	572	572	64	15	62	0	1	78
1374	926s (+0.5s)	1784	1784	128	45	127	0	9	181
1375	926s (+0.3s)	1028	1028	128	13	90	0	5	108
1376	926s (+0.4s)	1356	1356	128	44	97	9	0	150
1377	927s (+0.3s)	848	848	64	22	83	3	0	108
1378	927s (+0.2s)	632	632	64	25	56	6	0	87
1379	928s (+0.9s)	3716	3716	256	76	235	15	0	326
1380	928s (+0.4s)	1144	1144	128	32	90	2	0	124
1381	929s (+0.3s)	1036	1036	128	25	80	5	0	110
1382	929s (+0.7s)	2816	2816	256	52	184	10	0	246
1383	930s (+0.6s)	2124	2124	128	57	137	8	1	203
1384	931s (+0.6s)	2552	2552	256	62	143	14	0	219
1385	931s (+0.6s)	2556	2556	256	51	167	5	0	223
1386	932s (+0.5s)	1960	1960	128	41	142	11	0	194
1387	933s (+1.2s)	5844	5844	512	134	266	20	0	420
1388	934s (+1.0s)	4104	4104	256	103	226	14	0	343
1389	935s (+0.4s)	1388	1388	128	28	113	6	0	147
1390	935s (+0.6s)	2604	2604	256	38	178	0	10	226
1391	936s (+0.5s)	1772	1772	128	42	131	0	6	179
1392	936s (+0.4s)	1192	1192	64	35	105	5	0	145
1393	937s (+0.6s)	1932	1932	128	47	145	9	0	201
1394	938s (+1.0s)	4276	4276	256	94	240	21	0	355
1395	938s (+0.7s)	3164	3164	256	55	196	8	0	259
1396	939s (+0.6s)	1892	1892	128	46	135	10	0	191
1397	940s (+0.8s)	3212	3212	256	62	192	11	2	267
1398	940s (+0.5s)	1792	1792	128	37	139	6	0	182
1399	941s (+0.5s)	1608	1608	128	48	114	7	0	169
Episode	Time	Reward	Score	Highest	L	U	R	D	Steps
1400	942s (+1.0s)	4340	4340	256	106	217	20	0	343
1401	942s (+0.6s)	1960	1960	128	41	161	0	1	203
1402	943s (+0.3s)	1116	1116	128	18	100	0	4	122
1403	944s (+1.1s)	5712	5712	512	114	260	24	1	399
1404	944s (+0.4s)	1476	1476	128	25	125	3	0	153
1405	945s (+0.8s)	3404	3404	256	83	197	12	0	292
1406	946s (+0.4s)	1224	1224	64	39	94	5	0	138
1407	947s (+1.0s)	4244	4244	256	107	233	18	0	358
1408	947s (+0.8s)	3536	3536	256	77	195	11	1	284
1409	948s (+0.5s)	1900	1900	128	50	132	8	0	190
1410	949s (+0.6s)	1916	1916	128	44	149	4	0	197
1411	949s (+0.4s)	1176	1176	128	24	98	5	0	127
1412	949s (+0.5s)	1628	1628	128	48	114	7	1	170
1413	950s (+0.3s)	744	744	64	27	67	3	1	98
1414	950s (+0.7s)	2924	2924	256	51	182	10	0	243
1415	951s (+0.5s)	1876	1876	128	49	134	9	1	193
1416	952s (+0.7s)	2728	2728	256	50	179	8	0	237
1417	952s (+0.6s)	2452	2452	256	53	146	11	0	210
1418	953s (+0.8s)	3760	3760	256	86	206	14	0	306
1419	954s (+0.6s)	2376	2376	256	54	135	13	0	202
1420	954s (+0.8s)	3508	3508	256	91	178	23	1	293
1421	955s (+0.5s)	1640	1640	128	39	118	9	0	166
1422	955s (+0.5s)	1612	1612	128	34	133	3	0	170
1423	956s (+0.8s)	3432	3432	256	68	206	15	0	289
1424	957s (+0.8s)	3156	3156	256	59	194	11	0	264
1425	958s (+1.4s)	6892	6892	512	145	336	20	0	501
1426	959s (+0.5s)	1536	1536	128	39	120	3	1	163
1427	960s (+0.6s)	2532	2532	256	46	163	11	0	220
1428	960s (+0.5s)	1616	1616	128	44	123	4	0	171
1429	961s (+0.6s)	2268	2268	256	43	145	9	0	197
1430	961s (+0.5s)	1776	1776	128	44	126	9	0	179
1431	962s (+0.8s)	3396	3396	256	80	184	17	0	281
1432	963s (+0.5s)	1876	1876	128	45	126	7	0	178
1433	963s (+0.8s)	3340	3340	256	68	202	11	0	281
1434	964s (+0.7s)	3116	3116	256	67	187	9	0	263
1435	965s (+0.5s)	1940	1940	128	51	130	8	0	189
1436	966s (+1.0s)	4248	4248	256	96	237	19	0	352
1437	966s (+0.6s)	2028	2028	128	45	150	8	0	203
1438	968s (+1.1s)	4440	4440	256	103	251	14	0	368
1439	968s (+0.3s)	944	944	64	26	84	5	0	115
1440	968s (+0.4s)	1428	1428	128	26	113	6	0	145
1441	969s (+0.2s)	624	624	64	15	66	2	0	83
1442	969s (+0.5s)	1668	1668	128	43	120	7	0	170
1443	969s (+0.4s)	1348	1348	128	24	114	0	1	139
1444	970s (+0.7s)	3332	3332	256	63	195	0	12	270
1445	971s (+0.4s)	1168	1168	128	32	90	0	6	128
1446	971s (+0.7s)	2724	2724	256	52	166	0	12	230
1447	972s (+0.7s)	2856	2856	256	57	179	0	9	245
1448	972s (+0.3s)	1072	1072	128	21	92	3	0	116
1449	973s (+0.5s)	1600	1600	128	56	98	7	0	161
1450	974s (+1.0s)	4228	4228	256	70	256	20	1	347
1451	975s (+1.0s)	4348	4348	256	92	251	18	0	361
1452	975s (+0.5s)	2080	2080	128	46	132	18	0	196
1453	976s (+0.6s)	2188	2188	128	43	152	12	0	207
1454	976s (+0.5s)	1800	1800	128	37	139	9	0	185
1455	977s (+0.8s)	3396	3396	256	77	194	12	0	283
1456	978s (+0.8s)	3196	3196	256	70	185	12	0	267
1457	979s (+0.7s)	2936	2936	256	74	159	13	0	246
1458	979s (+0.5s)	1688	1688	128	49	117	8	0	174
1459	980s (+0.8s)	3464	3464	256	75	196	14	1	286
1460	981s (+0.5s)	2128	2128	256	43	132	9	0	184
1461	981s (+0.8s)	3444	3444	256	76	205	10	1	292
1462	982s (+0.4s)	1504	1504	128	28	124	7	0	159
1463	982s (+0.5s)	1824	1824	128	57	123	10	0	190
1464	983s (+0.4s)	1328	1328	128	38	96	5	1	140
1465	983s (+0.2s)	484	484	32	11	64	0	3	78
1466	984s (+0.6s)	1920	1920	128	49	139	0	10	198
1467	984s (+0.7s)	2476	2476	128	55	162	0	14	231
1468	985s (+0.5s)	1636	1636	128	41	124	0	10	175
1469	985s (+0.7s)	2716	2716	256	52	173	0	7	232
1470	986s (+0.8s)	3576	3576	256	60	217	0	15	292
1471	987s (+0.7s)	3024	3024	256	45	190	0	10	245
1472	988s (+0.6s)	2048	2048	128	41	148	0	10	199
1473	988s (+0.4s)	1460	1460	128	18	126	0	5	149
1474	988s (+0.5s)	1792	1792	128	38	139	0	6	183
1475	989s (+0.8s)	3436	3436	256	58	211	0	21	290
1476	990s (+0.7s)	2892	2892	256	51	187	12	0	250
1477	991s (+0.5s)	1832	1832	128	41	145	6	0	192
1478	991s (+0.3s)	984	984	64	25	81	9	0	115
1479	992s (+0.8s)	3288	3288	256	85	180	14	1	280
1480	993s (+0.8s)	3620	3620	256	68	221	18	0	307
1481	993s (+0.6s)	2620	2620	256	43	166	9	0	218
1482	994s (+0.7s)	2832	2832	256	63	164	13	0	240
1483	994s (+0.3s)	756	756	64	23	72	6	0	101
1484	995s (+0.5s)	1860	1860	128	33	154	2	0	189
1485	996s (+0.8s)	3556	3556	256	87	193	17	0	297
1486	996s (+0.7s)	3052	3052	256	61	187	10	0	258
1487	997s (+0.4s)	988	988	64	35	84	7	0	126
1488	997s (+0.6s)	2644	2644	256	60	153	12	0	225
1489	998s (+0.9s)	3620	3620	256	76	219	12	0	307
1490	999s (+0.9s)	4124	4124	256	88	231	18	0	337
1491	1000s (+0.7s)	2844	2844	256	60	175	11	1	247
1492	1000s (+0.4s)	1052	1052	64	27	94	6	0	127
1493	1001s (+0.8s)	3324	3324	256	81	183	12	1	277
1494	1002s (+0.6s)	1884	1884	128	48	137	9	0	194
1495	1002s (+0.6s)	1956	1956	128	51	148	8	0	207
1496	1003s (+1.3s)	6704	6704	512	141	291	30	0	462
1497	1004s (+0.6s)	2076	2076	128	47	153	10	0	210
1498	1005s (+0.6s)	1904	1904	128	44	144	6	0	194
1499	1005s (+0.4s)	1148	1148	128	22	99	3	0	124
Episode	Time	Reward	Score	Highest	L	U	R	D	Steps
1500	1006s (+0.8s)	3296	3296	256	71	192	12	1	276
1501	1007s (+0.8s)	3540	3540	256	77	200	16	0	293
1502	1007s (+0.4s)	1300	1300	128	45	91	6	0	142
1503	1008s (+0.9s)	3784	3784	256	91	214	16	0	321
1504	1009s (+0.5s)	1808	1808	128	36	135	9	0	180
1505	1010s (+1.0s)	4292	4292	256	87	250	15	0	352
1506	1010s (+0.8s)	3528	3528	256	68	221	7	0	296
1507	1011s (+0.4s)	1304	1304	128	29	108	5	0	142
1508	1011s (+0.4s)	1464	1464	128	43	106	3	0	152
1509	1012s (+0.5s)	1796	1796	128	47	133	3	1	184
1510	1012s (+0.4s)	1428	1428	128	34	104	8	0	146
1511	1013s (+0.5s)	1772	1772	128	41	130	7	0	178
1512	1013s (+0.5s)	1584	1584	128	36	120	7	0	163
1513	1014s (+0.3s)	876	876	64	29	81	5	0	115
1514	1014s (+0.7s)	3280	3280	256	61	192	12	0	265
1515	1015s (+0.8s)	3416	3416	256	73	199	13	0	285
1516	1016s (+0.4s)	1492	1492	128	33	106	8	0	147
1517	1016s (+0.5s)	1652	1652	128	55	105	9	0	169
1518	1017s (+0.5s)	1644	1644	128	30	131	0	6	167
1519	1017s (+0.7s)	2800	2800	256	45	190	0	7	242
1520	1018s (+1.0s)	4924	4924	512	74	263	0	15	352
1521	1019s (+1.1s)	5456	5456	512	69	295	0	20	384
1522	1020s (+0.5s)	1908	1908	128	40	143	0	12	195
1523	1021s (+0.5s)	1732	1732	128	34	133	0	7	174
1524	1021s (+0.8s)	3504	3504	256	56	226	0	10	292
1525	1022s (+0.4s)	1160	1160	64	33	95	9	0	137
1526	1023s (+0.7s)	2776	2776	128	68	172	17	0	257
1527	1023s (+0.7s)	3032	3032	256	63	187	11	0	261
1528	1024s (+0.4s)	1080	1080	64	36	90	7	0	133
1529	1024s (+0.4s)	1172	1172	64	42	92	6	0	140
1530	1025s (+0.7s)	3068	3068	256	59	182	0	11	252
1531	1025s (+0.6s)	2300	2300	128	36	177	0	6	219
1532	1026s (+0.2s)	676	676	64	18	65	0	5	88
1533	1026s (+0.2s)	348	348	32	16	44	0	4	64
1534	1026s (+0.3s)	816	816	64	21	78	5	1	105
1535	1027s (+0.9s)	3784	3784	256	81	217	14	0	312
1536	1028s (+0.5s)	1816	1816	128	53	131	5	0	189
1537	1028s (+0.5s)	1840	1840	128	48	127	12	1	188
1538	1029s (+0.7s)	2896	2896	256	56	169	11	0	236
1539	1030s (+0.7s)	2816	2816	256	64	171	11	0	246
1540	1030s (+0.4s)	1356	1356	128	37	89	12	1	139
1541	1031s (+0.5s)	1616	1616	128	45	117	9	0	171
1542	1031s (+0.5s)	1604	1604	128	40	120	8	0	168
1543	1032s (+0.6s)	1936	1936	128	45	147	10	0	202
1544	1032s (+0.8s)	3232	3232	256	81	174	15	1	271
1545	1033s (+0.4s)	1504	1504	128	39	116	5	0	160
1546	1033s (+0.3s)	948	948	64	23	85	3	0	111
1547	1034s (+0.6s)	2024	2024	128	46	145	11	0	202
1548	1034s (+0.4s)	1336	1336	128	29	102	4	0	135
1549	1035s (+0.9s)	4152	4152	256	82	224	19	1	326
1550	1035s (+0.3s)	1020	1020	128	22	81	3	0	106
1551	1036s (+0.4s)	1656	1656	128	38	116	0	9	163
1552	1037s (+0.8s)	3408	3408	256	82	189	12	0	283
1553	1037s (+0.5s)	1696	1696	128	36	136	0	4	176
1554	1038s (+0.6s)	2444	2444	256	43	158	7	0	208
1555	1038s (+0.4s)	1620	1620	128	36	123	4	0	163
1556	1039s (+0.7s)	2720	2720	256	52	171	0	10	233
1557	1039s (+0.2s)	288	288	32	7	46	0	3	56
1558	1040s (+0.7s)	2828	2828	256	48	187	0	15	250
1559	1041s (+0.8s)	3168	3168	256	88	167	19	1	275
1560	1042s (+1.0s)	4264	4264	256	94	238	17	0	349
1561	1042s (+0.3s)	1044	1044	64	25	87	7	0	119
1562	1043s (+0.8s)	3552	3552	256	79	200	16	0	295
1563	1044s (+0.8s)	3868	3868	256	82	213	15	0	310
1564	1044s (+0.5s)	1796	1796	128	40	130	8	0	178
1565	1045s (+0.5s)	1952	1952	128	43	131	7	1	182
1566	1046s (+1.0s)	4124	4124	256	97	215	24	1	337
1567	1046s (+0.8s)	3204	3204	256	75	191	13	0	279
1568	1047s (+1.0s)	4812	4812	512	77	252	13	0	342
1569	1048s (+0.5s)	1704	1704	128	43	115	10	0	168
1570	1048s (+0.4s)	1172	1172	128	23	99	3	0	125
1571	1049s (+0.6s)	2012	2012	128	60	123	16	0	199
1572	1050s (+0.8s)	3228	3228	256	62	199	10	0	271
1573	1050s (+0.6s)	2444	2444	128	63	148	14	1	226
1574	1051s (+0.8s)	3556	3556	256	61	225	10	0	296
1575	1052s (+0.7s)	2720	2720	256	47	172	10	0	229
1576	1052s (+0.5s)	1788	1788	128	56	117	9	0	182
1577	1053s (+0.8s)	3156	3156	256	65	188	11	0	264
1578	1054s (+0.5s)	1884	1884	128	60	118	7	0	185
1579	1054s (+0.7s)	2872	2872	256	76	162	11	0	249
1580	1055s (+0.5s)	2008	2008	128	46	133	14	0	193
1581	1055s (+0.2s)	692	692	64	14	71	4	0	89
1582	1056s (+0.3s)	988	988	64	40	81	5	0	126
1583	1056s (+0.6s)	2728	2728	256	63	158	9	0	230
1584	1057s (+0.5s)	1672	1672	128	54	114	11	0	179
1585	1058s (+1.0s)	4160	4160	256	90	233	19	0	342
1586	1059s (+1.3s)	6436	6436	512	142	287	26	0	455
1587	1060s (+0.5s)	1804	1804	128	41	136	9	0	186
1588	1061s (+1.0s)	4228	4228	256	94	237	16	0	347
1589	1061s (+0.7s)	2904	2904	256	54	190	8	0	252
1590	1062s (+0.3s)	880	880	64	23	77	6	0	106
1591	1062s (+0.5s)	1716	1716	128	50	116	11	0	177
1592	1063s (+0.8s)	3212	3212	256	58	199	9	0	266
1593	1064s (+0.9s)	4016	4016	256	80	234	17	0	331
1594	1065s (+0.6s)	1972	1972	128	54	147	5	0	206
1595	1065s (+0.5s)	2120	2120	256	40	136	6	0	182
1596	1066s (+0.5s)	1636	1636	128	45	122	8	0	175
1597	1066s (+0.4s)	1596	1596	128	41	111	6	0	158
1598	1067s (+0.5s)	1504	1504	128	36	122	3	0	161
1599	1067s (+0.8s)	3428	3428	256	89	183	9	0	281
Episode	Time	Reward	Score	Highest	L	U	R	D	Steps
1600	1069s (+1.2s)	6092	6092	512	118	285	27	0	430
1601	1070s (+1.2s)	5976	5976	512	94	316	26	0	436
1602	1071s (+0.5s)	1836	1836	128	50	132	5	0	187
1603	1071s (+0.5s)	1828	1828	128	44	135	6	0	185
1604	1072s (+0.9s)	4148	4148	256	80	236	16	0	332
1605	1073s (+0.6s)	2624	2624	256	66	152	13	0	231
1606	1073s (+0.4s)	1136	1136	64	37	86	9	0	132
1607	1074s (+0.4s)	1300	1300	128	31	103	7	0	141
1608	1075s (+0.9s)	3916	3916	256	87	215	15	0	317
1609	1075s (+0.5s)	1920	1920	128	36	138	8	1	183
1610	1076s (+0.4s)	1464	1464	128	34	112	8	0	154
1611	1076s (+0.7s)	3112	3112	256	63	180	13	2	258
1612	1077s (+0.7s)	3080	3080	256	47	198	0	10	255
1613	1078s (+0.5s)	1736	1736	128	34	130	0	11	175
1614	1078s (+0.4s)	1220	1220	128	32	90	1	8	131
1615	1078s (+0.4s)	1180	1180	128	25	98	4	0	127
1616	1079s (+0.6s)	2168	2168	128	72	137	11	0	220
1617	1080s (+0.8s)	3468	3468	256	55	226	5	0	286
1618	1080s (+0.4s)	1476	1476	128	42	101	10	0	153
1619	1081s (+0.5s)	1788	1788	128	52	122	8	0	182
1620	1082s (+1.0s)	4192	4192	256	97	226	16	0	339
1621	1082s (+0.3s)	824	824	64	26	82	5	0	113
1622	1083s (+0.5s)	1748	1748	128	35	136	7	0	178
1623	1083s (+0.7s)	2808	2808	256	55	177	0	9	241
1624	1084s (+0.8s)	3424	3424	256	52	222	0	13	287
1625	1084s (+0.4s)	1388	1388	128	37	106	0	4	147
1626	1085s (+0.7s)	2764	2764	256	41	184	0	10	235
1627	1086s (+0.7s)	3232	3232	256	52	202	0	16	270
1628	1086s (+0.4s)	1320	1320	64	31	116	3	0	150
1629	1087s (+0.4s)	1296	1296	128	33	99	7	0	139
1630	1087s (+0.3s)	908	908	64	31	78	8	0	117
1631	1087s (+0.4s)	1184	1184	128	26	101	3	0	130
1632	1088s (+0.3s)	720	720	64	16	72	0	6	94
1633	1088s (+0.6s)	1968	1968	128	52	146	7	0	205
1634	1089s (+0.8s)	3520	3520	256	77	207	11	0	295
1635	1090s (+0.7s)	3120	3120	256	80	163	17	0	260
1636	1090s (+0.5s)	1952	1952	128	40	158	3	0	201
1637	1091s (+0.6s)	2596	2596	256	55	158	11	0	224
1638	1092s (+0.5s)	1612	1612	128	38	127	5	0	170
1639	1092s (+0.2s)	608	608	64	18	58	5	0	81
1640	1092s (+0.5s)	1496	1496	128	36	114	8	0	158
1641	1093s (+0.6s)	2624	2624	256	49	165	7	0	221
1642	1093s (+0.4s)	1392	1392	128	28	103	0	7	138
1643	1094s (+0.4s)	1152	1152	128	28	94	0	3	125
1644	1094s (+0.5s)	1912	1912	128	41	149	0	7	197
1645	1095s (+0.8s)	3296	3296	256	47	218	0	11	276
1646	1095s (+0.4s)	1388	1388	128	33	111	1	2	147
1647	1096s (+0.3s)	752	752	64	20	66	0	5	91
1648	1097s (+1.0s)	4340	4340	256	98	249	16	0	363
1649	1098s (+0.9s)	3752	3752	256	101	191	22	0	314
1650	1098s (+0.5s)	1584	1584	128	29	130	5	0	164
1651	1098s (+0.3s)	920	920	64	34	75	5	0	114
1652	1099s (+0.2s)	452	452	32	9	60	1	0	70
1653	1099s (+0.5s)	1520	1520	128	40	115	8	0	163
1654	1099s (+0.3s)	984	984	64	20	92	0	4	116
1655	1100s (+0.3s)	944	944	64	28	84	0	4	116
1656	1100s (+0.5s)	1720	1720	128	46	125	9	0	180
1657	1101s (+0.8s)	3760	3760	256	82	205	15	0	302
1658	1102s (+0.5s)	2356	2356	256	47	144	7	0	198
1659	1103s (+0.9s)	3988	3988	256	82	223	15	1	321
1660	1103s (+0.5s)	1812	1812	128	34	148	6	0	188
1661	1104s (+0.9s)	3612	3612	256	70	224	11	0	305
1662	1104s (+0.3s)	736	736	64	25	67	5	0	97
1663	1105s (+0.8s)	3316	3316	256	79	183	18	0	280
1664	1106s (+0.7s)	2788	2788	256	67	163	10	0	240
1665	1107s (+0.8s)	3512	3512	256	62	219	12	0	293
1666	1108s (+1.2s)	6188	6188	512	134	267	29	1	431
1667	1109s (+0.5s)	1512	1512	128	25	131	3	0	159
1668	1109s (+0.9s)	3892	3892	256	78	233	11	1	323
1669	1110s (+0.6s)	1980	1980	128	63	132	8	0	203
1670	1110s (+0.3s)	804	804	64	28	76	4	0	108
1671	1111s (+0.7s)	2924	2924	256	80	165	11	1	257
1672	1112s (+0.8s)	3712	3712	256	84	205	16	1	306
1673	1113s (+0.6s)	2472	2472	256	47	160	7	0	214
1674	1113s (+0.5s)	1756	1756	128	49	121	8	1	179
1675	1114s (+0.4s)	1484	1484	128	30	118	6	0	154
1676	1114s (+0.9s)	3676	3676	256	84	209	13	0	306
1677	1115s (+0.8s)	3348	3348	256	65	210	8	0	283
1678	1116s (+0.7s)	2908	2908	256	63	180	10	0	253
1679	1117s (+0.7s)	3116	3116	256	57	191	9	1	258
1680	1117s (+0.5s)	1552	1552	128	32	124	4	0	160
1681	1117s (+0.3s)	1032	1032	64	38	78	6	0	122
1682	1118s (+0.3s)	876	876	64	31	79	4	0	114
1683	1118s (+0.3s)	944	944	64	23	88	5	0	116
1684	1119s (+0.4s)	1448	1448	128	49	94	8	0	151
1685	1119s (+0.9s)	3824	3824	256	86	213	13	0	312
1686	1120s (+0.5s)	1900	1900	128	38	134	0	11	183
1687	1120s (+0.3s)	980	980	64	17	92	0	6	115
1688	1121s (+0.8s)	3216	3216	256	58	197	0	11	266
1689	1122s (+0.8s)	3652	3652	256	53	233	0	11	297
1690	1122s (+0.3s)	1156	1156	128	18	102	0	4	124
1691	1123s (+0.6s)	1924	1924	128	35	155	0	9	199
1692	1123s (+0.6s)	1976	1976	128	56	133	12	0	201
1693	1124s (+0.8s)	3316	3316	256	67	210	10	0	287
1694	1125s (+0.3s)	664	664	64	19	64	5	0	88
1695	1125s (+0.8s)	3436	3436	256	72	205	13	0	290
1696	1126s (+0.8s)	3228	3228	256	67	190	13	0	270
1697	1127s (+0.9s)	3940	3940	256	100	213	21	1	335
1698	1128s (+0.8s)	3432	3432	256	60	214	15	0	289
1699	1129s (+0.8s)	3228	3228	256	84	171	15	0	270
Episode	Time	Reward	Score	Highest	L	U	R	D	Steps
1700	1129s (+0.3s)	696	696	64	20	71	3	0	94
1701	1130s (+0.5s)	1920	1920	128	33	161	4	0	198
1702	1131s (+1.0s)	5072	5072	512	75	260	14	0	349
1703	1131s (+0.5s)	1624	1624	128	48	113	8	0	169
1704	1132s (+1.1s)	4608	4608	256	105	250	23	0	378
1705	1133s (+0.2s)	576	576	64	15	61	2	0	78
1706	1133s (+0.8s)	3236	3236	256	80	180	13	0	273
1707	1134s (+1.0s)	4248	4248	256	79	263	11	0	353
1708	1135s (+1.1s)	4692	4692	256	106	273	14	1	394
1709	1136s (+0.5s)	1660	1660	128	34	127	6	0	167
1710	1137s (+0.6s)	2080	2080	128	62	131	12	0	205
1711	1137s (+0.4s)	1488	1488	128	33	111	7	1	152
1712	1138s (+0.7s)	2780	2780	256	57	167	13	0	237
1713	1139s (+0.8s)	3204	3204	256	66	189	10	0	265
1714	1139s (+0.8s)	3348	3348	256	73	196	14	0	283
1715	1140s (+0.9s)	3604	3604	256	71	218	14	0	303
1716	1141s (+0.5s)	1900	1900	128	41	147	5	0	193
1717	1141s (+0.6s)	2540	2540	256	54	149	7	1	211
1718	1142s (+0.8s)	3324	3324	256	69	201	11	0	281
1719	1143s (+1.2s)	5928	5928	512	121	273	23	0	417
1720	1144s (+0.9s)	3800	3800	256	76	227	13	0	316
1721	1145s (+0.6s)	2264	2264	128	64	141	9	0	214
1722	1145s (+0.5s)	1932	1932	128	46	134	11	0	191
1723	1146s (+0.4s)	1368	1368	128	37	103	3	0	143
1724	1147s (+0.6s)	2508	2508	256	51	156	7	0	214
1725	1147s (+0.6s)	2612	2612	256	65	142	14	0	221
1726	1148s (+0.5s)	1764	1764	128	47	120	10	1	178
1727	1149s (+0.8s)	3900	3900	256	84	216	14	0	314
1728	1149s (+0.9s)	4644	4644	512	62	239	14	0	315
1729	1150s (+1.0s)	4264	4264	256	100	233	15	0	348
1730	1151s (+0.3s)	1064	1064	128	26	81	7	0	114
1731	1151s (+0.5s)	1768	1768	128	57	116	9	0	182
1732	1152s (+0.6s)	2744	2744	256	58	163	12	0	233
1733	1152s (+0.5s)	1756	1756	128	38	141	7	0	186
1734	1153s (+0.5s)	1660	1660	128	46	115	6	0	167
1735	1153s (+0.4s)	1040	1040	64	30	88	6	0	124
1736	1154s (+0.2s)	440	440	32	13	53	0	6	72
1737	1155s (+1.0s)	4336	4336	256	93	256	13	0	362
1738	1155s (+0.7s)	2764	2764	256	67	156	12	0	235
1739	1156s (+0.5s)	1660	1660	128	45	112	8	0	165
1740	1157s (+0.7s)	2808	2808	256	65	164	15	0	244
1741	1157s (+0.8s)	3356	3356	256	61	201	13	0	275
1742	1158s (+0.9s)	3804	3804	256	71	231	15	0	317
1743	1159s (+0.7s)	2916	2916	256	60	186	9	0	255
1744	1160s (+0.7s)	2920	2920	256	56	188	12	0	256
1745	1160s (+0.5s)	1828	1828	128	55	121	10	0	186
1746	1161s (+1.1s)	5668	5668	512	108	269	23	0	400
1747	1162s (+0.8s)	3212	3212	256	72	188	6	0	266
1748	1163s (+0.3s)	884	884	64	23	87	6	0	116
1749	1163s (+0.8s)	3280	3280	256	67	191	13	0	271
1750	1164s (+0.8s)	3424	3424	256	53	218	10	0	281
1751	1165s (+0.5s)	1800	1800	128	50	124	11	0	185
1752	1166s (+1.0s)	5064	5064	512	110	233	17	0	360
1753	1166s (+0.5s)	1628	1628	128	35	123	6	0	164
1754	1167s (+0.5s)	1500	1500	128	34	121	3	0	158
1755	1167s (+0.7s)	2676	2676	256	52	163	13	0	228
1756	1168s (+0.6s)	2528	2528	128	69	155	7	0	231
1757	1168s (+0.4s)	1416	1416	128	32	110	11	0	153
1758	1169s (+0.5s)	1740	1740	128	48	121	5	0	174
1759	1170s (+0.8s)	3344	3344	256	69	192	11	1	273
1760	1171s (+0.9s)	3912	3912	256	81	221	14	1	317
1761	1171s (+0.5s)	1760	1760	128	33	137	0	9	179
1762	1172s (+0.6s)	2216	2216	128	51	144	0	14	209
1763	1172s (+0.8s)	3248	3248	256	51	215	0	4	270
1764	1173s (+0.7s)	2688	2688	256	45	184	0	8	237
1765	1174s (+0.8s)	3320	3320	256	63	195	0	18	276
1766	1175s (+1.4s)	6924	6924	512	141	331	21	0	493
1767	1176s (+0.8s)	3280	3280	256	66	200	12	0	278
1768	1177s (+0.8s)	3208	3208	256	61	188	15	0	264
1769	1177s (+0.4s)	1284	1284	128	25	101	6	1	133
1770	1178s (+0.7s)	2816	2816	256	52	181	14	0	247
1771	1179s (+0.6s)	1944	1944	128	38	159	7	0	204
1772	1180s (+1.1s)	4724	4724	256	108	252	16	0	376
1773	1181s (+0.7s)	3032	3032	256	80	165	13	0	258
1774	1181s (+0.5s)	1628	1628	128	44	115	6	0	165
1775	1182s (+0.8s)	3292	3292	256	77	191	13	0	281
1776	1183s (+0.7s)	3132	3132	256	66	187	10	0	263
1777	1183s (+0.9s)	3620	3620	256	79	212	13	0	304
1778	1184s (+0.5s)	1608	1608	128	48	114	7	0	169
1779	1185s (+0.5s)	1820	1820	128	48	131	10	0	189
1780	1185s (+0.7s)	2724	2724	256	56	172	8	0	236
1781	1186s (+0.4s)	1152	1152	128	27	93	5	0	125
1782	1186s (+0.8s)	3508	3508	256	73	205	17	1	296
1783	1187s (+0.7s)	3092	3092	256	76	172	9	0	257
1784	1188s (+0.4s)	1144	1144	128	29	90	4	0	123
1785	1188s (+0.7s)	3140	3140	256	65	183	17	0	265
1786	1189s (+0.7s)	2812	2812	256	52	181	8	0	241
1787	1190s (+0.8s)	3448	3448	256	88	185	14	0	287
1788	1190s (+0.4s)	1300	1300	128	27	109	5	0	141
1789	1191s (+0.6s)	2724	2724	256	54	165	10	0	229
1790	1191s (+0.5s)	1720	1720	128	41	127	9	0	177
1791	1192s (+0.4s)	1308	1308	128	29	99	6	0	134
1792	1193s (+0.8s)	3504	3504	256	87	191	14	0	292
1793	1193s (+0.4s)	1412	1412	128	25	115	3	1	144
1794	1194s (+0.7s)	3120	3120	256	64	175	15	0	254
1795	1194s (+0.2s)	452	452	32	21	50	3	0	74
1796	1194s (+0.4s)	1424	1424	128	33	108	10	0	151
1797	1195s (+0.7s)	2796	2796	256	50	181	6	0	237
1798	1195s (+0.2s)	584	584	64	19	56	3	0	78
1799	1196s (+0.5s)	1672	1672	128	49	122	9	0	180
Episode	Time	Reward	Score	Highest	L	U	R	D	Steps
1800	1197s (+0.7s)	3180	3180	256	60	195	7	0	262
1801	1197s (+0.5s)	1960	1960	128	39	140	0	10	189
1802	1198s (+0.4s)	1172	1172	64	36	99	0	5	140
1803	1198s (+0.9s)	4708	4708	512	66	246	0	13	325
1804	1199s (+0.5s)	1628	1628	128	41	125	0	4	170
1805	1200s (+0.6s)	1932	1932	128	35	157	0	9	201
1806	1201s (+1.3s)	7004	7004	512	113	351	17	1	482
1807	1202s (+0.9s)	3984	3984	256	78	234	15	0	327
1808	1203s (+1.2s)	5752	5752	512	121	267	21	0	409
1809	1204s (+0.5s)	2136	2136	256	52	118	8	0	178
1810	1204s (+0.5s)	1848	1848	128	49	128	10	0	187
1811	1205s (+0.7s)	2964	2964	256	64	190	13	0	267
1812	1206s (+0.7s)	2932	2932	256	55	178	11	1	245
1813	1206s (+0.6s)	2068	2068	128	53	141	10	0	204
1814	1207s (+0.6s)	2612	2612	256	51	165	13	0	229
1815	1208s (+0.7s)	2872	2872	256	58	179	12	1	250
1816	1209s (+0.9s)	3932	3932	256	77	236	10	0	323
1817	1210s (+0.8s)	3248	3248	256	69	187	12	0	268
1818	1210s (+0.3s)	932	932	64	25	82	6	0	113
1819	1210s (+0.4s)	1188	1188	64	36	101	7	0	144
1820	1210s (+0.3s)	700	700	64	18	71	2	1	92
1821	1212s (+1.0s)	4272	4272	256	80	263	12	0	355
1822	1212s (+0.6s)	2516	2516	256	50	162	5	1	218
1823	1213s (+0.8s)	3420	3420	256	77	194	16	0	287
1824	1214s (+1.2s)	5768	5768	512	139	253	20	1	413
1825	1215s (+0.9s)	4112	4112	256	92	224	12	0	328
1826	1216s (+0.5s)	1776	1776	128	34	139	6	0	179
1827	1216s (+0.6s)	2060	2060	128	50	144	8	0	202
1828	1217s (+0.5s)	2184	2184	256	33	143	4	1	181
1829	1217s (+0.3s)	788	788	64	29	74	2	0	105
1830	1218s (+0.7s)	2896	2896	256	46	182	9	0	237
1831	1218s (+0.5s)	1596	1596	64	43	118	13	0	174
1832	1219s (+0.7s)	2800	2800	256	63	171	9	0	243
1833	1220s (+0.6s)	2116	2116	128	51	154	11	0	216
1834	1220s (+0.5s)	1576	1576	128	38	126	8	0	172
1835	1221s (+0.5s)	1740	1740	128	35	135	6	0	176
1836	1221s (+0.8s)	3236	3236	256	59	202	11	0	272
1837	1222s (+0.9s)	3896	3896	256	89	205	20	0	314
1838	1223s (+0.7s)	3168	3168	256	52	197	10	0	259
1839	1224s (+1.0s)	4404	4404	256	95	241	22	1	359
1840	1225s (+0.8s)	3384	3384	256	71	200	11	0	282
1841	1225s (+0.5s)	1516	1516	128	32	121	5	0	158
1842	1226s (+0.6s)	2592	2592	256	47	172	8	0	227
1843	1227s (+0.5s)	1800	1800	128	43	130	11	0	184
1844	1227s (+0.8s)	3216	3216	256	63	191	13	0	267
1845	1229s (+1.2s)	5944	5944	512	88	312	20	0	420
1846	1229s (+0.4s)	1276	1276	128	37	93	9	1	140
1847	1229s (+0.4s)	1332	1332	128	26	115	7	0	148
1848	1230s (+0.5s)	1908	1908	128	45	143	7	0	195
1849	1231s (+1.0s)	4180	4180	256	70	253	13	1	337
1850	1232s (+1.0s)	4276	4276	256	96	239	18	1	354
1851	1233s (+0.5s)	1736	1736	128	46	120	8	0	174
1852	1233s (+0.5s)	1828	1828	128	36	143	0	9	188
1853	1234s (+1.1s)	5368	5368	512	113	247	23	0	383
1854	1235s (+0.5s)	1768	1768	128	40	127	10	1	178
1855	1236s (+0.8s)	3184	3184	256	54	204	7	0	265
1856	1236s (+0.7s)	2912	2912	256	60	182	11	1	254
1857	1237s (+0.3s)	1096	1096	128	26	84	6	0	116
1858	1238s (+0.9s)	4032	4032	256	87	225	15	0	327
1859	1238s (+0.5s)	1588	1588	128	40	117	7	0	164
1860	1239s (+0.6s)	2104	2104	128	41	147	0	10	198
1861	1239s (+0.4s)	1536	1536	128	38	109	0	9	156
1862	1240s (+0.5s)	1692	1692	128	42	125	0	7	174
1863	1240s (+0.6s)	2088	2088	128	45	147	0	12	204
1864	1241s (+0.9s)	3824	3824	256	66	227	0	16	309
1865	1242s (+0.8s)	3428	3428	256	77	191	14	0	282
1866	1243s (+0.5s)	1796	1796	128	39	139	6	0	184
1867	1243s (+0.7s)	2868	2868	256	51	176	12	1	240
1868	1244s (+0.6s)	2464	2464	256	60	133	15	0	208
1869	1245s (+0.9s)	3920	3920	256	74	230	15	0	319
1870	1245s (+0.7s)	2788	2788	256	61	165	13	0	239
1871	1246s (+0.7s)	3152	3152	256	62	182	12	1	257
1872	1247s (+0.5s)	1844	1844	128	45	139	7	0	191
1873	1247s (+0.4s)	1432	1432	128	43	96	8	0	147
1874	1248s (+0.6s)	1928	1928	128	41	151	8	0	200
1875	1249s (+0.8s)	3496	3496	256	82	194	17	0	293
1876	1249s (+0.7s)	3232	3232	256	51	205	9	1	266
1877	1250s (+0.9s)	3640	3640	256	91	204	13	0	308
1878	1251s (+0.4s)	1468	1468	128	37	107	10	1	155
1879	1251s (+0.5s)	1600	1600	128	45	114	8	0	167
1880	1252s (+1.3s)	6504	6504	512	136	295	18	0	449
1881	1253s (+0.7s)	2628	2628	256	58	161	13	0	232
1882	1254s (+0.8s)	3308	3308	256	82	181	17	0	280
1883	1255s (+0.8s)	3360	3360	256	76	196	10	0	282
1884	1256s (+1.0s)	4332	4332	256	88	251	22	0	361
1885	1257s (+0.7s)	2920	2920	256	54	187	14	1	256
1886	1257s (+0.5s)	1776	1776	128	44	128	11	0	183
1887	1258s (+0.6s)	1996	1996	128	60	127	13	1	201
1888	1258s (+0.6s)	2728	2728	256	45	174	12	0	231
1889	1259s (+0.5s)	1956	1956	128	40	137	0	6	183
1890	1260s (+0.6s)	2568	2568	256	46	162	0	14	222
1891	1260s (+0.3s)	1116	1116	128	22	92	0	4	118
1892	1261s (+0.9s)	3772	3772	256	65	230	0	15	310
1893	1261s (+0.7s)	2768	2768	256	51	171	0	13	235
1894	1262s (+0.5s)	1876	1876	128	45	131	12	1	189
1895	1263s (+0.5s)	1808	1808	128	38	142	7	0	187
1896	1263s (+0.5s)	1884	1884	128	33	136	11	0	180
1897	1263s (+0.3s)	868	868	64	21	88	3	0	112
1898	1264s (+0.7s)	2624	2624	256	39	182	10	0	231
1899	1265s (+0.7s)	2508	2508	128	62	166	11	0	239
Episode	Time	Reward	Score	Highest	L	U	R	D	Steps
1900	1265s (+0.8s)	3392	3392	256	73	200	16	0	289
1901	1266s (+0.7s)	2764	2764	256	57	167	10	0	234
1902	1267s (+0.9s)	4148	4148	256	74	240	0	15	329
1903	1268s (+1.2s)	5788	5788	512	91	302	0	21	414
1904	1269s (+0.7s)	2796	2796	256	49	177	0	16	242
1905	1270s (+0.7s)	2752	2752	256	47	176	0	14	237
1906	1271s (+0.9s)	3708	3708	256	55	235	0	13	303
1907	1271s (+0.6s)	2656	2656	256	48	170	0	7	225
1908	1272s (+0.9s)	3852	3852	256	75	231	0	19	325
1909	1273s (+0.6s)	2348	2348	128	42	165	0	15	222
1910	1274s (+0.7s)	2808	2808	256	67	165	0	12	244
1911	1274s (+0.6s)	2692	2692	256	44	171	0	11	226
1912	1275s (+0.6s)	2244	2244	128	44	159	0	9	212
1913	1275s (+0.4s)	1428	1428	128	24	119	0	4	147
1914	1276s (+0.8s)	3216	3216	256	59	196	0	11	266
1915	1277s (+0.8s)	3436	3436	256	67	206	0	16	289
1916	1277s (+0.4s)	1168	1168	128	27	93	0	6	126
1917	1278s (+0.7s)	2748	2748	256	55	180	0	7	242
1918	1279s (+0.7s)	2872	2872	256	52	185	0	13	250
1919	1280s (+0.8s)	3484	3484	256	54	224	0	13	291
1920	1280s (+0.6s)	1936	1936	128	41	152	0	9	202
1921	1281s (+0.6s)	2492	2492	256	53	151	9	2	215
1922	1281s (+0.5s)	1980	1980	128	44	147	7	0	198
1923	1282s (+0.7s)	2980	2980	256	72	164	9	0	245
1924	1282s (+0.4s)	1596	1596	128	44	108	10	0	162
1925	1284s (+1.3s)	6460	6460	512	117	310	30	0	457
1926	1284s (+0.7s)	3212	3212	256	67	187	12	0	266
1927	1285s (+0.3s)	1180	1180	128	31	79	7	0	117
1928	1286s (+0.8s)	3172	3172	256	49	209	9	0	267
1929	1286s (+0.7s)	2412	2412	128	74	148	8	0	230
1930	1287s (+0.9s)	3996	3996	256	93	217	17	0	327
1931	1288s (+0.7s)	2972	2972	256	61	177	19	1	258
1932	1289s (+0.9s)	3644	3644	256	87	208	14	0	309
1933	1290s (+0.8s)	3356	3356	256	81	181	17	0	279
1934	1290s (+0.5s)	1856	1856	128	45	132	10	0	187
1935	1291s (+0.7s)	2616	2616	256	57	164	8	0	229
1936	1292s (+0.7s)	3004	3004	256	58	176	16	0	250
1937	1292s (+0.4s)	912	912	64	24	92	3	0	119
1938	1292s (+0.3s)	916	916	64	26	87	6	0	119
1939	1293s (+1.0s)	4512	4512	256	97	255	17	0	369
1940	1294s (+0.8s)	3196	3196	256	55	198	9	0	262
1941	1295s (+1.2s)	6308	6308	512	109	300	22	1	432
1942	1296s (+0.7s)	2724	2724	256	66	161	9	0	236
1943	1297s (+1.0s)	4252	4252	256	99	228	26	0	353
1944	1297s (+0.4s)	1224	1224	128	27	93	0	5	125
1945	1298s (+0.7s)	2708	2708	256	44	175	0	12	231
1946	1299s (+0.7s)	2620	2620	256	49	171	0	10	230
1947	1300s (+0.9s)	3912	3912	256	69	231	0	13	313
1948	1300s (+0.4s)	1612	1612	128	39	116	0	6	161
1949	1301s (+0.8s)	3492	3492	256	80	202	11	0	293
1950	1301s (+0.4s)	1284	1284	64	43	93	9	0	145
1951	1302s (+0.5s)	2368	2368	256	48	141	8	0	197
1952	1302s (+0.4s)	1368	1368	128	35	102	5	1	143
1953	1303s (+0.7s)	2912	2912	256	62	182	10	0	254
1954	1304s (+0.5s)	1668	1668	128	46	111	11	0	168
1955	1304s (+0.9s)	3824	3824	256	89	209	20	1	319
1956	1305s (+0.7s)	2860	2860	256	65	166	13	0	244
1957	1306s (+1.1s)	5812	5812	512	91	316	12	0	419
1958	1307s (+0.8s)	3248	3248	256	60	204	11	0	275
1959	1308s (+0.4s)	1336	1336	128	27	106	5	0	138
1960	1308s (+0.6s)	2164	2164	128	56	137	12	0	205
1961	1309s (+0.8s)	3192	3192	256	46	214	0	7	267
1962	1310s (+1.0s)	4260	4260	256	88	244	0	20	352
1963	1310s (+0.4s)	1504	1504	128	38	108	0	7	153
1964	1311s (+0.6s)	2084	2084	128	53	144	10	0	207
1965	1312s (+0.5s)	2000	2000	256	31	125	8	0	164
1966	1312s (+0.7s)	3184	3184	256	67	189	8	0	264
1967	1313s (+0.9s)	3700	3700	256	93	193	17	0	303
1968	1314s (+0.8s)	2880	2880	128	74	179	14	0	267
1969	1315s (+0.7s)	2780	2780	256	60	161	14	0	235
1970	1315s (+0.4s)	1336	1336	128	32	103	3	0	138
1971	1316s (+0.7s)	2928	2928	256	61	188	9	0	258
1972	1316s (+0.5s)	2204	2204	256	42	141	8	0	191
1973	1317s (+0.7s)	3172	3172	256	71	172	17	1	261
1974	1317s (+0.3s)	688	688	64	18	68	3	0	89
1975	1318s (+0.4s)	1224	1224	128	37	92	5	0	134
1976	1318s (+0.4s)	1504	1504	128	36	111	6	0	153
1977	1320s (+1.5s)	7516	7516	512	128	369	25	0	522
1978	1320s (+0.5s)	1608	1608	128	42	116	11	0	169
1979	1321s (+0.5s)	1612	1612	128	42	116	10	1	169
1980	1321s (+0.5s)	1956	1956	128	51	138	8	0	197
1981	1322s (+0.4s)	1456	1456	128	29	118	2	0	149
1982	1322s (+0.7s)	2824	2824	256	61	161	19	0	241
1983	1324s (+1.1s)	4528	4528	256	99	255	20	0	374
1984	1324s (+0.6s)	1908	1908	128	36	154	5	0	195
1985	1324s (+0.2s)	488	488	64	14	52	0	3	69
1986	1325s (+0.7s)	2952	2952	256	55	175	0	13	243
1987	1325s (+0.2s)	540	540	64	12	58	0	3	73
1988	1326s (+0.6s)	2576	2576	256	45	171	0	8	224
1989	1326s (+0.3s)	684	684	64	13	72	0	4	89
1990	1327s (+0.6s)	2376	2376	256	43	155	0	5	203
1991	1327s (+0.7s)	2852	2852	128	85	166	13	0	264
1992	1328s (+0.8s)	3408	3408	256	67	218	9	0	294
1993	1329s (+0.8s)	3464	3464	256	65	209	11	0	285
1994	1330s (+0.9s)	3904	3904	256	81	223	12	0	316
1995	1331s (+0.8s)	3224	3224	256	73	179	17	0	269
1996	1331s (+0.5s)	1796	1796	128	33	145	6	0	184
1997	1332s (+0.5s)	1764	1764	128	42	125	12	1	180
1998	1332s (+0.4s)	1416	1416	128	22	119	3	0	144
1999	1333s (+0.5s)	1856	1856	128	62	123	9	0	194
Episode	Time	Reward	Score	Highest	L	U	R	D	Steps
2000	1333s (+0.3s)	852	852	64	24	71	3	1	99
2001	1334s (+0.6s)	1924	1924	128	45	142	12	0	199
2002	1335s (+0.8s)	3340	3340	256	78	181	18	1	278
2003	1335s (+0.9s)	3828	3828	256	97	214	12	0	323
2004	1336s (+0.8s)	3392	3392	256	71	197	12	0	280
2005	1337s (+0.4s)	1400	1400	128	34	101	5	0	140
2006	1337s (+0.4s)	1392	1392	128	26	105	10	0	141
2007	1337s (+0.5s)	1600	1600	128	45	113	9	0	167
2008	1338s (+0.9s)	3976	3976	256	79	239	10	0	328
2009	1339s (+0.4s)	1268	1268	128	31	104	3	0	138
2010	1339s (+0.5s)	1824	1824	128	40	131	11	1	183
2011	1340s (+0.4s)	1556	1556	128	32	124	0	4	160
2012	1340s (+0.7s)	2960	2960	256	48	178	0	11	237
2013	1341s (+0.3s)	820	820	64	21	70	0	5	96
2014	1341s (+0.6s)	2236	2236	128	40	164	0	10	214
2015	1342s (+0.7s)	2640	2640	256	46	179	0	9	234
2016	1343s (+0.7s)	2724	2724	256	47	176	0	13	236
2017	1344s (+0.8s)	3628	3628	256	72	215	9	0	296
2018	1344s (+0.4s)	1524	1524	128	45	108	7	0	160
2019	1345s (+0.5s)	1784	1784	128	31	144	6	0	181
2020	1346s (+0.9s)	4032	4032	256	84	235	11	0	330
2021	1346s (+0.7s)	2416	2416	128	59	159	9	0	227
2022	1347s (+0.3s)	1020	1020	128	18	88	4	0	110
2023	1348s (+1.1s)	5620	5620	512	106	266	22	0	394
2024	1348s (+0.3s)	796	796	64	30	69	7	0	106
2025	1348s (+0.5s)	1816	1816	128	48	121	12	1	182
2026	1349s (+0.4s)	1580	1580	128	29	117	8	0	154
2027	1350s (+0.9s)	3748	3748	256	74	218	15	1	308
2028	1351s (+0.8s)	3308	3308	256	58	206	14	0	278
2029	1351s (+0.6s)	2168	2168	128	55	132	16	0	203
2030	1352s (+0.6s)	1952	1952	128	49	150	7	0	206
2031	1353s (+0.9s)	3800	3800	256	65	240	11	0	316
2032	1353s (+0.7s)	3204	3204	256	69	191	9	0	269
2033	1354s (+0.4s)	1644	1644	128	39	121	4	0	164
2034	1354s (+0.2s)	480	480	64	17	48	2	0	67
2035	1355s (+0.6s)	2488	2488	256	39	164	1	11	215
2036	1355s (+0.8s)	3488	3488	256	60	216	0	15	291
2037	1356s (+0.5s)	1900	1900	128	34	152	0	7	193
2038	1356s (+0.4s)	1292	1292	128	27	97	0	6	130
2039	1357s (+0.1s)	284	284	32	8	43	0	3	54
2040	1357s (+0.4s)	1500	1500	128	36	118	4	0	158
2041	1358s (+0.5s)	1800	1800	128	48	128	8	0	184
2042	1358s (+0.8s)	3248	3248	256	59	201	15	0	275
2043	1359s (+0.8s)	3324	3324	256	69	196	12	0	277
2044	1360s (+0.7s)	3060	3060	256	65	174	11	0	250
2045	1360s (+0.3s)	988	988	64	30	91	5	0	126
2046	1361s (+0.8s)	3588	3588	256	91	197	16	0	304
2047	1362s (+0.4s)	1388	1388	128	22	117	2	0	141
2048	1362s (+0.4s)	1324	1324	64	35	109	6	0	150
2049	1362s (+0.5s)	1720	1720	128	35	133	8	1	177
2050	1363s (+0.3s)	904	904	64	24	85	2	0	111
2051	1364s (+1.1s)	5628	5628	512	78	311	17	0	406
2052	1364s (+0.4s)	1160	1160	128	31	88	4	1	124
2053	1365s (+0.5s)	1776	1776	128	41	130	8	0	179
2054	1366s (+0.5s)	1756	1756	128	47	117	9	1	174
2055	1366s (+0.5s)	1544	1544	128	49	97	12	0	158
2056	1367s (+1.0s)	4328	4328	256	100	249	11	0	360
2057	1368s (+0.8s)	3576	3576	256	81	200	16	0	297
2058	1368s (+0.6s)	2564	2564	256	49	163	0	12	224
2059	1369s (+0.7s)	2772	2772	256	47	178	0	11	236
2060	1369s (+0.3s)	752	752	64	16	73	0	3	92
2061	1370s (+0.9s)	4156	4156	256	63	239	0	20	322
2062	1371s (+1.0s)	4256	4256	256	74	263	0	17	354
2063	1372s (+0.6s)	2764	2764	256	50	172	0	12	234
2064	1373s (+0.9s)	4068	4068	256	66	249	0	17	332
2065	1374s (+0.7s)	2760	2760	256	60	163	0	11	234
2066	1374s (+0.5s)	1592	1592	128	43	113	0	9	165
2067	1374s (+0.2s)	532	532	64	14	59	0	2	75
2068	1375s (+0.8s)	3560	3560	256	74	211	13	0	298
2069	1376s (+0.5s)	2064	2064	256	38	132	4	0	174
2070	1376s (+0.4s)	1636	1636	128	37	101	9	1	148
2071	1377s (+0.9s)	3684	3684	256	84	209	15	0	308
2072	1378s (+0.5s)	1816	1816	128	39	141	8	0	188
2073	1379s (+1.0s)	4196	4196	256	109	214	21	0	344
2074	1379s (+0.8s)	3352	3352	256	62	210	12	0	284
2075	1380s (+0.5s)	1780	1780	128	59	111	10	0	180
2076	1380s (+0.4s)	1304	1304	128	34	101	6	1	142
2077	1381s (+0.8s)	3240	3240	256	51	212	10	0	273
2078	1382s (+1.0s)	4168	4168	256	91	239	14	0	344
2079	1383s (+1.1s)	5632	5632	512	103	272	20	0	395
2080	1384s (+0.6s)	2356	2356	256	43	143	12	0	198
2081	1385s (+0.6s)	2408	2408	256	50	139	10	0	199
2082	1385s (+0.6s)	2476	2476	256	54	145	11	1	211
2083	1386s (+0.6s)	2128	2128	128	54	141	15	0	210
2084	1387s (+0.9s)	3608	3608	256	69	213	18	0	300
2085	1387s (+0.7s)	3276	3276	256	53	205	10	0	268
2086	1388s (+0.3s)	892	892	64	24	83	2	0	109
2087	1388s (+0.4s)	1352	1352	128	26	110	3	0	139
2088	1389s (+0.5s)	1832	1832	128	47	133	9	0	189
2089	1389s (+0.5s)	1776	1776	128	46	124	9	0	179
2090	1390s (+0.9s)	3968	3968	256	77	228	21	0	326
2091	1391s (+1.0s)	4312	4312	256	92	245	19	0	356
2092	1391s (+0.2s)	332	332	32	9	43	0	3	55
2093	1392s (+0.9s)	3800	3800	256	67	223	0	16	306
2094	1393s (+0.7s)	2720	2720	256	63	165	1	11	240
2095	1393s (+0.4s)	1240	1240	64	30	103	0	9	142
2096	1394s (+0.6s)	2480	2480	256	35	170	1	6	212
2097	1395s (+0.6s)	1904	1904	128	31	154	0	11	196
2098	1395s (+0.7s)	3164	3164	256	69	171	0	19	259
2099	1396s (+0.8s)	3452	3452	256	84	186	19	0	289
Episode	Time	Reward	Score	Highest	L	U	R	D	Steps
2100	1397s (+1.0s)	4312	4312	256	99	234	24	0	357
2101	1398s (+1.0s)	4332	4332	256	102	234	17	0	353
2102	1399s (+1.0s)	5348	5348	512	83	270	20	1	374
2103	1400s (+0.7s)	3116	3116	256	51	192	9	0	252
2104	1400s (+0.4s)	1376	1376	128	32	110	2	0	144
2105	1401s (+0.7s)	3172	3172	256	64	185	13	0	262
2106	1402s (+0.5s)	1560	1560	128	37	116	5	1	159
2107	1402s (+0.7s)	2932	2932	256	75	175	9	0	259
2108	1403s (+0.5s)	1584	1584	128	41	114	7	1	163
2109	1403s (+0.5s)	1856	1856	128	52	129	6	0	187
2110	1404s (+0.6s)	2732	2732	256	49	159	11	0	219
2111	1405s (+1.0s)	4356	4356	256	88	260	15	0	363
2112	1406s (+0.9s)	4388	4388	256	83	241	16	1	341
2113	1407s (+0.7s)	3240	3240	256	63	198	11	0	272
2114	1408s (+0.9s)	3876	3876	256	83	214	12	0	309
2115	1409s (+1.1s)	5436	5436	512	93	270	16	0	379
2116	1409s (+0.5s)	1752	1752	128	34	135	8	0	177
2117	1410s (+0.9s)	3744	3744	256	80	216	12	0	308
2118	1411s (+0.4s)	1320	1320	128	37	104	4	0	145
2119	1411s (+0.6s)	2240	2240	128	56	148	11	0	215
2120	1412s (+0.6s)	2296	2296	256	52	135	9	2	198
2121	1413s (+1.0s)	4556	4556	256	105	245	20	0	370
2122	1414s (+0.8s)	3560	3560	256	98	186	13	0	297
2123	1415s (+1.1s)	5864	5864	512	103	278	25	0	406
2124	1416s (+0.6s)	2552	2552	256	53	156	8	1	218
2125	1416s (+0.5s)	1796	1796	128	50	122	12	0	184
2126	1417s (+0.7s)	2828	2828	256	53	178	11	0	242
2127	1417s (+0.5s)	1860	1860	128	52	126	11	0	189
2128	1418s (+0.4s)	1196	1196	128	36	93	3	0	132
2129	1418s (+0.4s)	1448	1448	128	42	108	6	0	156
2130	1419s (+0.6s)	2448	2448	256	54	138	13	0	205
2131	1419s (+0.4s)	1420	1420	128	37	112	5	0	154
2132	1420s (+0.5s)	1784	1784	128	54	115	12	0	181
2133	1420s (+0.5s)	2168	2168	256	43	135	5	0	183
2134	1421s (+0.5s)	1816	1816	128	41	142	6	0	189
2135	1421s (+0.5s)	1560	1560	128	40	116	6	0	162
2136	1422s (+0.9s)	3928	3928	256	76	229	16	1	322
2137	1423s (+0.7s)	3036	3036	256	67	177	10	0	254
2138	1423s (+0.5s)	2164	2164	256	43	131	8	0	182
2139	1424s (+0.9s)	3776	3776	256	62	229	12	1	304
2140	1425s (+0.8s)	3708	3708	256	73	215	13	0	301
2141	1426s (+0.5s)	1604	1604	128	41	120	7	0	168
2142	1426s (+0.6s)	2824	2824	256	51	174	5	0	230
2143	1427s (+0.7s)	2852	2852	256	65	165	14	0	244
2144	1428s (+0.7s)	2752	2752	256	52	182	8	0	242
2145	1428s (+0.7s)	2804	2804	256	59	171	11	0	241
2146	1429s (+0.3s)	1072	1072	64	37	81	3	0	121
2147	1429s (+0.4s)	1348	1348	128	34	96	7	0	137
2148	1429s (+0.4s)	1332	1332	128	31	99	5	0	135
2149	1431s (+1.4s)	6768	6768	512	133	330	22	1	486
2150	1432s (+0.4s)	1460	1460	128	42	104	7	1	154
2151	1432s (+0.5s)	1692	1692	128	43	123	8	0	174
2152	1432s (+0.3s)	1124	1124	128	21	87	4	0	112
2153	1433s (+0.9s)	3940	3940	256	85	221	13	0	319
2154	1434s (+0.5s)	1772	1772	128	46	126	6	0	178
2155	1434s (+0.5s)	1524	1524	128	49	105	6	0	160
2156	1435s (+0.5s)	1920	1920	128	43	148	6	1	198
2157	1436s (+0.7s)	2960	2960	256	65	188	8	0	261
2158	1436s (+0.9s)	3904	3904	256	82	221	13	0	316
2159	1437s (+0.4s)	1412	1412	128	35	108	5	0	148
2160	1437s (+0.3s)	796	796	64	26	73	7	0	106
2161	1438s (+0.5s)	1404	1404	64	40	113	5	1	159
2162	1438s (+0.4s)	1300	1300	128	29	96	6	0	131
2163	1439s (+0.5s)	1744	1744	128	33	134	9	0	176
2164	1439s (+0.2s)	560	560	32	22	56	6	0	84
2165	1439s (+0.6s)	2320	2320	256	38	142	12	1	193
2166	1440s (+0.4s)	1448	1448	128	40	105	5	0	150
2167	1440s (+0.5s)	1856	1856	128	48	131	12	0	191
2168	1441s (+0.9s)	3812	3812	256	77	218	13	0	308
2169	1442s (+0.5s)	1720	1720	128	42	117	11	0	170
2170	1442s (+0.6s)	2576	2576	256	43	172	0	5	220
2171	1443s (+0.5s)	1644	1644	128	33	137	0	4	174
2172	1443s (+0.6s)	2048	2048	128	51	139	0	9	199
2173	1444s (+0.4s)	1464	1464	128	40	102	0	8	150
2174	1444s (+0.4s)	1492	1492	128	35	114	0	8	157
2175	1445s (+1.2s)	5664	5664	512	110	276	23	0	409
2176	1446s (+0.6s)	2320	2320	256	48	138	7	1	194
2177	1448s (+2.0s)	11656	11656	1024	228	445	39	0	712
2178	1449s (+0.7s)	3200	3200	256	71	174	18	0	263
2179	1449s (+0.3s)	660	660	32	26	58	7	0	91
2180	1450s (+0.5s)	1604	1604	128	40	123	5	1	169
2181	1451s (+0.7s)	2960	2960	256	53	184	10	0	247
2182	1451s (+0.7s)	2864	2864	256	65	170	12	0	247
2183	1452s (+0.3s)	776	776	64	28	73	5	0	106
2184	1453s (+1.1s)	5280	5280	512	97	262	19	0	378
2185	1454s (+0.9s)	3804	3804	256	78	218	12	0	308
2186	1454s (+0.5s)	1576	1576	128	48	111	7	0	166
2187	1455s (+0.6s)	2244	2244	128	58	133	15	0	206
2188	1455s (+0.4s)	1240	1240	128	41	90	7	0	138
2189	1456s (+0.8s)	3276	3276	256	78	181	17	0	276
2190	1456s (+0.5s)	1808	1808	128	50	129	8	0	187
2191	1457s (+0.5s)	2164	2164	256	37	136	8	1	182
2192	1457s (+0.5s)	1860	1860	128	43	135	10	0	188
2193	1458s (+0.8s)	3296	3296	256	49	203	12	0	264
2194	1459s (+0.6s)	2484	2484	256	53	149	0	11	213
2195	1459s (+0.4s)	1156	1156	128	23	93	0	7	123
2196	1460s (+0.9s)	3864	3864	256	65	237	0	18	320
2197	1461s (+0.4s)	1152	1152	64	33	94	0	8	135
2198	1461s (+0.3s)	664	664	64	15	71	2	0	88
2199	1462s (+0.8s)	3672	3672	256	71	209	12	0	292
Episode	Time	Reward	Score	Highest	L	U	R	D	Steps
2200	1462s (+0.7s)	2752	2752	256	62	163	11	0	236
2201	1463s (+0.5s)	1780	1780	128	44	131	5	0	180
2202	1463s (+0.6s)	1944	1944	128	60	131	9	0	200
2203	1464s (+1.1s)	4584	4584	256	95	261	20	0	376
2204	1465s (+0.5s)	1860	1860	128	47	130	11	0	188
2205	1466s (+0.6s)	2268	2268	256	38	150	8	0	196
2206	1466s (+0.5s)	1920	1920	128	56	133	9	0	198
2207	1467s (+0.8s)	3412	3412	256	83	183	18	0	284
2208	1468s (+0.8s)	3476	3476	256	64	212	13	1	290
2209	1468s (+0.5s)	1844	1844	128	62	112	11	0	185
2210	1469s (+0.6s)	2532	2532	256	47	160	13	0	220
2211	1470s (+0.7s)	2964	2964	256	57	180	15	0	252
2212	1471s (+1.0s)	4176	4176	256	85	239	22	0	346
2213	1472s (+0.8s)	3320	3320	256	65	206	10	0	281
2214	1472s (+0.7s)	2628	2628	256	62	162	7	1	232
2215	1473s (+0.8s)	3380	3380	256	58	208	15	0	281
2216	1474s (+0.8s)	3368	3368	256	79	187	11	1	278
2217	1474s (+0.5s)	1596	1596	128	35	124	11	0	170
2218	1475s (+0.7s)	2704	2704	256	50	170	15	0	235
2219	1476s (+0.8s)	3500	3500	256	64	221	9	0	294
2220	1477s (+0.9s)	3644	3644	256	98	194	11	0	303
2221	1478s (+0.8s)	3408	3408	256	61	215	8	0	284
2222	1478s (+0.4s)	1956	1956	256	31	120	6	0	157
2223	1479s (+0.7s)	2924	2924	256	83	160	15	0	258
2224	1479s (+0.4s)	1372	1372	128	37	103	4	0	144
2225	1480s (+1.0s)	4032	4032	256	90	231	16	0	337
2226	1481s (+0.6s)	2512	2512	256	63	139	13	0	215
2227	1481s (+0.4s)	1536	1536	128	38	116	8	0	162
2228	1482s (+0.6s)	2024	2024	128	50	151	7	0	208
2229	1483s (+0.8s)	3452	3452	256	79	197	12	0	288
2230	1483s (+0.7s)	2944	2944	256	72	163	13	0	248
2231	1484s (+0.6s)	1920	1920	128	42	150	6	0	198
2232	1485s (+0.7s)	2784	2784	256	70	162	7	0	239
2233	1485s (+0.5s)	1612	1612	128	37	128	6	0	171
2234	1486s (+0.6s)	1908	1908	128	39	146	10	0	195
2235	1486s (+0.5s)	1632	1632	128	38	118	8	1	165
2236	1487s (+0.5s)	1608	1608	128	34	121	7	1	163
2237	1487s (+0.5s)	1656	1656	128	45	119	10	0	174
2238	1488s (+0.7s)	2756	2756	256	50	174	0	10	234
2239	1489s (+0.7s)	3228	3228	256	65	195	0	11	271
2240	1489s (+0.8s)	3180	3180	256	55	199	0	15	269
2241	1489s (+0.2s)	276	276	32	6	43	0	3	52
2242	1490s (+0.6s)	1992	1992	128	37	158	0	6	201
2243	1491s (+0.7s)	3080	3080	256	54	185	0	12	251
2244	1492s (+0.8s)	3384	3384	256	76	192	13	1	282
2245	1492s (+0.4s)	1340	1340	128	33	97	6	0	136
2246	1493s (+0.6s)	2380	2380	128	56	152	10	0	218
2247	1494s (+1.2s)	5788	5788	512	125	276	16	0	417
2248	1494s (+0.3s)	980	980	64	25	86	8	1	120
2249	1496s (+1.6s)	8328	8328	512	146	384	27	0	557
2250	1497s (+1.2s)	5884	5884	512	137	260	27	1	425
2251	1498s (+0.5s)	1672	1672	128	40	135	5	0	180
2252	1499s (+0.8s)	3396	3396	256	69	201	15	0	285
2253	1500s (+0.9s)	3752	3752	256	77	214	18	0	309
2254	1500s (+0.6s)	1996	1996	128	46	150	10	0	206
2255	1501s (+0.9s)	3896	3896	256	70	230	13	0	313
2256	1502s (+0.6s)	2644	2644	256	47	167	7	0	221
2257	1503s (+0.8s)	3688	3688	256	75	211	11	1	298
2258	1503s (+0.8s)	3476	3476	256	75	197	16	0	288
2259	1504s (+0.8s)	3508	3508	256	88	186	17	0	291
2260	1505s (+0.5s)	1792	1792	128	34	144	5	0	183
2261	1505s (+0.6s)	2656	2656	256	51	163	10	0	224
2262	1506s (+1.0s)	4912	4912	512	82	248	17	0	347
2263	1507s (+0.9s)	4016	4016	256	84	238	11	0	333
2264	1509s (+1.4s)	7008	7008	512	143	305	30	0	478
2265	1510s (+0.7s)	3116	3116	256	58	189	12	0	259
2266	1510s (+0.5s)	1800	1800	128	54	114	14	0	182
2267	1511s (+0.4s)	1472	1472	128	34	111	7	0	152
2268	1511s (+0.4s)	1256	1256	64	43	92	6	0	141
2269	1512s (+0.7s)	2804	2804	256	52	181	10	0	243
2270	1513s (+0.8s)	3308	3308	256	76	198	11	0	285
2271	1513s (+0.5s)	1692	1692	128	45	117	9	0	171
2272	1514s (+1.3s)	6412	6412	512	112	327	18	0	457
2273	1515s (+0.3s)	728	728	64	27	65	6	0	98
2274	1516s (+0.9s)	4200	4200	256	86	241	18	0	345
2275	1516s (+0.3s)	896	896	64	22	80	6	1	109
2276	1516s (+0.5s)	1620	1620	128	37	127	8	0	172
2277	1517s (+1.0s)	4168	4168	256	91	241	12	0	344
2278	1518s (+0.6s)	1924	1924	128	47	142	6	0	195
2279	1519s (+0.6s)	2412	2412	256	46	155	6	0	207
2280	1519s (+0.3s)	784	784	64	28	68	4	0	100
2281	1519s (+0.5s)	1844	1844	128	49	132	8	0	189
2282	1520s (+0.3s)	712	712	64	26	66	4	0	96
2283	1520s (+0.7s)	2820	2820	256	58	181	9	0	248
2284	1521s (+0.5s)	1636	1636	128	48	114	7	0	169
2285	1522s (+0.7s)	2984	2984	256	64	181	16	0	261
2286	1522s (+0.5s)	1716	1716	128	42	129	5	0	176
2287	1523s (+0.9s)	4036	4036	256	91	227	14	0	332
2288	1523s (+0.4s)	1332	1332	128	34	99	6	0	139
2289	1524s (+0.5s)	1536	1536	128	33	119	5	0	157
2290	1525s (+0.8s)	3524	3524	256	87	198	11	0	296
2291	1526s (+0.8s)	3508	3508	256	84	192	19	1	296
2292	1526s (+0.5s)	1708	1708	128	55	114	5	0	174
2293	1527s (+0.8s)	3472	3472	256	67	206	13	1	287
2294	1527s (+0.3s)	752	752	64	26	68	7	0	101
2295	1528s (+0.9s)	3620	3620	256	85	206	17	0	308
2296	1529s (+0.5s)	1812	1812	128	40	143	6	0	189
2297	1529s (+0.3s)	748	748	64	20	75	4	0	99
2298	1530s (+0.9s)	3876	3876	256	87	214	18	0	319
2299	1530s (+0.5s)	1776	1776	128	60	118	6	0	184
Episode	Time	Reward	Score	Highest	L	U	R	D	Steps
2300	1531s (+0.7s)	3340	3340	256	72	187	11	1	271
2301	1532s (+0.5s)	1888	1888	128	49	126	8	0	183
2302	1532s (+0.7s)	2804	2804	256	60	170	14	0	244
2303	1533s (+1.0s)	4120	4120	256	69	262	0	13	344
2304	1534s (+0.6s)	2384	2384	256	34	161	0	7	202
2305	1535s (+0.7s)	2988	2988	256	48	186	0	10	244
2306	1535s (+0.2s)	544	544	64	11	61	0	4	76
2307	1535s (+0.6s)	1920	1920	128	33	157	0	5	195
2308	1536s (+0.3s)	760	760	64	27	64	0	6	97
2309	1536s (+0.7s)	2768	2768	256	55	164	16	0	235
2310	1537s (+1.0s)	4356	4356	256	96	243	19	1	359
2311	1538s (+0.6s)	2184	2184	128	50	146	11	0	207
2312	1538s (+0.5s)	1736	1736	128	43	126	6	0	175
2313	1539s (+0.5s)	1672	1672	128	45	119	6	0	170
2314	1540s (+1.1s)	5604	5604	512	99	280	19	1	399
2315	1541s (+0.7s)	3288	3288	256	67	192	11	0	270
2316	1541s (+0.6s)	2888	2888	256	58	159	17	0	234
2317	1542s (+0.5s)	1832	1832	128	48	133	7	0	188
2318	1542s (+0.4s)	1180	1180	128	24	100	4	0	128
2319	1543s (+0.7s)	2820	2820	256	69	167	7	0	243
2320	1543s (+0.3s)	892	892	64	27	84	3	0	114
2321	1544s (+0.8s)	3388	3388	256	76	187	16	0	279
2322	1545s (+0.5s)	1740	1740	128	33	132	8	0	173
2323	1546s (+1.0s)	4568	4568	256	73	285	14	0	372
2324	1546s (+0.7s)	3136	3136	256	53	194	10	0	257
2325	1547s (+0.5s)	1620	1620	128	56	106	10	0	172
2326	1547s (+0.3s)	812	812	64	20	79	4	0	103
2327	1548s (+0.8s)	3228	3228	256	83	173	16	0	272
2328	1549s (+0.9s)	3924	3924	256	87	214	20	0	321
2329	1550s (+1.1s)	4592	4592	256	91	263	24	0	378
2330	1551s (+0.7s)	3156	3156	256	68	187	11	1	267
2331	1551s (+0.6s)	2536	2536	256	39	167	8	0	214
2332	1552s (+0.5s)	1788	1788	128	33	128	0	8	169
2333	1553s (+0.6s)	2516	2516	256	39	169	0	9	217
2334	1553s (+0.5s)	1744	1744	128	35	127	0	11	173
2335	1554s (+0.8s)	3620	3620	256	64	223	0	10	297
2336	1554s (+0.5s)	1908	1908	128	36	152	0	7	195
2337	1555s (+0.6s)	2652	2652	256	51	172	0	10	233
2338	1556s (+0.7s)	2932	2932	256	46	205	0	8	259
2339	1556s (+0.4s)	1484	1484	128	36	112	2	0	150
2340	1557s (+0.3s)	776	776	64	24	77	2	0	103
2341	1557s (+0.8s)	3364	3364	256	66	208	13	0	287
2342	1558s (+0.6s)	2664	2664	256	60	155	12	0	227
2343	1558s (+0.5s)	1656	1656	128	46	111	10	0	167
2344	1559s (+0.3s)	824	824	64	23	78	4	0	105
2345	1559s (+0.4s)	1412	1412	128	30	115	4	0	149
2346	1560s (+0.8s)	3572	3572	256	82	204	14	0	300
2347	1561s (+0.7s)	3208	3208	256	60	194	14	1	269
2348	1562s (+0.9s)	3988	3988	256	76	240	15	0	331
2349	1563s (+0.8s)	3484	3484	256	71	211	11	1	294
2350	1563s (+0.3s)	868	868	64	26	82	4	0	112
2351	1563s (+0.6s)	2100	2100	128	54	140	11	0	205
2352	1564s (+0.4s)	1172	1172	64	34	100	6	0	140
2353	1565s (+0.8s)	3712	3712	256	67	209	15	0	291
2354	1566s (+0.9s)	4192	4192	256	96	228	19	0	343
2355	1566s (+0.6s)	2400	2400	128	62	138	16	0	216
2356	1567s (+0.5s)	1492	1492	128	37	114	6	0	157
2357	1567s (+0.4s)	1488	1488	128	32	117	0	7	156
2358	1567s (+0.3s)	720	720	64	12	81	0	4	97
2359	1568s (+0.4s)	1408	1408	128	21	117	0	8	146
2360	1569s (+0.8s)	3200	3200	256	63	189	13	1	266
2361	1569s (+0.6s)	2512	2512	256	55	147	13	0	215
2362	1570s (+0.6s)	2200	2200	128	59	143	8	0	210
2363	1570s (+0.5s)	1860	1860	128	47	131	10	0	188
2364	1571s (+0.4s)	1160	1160	128	26	100	2	0	128
2365	1572s (+1.0s)	4160	4160	256	87	239	16	0	342
2366	1572s (+0.7s)	2696	2696	256	52	171	9	1	233
2367	1573s (+0.6s)	1908	1908	128	51	133	13	0	197
2368	1573s (+0.5s)	1760	1760	128	49	115	9	0	173
2369	1574s (+0.8s)	3352	3352	256	69	204	11	0	284
2370	1575s (+0.6s)	2668	2668	256	55	165	0	8	228
2371	1575s (+0.5s)	1704	1704	128	50	106	0	10	166
2372	1576s (+0.6s)	2504	2504	128	51	171	0	15	237
2373	1577s (+0.5s)	1788	1788	128	54	122	0	6	182
2374	1577s (+0.7s)	3076	3076	256	54	195	0	10	259
2375	1578s (+0.5s)	1816	1816	128	39	138	0	7	184
2376	1579s (+0.7s)	2852	2852	256	55	184	0	12	251
2377	1579s (+0.4s)	1180	1180	64	27	101	0	7	135
2378	1579s (+0.3s)	996	996	64	28	83	0	7	118
2379	1580s (+0.7s)	2620	2620	256	44	178	0	8	230
2380	1580s (+0.4s)	1428	1428	128	31	108	7	0	146
2381	1581s (+0.4s)	1168	1168	64	36	95	8	0	139
2382	1582s (+0.9s)	3972	3972	256	88	226	13	0	327
2383	1582s (+0.4s)	1476	1476	128	41	110	4	1	156
2384	1583s (+0.8s)	3256	3256	256	68	191	13	0	272
2385	1583s (+0.6s)	2604	2604	256	48	156	9	0	213
2386	1585s (+1.2s)	5876	5876	512	122	267	20	0	409
2387	1585s (+0.8s)	3216	3216	256	64	194	9	0	267
2388	1586s (+0.5s)	1780	1780	128	42	134	4	0	180
2389	1586s (+0.4s)	1468	1468	128	30	118	4	0	152
2390	1587s (+0.7s)	3044	3044	256	51	190	9	0	250
2391	1588s (+0.8s)	3284	3284	256	70	197	10	0	277
2392	1589s (+1.4s)	7272	7272	512	137	340	28	0	505
2393	1590s (+0.4s)	1484	1484	128	49	97	9	0	155
2394	1591s (+0.8s)	3576	3576	256	71	210	11	1	293
2395	1592s (+1.0s)	4320	4320	256	89	256	13	0	358
2396	1592s (+0.5s)	2060	2060	128	61	124	8	0	193
2397	1593s (+0.6s)	2628	2628	256	56	160	12	0	228
2398	1594s (+0.6s)	1924	1924	128	54	135	10	0	199
2399	1594s (+0.6s)	2448	2448	256	57	138	12	1	208
Episode	Time	Reward	Score	Highest	L	U	R	D	Steps
2400	1595s (+0.3s)	1128	1128	128	23	89	0	7	119
2401	1595s (+0.7s)	2716	2716	256	38	189	0	7	234
2402	1596s (+0.7s)	2872	2872	256	38	189	0	11	238
2403	1597s (+0.7s)	2452	2452	128	40	180	0	12	232
2404	1597s (+0.3s)	1096	1096	128	20	92	0	2	114
2405	1598s (+0.8s)	3528	3528	256	69	211	0	16	296
2406	1599s (+1.0s)	4232	4232	256	65	269	0	15	349
2407	1600s (+1.0s)	4220	4220	256	64	265	0	16	345
2408	1600s (+0.7s)	2448	2448	128	54	167	0	13	234
2409	1601s (+1.1s)	4628	4628	256	72	292	0	19	383
2410	1602s (+0.3s)	836	836	64	26	72	0	8	106
2411	1602s (+0.3s)	700	700	64	18	71	0	3	92
2412	1603s (+0.8s)	3372	3372	256	57	218	0	14	289
2413	1603s (+0.4s)	1460	1460	128	35	113	5	0	153
2414	1604s (+0.7s)	3208	3208	256	68	181	13	3	265
2415	1605s (+0.7s)	2704	2704	256	63	164	11	0	238
2416	1605s (+0.5s)	1600	1600	128	38	125	4	0	167
2417	1606s (+0.3s)	1004	1004	64	33	82	5	0	120
2418	1606s (+0.3s)	784	784	64	25	72	5	2	104
2419	1607s (+0.8s)	3524	3524	256	74	208	13	0	295
2420	1607s (+0.6s)	2268	2268	256	45	139	10	0	194
2421	1608s (+1.1s)	5504	5504	512	97	273	15	1	386
2422	1609s (+0.6s)	2304	2304	256	43	153	3	0	199
2423	1610s (+0.9s)	3980	3980	256	82	239	8	0	329
2424	1611s (+1.0s)	5212	5212	512	94	251	16	0	361
2425	1612s (+0.7s)	2832	2832	256	72	162	12	0	246
2426	1612s (+0.6s)	2652	2652	256	39	180	6	0	225
2427	1613s (+0.5s)	1996	1996	256	47	110	9	0	166
2428	1614s (+1.2s)	5752	5752	512	96	287	22	0	405
2429	1615s (+0.4s)	1448	1448	128	38	106	6	0	150
2430	1615s (+0.4s)	1540	1540	128	46	106	9	0	161
2431	1615s (+0.5s)	1556	1556	128	38	116	7	0	161
2432	1616s (+0.5s)	1528	1528	128	36	117	8	0	161
2433	1616s (+0.5s)	1800	1800	128	50	127	7	0	184
2434	1617s (+0.9s)	3904	3904	256	79	216	15	0	310
2435	1618s (+1.1s)	5668	5668	512	92	288	16	0	396
2436	1619s (+0.4s)	1408	1408	128	33	108	7	0	148
2437	1620s (+0.8s)	3324	3324	256	71	197	14	0	282
2438	1620s (+0.4s)	1284	1284	128	32	97	8	0	137
2439	1621s (+0.5s)	1548	1548	128	31	131	4	0	166
2440	1621s (+0.3s)	1032	1032	64	33	84	5	0	122
2441	1622s (+0.8s)	3528	3528	256	88	195	18	0	301
2442	1623s (+1.1s)	5696	5696	512	107	281	20	0	408
2443	1624s (+0.5s)	1884	1884	128	42	146	6	0	194
2444	1624s (+0.8s)	3208	3208	256	73	186	8	0	267
2445	1625s (+0.6s)	2568	2568	256	48	161	9	0	218
2446	1626s (+0.8s)	3336	3336	256	64	201	12	0	277
2447	1626s (+0.6s)	2308	2308	256	50	141	10	0	201
2448	1627s (+0.4s)	1472	1472	128	39	106	7	0	152
2449	1627s (+0.7s)	2724	2724	256	49	177	7	1	234
2450	1628s (+0.5s)	1576	1576	128	33	123	5	0	161
2451	1629s (+0.8s)	3232	3232	256	68	193	9	0	270
2452	1629s (+0.7s)	2800	2800	256	56	177	9	0	242
2453	1630s (+0.7s)	2804	2804	256	56	177	10	0	243
2454	1631s (+1.0s)	4568	4568	256	112	241	24	0	377
2455	1632s (+0.4s)	1396	1396	128	38	103	8	0	149
2456	1632s (+0.8s)	3544	3544	256	85	190	18	1	294
2457	1633s (+0.7s)	2916	2916	256	50	196	9	0	255
2458	1634s (+0.4s)	1144	1144	128	37	86	3	0	126
2459	1634s (+0.4s)	1360	1360	128	35	99	4	0	138
2460	1634s (+0.5s)	1900	1900	128	46	141	6	0	193
2461	1635s (+0.7s)	2752	2752	256	57	168	11	0	236
2462	1636s (+0.8s)	3392	3392	256	64	212	8	0	284
2463	1636s (+0.5s)	1844	1844	128	40	140	5	0	185
2464	1637s (+0.7s)	2996	2996	256	69	180	10	0	259
2465	1638s (+0.6s)	1916	1916	128	58	133	6	0	197
2466	1638s (+0.7s)	3100	3100	256	55	196	4	0	255
2467	1639s (+0.4s)	1268	1268	128	39	89	5	0	133
2468	1639s (+0.5s)	1788	1788	128	47	127	0	8	182
2469	1640s (+0.7s)	3192	3192	256	64	193	7	1	265
2470	1641s (+0.9s)	3768	3768	256	76	210	13	0	299
2471	1641s (+0.4s)	1388	1388	128	36	102	9	0	147
2472	1642s (+0.8s)	3396	3396	256	80	188	12	0	280
2473	1643s (+0.7s)	2824	2824	256	60	162	11	0	233
2474	1644s (+0.7s)	3100	3100	256	55	187	13	0	255
2475	1644s (+0.8s)	3468	3468	256	67	211	9	0	287
2476	1645s (+0.5s)	1588	1588	128	37	121	6	0	164
2477	1646s (+1.0s)	5044	5044	512	94	238	14	0	346
2478	1647s (+0.8s)	3372	3372	256	69	200	10	0	279
2479	1647s (+0.6s)	2368	2368	256	47	145	8	0	200
2480	1648s (+0.7s)	2464	2464	128	52	165	15	0	232
2481	1648s (+0.2s)	348	348	32	13	50	1	0	64
2482	1649s (+0.6s)	1948	1948	128	43	146	9	0	198
2483	1650s (+1.0s)	4236	4236	256	81	252	16	0	349
2484	1651s (+0.9s)	3664	3664	256	89	212	11	1	313
2485	1651s (+0.4s)	1472	1472	128	43	107	5	1	156
2486	1651s (+0.3s)	776	776	64	23	75	4	1	103
2487	1652s (+0.4s)	1412	1412	128	39	105	8	0	152
2488	1652s (+0.6s)	2264	2264	128	53	148	13	0	214
2489	1653s (+0.4s)	1092	1092	64	33	94	5	0	132
2490	1653s (+0.4s)	1256	1256	128	21	110	4	0	135
2491	1654s (+0.4s)	1008	1008	64	27	100	3	0	130
2492	1654s (+0.4s)	1320	1320	128	38	101	6	0	145
2493	1655s (+0.6s)	2024	2024	128	48	137	17	0	202
2494	1655s (+0.7s)	3112	3112	256	61	172	18	0	251
2495	1656s (+0.8s)	3296	3296	256	76	191	15	0	282
2496	1656s (+0.4s)	1368	1368	128	33	103	6	0	142
2497	1657s (+0.9s)	3948	3948	256	71	230	0	20	321
2498	1658s (+0.2s)	412	412	32	17	45	0	4	66
2499	1658s (+0.3s)	720	720	64	21	71	0	2	94
Episode	Time	Reward	Score	Highest	L	U	R	D	Steps
2500	1659s (+0.6s)	1944	1944	128	50	139	10	2	201
2501	1660s (+1.0s)	4328	4328	256	103	236	18	0	357
2502	1660s (+0.6s)	1920	1920	128	44	147	7	0	198
2503	1661s (+0.9s)	3600	3600	256	70	220	13	0	303
2504	1662s (+1.1s)	4420	4420	256	97	247	30	0	374
2505	1663s (+1.1s)	4652	4652	256	117	254	21	0	392
2506	1664s (+0.6s)	2284	2284	128	57	153	11	0	221
2507	1665s (+0.8s)	3148	3148	256	55	196	11	0	262
2508	1665s (+0.7s)	2596	2596	256	47	164	13	0	224
2509	1665s (+0.3s)	708	708	64	25	65	5	0	95
2510	1666s (+0.5s)	1732	1732	128	36	135	3	0	174
2511	1667s (+0.8s)	3352	3352	256	68	200	16	0	284
2512	1667s (+0.4s)	1232	1232	64	38	97	4	0	139
2513	1668s (+0.4s)	1044	1044	64	36	83	6	0	125
2514	1668s (+0.5s)	1932	1932	128	50	141	10	0	201
2515	1669s (+0.4s)	1528	1528	128	38	110	8	0	156
2516	1669s (+0.4s)	1368	1368	128	28	110	0	4	142
2517	1669s (+0.4s)	1480	1480	128	40	104	0	10	154
2518	1670s (+0.7s)	2796	2796	256	49	181	0	12	242
2519	1671s (+0.6s)	2596	2596	256	48	167	9	0	224
2520	1671s (+0.6s)	2384	2384	128	77	134	13	0	224
2521	1672s (+0.5s)	1888	1888	128	39	145	6	0	190
2522	1673s (+0.7s)	2800	2800	256	60	169	13	0	242
2523	1673s (+0.6s)	2480	2480	256	53	157	6	0	216
2524	1674s (+0.8s)	3488	3488	256	76	200	15	0	291
2525	1675s (+0.9s)	3808	3808	256	103	199	16	0	318
2526	1675s (+0.4s)	1152	1152	128	32	86	6	0	124
2527	1676s (+0.7s)	2744	2744	256	56	170	9	0	235
2528	1676s (+0.4s)	1276	1276	128	45	85	6	0	136
2529	1677s (+0.7s)	3176	3176	256	62	191	10	0	263
2530	1678s (+0.6s)	2380	2380	128	64	143	15	0	222
2531	1678s (+0.7s)	2668	2668	256	67	159	10	1	237
2532	1679s (+0.3s)	868	868	64	29	80	4	0	113
2533	1679s (+0.4s)	1484	1484	128	28	124	3	0	155
2534	1680s (+0.9s)	4196	4196	256	93	226	20	1	340
2535	1681s (+0.8s)	3476	3476	256	83	188	18	0	289
2536	1681s (+0.5s)	1620	1620	128	50	113	5	1	169
2537	1682s (+0.5s)	1608	1608	128	40	120	9	0	169
2538	1683s (+0.7s)	2884	2884	256	74	163	15	0	252
2539	1683s (+0.7s)	3100	3100	256	56	188	0	14	258
2540	1684s (+0.3s)	1008	1008	64	20	97	0	3	120
2541	1684s (+0.6s)	2296	2296	128	45	167	0	12	224
2542	1685s (+0.4s)	1484	1484	128	36	112	7	0	155
2543	1685s (+0.5s)	1844	1844	128	43	135	10	1	189
2544	1686s (+0.8s)	3272	3272	256	84	181	15	0	280
2545	1687s (+0.6s)	2640	2640	256	52	163	8	0	223
2546	1687s (+0.3s)	1128	1128	128	21	95	3	1	120
2547	1688s (+0.8s)	3248	3248	256	53	203	0	18	274
2548	1689s (+0.9s)	4036	4036	256	66	247	9	0	322
2549	1690s (+0.9s)	3496	3496	256	64	230	6	0	300
2550	1691s (+0.8s)	3720	3720	256	90	191	18	1	300
2551	1691s (+0.7s)	2892	2892	256	80	150	18	0	248
2552	1692s (+0.6s)	2176	2176	128	59	146	14	0	219
2553	1693s (+1.0s)	4308	4308	256	78	258	14	1	351
2554	1694s (+1.1s)	5764	5764	512	98	298	12	0	408
2555	1695s (+1.1s)	5552	5552	512	93	271	23	0	387
2556	1696s (+0.2s)	632	632	64	26	58	3	0	87
2557	1696s (+0.6s)	2440	2440	256	63	138	12	0	213
2558	1697s (+0.3s)	836	836	64	25	78	3	0	106
2559	1697s (+0.5s)	1668	1668	128	31	134	5	0	170
2560	1698s (+1.0s)	4236	4236	256	92	245	17	0	354
2561	1699s (+1.1s)	4512	4512	256	107	242	22	0	371
2562	1700s (+0.8s)	3344	3344	256	70	191	11	0	272
2563	1700s (+0.4s)	1040	1040	64	39	81	4	0	124
2564	1701s (+0.3s)	1020	1020	128	15	97	2	0	114
2565	1701s (+0.5s)	1772	1772	128	39	134	9	0	182
2566	1702s (+0.7s)	3236	3236	256	67	190	12	0	269
2567	1703s (+0.9s)	3976	3976	256	84	235	13	0	332
2568	1703s (+0.3s)	652	652	64	15	73	0	1	89
2569	1704s (+0.6s)	2420	2420	256	37	158	0	7	202
2570	1704s (+0.5s)	1660	1660	128	32	127	0	8	167
2571	1705s (+0.7s)	2816	2816	256	38	198	0	10	246
2572	1705s (+0.3s)	632	632	64	24	58	0	5	87
2573	1706s (+0.8s)	3720	3720	256	56	230	0	16	302
2574	1706s (+0.5s)	1592	1592	128	37	115	0	7	159
2575	1707s (+0.7s)	2788	2788	256	66	162	12	0	240
2576	1708s (+0.6s)	2420	2420	128	56	157	8	0	221
2577	1708s (+0.5s)	1552	1552	128	47	115	4	0	166
2578	1709s (+0.6s)	2520	2520	256	46	166	9	0	221
2579	1709s (+0.6s)	2384	2384	256	58	138	8	0	204
2580	1710s (+0.7s)	3012	3012	256	67	176	9	0	252
2581	1711s (+0.6s)	2284	2284	128	59	142	9	0	210
2582	1711s (+0.5s)	1736	1736	128	44	127	4	0	175
2583	1712s (+0.7s)	2696	2696	256	67	148	18	0	233
2584	1713s (+0.8s)	3324	3324	256	99	155	14	0	268
2585	1713s (+0.4s)	1488	1488	128	26	125	4	0	155
2586	1713s (+0.3s)	668	668	64	20	65	7	0	92
2587	1714s (+0.4s)	1376	1376	128	27	112	5	0	144
2588	1715s (+0.8s)	3348	3348	256	63	211	9	0	283
2589	1715s (+0.4s)	1088	1088	64	32	91	8	0	131
2590	1716s (+0.5s)	2288	2288	256	39	152	0	6	197
2591	1716s (+0.7s)	2964	2964	256	48	175	0	15	238
2592	1717s (+0.3s)	656	656	64	15	70	0	4	89
2593	1717s (+0.9s)	3572	3572	256	67	225	0	15	307
2594	1718s (+0.7s)	2672	2672	256	50	170	0	12	232
2595	1719s (+0.8s)	3432	3432	256	52	224	0	13	289
2596	1719s (+0.3s)	700	700	64	17	74	0	2	93
2597	1720s (+0.7s)	3112	3112	256	55	194	0	9	258
2598	1720s (+0.4s)	1240	1240	128	21	98	0	6	125
2599	1721s (+0.5s)	2164	2164	256	52	121	0	9	182
Episode	Time	Reward	Score	Highest	L	U	R	D	Steps
2600	1721s (+0.5s)	1684	1684	128	37	116	0	13	166
2601	1722s (+0.5s)	1604	1604	128	35	128	5	0	168
2602	1722s (+0.4s)	1380	1380	128	31	111	3	0	145
2603	1723s (+0.9s)	3704	3704	256	66	231	11	0	308
2604	1724s (+0.9s)	3572	3572	256	80	202	17	1	300
2605	1725s (+0.6s)	2228	2228	128	52	148	12	0	212
2606	1725s (+0.8s)	3288	3288	256	76	187	10	0	273
2607	1726s (+0.8s)	3536	3536	256	74	211	13	0	298
2608	1727s (+0.5s)	1692	1692	128	32	137	6	0	175
2609	1727s (+0.4s)	1316	1316	128	24	109	3	0	136
2610	1728s (+0.9s)	3648	3648	256	76	211	13	0	300
2611	1728s (+0.4s)	1408	1408	128	38	98	8	1	145
2612	1729s (+0.6s)	2240	2240	128	50	154	11	0	215
2613	1730s (+1.3s)	6228	6228	512	104	323	16	0	443
2614	1731s (+0.9s)	3584	3584	256	78	208	17	0	303
2615	1732s (+0.8s)	3464	3464	256	71	204	14	0	289
2616	1733s (+0.4s)	1328	1328	128	43	96	8	0	147
2617	1733s (+0.5s)	1824	1824	128	60	117	9	0	186
2618	1734s (+0.8s)	3380	3380	256	62	204	14	0	280
2619	1734s (+0.4s)	1476	1476	128	40	106	6	0	152
2620	1735s (+0.4s)	1396	1396	128	39	101	8	0	148
2621	1736s (+0.9s)	4736	4736	512	70	241	17	0	328
2622	1737s (+0.8s)	3492	3492	256	74	206	11	1	292
2623	1737s (+0.3s)	864	864	64	23	85	4	0	112
2624	1738s (+0.6s)	2744	2744	256	63	158	10	0	231
2625	1738s (+0.4s)	1320	1320	128	25	104	6	0	135
2626	1738s (+0.5s)	1568	1568	128	33	124	0	8	165
2627	1739s (+0.5s)	1788	1788	128	39	135	0	10	184
2628	1739s (+0.5s)	1616	1616	128	37	114	0	10	161
2629	1740s (+0.5s)	1752	1752	128	40	140	0	5	185
2630	1741s (+0.8s)	3196	3196	256	55	199	0	13	267
2631	1741s (+0.4s)	1296	1296	64	29	116	0	6	151
2632	1742s (+0.8s)	3260	3260	256	62	200	0	11	273
2633	1743s (+0.7s)	2892	2892	256	60	175	0	15	250
2634	1743s (+0.5s)	1676	1676	128	27	135	0	6	168
2635	1744s (+0.8s)	3200	3200	256	50	204	0	11	265
2636	1744s (+0.5s)	1604	1604	128	41	119	0	8	168
2637	1745s (+0.8s)	3248	3248	256	55	205	0	11	271
2638	1746s (+0.6s)	2752	2752	256	48	164	10	0	222
2639	1746s (+0.5s)	1768	1768	128	28	147	6	0	181
2640	1747s (+0.5s)	1708	1708	128	39	137	3	0	179
2641	1747s (+0.2s)	588	588	64	11	71	0	0	82
2642	1748s (+0.7s)	2772	2772	256	65	167	9	0	241
2643	1748s (+0.5s)	1600	1600	128	29	129	6	0	164
2644	1749s (+0.5s)	1720	1720	128	47	118	12	0	177
2645	1749s (+0.5s)	1956	1956	128	52	125	9	1	187
2646	1750s (+0.8s)	3376	3376	256	71	201	13	0	285
2647	1751s (+1.2s)	6780	6780	512	153	276	25	1	455
2648	1752s (+0.5s)	1608	1608	128	43	118	8	0	169
2649	1753s (+0.7s)	3092	3092	256	64	182	11	0	257
2650	1753s (+0.7s)	2560	2560	128	52	178	9	1	240
2651	1754s (+0.5s)	1716	1716	128	40	121	8	0	169
2652	1754s (+0.2s)	472	472	32	19	51	4	0	74
2653	1755s (+0.8s)	3580	3580	256	56	216	0	13	285
2654	1756s (+0.8s)	3128	3128	256	58	191	0	13	262
2655	1756s (+0.6s)	2456	2456	256	44	151	0	6	201
2656	1757s (+0.8s)	3220	3220	256	57	201	0	10	268
2657	1758s (+0.8s)	3528	3528	256	62	221	0	13	296
2658	1758s (+0.6s)	2448	2448	128	59	158	12	0	229
2659	1759s (+0.7s)	2760	2760	256	67	155	16	0	238
2660	1760s (+0.9s)	3680	3680	256	71	213	16	0	300
2661	1761s (+0.6s)	1944	1944	128	43	154	7	0	204
2662	1761s (+0.6s)	2748	2748	256	50	174	11	0	235
2663	1762s (+0.4s)	1188	1188	64	31	93	9	1	134
2664	1762s (+0.3s)	1172	1172	128	25	93	7	0	125
2665	1762s (+0.5s)	1760	1760	128	36	136	7	0	179
2666	1763s (+0.3s)	1016	1016	128	15	91	2	0	108
2667	1764s (+1.0s)	4212	4212	256	85	249	14	0	348
2668	1764s (+0.4s)	1236	1236	128	24	99	4	0	127
2669	1765s (+0.7s)	3132	3132	256	60	182	14	0	256
2670	1765s (+0.6s)	2276	2276	128	62	151	14	0	227
2671	1767s (+1.1s)	5356	5356	512	90	257	23	1	371
2672	1767s (+0.8s)	3524	3524	256	72	203	15	0	290
2673	1768s (+0.6s)	2444	2444	256	53	148	12	1	214
2674	1769s (+0.8s)	3332	3332	256	77	195	12	0	284
2675	1769s (+0.5s)	1844	1844	128	46	136	7	0	189
2676	1770s (+0.5s)	2292	2292	256	38	151	6	0	195
2677	1771s (+0.8s)	3480	3480	256	67	206	17	0	290
2678	1772s (+1.0s)	5284	5284	512	66	282	0	20	368
2679	1773s (+0.9s)	3792	3792	256	60	239	0	15	314
2680	1773s (+0.3s)	1008	1008	128	15	87	1	4	107
2681	1774s (+0.5s)	1780	1780	128	34	140	6	0	180
2682	1774s (+0.4s)	1576	1576	128	39	107	9	1	156
2683	1774s (+0.4s)	1192	1192	128	27	98	5	0	130
2684	1775s (+0.9s)	4076	4076	256	86	228	13	0	327
2685	1776s (+0.9s)	3652	3652	256	84	195	20	1	300
2686	1777s (+0.5s)	1736	1736	128	31	149	1	0	181
2687	1777s (+0.8s)	3416	3416	256	66	207	12	0	285
2688	1778s (+0.7s)	3132	3132	256	62	184	16	0	262
2689	1779s (+0.8s)	3596	3596	256	67	209	9	1	286
2690	1780s (+0.7s)	2752	2752	256	58	163	14	0	235
2691	1780s (+0.3s)	860	860	64	22	85	4	0	111
2692	1781s (+0.9s)	3648	3648	256	77	221	11	1	310
2693	1781s (+0.4s)	1496	1496	128	31	122	4	0	157
2694	1782s (+0.6s)	1912	1912	128	44	145	7	0	196
2695	1782s (+0.2s)	668	668	64	15	69	0	3	87
2696	1783s (+0.4s)	1224	1224	128	23	103	0	7	133
2697	1783s (+0.8s)	3700	3700	256	86	206	12	0	304
2698	1784s (+0.5s)	1520	1520	128	41	109	13	0	163
2699	1784s (+0.5s)	1652	1652	64	58	113	9	0	180
Episode	Time	Reward	Score	Highest	L	U	R	D	Steps
2700	1785s (+0.9s)	3952	3952	256	78	230	15	0	323
2701	1787s (+1.2s)	5792	5792	512	121	275	19	0	415
2702	1788s (+0.9s)	3932	3932	256	78	231	13	0	322
2703	1789s (+0.9s)	3632	3632	256	68	229	13	0	310
2704	1789s (+0.8s)	3348	3348	256	71	191	15	0	277
2705	1790s (+0.4s)	1340	1340	128	34	97	8	1	140
2706	1790s (+0.6s)	2636	2636	256	63	161	10	0	234
2707	1791s (+0.5s)	1784	1784	128	56	115	10	0	181
2708	1792s (+0.6s)	2504	2504	256	50	155	12	0	217
2709	1792s (+0.8s)	3376	3376	256	72	195	13	0	280
2710	1793s (+0.5s)	1836	1836	128	46	126	10	0	182
2711	1793s (+0.3s)	752	752	64	24	73	4	0	101
2712	1794s (+0.8s)	3788	3788	256	94	201	18	0	313
2713	1795s (+0.6s)	2500	2500	128	70	150	16	0	236
2714	1796s (+1.1s)	4544	4544	256	104	252	22	0	378
2715	1796s (+0.4s)	1068	1068	64	30	95	5	0	130
2716	1797s (+0.9s)	4040	4040	256	84	230	18	0	332
2717	1798s (+0.6s)	1904	1904	128	61	121	9	0	191
2718	1799s (+1.0s)	4964	4964	512	75	257	10	0	342
2719	1799s (+0.5s)	1900	1900	128	56	132	6	0	194
2720	1800s (+0.8s)	3416	3416	256	69	206	14	0	289
2721	1800s (+0.5s)	1864	1864	128	50	128	11	0	189
2722	1801s (+0.5s)	1680	1680	128	48	122	4	1	175
2723	1802s (+0.7s)	2732	2732	256	64	156	12	0	232
2724	1803s (+1.0s)	4336	4336	256	106	234	22	0	362
2725	1804s (+0.9s)	3988	3988	256	84	235	12	0	331
2726	1805s (+1.4s)	6900	6900	512	140	338	29	0	507
2727	1806s (+0.3s)	1144	1144	128	27	90	6	0	123
2728	1806s (+0.3s)	628	628	64	15	67	4	1	87
2729	1806s (+0.3s)	756	756	64	24	70	7	0	101
2730	1807s (+0.8s)	3316	3316	256	71	194	15	0	280
2731	1807s (+0.3s)	1104	1104	128	29	83	5	0	117
2732	1808s (+0.5s)	2196	2196	256	37	147	6	0	190
2733	1808s (+0.4s)	1132	1132	64	31	99	5	0	135
2734	1809s (+1.0s)	4300	4300	256	82	250	17	0	349
2735	1810s (+0.6s)	2384	2384	256	42	154	0	9	205
2736	1810s (+0.5s)	1716	1716	128	29	136	0	5	170
2737	1811s (+0.7s)	2812	2812	256	61	172	0	13	246
2738	1812s (+0.5s)	1736	1736	128	40	116	0	11	167
2739	1812s (+0.7s)	2748	2748	256	57	169	0	9	235
2740	1813s (+0.6s)	1924	1924	128	39	155	0	5	199
2741	1813s (+0.5s)	1788	1788	128	42	134	0	7	183
2742	1814s (+0.3s)	728	728	64	16	78	0	2	96
2743	1815s (+0.9s)	3980	3980	256	88	226	14	1	329
2744	1815s (+0.7s)	2956	2956	256	54	178	9	0	241
2745	1816s (+0.4s)	1316	1316	128	29	109	7	0	145
2746	1816s (+0.4s)	1384	1384	128	36	90	10	1	137
2747	1817s (+0.6s)	2516	2516	256	57	147	13	0	217
2748	1817s (+0.8s)	3420	3420	256	67	207	11	0	285
2749	1818s (+0.5s)	1852	1852	128	37	140	9	0	186
2750	1819s (+0.8s)	3400	3400	256	75	207	9	0	291
2751	1820s (+0.7s)	2888	2888	256	61	181	11	0	253
2752	1820s (+0.5s)	1944	1944	128	49	125	13	1	188
2753	1820s (+0.3s)	1028	1028	64	25	89	6	2	122
2754	1821s (+0.9s)	4012	4012	256	82	226	19	0	327
2755	1822s (+0.9s)	3864	3864	256	81	224	13	0	318
2756	1823s (+0.9s)	3548	3548	256	75	211	15	0	301
2757	1824s (+0.9s)	3924	3924	256	88	222	13	0	323
2758	1825s (+0.5s)	1736	1736	128	49	118	10	1	178
2759	1825s (+0.7s)	2500	2500	128	65	159	15	1	240
2760	1826s (+0.6s)	2044	2044	128	52	139	7	0	198
2761	1827s (+0.8s)	3328	3328	256	73	196	10	0	279
2762	1828s (+0.9s)	3568	3568	256	89	202	15	0	306
2763	1828s (+0.7s)	2628	2628	256	50	173	9	0	232
2764	1829s (+0.7s)	3128	3128	256	72	173	16	0	261
2765	1830s (+0.9s)	3628	3628	256	77	217	12	0	306
2766	1830s (+0.6s)	2184	2184	128	52	160	8	0	220
2767	1831s (+0.4s)	1008	1008	64	24	92	5	0	121
2768	1831s (+0.4s)	1276	1276	128	29	102	5	0	136
2769	1832s (+0.9s)	3992	3992	256	98	222	12	0	332
2770	1833s (+0.8s)	3524	3524	256	75	206	14	0	295
2771	1834s (+0.7s)	2732	2732	256	50	172	9	0	231
2772	1834s (+0.2s)	392	392	32	17	48	5	0	70
2773	1834s (+0.7s)	2692	2692	256	57	163	12	0	232
2774	1836s (+1.1s)	5724	5724	512	100	283	19	0	402
2775	1836s (+0.6s)	1940	1940	128	50	134	12	0	196
2776	1837s (+0.8s)	3292	3292	256	57	205	11	1	274
2777	1837s (+0.2s)	288	288	32	12	42	1	0	55
2778	1838s (+0.6s)	2180	2180	128	54	147	11	0	212
2779	1838s (+0.5s)	1760	1760	128	41	128	10	0	179
2780	1839s (+0.3s)	768	768	64	23	74	6	0	103
2781	1839s (+0.6s)	2540	2540	256	56	155	12	0	223
2782	1840s (+0.8s)	3452	3452	256	70	210	8	0	288
2783	1841s (+0.6s)	2236	2236	128	64	130	17	0	211
2784	1841s (+0.5s)	1620	1620	128	43	119	10	0	172
2785	1842s (+0.8s)	2864	2864	128	79	176	12	0	267
2786	1843s (+0.9s)	3556	3556	256	74	218	11	0	303
2787	1843s (+0.4s)	1440	1440	128	24	122	2	0	148
2788	1844s (+0.4s)	1344	1344	64	31	115	0	6	152
2789	1844s (+0.5s)	1788	1788	128	41	132	0	9	182
2790	1845s (+0.5s)	1788	1788	128	34	137	0	12	183
2791	1845s (+0.3s)	796	796	64	15	78	0	4	97
2792	1846s (+0.6s)	2524	2524	256	42	167	0	8	217
2793	1846s (+0.4s)	1340	1340	128	21	109	0	7	137
2794	1847s (+0.6s)	2216	2216	128	46	159	4	0	209
2795	1847s (+0.9s)	3556	3556	256	88	200	15	0	303
2796	1848s (+0.8s)	3504	3504	256	74	191	15	0	280
2797	1849s (+0.3s)	776	776	64	20	84	1	0	105
2798	1849s (+0.6s)	2444	2444	256	46	154	7	0	207
2799	1850s (+0.9s)	4784	4784	512	100	218	18	0	336
Episode	Time	Reward	Score	Highest	L	U	R	D	Steps
2800	1851s (+0.9s)	3692	3692	256	89	208	17	0	314
2801	1852s (+0.7s)	2952	2952	256	66	181	12	0	259
2802	1853s (+1.2s)	5832	5832	512	122	276	19	0	417
2803	1854s (+0.7s)	3132	3132	256	72	175	9	0	256
2804	1854s (+0.4s)	1136	1136	64	37	86	8	0	131
2805	1855s (+0.4s)	1516	1516	128	50	100	8	0	158
2806	1855s (+0.8s)	3348	3348	256	67	191	15	1	274
2807	1856s (+1.0s)	4312	4312	256	93	241	18	0	352
2808	1857s (+0.5s)	1728	1728	128	43	126	9	0	178
2809	1858s (+1.2s)	6200	6200	512	108	295	25	0	428
2810	1859s (+1.0s)	4080	4080	256	98	221	17	1	337
2811	1860s (+0.4s)	1412	1412	128	43	93	11	1	148
2812	1860s (+0.5s)	1600	1600	128	32	121	5	0	158
2813	1861s (+0.4s)	1508	1508	128	36	107	13	0	156
2814	1861s (+0.8s)	3320	3320	256	60	204	14	0	278
2815	1862s (+0.4s)	1516	1516	128	45	107	7	0	159
2816	1862s (+0.6s)	2620	2620	256	53	168	8	0	229
2817	1863s (+0.7s)	2872	2872	256	65	170	15	0	250
2818	1864s (+0.5s)	1692	1692	128	47	120	7	0	174
2819	1864s (+0.4s)	1512	1512	128	30	118	6	0	154
2820	1864s (+0.3s)	648	648	64	18	68	1	0	87
2821	1865s (+0.4s)	1148	1148	64	30	94	6	0	130
2822	1865s (+0.7s)	2840	2840	256	48	174	6	0	228
2823	1866s (+0.3s)	716	716	64	27	64	5	0	96
2824	1866s (+0.3s)	980	980	128	18	81	4	1	104
2825	1867s (+0.6s)	2092	2092	128	62	132	12	0	206
2826	1867s (+0.6s)	1924	1924	128	40	151	8	0	199
2827	1868s (+0.7s)	2868	2868	256	63	176	8	1	248
2828	1869s (+0.7s)	2952	2952	256	66	187	11	0	264
2829	1869s (+0.4s)	1476	1476	128	21	130	3	0	154
2830	1870s (+0.7s)	3228	3228	256	60	200	10	0	270
2831	1870s (+0.4s)	1376	1376	128	28	113	3	1	145
2832	1871s (+0.5s)	1560	1560	128	37	123	5	0	165
2833	1871s (+0.6s)	2224	2224	128	53	145	13	0	211
2834	1872s (+0.9s)	3816	3816	256	75	226	0	15	316
2835	1873s (+0.5s)	1868	1868	128	36	157	0	4	197
2836	1873s (+0.5s)	1792	1792	128	40	136	0	7	183
2837	1874s (+0.5s)	1516	1516	128	30	127	5	0	162
2838	1875s (+0.8s)	3320	3320	256	76	184	10	1	271
2839	1875s (+0.8s)	3204	3204	256	57	195	13	0	265
2840	1876s (+0.8s)	3520	3520	256	77	196	21	0	294
2841	1877s (+0.4s)	1448	1448	128	28	116	8	0	152
2842	1877s (+0.7s)	2492	2492	128	57	164	12	1	234
2843	1878s (+0.7s)	3264	3264	256	59	198	12	0	269
2844	1878s (+0.4s)	1164	1164	64	22	109	0	7	138
2845	1879s (+0.5s)	2004	2004	128	48	127	6	2	183
2846	1879s (+0.5s)	1764	1764	128	49	120	11	0	180
2847	1880s (+0.5s)	1552	1552	128	41	117	9	0	167
2848	1881s (+0.7s)	2808	2808	256	49	185	10	0	244
2849	1881s (+0.4s)	1620	1620	128	49	107	0	5	161
2850	1881s (+0.3s)	1048	1048	128	16	95	1	1	113
2851	1882s (+0.4s)	1068	1068	64	40	89	6	0	135
2852	1882s (+0.7s)	2780	2780	256	43	187	8	0	238
2853	1883s (+0.6s)	2052	2052	128	68	114	14	0	196
2854	1884s (+0.8s)	3356	3356	256	59	217	9	0	285
2855	1884s (+0.6s)	2608	2608	256	53	163	8	0	224
2856	1885s (+0.5s)	1788	1788	128	45	127	10	0	182
2857	1885s (+0.4s)	1168	1168	128	19	109	1	0	129
2858	1886s (+0.4s)	1340	1340	128	38	99	3	0	140
2859	1887s (+0.8s)	3376	3376	256	64	203	13	0	280
2860	1887s (+0.7s)	3132	3132	256	55	193	10	0	258
2861	1888s (+0.7s)	2724	2724	256	43	185	5	0	233
2862	1889s (+0.7s)	3164	3164	256	60	191	8	0	259
2863	1889s (+0.4s)	1496	1496	128	29	121	4	0	154
2864	1890s (+0.6s)	2000	2000	128	52	141	12	1	206
2865	1890s (+0.5s)	1660	1660	128	38	123	6	0	167
2866	1891s (+0.5s)	1788	1788	128	43	128	9	0	180
2867	1891s (+0.5s)	1792	1792	128	40	134	9	0	183
2868	1892s (+0.5s)	1500	1500	128	33	117	8	0	158
2869	1893s (+1.0s)	4152	4152	256	77	245	0	19	341
2870	1893s (+0.5s)	2164	2164	256	36	139	0	11	186
2871	1894s (+0.8s)	3532	3532	256	69	203	0	12	284
2872	1895s (+0.6s)	2516	2516	256	49	164	0	8	221
2873	1895s (+0.7s)	3276	3276	256	49	215	0	7	271
2874	1896s (+0.2s)	612	612	64	14	66	0	5	85
2875	1897s (+1.0s)	5256	5256	512	70	275	0	15	360
2876	1897s (+0.7s)	2388	2388	128	40	172	0	13	225
2877	1898s (+0.7s)	3048	3048	256	62	173	0	11	246
2878	1899s (+0.8s)	3360	3360	256	58	216	0	12	286
2879	1900s (+0.7s)	2736	2736	256	59	162	0	13	234
2880	1900s (+0.6s)	2436	2436	256	56	149	7	0	212
2881	1901s (+0.7s)	2800	2800	256	52	182	8	0	242
2882	1901s (+0.6s)	1916	1916	128	55	130	12	0	197
2883	1902s (+0.5s)	1840	1840	128	50	132	8	0	190
2884	1903s (+0.7s)	2908	2908	256	72	170	11	0	253
2885	1904s (+1.0s)	4232	4232	256	102	224	23	0	349
2886	1904s (+0.5s)	1612	1612	128	35	118	7	0	160
2887	1905s (+0.8s)	3644	3644	256	71	213	14	0	298
2888	1906s (+1.2s)	5792	5792	512	115	269	23	1	408
2889	1907s (+0.7s)	2500	2500	256	51	158	7	0	216
2890	1908s (+0.8s)	3240	3240	256	58	208	7	0	273
2891	1908s (+0.5s)	1688	1688	128	44	120	10	0	174
2892	1909s (+0.7s)	3200	3200	256	69	185	10	0	264
2893	1909s (+0.5s)	1992	1992	128	54	129	7	0	190
2894	1910s (+0.4s)	1488	1488	128	34	112	9	0	155
2895	1911s (+0.7s)	2780	2780	256	62	171	9	0	242
2896	1911s (+0.9s)	3832	3832	256	66	231	17	1	315
2897	1912s (+0.9s)	3972	3972	256	73	242	12	0	327
2898	1913s (+0.8s)	3400	3400	256	82	195	14	0	291
2899	1914s (+0.6s)	2252	2252	128	58	149	11	0	218
Episode	Time	Reward	Score	Highest	L	U	R	D	Steps
2900	1914s (+0.5s)	1908	1908	128	44	141	10	0	195
2901	1915s (+0.5s)	1876	1876	128	49	133	9	0	191
2902	1915s (+0.4s)	1352	1352	128	36	96	11	0	143
2903	1916s (+0.4s)	1468	1468	128	44	101	10	0	155
2904	1916s (+0.6s)	2576	2576	256	63	146	10	0	219
2905	1917s (+0.5s)	1768	1768	128	44	116	7	0	167
2906	1918s (+0.7s)	2956	2956	256	76	159	15	0	250
2907	1918s (+0.5s)	1620	1620	128	46	116	10	0	172
2908	1919s (+0.5s)	1592	1592	128	46	109	10	0	165
2909	1920s (+1.0s)	4244	4244	256	88	243	20	0	351
2910	1920s (+0.8s)	3512	3512	256	79	203	15	0	297
2911	1921s (+0.4s)	1072	1072	64	30	95	6	0	131
2912	1921s (+0.4s)	1320	1320	64	38	102	9	1	150
2913	1922s (+0.3s)	1056	1056	128	32	77	5	0	114
2914	1922s (+0.8s)	3280	3280	256	59	203	10	0	272
2915	1923s (+1.2s)	5916	5916	512	89	322	17	0	428
2916	1925s (+1.1s)	4372	4372	256	93	256	18	0	367
2917	1925s (+0.5s)	1588	1588	128	31	123	7	0	161
2918	1925s (+0.3s)	824	824	64	35	69	5	0	109
2919	1926s (+0.4s)	1432	1432	128	42	97	5	0	144
2920	1926s (+0.2s)	600	600	64	18	61	1	0	80
2921	1926s (+0.5s)	1500	1500	128	38	115	5	0	158
2922	1927s (+0.5s)	1584	1584	128	40	120	7	0	167
2923	1927s (+0.3s)	1112	1112	128	21	97	3	0	121
2924	1928s (+1.1s)	5564	5564	512	89	283	17	0	389
2925	1929s (+0.9s)	3856	3856	256	68	233	8	0	309
2926	1930s (+0.9s)	4048	4048	256	95	226	13	0	334
2927	1931s (+0.5s)	1696	1696	128	33	128	8	0	169
2928	1931s (+0.6s)	1924	1924	128	44	150	5	0	199
2929	1932s (+0.7s)	2684	2684	128	58	179	13	0	250
2930	1932s (+0.4s)	1284	1284	128	38	94	5	0	137
2931	1933s (+0.4s)	1072	1072	64	36	91	5	0	132
2932	1933s (+0.4s)	1228	1228	128	29	102	4	0	135
2933	1934s (+0.7s)	3040	3040	256	44	202	0	9	255
2934	1935s (+0.8s)	3436	3436	256	61	210	0	18	289
2935	1935s (+0.6s)	2420	2420	128	41	180	0	7	228
2936	1936s (+0.7s)	2424	2424	128	47	175	0	7	229
2937	1936s (+0.4s)	1080	1080	64	24	94	0	9	127
2938	1937s (+0.3s)	716	716	64	22	70	0	6	98
2939	1937s (+0.6s)	2220	2220	128	49	152	0	9	210
2940	1938s (+0.3s)	776	776	64	15	82	0	4	101
2941	1938s (+0.4s)	1016	1016	64	30	85	0	7	122
2942	1939s (+0.9s)	3644	3644	256	71	215	0	13	299
2943	1940s (+0.7s)	2704	2704	256	50	175	0	10	235
2944	1940s (+0.6s)	1956	1956	128	36	153	0	8	197
2945	1941s (+0.9s)	3792	3792	256	60	234	0	11	305
2946	1941s (+0.4s)	1428	1428	128	38	99	0	9	146
2947	1942s (+0.6s)	1984	1984	128	45	155	0	9	209
2948	1943s (+0.6s)	2492	2492	256	44	166	0	4	214
2949	1943s (+0.2s)	448	448	32	12	58	0	3	73
2950	1943s (+0.3s)	1048	1048	128	28	81	0	3	112
2951	1944s (+0.4s)	1200	1200	128	30	94	0	8	132
2952	1944s (+0.2s)	616	616	64	13	64	0	5	82
2953	1945s (+0.8s)	3612	3612	256	55	224	0	16	295
2954	1945s (+0.5s)	1868	1868	128	48	134	8	0	190
2955	1946s (+0.5s)	1704	1704	128	30	135	3	0	168
2956	1946s (+0.5s)	1768	1768	128	51	116	14	0	181
2957	1947s (+0.6s)	2356	2356	256	43	151	5	0	199
2958	1947s (+0.5s)	2148	2148	256	51	122	9	0	182
2959	1948s (+0.5s)	1788	1788	128	44	132	6	0	182
2960	1948s (+0.5s)	1772	1772	128	43	128	5	0	176
2961	1949s (+0.7s)	2704	2704	256	58	163	14	0	235
2962	1950s (+0.8s)	3596	3596	256	84	203	15	0	302
2963	1950s (+0.3s)	964	964	64	27	80	2	1	110
2964	1951s (+0.4s)	1348	1348	64	43	105	4	0	152
2965	1951s (+0.4s)	1484	1484	128	44	103	7	1	155
2966	1952s (+0.5s)	1840	1840	128	29	144	0	8	181
2967	1952s (+0.6s)	2340	2340	128	37	171	0	10	218
2968	1953s (+0.5s)	2164	2164	256	52	120	0	10	182
2969	1953s (+0.8s)	3248	3248	256	54	205	0	15	274
2970	1954s (+0.4s)	1028	1028	64	23	96	0	8	127
2971	1955s (+1.2s)	5572	5572	512	91	292	0	20	403
2972	1956s (+1.0s)	5320	5320	512	72	285	0	20	377
2973	1957s (+0.6s)	2344	2344	256	34	146	0	15	195
2974	1957s (+0.4s)	1444	1444	128	25	115	0	7	147
2975	1958s (+0.8s)	3464	3464	256	79	192	14	0	285
2976	1959s (+0.7s)	3188	3188	256	73	177	14	0	264
2977	1960s (+0.7s)	3228	3228	256	70	184	16	0	270
2978	1960s (+0.7s)	2824	2824	256	48	185	9	0	242
2979	1961s (+0.7s)	3208	3208	256	70	174	11	0	255
2980	1961s (+0.5s)	1712	1712	128	60	107	8	0	175
2981	1962s (+0.6s)	2040	2040	128	52	136	13	0	201
2982	1963s (+0.8s)	3504	3504	256	91	190	14	0	295
2983	1963s (+0.5s)	1820	1820	128	45	133	7	0	185
2984	1964s (+0.6s)	1936	1936	128	42	152	8	0	202
2985	1965s (+0.8s)	3464	3464	256	62	206	16	1	285
2986	1966s (+0.8s)	3536	3536	256	66	223	10	0	299
2987	1966s (+0.5s)	1620	1620	128	36	121	5	0	162
2988	1967s (+0.4s)	1440	1440	128	38	111	10	0	159
2989	1967s (+0.7s)	2720	2720	256	62	167	6	0	235
2990	1968s (+1.0s)	4380	4380	256	105	239	24	0	368
2991	1969s (+0.6s)	1988	1988	128	58	137	5	0	200
2992	1970s (+0.8s)	3416	3416	256	58	214	0	14	286
2993	1971s (+0.9s)	4176	4176	256	82	221	20	1	324
2994	1971s (+0.6s)	2476	2476	256	49	155	6	0	210
2995	1972s (+0.5s)	1660	1660	128	41	132	4	0	177
2996	1972s (+0.4s)	1568	1568	128	39	112	8	1	160
2997	1972s (+0.2s)	612	612	32	15	66	5	1	87
2998	1973s (+0.5s)	1660	1660	128	45	117	6	0	168
2999	1973s (+0.5s)	1504	1504	128	36	121	3	0	160
Episode	Time	Reward	Score	Highest	L	U	R	D	Steps
3000	1974s (+0.8s)	3660	3660	256	82	200	20	1	303
3001	1975s (+0.6s)	2760	2760	256	40	176	0	8	224
3002	1975s (+0.3s)	1148	1148	128	24	93	0	8	125
3003	1976s (+0.4s)	1444	1444	128	31	107	0	12	150
3004	1976s (+0.6s)	1932	1932	128	46	142	13	0	201
3005	1977s (+0.5s)	1744	1744	128	45	123	8	0	176
3006	1977s (+0.5s)	1792	1792	128	38	134	10	0	182
3007	1978s (+0.5s)	1676	1676	128	35	130	6	0	171
3008	1979s (+0.9s)	4012	4012	256	60	261	0	13	334
3009	1980s (+1.0s)	5168	5168	512	82	269	0	19	370
3010	1981s (+0.8s)	3360	3360	256	58	219	0	9	286
3011	1982s (+1.3s)	6316	6316	512	83	344	0	26	453
3012	1982s (+0.4s)	1056	1056	64	26	93	0	9	128
3013	1983s (+0.4s)	1168	1168	128	20	105	0	3	128
3014	1983s (+0.6s)	2084	2084	128	57	142	9	0	208
3015	1984s (+0.5s)	1820	1820	128	41	144	4	0	189
3016	1985s (+0.6s)	1924	1924	128	42	148	9	0	199
3017	1985s (+0.4s)	1216	1216	128	26	100	5	0	131
3018	1986s (+1.2s)	5800	5800	512	103	295	18	0	416
3019	1987s (+0.5s)	1816	1816	128	49	130	9	0	188
3020	1987s (+0.7s)	3236	3236	256	61	199	13	0	273
3021	1989s (+1.2s)	5940	5940	512	108	286	25	1	420
3022	1989s (+0.5s)	2188	2188	256	32	149	7	0	188
3023	1990s (+0.6s)	2568	2568	256	50	164	8	0	222
3024	1990s (+0.4s)	1040	1040	64	33	83	8	0	124
3025	1991s (+0.5s)	1608	1608	128	45	115	9	0	169
3026	1992s (+0.9s)	4104	4104	256	84	237	12	0	333
3027	1993s (+1.1s)	5376	5376	512	73	277	25	0	375
3028	1993s (+0.3s)	980	980	128	20	81	3	0	104
3029	1994s (+0.9s)	4432	4432	512	95	187	18	1	301
3030	1995s (+0.8s)	3236	3236	256	60	196	15	0	271
3031	1995s (+0.5s)	1592	1592	128	43	116	6	0	165
3032	1996s (+0.4s)	1520	1520	128	31	121	5	0	157
3033	1997s (+1.1s)	5344	5344	512	115	237	21	0	373
3034	1997s (+0.4s)	1392	1392	128	34	102	8	2	146
3035	1998s (+0.7s)	2816	2816	256	68	168	11	0	247
3036	1999s (+0.5s)	1656	1656	128	37	132	1	0	170
3037	1999s (+0.7s)	2528	2528	128	58	166	12	0	236
3038	2000s (+0.5s)	1612	1612	128	37	128	5	0	170
3039	2000s (+0.5s)	1520	1520	128	40	113	6	1	160
3040	2000s (+0.2s)	484	484	32	19	55	0	4	78
3041	2001s (+0.8s)	3444	3444	256	68	207	13	0	288
3042	2002s (+0.3s)	732	732	64	22	71	4	0	97
3043	2002s (+0.6s)	2192	2192	128	52	159	11	0	222
3044	2003s (+0.6s)	2608	2608	256	43	178	0	6	227
3045	2004s (+0.8s)	3252	3252	256	43	222	0	12	277
3046	2005s (+1.1s)	5304	5304	512	90	267	21	0	378
3047	2006s (+0.9s)	4716	4716	512	80	226	17	0	323
3048	2007s (+1.0s)	5132	5132	512	97	246	22	1	366
3049	2007s (+0.7s)	3128	3128	256	65	178	12	0	255
3050	2008s (+0.4s)	1344	1344	128	26	111	4	0	141
3051	2008s (+0.5s)	1672	1672	128	52	122	5	0	179
3052	2009s (+0.8s)	3552	3552	256	78	213	11	0	302
3053	2010s (+0.7s)	2568	2568	128	68	162	12	0	242
3054	2011s (+0.8s)	3412	3412	256	63	209	9	0	281
3055	2011s (+0.6s)	2428	2428	256	41	155	7	0	203
3056	2012s (+0.8s)	3516	3516	256	67	215	11	0	293
3057	2013s (+0.5s)	1760	1760	128	47	126	7	0	180
3058	2013s (+0.7s)	2776	2776	256	60	167	10	0	237
3059	2014s (+0.6s)	2436	2436	256	53	145	6	1	205
3060	2015s (+0.8s)	3364	3364	256	68	206	13	0	287
3061	2015s (+0.7s)	2736	2736	256	56	168	9	0	233
3062	2016s (+0.8s)	3400	3400	256	66	216	9	0	291
3063	2017s (+0.4s)	1172	1172	64	33	95	8	0	136
3064	2017s (+0.8s)	3592	3592	256	73	212	16	0	301
3065	2018s (+0.5s)	2196	2196	256	40	139	10	0	189
3066	2019s (+0.7s)	3144	3144	256	51	192	0	13	256
3067	2020s (+0.8s)	3600	3600	256	63	221	0	11	295
3068	2020s (+0.8s)	3368	3368	256	54	223	0	11	288
3069	2021s (+0.5s)	1556	1556	128	22	129	0	10	161
3070	2022s (+0.7s)	3212	3212	256	56	198	0	13	267
3071	2022s (+0.7s)	2668	2668	256	51	178	0	8	237
3072	2023s (+0.7s)	2908	2908	256	70	169	14	0	253
3073	2023s (+0.4s)	1224	1224	128	42	85	6	0	133
3074	2024s (+0.8s)	3192	3192	256	61	194	11	1	267
3075	2025s (+1.0s)	4956	4956	512	86	239	14	1	340
3076	2026s (+0.4s)	1356	1356	128	33	101	5	0	139
3077	2026s (+0.6s)	2540	2540	256	55	156	11	0	222
3078	2027s (+0.8s)	3328	3328	256	63	198	11	0	272
3079	2027s (+0.4s)	1056	1056	64	26	96	6	0	128
3080	2028s (+0.5s)	1636	1636	128	44	108	13	0	165
3081	2029s (+0.6s)	2524	2524	256	46	160	12	0	218
3082	2029s (+0.7s)	2944	2944	256	55	187	6	0	248
3083	2030s (+0.4s)	1448	1448	128	37	107	5	1	150
3084	2031s (+0.8s)	3784	3784	256	87	210	15	0	312
3085	2032s (+1.3s)	6416	6416	512	130	302	26	0	458
3086	2033s (+0.8s)	3204	3204	256	71	184	14	0	269
3087	2033s (+0.5s)	1572	1572	128	34	127	4	0	165
3088	2034s (+0.6s)	2628	2628	256	54	167	10	1	232
3089	2035s (+0.5s)	2280	2280	256	50	138	7	0	195
3090	2036s (+1.0s)	5028	5028	512	101	234	22	0	357
3091	2036s (+0.5s)	1612	1612	128	44	119	7	0	170
3092	2037s (+0.5s)	1680	1680	128	33	125	7	1	166
3093	2037s (+0.7s)	2868	2868	256	69	172	12	0	253
3094	2038s (+0.6s)	2236	2236	128	80	128	13	1	222
3095	2038s (+0.5s)	1900	1900	128	42	144	7	0	193
3096	2039s (+0.7s)	2500	2500	128	67	153	16	0	236
3097	2040s (+0.8s)	3476	3476	256	68	209	11	0	288
3098	2040s (+0.5s)	1624	1624	128	45	121	6	0	172
3099	2041s (+0.4s)	980	980	64	39	78	7	0	124
Episode	Time	Reward	Score	Highest	L	U	R	D	Steps
3100	2041s (+0.6s)	2192	2192	128	60	150	12	0	222
3101	2042s (+0.2s)	392	392	32	10	49	0	6	65
3102	2042s (+0.3s)	984	984	64	21	89	0	6	116
3103	2042s (+0.4s)	1124	1124	64	31	94	0	5	130
3104	2043s (+0.4s)	1460	1460	128	33	110	6	0	149
3105	2043s (+0.6s)	2072	2072	128	63	134	8	0	205
3106	2044s (+0.4s)	1488	1488	128	32	115	9	0	156
3107	2044s (+0.5s)	1748	1748	128	41	128	7	0	176
3108	2045s (+0.9s)	3680	3680	256	83	218	13	0	314
3109	2046s (+0.8s)	3376	3376	256	73	194	13	0	280
3110	2047s (+0.6s)	2404	2404	128	53	162	8	1	224
3111	2047s (+0.7s)	2764	2764	256	63	160	10	1	234
3112	2048s (+0.5s)	1696	1696	128	40	125	11	0	176
3113	2049s (+0.8s)	3280	3280	256	71	197	10	0	278
3114	2049s (+0.3s)	860	860	64	25	79	7	0	111
3115	2050s (+1.0s)	5032	5032	512	83	250	20	0	353
3116	2051s (+0.9s)	3612	3612	256	72	220	14	0	306
3117	2051s (+0.4s)	1440	1440	128	43	104	8	0	155
3118	2053s (+1.4s)	6532	6532	512	109	337	29	0	475
3119	2054s (+0.8s)	3576	3576	256	76	204	16	1	297
3120	2054s (+0.7s)	3052	3052	256	51	186	10	1	248
3121	2055s (+0.7s)	3104	3104	256	77	169	17	0	263
3122	2056s (+0.5s)	1708	1708	128	50	114	7	0	171
3123	2056s (+0.4s)	1324	1324	128	27	115	4	1	147
3124	2057s (+1.0s)	4340	4340	256	95	244	20	0	359
3125	2058s (+0.5s)	1568	1568	128	43	110	11	0	164
3126	2058s (+0.4s)	1444	1444	128	39	104	7	0	150
3127	2059s (+0.6s)	2536	2536	256	62	136	10	0	208
3128	2059s (+0.4s)	1288	1288	128	18	113	2	0	133
3129	2060s (+0.8s)	3164	3164	256	59	198	9	0	266
3130	2060s (+0.5s)	1592	1592	128	47	112	6	0	165
3131	2061s (+0.7s)	2564	2564	128	65	171	10	1	247
3132	2061s (+0.3s)	996	996	64	24	85	5	1	115
3133	2062s (+0.3s)	888	888	64	25	76	0	7	108
3134	2062s (+0.7s)	2772	2772	128	85	153	22	0	260
3135	2063s (+0.3s)	744	744	64	18	75	5	0	98
3136	2063s (+0.4s)	1448	1448	128	29	119	3	0	151
3137	2064s (+0.4s)	1188	1188	128	33	84	8	0	125
3138	2064s (+0.4s)	1340	1340	128	33	97	9	0	139
3139	2065s (+0.7s)	2744	2744	128	71	165	16	1	253
3140	2065s (+0.8s)	3428	3428	256	78	193	17	0	288
3141	2066s (+0.7s)	2760	2760	256	54	174	10	0	238
3142	2067s (+0.9s)	4144	4144	256	74	244	0	21	339
3143	2068s (+0.4s)	1520	1520	128	29	125	0	9	163
3144	2068s (+0.8s)	3380	3380	256	65	200	20	0	285
3145	2069s (+0.8s)	3324	3324	256	82	180	15	0	277
3146	2070s (+0.6s)	1924	1924	128	50	139	10	0	199
3147	2070s (+0.4s)	1068	1068	64	27	97	5	1	130
3148	2071s (+0.5s)	1680	1680	128	38	125	9	0	172
3149	2071s (+0.3s)	1040	1040	64	28	86	9	0	123
3150	2072s (+0.6s)	1936	1936	128	51	145	6	0	202
3151	2072s (+0.3s)	792	792	64	21	76	0	9	106
3152	2072s (+0.5s)	1716	1716	128	41	132	7	0	180
3153	2073s (+0.6s)	1960	1960	128	60	135	8	0	203
3154	2074s (+0.8s)	3300	3300	256	61	201	10	0	272
3155	2075s (+0.8s)	3432	3432	256	82	178	20	1	281
3156	2075s (+0.6s)	2132	2132	128	55	141	8	0	204
3157	2076s (+0.6s)	2700	2700	256	44	167	9	0	220
3158	2076s (+0.5s)	1736	1736	128	37	133	5	0	175
3159	2077s (+0.4s)	1576	1576	128	27	126	3	0	156
3160	2077s (+0.7s)	2724	2724	256	66	160	17	0	243
3161	2078s (+0.7s)	3036	3036	256	71	170	17	0	258
3162	2079s (+0.8s)	3520	3520	256	74	206	14	0	294
3163	2080s (+0.4s)	1432	1432	128	39	109	6	0	154
3164	2080s (+0.6s)	2272	2272	128	46	157	12	1	216
3165	2081s (+0.7s)	2832	2832	256	40	185	5	0	230
3166	2082s (+1.1s)	5764	5764	512	111	278	23	0	412
3167	2083s (+0.7s)	3084	3084	256	56	178	20	1	255
3168	2084s (+1.1s)	4408	4408	256	103	255	13	0	371
3169	2085s (+0.9s)	3712	3712	256	73	225	12	0	310
3170	2085s (+0.3s)	788	788	64	27	74	4	0	105
3171	2086s (+0.5s)	1808	1808	128	42	136	9	0	187
3172	2086s (+0.8s)	3208	3208	256	64	191	10	0	265
3173	2087s (+0.4s)	1300	1300	128	35	99	7	0	141
3174	2087s (+0.5s)	1760	1760	128	45	130	5	0	180
3175	2088s (+0.4s)	1212	1212	128	26	97	4	0	127
3176	2088s (+0.4s)	1384	1384	128	36	102	7	1	146
3177	2089s (+0.7s)	2920	2920	256	64	177	15	0	256
3178	2089s (+0.5s)	2364	2364	256	47	141	7	0	195
3179	2090s (+0.4s)	1140	1140	64	28	110	0	5	143
3180	2091s (+0.8s)	3260	3260	256	53	207	0	13	273
3181	2091s (+0.7s)	2732	2732	256	39	187	0	7	233
3182	2092s (+0.6s)	2020	2020	128	45	156	0	6	207
3183	2092s (+0.4s)	1336	1336	128	28	108	0	9	145
3184	2093s (+0.4s)	1180	1180	64	46	90	6	0	142
3185	2093s (+0.7s)	2892	2892	256	64	174	11	0	249
3186	2094s (+0.6s)	2404	2404	256	58	138	8	0	204
3187	2095s (+0.8s)	3348	3348	256	59	215	10	0	284
3188	2095s (+0.4s)	1496	1496	128	53	96	8	0	157
3189	2096s (+0.7s)	2804	2804	256	58	177	9	0	244
3190	2097s (+0.5s)	2208	2208	256	45	138	8	0	191
3191	2097s (+0.5s)	1868	1868	128	60	116	14	0	190
3192	2098s (+0.7s)	2908	2908	256	59	185	9	0	253
3193	2098s (+0.5s)	1852	1852	128	46	131	8	1	186
3194	2099s (+0.7s)	2744	2744	256	44	183	7	0	234
3195	2100s (+0.6s)	2348	2348	256	50	145	5	0	200
3196	2100s (+0.8s)	3408	3408	256	74	207	12	0	293
3197	2101s (+0.6s)	2632	2632	256	58	148	17	0	223
3198	2101s (+0.3s)	1100	1100	128	33	78	7	0	118
3199	2102s (+0.8s)	3512	3512	256	74	210	12	0	296
Episode	Time	Reward	Score	Highest	L	U	R	D	Steps
3200	2103s (+0.3s)	1224	1224	128	28	92	4	0	124
3201	2103s (+0.4s)	1272	1272	128	35	96	3	0	134
3202	2104s (+0.9s)	3864	3864	256	74	231	12	0	317
3203	2104s (+0.5s)	1808	1808	128	43	137	6	1	187
3204	2105s (+0.8s)	3548	3548	256	70	211	13	0	294
3205	2106s (+0.6s)	2756	2756	256	68	161	8	0	237
3206	2107s (+0.7s)	3176	3176	256	71	176	11	1	259
3207	2108s (+0.9s)	3744	3744	256	74	221	16	0	311
3208	2108s (+0.5s)	1768	1768	128	47	128	7	0	182
3209	2109s (+0.5s)	1796	1796	128	36	141	7	0	184
3210	2109s (+0.5s)	1588	1588	128	42	113	9	0	164
3211	2110s (+0.5s)	1848	1848	128	57	116	13	0	186
3212	2111s (+1.1s)	4604	4604	256	105	263	17	0	385
3213	2112s (+0.6s)	2184	2184	128	43	151	0	12	206
3214	2112s (+0.5s)	2188	2188	256	33	148	0	8	189
3215	2113s (+0.6s)	2500	2500	256	38	165	0	10	213
3216	2114s (+0.8s)	3364	3364	256	47	226	0	14	287
3217	2114s (+0.3s)	1104	1104	128	25	89	0	3	117
3218	2115s (+0.8s)	3356	3356	256	68	200	0	18	286
3219	2115s (+0.7s)	2464	2464	128	38	176	0	13	227
3220	2116s (+0.9s)	4640	4640	512	68	229	0	17	314
3221	2117s (+0.3s)	720	720	64	19	73	0	2	94
3222	2117s (+0.5s)	2040	2040	128	36	148	0	7	191
3223	2117s (+0.2s)	568	568	64	12	67	0	2	81
3224	2118s (+0.5s)	1816	1816	128	43	134	0	11	188
3225	2119s (+0.6s)	2572	2572	256	42	169	0	13	224
3226	2119s (+0.7s)	3152	3152	256	57	195	8	0	260
3227	2120s (+1.0s)	4360	4360	256	89	251	20	0	360
3228	2121s (+0.6s)	2472	2472	256	48	153	8	0	209
3229	2121s (+0.4s)	1208	1208	128	33	93	5	0	131
3230	2122s (+0.6s)	2276	2276	128	60	152	15	0	227
3231	2123s (+0.7s)	2896	2896	256	58	184	10	0	252
3232	2123s (+0.5s)	1772	1772	128	42	134	6	0	182
3233	2124s (+0.3s)	904	904	64	30	81	6	0	117
3234	2124s (+0.5s)	1804	1804	128	46	131	9	0	186
3235	2124s (+0.3s)	676	676	64	18	72	4	0	94
3236	2126s (+1.2s)	5828	5828	512	111	285	27	0	423
3237	2127s (+1.0s)	4208	4208	256	92	232	18	0	342
3238	2128s (+0.9s)	4028	4028	256	74	238	17	0	329
3239	2128s (+0.6s)	2236	2236	128	50	154	10	0	214
3240	2129s (+0.7s)	2940	2940	256	66	184	11	0	261
3241	2130s (+0.4s)	1468	1468	128	40	103	8	0	151
3242	2130s (+0.4s)	1200	1200	64	42	94	6	0	142
3243	2131s (+0.9s)	4004	4004	256	87	228	13	0	328
3244	2132s (+0.7s)	2860	2860	256	59	185	9	0	253
3245	2132s (+0.7s)	2724	2724	256	49	181	6	0	236
3246	2133s (+0.7s)	2844	2844	256	63	178	9	0	250
3247	2134s (+1.0s)	5156	5156	512	78	263	15	1	357
3248	2135s (+0.5s)	1768	1768	128	49	115	17	0	181
3249	2135s (+0.3s)	804	804	64	25	71	6	0	102
3250	2135s (+0.4s)	1404	1404	128	34	107	6	0	147
3251	2136s (+0.5s)	1684	1684	128	39	127	7	0	173
3252	2136s (+0.4s)	1500	1500	128	39	114	5	0	158
3253	2137s (+0.3s)	620	620	32	37	55	3	0	95
3254	2137s (+0.9s)	3860	3860	256	87	216	13	0	316
3255	2138s (+0.7s)	3044	3044	256	63	180	13	0	256
3256	2139s (+0.5s)	2152	2152	256	43	134	7	0	184
3257	2139s (+0.6s)	2536	2536	256	59	149	13	0	221
3258	2140s (+0.9s)	3528	3528	256	72	209	15	0	296
3259	2141s (+0.5s)	1940	1940	128	50	130	10	0	190
3260	2141s (+0.7s)	2932	2932	256	49	199	11	0	259
3261	2142s (+0.5s)	2164	2164	256	36	140	9	1	186
3262	2143s (+0.5s)	2172	2172	256	56	119	9	0	184
3263	2143s (+0.7s)	2908	2908	256	65	176	12	0	253
3264	2144s (+0.5s)	1736	1736	128	50	113	11	0	174
3265	2145s (+0.9s)	3968	3968	256	88	200	16	1	305
3266	2146s (+1.1s)	4632	4632	256	103	260	20	0	383
3267	2146s (+0.7s)	2444	2444	128	71	147	15	0	233
3268	2147s (+1.0s)	4056	4056	256	74	241	18	0	333
3269	2148s (+0.8s)	3176	3176	256	68	189	11	0	268
3270	2149s (+0.4s)	1392	1392	128	44	94	10	0	148
3271	2149s (+0.7s)	3120	3120	256	75	174	13	1	263
3272	2150s (+0.7s)	2728	2728	256	63	162	10	0	235
3273	2151s (+0.9s)	3888	3888	256	97	211	17	1	326
3274	2151s (+0.4s)	1568	1568	128	34	124	0	6	164
3275	2152s (+0.7s)	2976	2976	256	45	186	0	13	244
3276	2153s (+0.6s)	1956	1956	128	39	153	0	6	198
3277	2153s (+0.6s)	2172	2172	128	56	143	18	0	217
3278	2154s (+0.4s)	1452	1452	128	40	104	7	0	151
3279	2154s (+0.5s)	1584	1584	128	35	125	8	0	168
3280	2155s (+0.5s)	1712	1712	128	25	143	0	5	173
3281	2155s (+0.7s)	2864	2864	256	45	200	0	10	255
3282	2156s (+0.3s)	660	660	64	19	71	2	1	93
3283	2156s (+0.5s)	1776	1776	128	47	125	7	0	179
3284	2156s (+0.2s)	420	420	64	9	47	0	2	58
3285	2158s (+1.2s)	5912	5912	512	113	291	23	1	428
3286	2158s (+0.5s)	1520	1520	128	42	110	11	0	163
3287	2159s (+1.0s)	4376	4376	256	96	250	19	0	365
3288	2160s (+0.9s)	3884	3884	256	71	229	11	0	311
3289	2161s (+1.2s)	6144	6144	512	107	302	13	0	422
3290	2162s (+0.9s)	3880	3880	256	70	233	10	0	313
3291	2163s (+0.5s)	1608	1608	128	39	125	5	0	169
3292	2164s (+0.7s)	3036	3036	256	60	181	11	2	254
3293	2164s (+0.6s)	2668	2668	256	52	165	10	0	227
3294	2165s (+0.4s)	1180	1180	64	33	100	8	0	141
3295	2165s (+0.7s)	2928	2928	256	51	201	6	0	258
3296	2166s (+0.8s)	3516	3516	256	73	213	12	0	298
3297	2167s (+0.7s)	3060	3060	256	61	184	13	2	260
3298	2168s (+0.8s)	3392	3392	256	71	186	18	1	276
3299	2168s (+0.6s)	2476	2476	256	54	153	5	0	212
Episode	Time	Reward	Score	Highest	L	U	R	D	Steps
3300	2169s (+0.7s)	3076	3076	256	62	190	14	2	268
3301	2170s (+0.7s)	3292	3292	256	65	195	10	0	270
3302	2171s (+0.8s)	3300	3300	256	63	199	13	1	276
3303	2171s (+0.3s)	720	720	32	29	69	5	0	103
3304	2172s (+0.7s)	3300	3300	256	60	203	0	10	273
3305	2172s (+0.5s)	1668	1668	128	32	131	0	6	169
3306	2173s (+0.5s)	1580	1580	128	31	131	0	8	170
3307	2173s (+0.6s)	2460	2460	256	43	162	0	7	212
3308	2174s (+0.5s)	1800	1800	128	33	130	0	8	171
3309	2174s (+0.5s)	1856	1856	128	34	151	0	9	194
3310	2175s (+0.5s)	2048	2048	256	31	132	0	8	171
3311	2176s (+0.6s)	2132	2132	128	57	142	13	0	212
3312	2176s (+0.8s)	3268	3268	256	93	169	13	0	275
3313	2177s (+0.3s)	928	928	64	38	78	7	0	123
3314	2177s (+0.8s)	3172	3172	256	51	206	11	1	269
3315	2178s (+0.4s)	1160	1160	64	30	102	4	1	137
3316	2178s (+0.5s)	1576	1576	128	34	120	7	0	161
3317	2179s (+0.9s)	3920	3920	256	85	225	13	0	323
3318	2180s (+1.0s)	4260	4260	256	83	255	17	0	355
3319	2181s (+0.9s)	3752	3752	256	64	219	0	13	296
3320	2182s (+0.5s)	1568	1568	128	31	124	1	4	160
3321	2182s (+0.5s)	2352	2352	256	34	156	0	4	194
3322	2183s (+0.8s)	3272	3272	256	56	202	0	13	271
3323	2183s (+0.4s)	1060	1060	64	24	99	0	6	129
3324	2184s (+1.0s)	4088	4088	256	77	247	0	15	339
3325	2185s (+0.5s)	2168	2168	256	40	134	0	10	184
3326	2185s (+0.5s)	2288	2288	256	49	139	8	0	196
3327	2186s (+0.7s)	2876	2876	256	61	180	9	0	250
3328	2187s (+0.6s)	2368	2368	256	47	146	7	0	200
3329	2187s (+0.3s)	884	884	64	33	80	3	0	116
3330	2187s (+0.6s)	1924	1924	128	57	134	8	0	199
3331	2188s (+0.4s)	940	940	64	34	89	2	0	125
3332	2188s (+0.3s)	812	812	64	32	65	6	0	103
3333	2189s (+0.7s)	3128	3128	256	55	194	7	0	256
3334	2189s (+0.4s)	1348	1348	128	43	101	4	0	148
3335	2191s (+1.5s)	7248	7248	512	140	338	28	0	506
3336	2191s (+0.4s)	1488	1488	128	37	111	8	0	156
3337	2192s (+0.5s)	1532	1532	128	35	121	6	0	162
3338	2192s (+0.5s)	1832	1832	128	46	136	10	0	192
3339	2193s (+0.9s)	3816	3816	256	77	226	16	1	320
3340	2194s (+0.6s)	2564	2564	256	52	168	0	7	227
3341	2195s (+0.7s)	3104	3104	256	58	188	0	10	256
3342	2195s (+0.4s)	1436	1436	128	30	109	1	8	148
3343	2196s (+0.3s)	1200	1200	128	19	99	0	4	122
3344	2196s (+0.7s)	2916	2916	256	59	186	0	11	256
3345	2197s (+0.6s)	2252	2252	128	46	159	0	11	216
3346	2198s (+0.7s)	2944	2944	256	53	196	0	13	262
3347	2198s (+0.4s)	1080	1080	64	34	88	0	4	126
3348	2199s (+0.7s)	3008	3008	256	51	187	0	11	249
3349	2199s (+0.6s)	1920	1920	128	35	157	0	6	198
3350	2200s (+0.7s)	3168	3168	256	45	208	0	8	261
3351	2200s (+0.4s)	1156	1156	128	23	95	0	4	122
3352	2201s (+0.9s)	4056	4056	256	88	232	12	0	332
3353	2202s (+0.8s)	3348	3348	256	80	187	16	0	283
3354	2203s (+0.7s)	3256	3256	256	59	201	8	2	270
3355	2203s (+0.4s)	1536	1536	128	33	125	5	0	163
3356	2204s (+0.8s)	3304	3304	256	82	187	9	0	278
3357	2205s (+1.2s)	6716	6716	512	128	303	18	0	449
3358	2206s (+0.5s)	1800	1800	128	44	131	9	0	184
3359	2207s (+0.9s)	4000	4000	256	72	232	23	0	327
3360	2208s (+1.0s)	4360	4360	256	117	227	20	0	364
3361	2209s (+0.9s)	3976	3976	256	68	248	12	0	328
3362	2210s (+0.9s)	3676	3676	256	76	207	19	0	302
3363	2210s (+0.8s)	3352	3352	256	75	192	17	0	284
3364	2211s (+0.6s)	2740	2740	256	51	168	13	1	233
3365	2212s (+0.6s)	2848	2848	256	41	178	9	1	229
3366	2213s (+1.0s)	4188	4188	256	95	228	19	0	342
3367	2214s (+0.8s)	3416	3416	256	71	202	12	0	285
3368	2214s (+0.7s)	3196	3196	256	78	173	16	0	267
3369	2215s (+1.1s)	5640	5640	512	97	276	19	0	392
3370	2216s (+0.4s)	1268	1268	128	23	99	6	0	128
3371	2216s (+0.5s)	1808	1808	128	41	137	8	0	186
3372	2217s (+0.5s)	1796	1796	128	48	123	13	0	184
3373	2218s (+0.7s)	2508	2508	128	71	153	13	1	238
3374	2218s (+0.7s)	2524	2524	128	63	154	14	0	231
3375	2219s (+0.4s)	1040	1040	64	33	86	5	0	124
3376	2219s (+0.7s)	3152	3152	256	74	170	12	0	256
3377	2220s (+0.4s)	1432	1432	128	32	102	12	0	146
3378	2220s (+0.6s)	1912	1912	128	46	142	7	1	196
3379	2221s (+0.6s)	2476	2476	256	52	149	10	0	211
3380	2222s (+0.7s)	3132	3132	256	71	181	10	0	262
3381	2222s (+0.4s)	1476	1476	128	44	101	8	0	153
3382	2222s (+0.3s)	968	968	64	25	81	0	5	111
3383	2223s (+0.8s)	3212	3212	256	51	200	0	16	267
3384	2224s (+0.5s)	1616	1616	64	38	124	0	13	175
3385	2225s (+0.8s)	3384	3384	256	51	221	0	20	292
3386	2225s (+0.6s)	2716	2716	256	42	177	0	9	228
3387	2225s (+0.3s)	704	704	64	15	72	0	7	94
3388	2226s (+0.8s)	3484	3484	256	57	213	0	16	286
3389	2227s (+0.7s)	2800	2800	256	46	184	0	13	243
3390	2228s (+0.5s)	1888	1888	128	54	131	9	1	195
3391	2228s (+0.8s)	3556	3556	256	68	215	14	0	297
3392	2229s (+0.5s)	2112	2112	128	43	147	10	0	200
3393	2229s (+0.6s)	1924	1924	128	43	149	7	0	199
3394	2230s (+0.4s)	1204	1204	128	26	98	5	0	129
3395	2230s (+0.2s)	540	540	32	21	54	5	0	80
3396	2230s (+0.2s)	632	632	64	27	52	8	0	87
3397	2231s (+0.6s)	2588	2588	256	49	165	9	0	223
3398	2232s (+0.7s)	2860	2860	256	59	175	12	0	246
3399	2232s (+0.6s)	2472	2472	256	51	152	9	0	212
Episode	Time	Reward	Score	Highest	L	U	R	D	Steps
3400	2233s (+0.6s)	2496	2496	256	57	144	14	0	215
3401	2234s (+0.8s)	3432	3432	256	65	214	11	0	290
3402	2234s (+0.6s)	1912	1912	128	42	148	6	0	196
3403	2235s (+0.5s)	1604	1604	128	40	121	6	0	167
3404	2235s (+0.4s)	1544	1544	128	45	106	7	0	158
3405	2235s (+0.1s)	296	296	32	7	42	0	1	50
3406	2236s (+0.6s)	2784	2784	256	38	181	0	7	226
3407	2237s (+0.8s)	3368	3368	256	65	209	0	14	288
3408	2237s (+0.5s)	1796	1796	128	39	137	0	8	184
3409	2238s (+0.5s)	1920	1920	128	43	131	0	10	184
3410	2239s (+0.5s)	1784	1784	128	39	134	0	8	181
3411	2239s (+0.2s)	532	532	64	12	57	0	4	73
3412	2239s (+0.6s)	1952	1952	128	41	153	0	7	201
3413	2240s (+0.5s)	1652	1652	128	34	131	0	10	175
3414	2241s (+0.7s)	2660	2660	256	47	179	0	9	235
3415	2241s (+0.7s)	2848	2848	256	53	184	0	13	250
3416	2242s (+0.5s)	1928	1928	128	30	144	0	12	186
3417	2243s (+0.8s)	3260	3260	256	67	188	0	18	273
3418	2243s (+0.7s)	2796	2796	256	41	189	0	12	242
3419	2244s (+0.9s)	4108	4108	256	68	243	0	19	330
3420	2245s (+0.7s)	2760	2760	256	42	187	0	7	236
3421	2246s (+1.0s)	5348	5348	512	75	275	0	19	369
3422	2246s (+0.6s)	2188	2188	256	46	138	0	7	191
3423	2247s (+0.8s)	2760	2760	128	50	196	0	17	263
3424	2248s (+0.6s)	2572	2572	256	53	149	11	0	213
3425	2248s (+0.3s)	788	788	64	26	71	7	0	104
3426	2249s (+0.7s)	2968	2968	256	73	179	11	0	263
3427	2249s (+0.6s)	2504	2504	128	61	166	10	0	237
3428	2250s (+0.6s)	2408	2408	256	53	145	6	0	204
3429	2251s (+0.7s)	3192	3192	256	79	171	11	0	261
3430	2252s (+0.9s)	4032	4032	256	89	225	13	0	327
3431	2252s (+0.4s)	1420	1420	128	25	112	8	0	145
3432	2253s (+1.0s)	4148	4148	256	85	239	15	0	339
3433	2254s (+0.6s)	2376	2376	256	61	135	6	0	202
3434	2255s (+1.0s)	4276	4276	256	84	238	25	0	347
3435	2255s (+0.6s)	2408	2408	256	64	130	10	1	205
3436	2256s (+0.5s)	1872	1872	128	30	154	3	0	187
3437	2256s (+0.5s)	1616	1616	128	48	117	6	0	171
3438	2257s (+1.0s)	4148	4148	256	87	236	16	0	339
3439	2258s (+0.7s)	3112	3112	256	61	182	14	1	258
3440	2259s (+0.9s)	3988	3988	256	85	227	19	0	331
3441	2260s (+0.7s)	2876	2876	256	61	171	10	0	242
3442	2260s (+0.4s)	1156	1156	64	43	87	6	0	136
3443	2261s (+0.9s)	3916	3916	256	99	189	21	0	309
3444	2262s (+0.6s)	2496	2496	256	53	151	11	0	215
3445	2262s (+0.5s)	1908	1908	128	47	129	9	0	185
3446	2263s (+0.6s)	2712	2712	256	43	176	7	0	226
3447	2264s (+0.8s)	3264	3264	256	74	180	18	0	272
3448	2264s (+0.4s)	1184	1184	64	39	98	6	0	143
3449	2265s (+0.8s)	3652	3652	256	65	216	0	15	296
3450	2265s (+0.3s)	668	668	64	15	73	0	3	91
3451	2266s (+0.5s)	1620	1620	128	34	126	0	8	168
3452	2266s (+0.4s)	1496	1496	128	27	121	0	7	155
3453	2267s (+0.5s)	1760	1760	128	53	115	0	10	178
3454	2267s (+0.4s)	1220	1220	64	33	107	0	7	147
3455	2268s (+0.7s)	3224	3224	256	52	207	0	10	269
3456	2269s (+0.7s)	3144	3144	256	50	197	0	9	256
3457	2269s (+0.3s)	1076	1076	128	24	89	0	3	116
3458	2270s (+0.7s)	2940	2940	256	49	199	0	13	261
3459	2271s (+1.0s)	5100	5100	512	86	270	0	9	365
3460	2271s (+0.5s)	1800	1800	128	47	133	0	5	185
3461	2272s (+0.6s)	2356	2356	256	44	143	0	11	198
3462	2272s (+0.6s)	2752	2752	256	44	185	0	8	237
3463	2273s (+0.7s)	3296	3296	256	71	198	7	0	276
3464	2274s (+0.8s)	3340	3340	256	71	199	11	0	281
3465	2275s (+1.1s)	5804	5804	512	96	296	18	0	410
3466	2276s (+0.3s)	1016	1016	64	28	86	4	1	119
3467	2276s (+0.5s)	1792	1792	128	41	133	8	0	182
3468	2277s (+0.9s)	3920	3920	256	77	227	17	0	321
3469	2277s (+0.4s)	1340	1340	128	29	101	4	0	134
3470	2278s (+0.5s)	1736	1736	128	44	125	5	0	174
3471	2279s (+1.2s)	5972	5972	512	111	299	25	0	435
3472	2280s (+0.7s)	2632	2632	128	61	168	13	0	242
3473	2280s (+0.5s)	1600	1600	128	42	118	7	0	167
3474	2281s (+0.7s)	2892	2892	256	65	169	20	0	254
3475	2282s (+0.9s)	4000	4000	256	69	257	7	1	334
3476	2283s (+0.5s)	1852	1852	128	52	122	11	0	185
3477	2283s (+0.6s)	2684	2684	256	70	148	12	0	230
3478	2284s (+0.8s)	3228	3228	256	43	218	9	0	270
3479	2284s (+0.5s)	1624	1624	128	39	125	9	0	173
3480	2285s (+0.9s)	3888	3888	256	88	209	16	0	313
3481	2286s (+0.9s)	3900	3900	256	74	229	15	0	318
3482	2287s (+0.9s)	3804	3804	256	78	229	10	0	317
3483	2288s (+0.5s)	1628	1628	128	38	129	6	0	173
3484	2289s (+0.8s)	3480	3480	256	89	187	13	0	289
3485	2289s (+0.8s)	3240	3240	256	56	203	13	1	273
3486	2290s (+0.7s)	3164	3164	256	61	183	18	1	263
3487	2291s (+0.8s)	3604	3604	256	77	194	18	0	289
3488	2291s (+0.6s)	2100	2100	128	51	142	8	0	201
3489	2292s (+0.4s)	1168	1168	128	35	82	8	0	125
3490	2292s (+0.7s)	2692	2692	256	52	170	10	0	232
3491	2293s (+0.5s)	1664	1664	128	42	120	6	0	168
3492	2294s (+0.7s)	2668	2668	256	54	175	12	0	241
3493	2294s (+0.7s)	2780	2780	256	68	156	13	1	238
3494	2295s (+0.6s)	2248	2248	128	60	135	17	0	212
3495	2295s (+0.5s)	1572	1572	128	43	115	6	0	164
3496	2296s (+0.8s)	3348	3348	256	71	202	10	0	283
3497	2297s (+0.6s)	2664	2664	256	55	154	16	0	225
3498	2298s (+0.8s)	3340	3340	256	71	199	12	0	282
3499	2298s (+0.5s)	1856	1856	128	49	128	10	0	187
Episode	Time	Reward	Score	Highest	L	U	R	D	Steps
3500	2299s (+0.7s)	2776	2776	256	68	159	10	0	237
3501	2300s (+0.7s)	2768	2768	256	63	167	9	0	239
3502	2300s (+0.5s)	1820	1820	128	45	132	8	0	185
3503	2301s (+0.7s)	2724	2724	256	60	166	11	0	237
3504	2301s (+0.4s)	1488	1488	128	35	117	3	0	155
3505	2302s (+0.6s)	1928	1928	128	42	153	5	0	200
3506	2302s (+0.6s)	2444	2444	256	50	149	8	0	207
3507	2303s (+0.4s)	1304	1304	128	28	97	7	0	132
3508	2303s (+0.3s)	924	924	64	26	88	8	0	122
3509	2304s (+0.7s)	3136	3136	256	71	176	16	0	263
3510	2305s (+0.7s)	3116	3116	256	51	192	0	13	256
3511	2305s (+0.6s)	1908	1908	128	46	138	0	11	195
3512	2306s (+0.5s)	1520	1520	128	36	117	0	10	163
3513	2306s (+0.3s)	1004	1004	64	28	82	1	9	120
3514	2306s (+0.2s)	584	584	32	19	66	0	2	87
3515	2307s (+0.7s)	2800	2800	256	52	180	0	11	243
3516	2307s (+0.6s)	1904	1904	128	39	148	0	11	198
3517	2308s (+0.8s)	3256	3256	256	68	187	0	18	273
3518	2309s (+0.5s)	1632	1632	128	43	119	0	13	175
3519	2309s (+0.5s)	1808	1808	128	32	148	0	7	187
3520	2310s (+0.3s)	668	668	64	14	75	0	1	90
3521	2310s (+0.4s)	1112	1112	64	41	83	0	7	131
3522	2311s (+0.7s)	2868	2868	256	60	167	13	0	240
3523	2311s (+0.4s)	1072	1072	64	35	88	8	0	131
3524	2312s (+0.8s)	3548	3548	256	73	209	19	0	301
3525	2312s (+0.6s)	1936	1936	128	46	145	11	0	202
3526	2313s (+0.8s)	3056	3056	256	62	189	12	0	263
3527	2314s (+0.7s)	2920	2920	256	58	176	8	0	242
3528	2314s (+0.5s)	1768	1768	128	39	129	9	1	178
3529	2315s (+0.5s)	2152	2152	256	37	138	8	0	183
3530	2316s (+0.8s)	3488	3488	256	74	203	14	0	291
3531	2316s (+0.4s)	1052	1052	64	28	94	5	0	127
3532	2317s (+0.7s)	2672	2672	256	50	165	13	0	228
3533	2318s (+0.9s)	3832	3832	256	86	207	16	0	309
3534	2318s (+0.4s)	1168	1168	64	33	99	7	0	139
3535	2318s (+0.4s)	1048	1048	64	29	95	4	1	129
3536	2319s (+0.5s)	2180	2180	256	39	144	6	0	189
3537	2320s (+1.0s)	4368	4368	256	97	253	16	0	366
3538	2321s (+0.7s)	2668	2668	256	53	164	10	0	227
3539	2321s (+0.5s)	1592	1592	128	43	119	3	0	165
3540	2322s (+0.8s)	3444	3444	256	69	201	13	0	283
3541	2323s (+0.7s)	2628	2628	256	54	164	0	13	231
3542	2323s (+0.4s)	1136	1136	64	32	90	0	10	132
3543	2324s (+0.9s)	3612	3612	256	49	251	0	12	312
3544	2325s (+0.6s)	2440	2440	256	44	161	0	8	213
3545	2326s (+1.0s)	5060	5060	512	75	268	0	17	360
3546	2326s (+0.5s)	1704	1704	128	33	130	0	5	168
3547	2327s (+1.1s)	5572	5572	512	78	297	0	21	396
3548	2328s (+0.4s)	1512	1512	128	29	119	0	8	156
3549	2328s (+0.6s)	2444	2444	256	38	164	0	6	208
3550	2329s (+0.6s)	1964	1964	128	47	140	0	11	198
3551	2330s (+0.8s)	3760	3760	256	54	239	0	13	306
3552	2330s (+0.7s)	2928	2928	256	54	192	0	12	258
3553	2331s (+0.9s)	3608	3608	256	80	209	15	1	305
3554	2332s (+0.8s)	3304	3304	256	77	186	15	0	278
3555	2333s (+1.3s)	6224	6224	512	121	291	30	0	442
3556	2335s (+1.2s)	5768	5768	512	113	277	18	0	408
3557	2336s (+0.7s)	3192	3192	256	69	180	16	0	265
3558	2337s (+1.1s)	5508	5508	512	89	273	18	0	380
3559	2337s (+0.3s)	992	992	128	15	87	2	0	104
3560	2338s (+0.6s)	1996	1996	128	59	126	16	1	202
3561	2338s (+0.5s)	1540	1540	128	41	118	5	0	164
3562	2339s (+0.6s)	2512	2512	256	45	164	11	0	220
3563	2339s (+0.5s)	1648	1648	128	40	127	1	0	168
3564	2340s (+0.7s)	2680	2680	256	45	175	10	0	230
3565	2340s (+0.5s)	1656	1656	128	38	123	8	0	169
3566	2341s (+0.9s)	3592	3592	256	82	202	16	1	301
3567	2342s (+0.7s)	3184	3184	256	79	166	19	0	264
3568	2343s (+0.9s)	3784	3784	256	84	213	15	1	313
3569	2343s (+0.5s)	2056	2056	256	37	132	3	0	172
3570	2344s (+0.5s)	1768	1768	128	39	135	5	0	179
3571	2344s (+0.7s)	2864	2864	256	48	201	5	0	254
3572	2345s (+0.3s)	880	880	64	29	83	4	0	116
3573	2345s (+0.6s)	1912	1912	128	50	137	9	0	196
3574	2346s (+1.1s)	5284	5284	512	93	256	23	0	372
3575	2347s (+0.7s)	2780	2780	256	53	171	14	1	239
3576	2348s (+0.8s)	3392	3392	256	78	186	14	1	279
3577	2348s (+0.3s)	880	880	64	25	83	7	0	115
3578	2349s (+0.5s)	2016	2016	128	47	136	8	1	192
3579	2349s (+0.4s)	1244	1244	128	25	95	0	8	128
3580	2350s (+0.3s)	892	892	64	18	89	0	7	114
3581	2350s (+0.5s)	1656	1656	128	31	137	0	8	176
3582	2351s (+0.8s)	3204	3204	256	64	190	0	15	269
3583	2351s (+0.3s)	796	796	64	18	77	0	6	101
3584	2352s (+0.6s)	2116	2116	128	42	149	0	10	201
3585	2352s (+0.5s)	1652	1652	128	35	124	0	6	165
3586	2353s (+0.6s)	2560	2560	256	58	158	0	10	226
3587	2353s (+0.6s)	2600	2600	256	48	158	0	9	215
3588	2354s (+0.7s)	2668	2668	256	47	170	0	10	227
3589	2355s (+0.8s)	3428	3428	256	71	205	0	12	288
3590	2356s (+0.7s)	2904	2904	256	57	182	0	13	252
3591	2356s (+0.4s)	1428	1428	128	39	107	7	0	153
3592	2357s (+0.6s)	1928	1928	128	49	140	7	0	196
3593	2357s (+0.8s)	3452	3452	256	83	190	12	2	287
3594	2358s (+0.4s)	1348	1348	128	32	101	6	0	139
3595	2358s (+0.7s)	2792	2792	256	47	185	10	0	242
3596	2359s (+0.5s)	1800	1800	128	54	120	11	0	185
3597	2360s (+0.8s)	3304	3304	256	82	177	19	0	278
3598	2360s (+0.3s)	836	836	64	18	84	4	0	106
3599	2361s (+1.0s)	4312	4312	256	90	253	13	0	356
Episode	Time	Reward	Score	Highest	L	U	R	D	Steps
3600	2362s (+0.6s)	2208	2208	128	57	140	11	0	208
3601	2362s (+0.8s)	3312	3312	256	60	209	10	0	279
3602	2363s (+0.2s)	620	620	64	17	64	4	0	85
3603	2363s (+0.7s)	2776	2776	256	54	171	12	0	237
3604	2364s (+0.6s)	1928	1928	128	42	151	7	0	200
3605	2364s (+0.2s)	592	592	64	17	60	2	0	79
3606	2365s (+0.6s)	2600	2600	256	48	167	10	0	225
3607	2365s (+0.6s)	2116	2116	128	43	150	8	0	201
3608	2366s (+0.8s)	3520	3520	256	70	213	11	0	294
3609	2367s (+0.5s)	1836	1836	128	39	146	4	0	189
3610	2368s (+1.0s)	4428	4428	256	95	255	14	1	365
3611	2368s (+0.5s)	1500	1500	128	28	127	4	0	159
3612	2369s (+0.9s)	3636	3636	256	84	207	20	1	312
3613	2370s (+0.5s)	1824	1824	128	44	135	8	0	187
3614	2370s (+0.5s)	1864	1864	128	36	149	0	5	190
3615	2371s (+0.7s)	2756	2756	128	85	155	16	0	256
3616	2371s (+0.5s)	1628	1628	128	45	116	8	1	170
3617	2372s (+0.8s)	3472	3472	256	60	210	0	18	288
3618	2373s (+0.5s)	1692	1692	128	30	134	0	10	174
3619	2374s (+0.9s)	3976	3976	256	73	241	14	0	328
3620	2374s (+0.5s)	1520	1520	128	36	120	8	0	164
3621	2375s (+0.7s)	3040	3040	256	61	175	13	0	249
3622	2375s (+0.4s)	1420	1420	128	41	102	8	0	151
3623	2376s (+0.8s)	3536	3536	256	83	190	25	0	298
3624	2377s (+0.7s)	2732	2732	256	61	158	12	0	231
3625	2378s (+0.8s)	3548	3548	256	80	205	13	0	298
3626	2378s (+0.7s)	2940	2940	256	57	175	11	0	243
3627	2379s (+0.6s)	2236	2236	128	43	163	0	8	214
3628	2380s (+0.8s)	3432	3432	256	44	232	0	13	289
3629	2380s (+0.5s)	1744	1744	128	36	132	0	9	177
3630	2381s (+0.4s)	1356	1356	128	33	102	0	5	140
3631	2381s (+0.7s)	3016	3016	256	61	169	0	13	243
3632	2382s (+0.8s)	3524	3524	256	54	227	0	18	299
3633	2383s (+0.5s)	1816	1816	128	42	133	0	14	189
3634	2384s (+1.3s)	6484	6484	512	123	321	18	1	463
3635	2385s (+1.0s)	4480	4480	256	92	254	20	0	366
3636	2386s (+0.3s)	992	992	64	27	79	11	0	117
3637	2386s (+0.5s)	1720	1720	128	27	143	1	0	171
3638	2387s (+0.5s)	1688	1688	128	40	126	8	0	174
3639	2387s (+0.4s)	1476	1476	128	40	111	5	0	156
3640	2388s (+0.4s)	1448	1448	128	37	109	5	0	151
3641	2388s (+0.6s)	2448	2448	256	52	148	8	0	208
3642	2389s (+0.8s)	3240	3240	256	71	184	12	0	267
3643	2390s (+1.1s)	5204	5204	512	105	250	19	0	374
3644	2390s (+0.4s)	1328	1328	128	36	95	7	0	138
3645	2391s (+0.2s)	520	520	64	12	58	1	0	71
3646	2392s (+1.0s)	4168	4168	256	88	237	18	1	344
3647	2392s (+0.6s)	2380	2380	128	60	147	15	0	222
3648	2393s (+0.7s)	2916	2916	256	59	173	8	0	240
3649	2394s (+0.8s)	3476	3476	256	83	197	12	0	292
3650	2394s (+0.5s)	1792	1792	128	49	124	10	0	183
3651	2395s (+0.4s)	1252	1252	64	36	101	7	0	144
3652	2396s (+0.9s)	4024	4024	256	87	233	15	0	335
3653	2396s (+0.6s)	2200	2200	128	46	149	0	15	210
3654	2397s (+0.9s)	3760	3760	256	74	220	0	21	315
3655	2398s (+0.4s)	1240	1240	128	33	99	0	6	138
3656	2398s (+0.5s)	1764	1764	128	31	144	0	6	181
3657	2399s (+0.7s)	3112	3112	256	52	194	0	11	257
3658	2400s (+0.8s)	3612	3612	256	56	231	0	10	297
3659	2401s (+1.2s)	5864	5864	512	102	298	20	0	420
3660	2402s (+0.8s)	3256	3256	256	70	195	11	0	276
3661	2403s (+0.7s)	2912	2912	256	57	186	11	0	254
3662	2403s (+0.6s)	1908	1908	128	52	132	11	0	195
3663	2404s (+1.1s)	5264	5264	512	100	253	18	3	374
3664	2405s (+0.7s)	3024	3024	256	50	189	12	0	251
3665	2406s (+0.7s)	3048	3048	256	44	191	0	11	246
3666	2406s (+0.7s)	3084	3084	256	49	192	0	8	249
3667	2407s (+0.2s)	524	524	64	16	59	0	2	77
3668	2407s (+0.6s)	2528	2528	256	57	152	11	0	220
3669	2408s (+1.0s)	4184	4184	256	88	246	14	0	348
3670	2409s (+0.7s)	2628	2628	256	67	152	13	0	232
3671	2410s (+1.3s)	7108	7108	512	115	354	20	0	489
3672	2411s (+0.9s)	4032	4032	256	80	239	16	0	335
3673	2412s (+0.3s)	720	720	64	23	69	5	0	97
3674	2412s (+0.4s)	1488	1488	128	33	115	8	0	156
3675	2413s (+0.7s)	2876	2876	256	58	165	9	0	232
3676	2414s (+0.8s)	3192	3192	256	67	185	14	0	266
3677	2414s (+0.3s)	1124	1124	128	37	74	9	0	120
3678	2414s (+0.6s)	1916	1916	128	44	144	9	0	197
3679	2415s (+1.0s)	4216	4216	256	95	231	18	0	344
3680	2416s (+0.5s)	1664	1664	128	60	110	8	0	178
3681	2417s (+0.6s)	1880	1880	128	46	139	8	1	194
3682	2417s (+0.8s)	3228	3228	256	68	183	19	0	270
3683	2418s (+0.3s)	908	908	64	33	80	5	0	118
3684	2418s (+0.5s)	1864	1864	128	42	140	7	0	189
3685	2419s (+1.3s)	6396	6396	512	97	334	22	0	453
3686	2420s (+0.7s)	2772	2772	256	56	178	9	0	243
3687	2421s (+0.3s)	1176	1176	128	28	94	5	0	127
3688	2421s (+0.8s)	3380	3380	256	67	203	11	0	281
3689	2422s (+0.5s)	1464	1464	128	48	93	13	1	155
3690	2422s (+0.6s)	2488	2488	256	64	142	7	0	213
3691	2423s (+0.8s)	3420	3420	256	65	213	8	0	286
3692	2424s (+0.7s)	2992	2992	256	75	155	16	0	246
3693	2425s (+0.7s)	2552	2552	128	80	151	12	0	243
3694	2425s (+0.6s)	1928	1928	128	43	150	7	0	200
3695	2426s (+0.7s)	3212	3212	256	62	193	11	0	266
3696	2426s (+0.4s)	1480	1480	128	38	107	10	0	155
3697	2427s (+0.4s)	1444	1444	128	40	104	6	0	150
3698	2427s (+0.4s)	1536	1536	128	33	120	0	3	156
3699	2428s (+0.7s)	2656	2656	256	48	176	0	10	234
Episode	Time	Reward	Score	Highest	L	U	R	D	Steps
3700	2428s (+0.6s)	1912	1912	128	42	145	0	10	197
3701	2429s (+0.6s)	2588	2588	256	40	174	0	9	223
3702	2430s (+0.7s)	2840	2840	256	57	180	0	11	248
3703	2431s (+0.8s)	3672	3672	256	70	212	0	16	298
3704	2431s (+0.5s)	1704	1704	128	40	127	0	8	175
3705	2432s (+1.0s)	4208	4208	256	93	230	24	0	347
3706	2433s (+0.5s)	1552	1552	128	34	127	5	0	166
3707	2433s (+0.4s)	1360	1360	128	35	95	7	0	137
3708	2434s (+1.0s)	4312	4312	256	100	236	20	0	356
3709	2435s (+0.7s)	2800	2800	256	74	157	12	0	243
3710	2435s (+0.5s)	1656	1656	128	48	112	10	0	170
3711	2436s (+0.6s)	2320	2320	128	56	150	7	0	213
3712	2436s (+0.6s)	2532	2532	256	50	157	13	0	220
3713	2437s (+0.4s)	1436	1436	128	40	99	8	0	147
3714	2437s (+0.2s)	464	464	32	24	50	3	0	77
3715	2438s (+0.4s)	1476	1476	128	43	99	7	0	149
3716	2439s (+1.2s)	5928	5928	512	103	310	18	0	431
3717	2439s (+0.3s)	1060	1060	128	25	85	2	0	112
3718	2440s (+0.5s)	1844	1844	128	50	130	8	0	188
3719	2440s (+0.7s)	2912	2912	256	64	181	9	0	254
3720	2441s (+0.6s)	2504	2504	256	53	157	8	1	219
3721	2441s (+0.4s)	1452	1452	128	29	114	4	0	147
3722	2443s (+1.2s)	6216	6216	512	117	294	29	0	440
3723	2444s (+0.8s)	3328	3328	256	60	202	13	0	275
3724	2444s (+0.3s)	784	784	64	18	83	4	0	105
3725	2445s (+1.0s)	4224	4224	256	92	247	14	0	353
3726	2446s (+1.1s)	5472	5472	512	102	259	23	0	384
3727	2446s (+0.3s)	716	716	64	16	77	3	0	96
3728	2447s (+0.6s)	1948	1948	128	50	137	10	1	198
3729	2448s (+0.7s)	3108	3108	256	55	188	13	1	257
3730	2448s (+0.6s)	2524	2524	128	54	165	11	0	230
3731	2449s (+0.5s)	1864	1864	128	48	133	8	0	189
3732	2450s (+0.7s)	2880	2880	256	89	145	17	0	251
3733	2450s (+0.5s)	1776	1776	128	33	128	10	2	173
3734	2451s (+0.9s)	3680	3680	256	91	199	20	0	310
3735	2452s (+0.9s)	3756	3756	256	88	210	16	0	314
3736	2452s (+0.4s)	1320	1320	128	41	99	5	0	145
3737	2453s (+0.6s)	2624	2624	256	39	169	13	1	222
3738	2454s (+0.7s)	2812	2812	256	64	165	10	0	239
3739	2454s (+0.3s)	952	952	128	24	67	0	7	98
3740	2454s (+0.6s)	1924	1924	128	46	146	0	7	199
3741	2456s (+1.1s)	5268	5268	512	77	272	0	20	369
3742	2456s (+0.4s)	1436	1436	128	27	115	0	6	148
3743	2457s (+0.7s)	2960	2960	256	44	189	0	8	241
3744	2458s (+1.0s)	4284	4284	256	63	275	0	18	356
3745	2458s (+0.7s)	2672	2672	128	53	178	0	15	246
3746	2459s (+0.5s)	1756	1756	128	47	121	10	0	178
3747	2460s (+0.8s)	3384	3384	256	66	204	10	0	280
3748	2460s (+0.3s)	836	836	64	32	70	7	0	109
3749	2461s (+0.7s)	2756	2756	256	66	156	11	1	234
3750	2461s (+0.4s)	1312	1312	64	45	97	7	0	149
3751	2462s (+0.9s)	4036	4036	256	103	217	18	0	338
3752	2463s (+0.8s)	3216	3216	256	64	193	10	0	267
3753	2464s (+1.2s)	5968	5968	512	91	302	18	1	412
3754	2465s (+0.7s)	3092	3092	256	52	196	9	0	257
3755	2466s (+0.8s)	3540	3540	256	86	192	18	0	296
3756	2466s (+0.8s)	3500	3500	256	75	192	14	0	281
3757	2467s (+0.4s)	1212	1212	128	34	95	5	0	134
3758	2467s (+0.6s)	2580	2580	256	50	162	5	0	217
3759	2468s (+0.5s)	1836	1836	128	59	118	10	0	187
3760	2469s (+0.5s)	1796	1796	128	46	126	12	0	184
3761	2469s (+0.9s)	3904	3904	256	83	221	15	1	320
3762	2470s (+0.7s)	2916	2916	256	74	164	15	0	253
3763	2470s (+0.3s)	676	676	64	26	61	4	0	91
3764	2471s (+0.5s)	1608	1608	128	37	126	5	1	169
3765	2471s (+0.4s)	1472	1472	128	31	115	7	0	153
3766	2472s (+0.7s)	2792	2792	256	46	188	0	9	243
3767	2473s (+1.0s)	4220	4220	256	71	255	0	19	345
3768	2473s (+0.5s)	1680	1680	128	42	124	0	6	172
3769	2474s (+0.5s)	1588	1588	128	32	126	0	6	164
3770	2474s (+0.3s)	1064	1064	128	15	91	0	3	109
3771	2475s (+0.7s)	2656	2656	256	53	177	0	3	233
3772	2476s (+0.6s)	1940	1940	128	50	142	11	0	203
3773	2477s (+1.1s)	4536	4536	256	105	258	17	0	380
3774	2477s (+0.4s)	1364	1364	128	32	105	5	0	142
3775	2478s (+0.6s)	2452	2452	256	36	164	7	0	207
3776	2478s (+0.3s)	1064	1064	64	40	76	7	0	123
3777	2479s (+1.3s)	6672	6672	512	127	308	25	0	460
3778	2480s (+0.7s)	2748	2748	256	62	160	13	0	235
3779	2481s (+0.8s)	3536	3536	256	89	182	20	0	291
3780	2481s (+0.5s)	1752	1752	128	37	135	6	0	178
3781	2482s (+0.9s)	3412	3412	256	66	210	12	0	288
3782	2483s (+1.1s)	4668	4668	256	109	254	25	0	388
3783	2484s (+0.8s)	3468	3468	256	60	217	9	0	286
3784	2485s (+0.9s)	4044	4044	256	85	233	15	0	333
3785	2486s (+0.7s)	3104	3104	256	48	200	9	0	257
3786	2486s (+0.7s)	2800	2800	256	50	184	9	0	243
3787	2487s (+0.6s)	2420	2420	256	46	146	10	0	202
3788	2488s (+0.9s)	4036	4036	256	85	225	19	0	329
3789	2489s (+0.6s)	2392	2392	128	65	145	11	0	221
3790	2489s (+0.6s)	1944	1944	128	49	144	11	0	204
3791	2490s (+0.4s)	1192	1192	64	42	92	9	1	144
3792	2490s (+0.5s)	1632	1632	128	31	126	7	1	165
3793	2491s (+0.7s)	2800	2800	256	58	172	13	0	243
3794	2491s (+0.5s)	1604	1604	128	25	128	0	5	158
3795	2492s (+0.6s)	2268	2268	128	43	161	0	14	218
3796	2492s (+0.6s)	1900	1900	128	45	143	0	7	195
3797	2493s (+0.5s)	1812	1812	128	32	144	0	12	188
3798	2494s (+0.5s)	1612	1612	128	30	130	0	9	169
3799	2494s (+0.7s)	2800	2800	256	72	160	11	0	243
Episode	Time	Reward	Score	Highest	L	U	R	D	Steps
3800	2495s (+0.5s)	1616	1616	128	43	113	5	1	162
3801	2495s (+0.7s)	2812	2812	256	53	177	10	0	240
3802	2496s (+1.1s)	4440	4440	256	99	250	18	1	368
3803	2497s (+0.3s)	900	900	128	16	75	4	0	95
3804	2497s (+0.4s)	1236	1236	128	41	83	6	0	130
3805	2498s (+1.0s)	5008	5008	512	85	265	13	0	363
3806	2499s (+0.5s)	1804	1804	128	42	134	6	0	182
3807	2499s (+0.5s)	1784	1784	128	38	138	5	0	181
3808	2500s (+0.9s)	4060	4060	256	80	241	16	0	337
3809	2501s (+0.9s)	3868	3868	256	73	234	11	1	319
3810	2502s (+0.7s)	2924	2924	256	81	157	12	0	250
3811	2502s (+0.4s)	1296	1296	128	27	104	5	0	136
3812	2503s (+0.7s)	2756	2756	256	56	169	12	0	237
3813	2503s (+0.4s)	1412	1412	128	37	104	4	1	146
3814	2504s (+0.8s)	3348	3348	256	68	206	11	2	287
3815	2505s (+0.7s)	3176	3176	256	66	187	9	0	262
3816	2506s (+0.9s)	3604	3604	256	71	223	10	0	304
3817	2507s (+0.8s)	3048	3048	256	48	212	7	1	268
3818	2507s (+0.7s)	2928	2928	256	70	153	12	0	235
3819	2508s (+0.5s)	1600	1600	128	37	126	4	0	167
3820	2508s (+0.4s)	1040	1040	64	34	86	4	0	124
3821	2509s (+0.5s)	1784	1784	128	40	135	7	0	182
3822	2509s (+0.8s)	3444	3444	256	69	210	13	0	292
3823	2510s (+0.4s)	1168	1168	64	35	91	13	0	139
3824	2511s (+0.7s)	2908	2908	256	58	179	16	0	253
3825	2511s (+0.6s)	1920	1920	128	46	147	5	0	198
3826	2512s (+1.0s)	4332	4332	256	99	241	17	0	357
3827	2513s (+0.8s)	2984	2984	256	60	202	10	0	272
3828	2513s (+0.3s)	660	660	32	26	62	5	0	93
3829	2514s (+1.0s)	4236	4236	256	85	251	13	0	349
3830	2515s (+0.5s)	2040	2040	256	44	118	9	0	171
3831	2516s (+0.9s)	4212	4212	256	94	233	16	0	343
3832	2516s (+0.4s)	1368	1368	128	26	110	0	7	143
3833	2517s (+0.7s)	2900	2900	256	39	202	0	10	251
3834	2517s (+0.6s)	2456	2456	128	57	160	0	9	226
3835	2518s (+0.5s)	1632	1632	128	42	111	8	0	161
3836	2519s (+0.8s)	3492	3492	256	71	204	17	1	293
3837	2519s (+0.5s)	1848	1848	128	43	141	8	0	192
3838	2520s (+0.5s)	1728	1728	128	46	120	10	0	176
3839	2521s (+0.9s)	3868	3868	256	76	228	14	0	318
3840	2521s (+0.5s)	1804	1804	128	29	148	0	9	186
3841	2522s (+0.8s)	3560	3560	256	83	193	13	0	289
3842	2523s (+1.1s)	5416	5416	512	96	260	21	1	378
3843	2524s (+0.5s)	1828	1828	128	52	131	4	0	187
3844	2524s (+0.4s)	1488	1488	128	33	117	6	0	156
3845	2525s (+0.8s)	3588	3588	256	75	210	18	0	303
3846	2525s (+0.6s)	1916	1916	128	44	147	6	0	197
3847	2526s (+0.9s)	3924	3924	256	80	231	9	0	320
3848	2527s (+0.4s)	1484	1484	128	46	97	11	1	155
3849	2527s (+0.5s)	1752	1752	128	34	135	5	0	174
3850	2528s (+0.5s)	1788	1788	128	35	143	0	6	184
3851	2528s (+0.5s)	1796	1796	128	39	138	0	7	184
3852	2529s (+0.4s)	1408	1408	128	37	99	11	1	148
3853	2529s (+0.6s)	1940	1940	128	39	154	7	0	200
3854	2530s (+0.8s)	3288	3288	256	67	190	15	0	272
3855	2531s (+0.8s)	3592	3592	256	63	229	9	0	301
3856	2532s (+0.6s)	2444	2444	256	48	155	5	0	208
3857	2532s (+0.4s)	1224	1224	128	26	105	3	0	134
3858	2533s (+0.9s)	3956	3956	256	71	236	16	0	323
3859	2533s (+0.3s)	868	868	64	28	75	10	0	113
3860	2534s (+0.9s)	3828	3828	256	92	199	21	0	312
3861	2535s (+0.8s)	3344	3344	256	63	198	12	0	273
3862	2535s (+0.5s)	1696	1696	128	46	122	7	0	175
3863	2536s (+0.5s)	1596	1596	128	47	107	12	0	166
3864	2537s (+1.0s)	4080	4080	256	95	235	8	0	338
3865	2537s (+0.5s)	1772	1772	128	42	129	11	0	182
3866	2538s (+0.4s)	1412	1412	128	37	102	4	0	143
3867	2538s (+0.5s)	1932	1932	128	33	143	0	10	186
3868	2539s (+0.3s)	864	864	64	26	81	0	4	111
3869	2539s (+0.4s)	1444	1444	128	28	111	0	7	146
3870	2539s (+0.2s)	584	584	64	15	62	0	4	81
3871	2539s (+0.2s)	312	312	32	7	45	0	5	57
3872	2540s (+0.8s)	3408	3408	256	51	218	0	15	284
3873	2541s (+0.5s)	1776	1776	128	37	137	0	6	180
3874	2541s (+0.3s)	888	888	64	22	80	0	5	107
3875	2541s (+0.3s)	672	672	64	17	73	0	3	93
3876	2542s (+0.5s)	2056	2056	128	38	139	0	14	191
3877	2543s (+0.5s)	1912	1912	128	43	144	9	0	196
3878	2543s (+0.7s)	2836	2836	128	77	172	14	0	263
3879	2544s (+0.5s)	1664	1664	128	38	120	10	0	168
3880	2544s (+0.6s)	1908	1908	128	45	139	11	0	195
3881	2545s (+0.3s)	892	892	64	22	88	4	0	114
3882	2545s (+0.7s)	2832	2832	256	56	186	9	0	251
3883	2546s (+0.6s)	1928	1928	128	37	156	0	7	200
3884	2546s (+0.5s)	1528	1528	128	33	126	0	2	161
3885	2547s (+0.4s)	1152	1152	64	30	97	0	8	135
3886	2547s (+0.5s)	1544	1544	64	61	97	16	0	174
3887	2548s (+0.8s)	3260	3260	256	70	192	15	0	277
3888	2549s (+0.4s)	1508	1508	128	35	106	12	0	153
3889	2549s (+0.6s)	2924	2924	256	54	169	11	0	234
3890	2550s (+0.3s)	792	792	64	24	77	8	0	109
3891	2551s (+1.0s)	4156	4156	256	100	225	16	0	341
3892	2551s (+0.9s)	3752	3752	256	90	216	15	0	321
3893	2552s (+0.3s)	1044	1044	128	31	80	4	0	115
3894	2553s (+0.9s)	4060	4060	256	85	232	17	0	334
3895	2553s (+0.4s)	1440	1440	128	33	111	4	0	148
3896	2554s (+0.4s)	1428	1428	128	50	88	7	0	145
3897	2554s (+0.2s)	476	476	64	12	53	1	1	67
3898	2554s (+0.6s)	2768	2768	256	61	166	7	0	234
3899	2555s (+1.0s)	4304	4304	256	100	233	21	0	354
Episode	Time	Reward	Score	Highest	L	U	R	D	Steps
3900	2556s (+0.4s)	1316	1316	128	23	110	2	0	135
3901	2556s (+0.4s)	1456	1456	128	31	109	9	0	149
3902	2557s (+0.8s)	3384	3384	256	82	191	14	0	287
3903	2557s (+0.4s)	1188	1188	64	34	89	10	0	133
3904	2558s (+0.7s)	2808	2808	256	64	158	16	0	238
3905	2559s (+0.7s)	2908	2908	256	63	179	10	1	253
3906	2559s (+0.5s)	1620	1620	128	39	121	4	0	164
3907	2560s (+0.5s)	1692	1692	128	44	122	9	0	175
3908	2560s (+0.4s)	1284	1284	128	27	104	6	0	137
3909	2561s (+0.7s)	2568	2568	128	64	163	14	0	241
3910	2561s (+0.5s)	1608	1608	128	34	128	6	1	169
3911	2562s (+0.5s)	1604	1604	128	46	111	11	0	168
3912	2563s (+1.0s)	5168	5168	512	96	248	15	1	360
3913	2563s (+0.6s)	1900	1900	128	43	148	2	0	193
3914	2564s (+0.5s)	1912	1912	128	30	145	0	7	182
3915	2564s (+0.4s)	1524	1524	128	31	119	0	9	159
3916	2565s (+0.5s)	1608	1608	128	32	129	0	9	170
3917	2565s (+0.5s)	1852	1852	128	42	141	0	10	193
3918	2566s (+0.5s)	1752	1752	128	37	138	0	9	184
3919	2566s (+0.4s)	1308	1308	128	29	103	0	10	142
3920	2567s (+0.6s)	2636	2636	256	46	170	0	15	231
3921	2567s (+0.3s)	900	900	64	26	82	0	8	116
3922	2568s (+0.8s)	3212	3212	256	63	186	0	18	267
3923	2569s (+0.6s)	2520	2520	256	42	169	6	0	217
3924	2570s (+0.8s)	3560	3560	256	83	201	13	0	297
3925	2570s (+0.8s)	3432	3432	256	63	214	6	0	283
3926	2571s (+0.8s)	3376	3376	256	77	183	15	0	275
3927	2572s (+0.6s)	2684	2684	256	54	165	12	0	231
3928	2572s (+0.5s)	1572	1572	128	33	125	7	0	165
3929	2573s (+0.3s)	788	788	64	14	84	5	0	103
3930	2573s (+0.5s)	1516	1516	128	32	119	8	0	159
3931	2573s (+0.4s)	1292	1292	64	48	89	7	0	144
3932	2574s (+0.7s)	2832	2832	256	57	177	11	0	245
3933	2575s (+0.9s)	3752	3752	256	90	204	19	0	313
3934	2576s (+0.5s)	1916	1916	128	45	143	9	0	197
3935	2576s (+0.8s)	3196	3196	256	69	181	16	0	266
3936	2577s (+0.6s)	2172	2172	128	60	147	10	0	217
3937	2577s (+0.4s)	1484	1484	128	36	113	6	0	155
3938	2578s (+0.7s)	3188	3188	256	80	168	12	0	260
3939	2579s (+0.6s)	2468	2468	256	59	143	0	7	209
3940	2580s (+0.8s)	3632	3632	256	58	227	0	10	295
3941	2580s (+0.6s)	2608	2608	256	46	161	0	11	218
3942	2581s (+1.0s)	4456	4456	256	75	271	0	22	368
3943	2582s (+0.3s)	984	984	64	18	95	0	3	116
3944	2582s (+0.5s)	1728	1728	128	36	122	0	13	171
3945	2582s (+0.3s)	828	828	64	28	71	2	0	101
3946	2583s (+0.7s)	2980	2980	256	62	168	13	0	243
3947	2584s (+0.9s)	3748	3748	256	83	207	20	1	311
3948	2585s (+0.7s)	3064	3064	256	69	181	11	0	261
3949	2585s (+0.6s)	2868	2868	256	57	168	8	0	233
3950	2586s (+0.7s)	3212	3212	256	59	197	11	0	267
3951	2587s (+0.7s)	3108	3108	256	70	175	19	0	264
3952	2587s (+0.4s)	1152	1152	64	35	99	6	0	140
3953	2588s (+0.7s)	2856	2856	256	59	187	6	0	252
3954	2588s (+0.6s)	2564	2564	256	61	148	12	0	221
3955	2589s (+0.9s)	3932	3932	256	81	236	17	0	334
3956	2590s (+0.8s)	3156	3156	256	58	195	11	0	264
3957	2591s (+0.4s)	1172	1172	64	31	105	4	0	140
3958	2591s (+0.7s)	3104	3104	256	58	193	6	0	257
3959	2592s (+1.0s)	4332	4332	256	82	266	13	0	361
3960	2593s (+0.9s)	3828	3828	256	79	220	12	1	312
3961	2594s (+0.5s)	1824	1824	128	43	134	7	0	184
3962	2595s (+0.8s)	3292	3292	256	73	189	13	1	276
3963	2595s (+0.6s)	2520	2520	256	58	147	13	0	218
3964	2596s (+1.0s)	4784	4784	512	84	234	17	0	335
3965	2597s (+0.6s)	2800	2800	256	47	177	8	0	232
3966	2597s (+0.7s)	2820	2820	256	65	158	10	0	233
3967	2598s (+0.6s)	2704	2704	256	48	153	13	1	215
3968	2598s (+0.3s)	1076	1076	128	25	87	4	0	116
3969	2599s (+1.1s)	4644	4644	256	109	262	15	0	386
3970	2600s (+0.5s)	1772	1772	128	48	121	9	0	178
3971	2601s (+0.8s)	3056	3056	128	91	162	21	0	274
3972	2602s (+0.8s)	3376	3376	256	69	200	11	0	280
3973	2602s (+0.7s)	3232	3232	256	69	194	9	0	272
3974	2603s (+0.7s)	3188	3188	256	63	190	12	0	265
3975	2604s (+0.6s)	1924	1924	128	43	147	9	0	199
3976	2604s (+0.5s)	1512	1512	128	46	105	10	0	161
3977	2605s (+0.5s)	1872	1872	128	49	137	5	0	191
3978	2606s (+1.0s)	4324	4324	256	92	249	18	0	359
3979	2606s (+0.5s)	1664	1664	128	39	123	7	0	169
3980	2607s (+0.6s)	2488	2488	256	43	160	11	0	214
3981	2607s (+0.3s)	808	808	64	24	70	8	0	102
3982	2608s (+0.5s)	1804	1804	128	45	132	9	0	186
3983	2609s (+1.0s)	4420	4420	256	93	255	15	0	363
3984	2609s (+0.7s)	3220	3220	256	63	195	9	1	268
3985	2610s (+0.6s)	2620	2620	256	52	157	10	0	219
3986	2611s (+0.6s)	2428	2428	256	54	144	6	0	204
3987	2612s (+0.8s)	3464	3464	256	89	185	17	0	291
3988	2612s (+0.5s)	1908	1908	128	43	146	6	0	195
3989	2613s (+1.0s)	4300	4300	256	84	250	15	0	349
3990	2614s (+0.9s)	4140	4140	256	88	231	12	0	331
3991	2615s (+1.0s)	4248	4248	256	78	259	15	0	352
3992	2616s (+0.5s)	1736	1736	128	40	130	5	0	175
3993	2616s (+0.7s)	2716	2716	256	49	176	7	0	232
3994	2617s (+0.5s)	1688	1688	128	37	129	7	0	173
3995	2617s (+0.3s)	800	800	64	23	81	3	0	107
3996	2618s (+0.7s)	2776	2776	256	61	169	8	0	238
3997	2619s (+1.1s)	5416	5416	512	80	282	0	18	380
3998	2619s (+0.6s)	2332	2332	256	36	153	0	8	197
3999	2620s (+0.7s)	2956	2956	256	48	202	0	10	260
Episode	Time	Reward	Score	Highest	L	U	R	D	Steps
4000	2621s (+0.7s)	2784	2784	256	46	182	0	13	241
4001	2621s (+0.7s)	2716	2716	256	43	176	0	15	234
4002	2622s (+0.7s)	2908	2908	256	61	180	0	12	253
4003	2623s (+0.8s)	3280	3280	256	59	206	0	12	277
4004	2623s (+0.3s)	692	692	64	19	70	0	3	92
4005	2624s (+0.8s)	3252	3252	256	56	207	0	12	275
4006	2625s (+0.5s)	1612	1612	128	33	119	0	9	161
4007	2625s (+0.8s)	3592	3592	256	81	204	15	0	300
4008	2626s (+0.7s)	2896	2896	256	62	175	14	0	251
4009	2627s (+0.4s)	1500	1500	128	39	111	8	0	158
4010	2627s (+0.7s)	3036	3036	256	76	159	13	0	248
4011	2628s (+0.6s)	2148	2148	128	53	134	14	0	201
4012	2628s (+0.4s)	1036	1036	64	30	88	4	1	123
4013	2629s (+0.3s)	1092	1092	128	23	88	6	0	117
4014	2630s (+1.0s)	4280	4280	256	87	240	22	0	349
4015	2630s (+0.5s)	1496	1496	128	40	108	9	1	158
4016	2630s (+0.4s)	1072	1072	64	35	88	7	0	130
4017	2631s (+0.8s)	3508	3508	256	76	192	12	1	281
4018	2632s (+1.0s)	4380	4380	256	105	241	19	0	365
4019	2633s (+0.7s)	2920	2920	256	57	189	10	0	256
4020	2634s (+0.6s)	2540	2540	256	42	172	12	0	226
4021	2634s (+0.3s)	844	844	64	32	69	4	1	106
4022	2634s (+0.5s)	1488	1488	64	48	103	13	0	164
4023	2635s (+0.6s)	2308	2308	128	58	152	10	0	220
4024	2636s (+0.9s)	3700	3700	256	81	197	19	0	297
4025	2636s (+0.6s)	2448	2448	256	49	154	5	0	208
4026	2637s (+0.5s)	1684	1684	128	38	127	8	0	173
4027	2638s (+0.7s)	2780	2780	256	52	176	9	0	237
4028	2638s (+0.4s)	1304	1304	128	31	107	3	0	141
4029	2638s (+0.4s)	1136	1136	64	30	102	4	0	136
4030	2639s (+0.5s)	2280	2280	256	40	140	0	9	189
4031	2639s (+0.4s)	1268	1268	64	33	106	0	5	144
4032	2640s (+0.6s)	2704	2704	256	49	172	0	9	230
4033	2641s (+1.1s)	5316	5316	512	75	277	0	24	376
4034	2642s (+0.4s)	1524	1524	128	31	116	1	6	154
4035	2642s (+0.6s)	2532	2532	256	46	167	0	7	220
4036	2642s (+0.2s)	312	312	32	11	43	0	3	57
4037	2643s (+0.9s)	4124	4124	256	71	241	0	22	334
4038	2644s (+0.8s)	3428	3428	256	67	206	0	15	288
4039	2644s (+0.2s)	644	644	64	15	65	0	4	84
4040	2645s (+0.6s)	2484	2484	256	51	152	10	0	213
4041	2645s (+0.4s)	1480	1480	128	33	115	7	0	155
4042	2646s (+0.7s)	3288	3288	256	60	189	13	1	263
4043	2647s (+0.4s)	1272	1272	128	29	98	6	0	133
4044	2648s (+1.2s)	5868	5868	512	123	274	25	0	422
4045	2649s (+0.8s)	3528	3528	256	84	196	14	0	294
4046	2649s (+0.8s)	3328	3328	256	77	192	14	0	283
4047	2650s (+0.6s)	2632	2632	256	53	165	10	0	228
4048	2650s (+0.3s)	1120	1120	128	28	94	3	0	125
4049	2651s (+0.6s)	2520	2520	256	44	154	11	0	209
4050	2652s (+0.8s)	3368	3368	256	76	191	13	0	280
4051	2653s (+1.0s)	4284	4284	256	105	220	21	0	346
4052	2654s (+1.0s)	4248	4248	256	79	259	14	0	352
4053	2654s (+0.7s)	2812	2812	256	57	165	9	1	232
4054	2655s (+0.8s)	3416	3416	256	72	196	16	0	284
4055	2656s (+0.7s)	2940	2940	256	54	186	14	0	254
4056	2657s (+0.7s)	2832	2832	256	56	178	7	0	241
4057	2657s (+0.5s)	1852	1852	128	52	122	11	0	185
4058	2658s (+1.2s)	6060	6060	512	106	308	19	0	433
4059	2660s (+1.4s)	7196	7196	512	143	335	20	0	498
4060	2661s (+0.8s)	3288	3288	256	59	214	10	1	284
4061	2662s (+0.7s)	2924	2924	256	57	177	13	0	247
4062	2662s (+0.5s)	1636	1636	128	38	120	4	0	162
4063	2663s (+1.0s)	4264	4264	256	93	242	21	0	356
4064	2664s (+0.4s)	1468	1468	128	36	108	7	0	151
4065	2664s (+0.5s)	1540	1540	64	45	111	13	0	169
4066	2665s (+0.8s)	3232	3232	256	75	184	12	0	271
4067	2666s (+0.8s)	3448	3448	256	60	207	15	0	282
4068	2667s (+1.2s)	6040	6040	512	114	293	22	0	429
4069	2668s (+0.8s)	3484	3484	256	60	226	8	0	294
4070	2669s (+0.7s)	3052	3052	256	63	182	12	1	258
4071	2669s (+0.7s)	2840	2840	256	60	173	12	0	245
4072	2670s (+0.3s)	920	920	64	26	90	5	0	121
4073	2671s (+0.7s)	3180	3180	256	67	182	12	1	262
4074	2671s (+0.3s)	736	736	64	26	68	3	0	97
4075	2672s (+0.8s)	3420	3420	256	66	204	15	1	286
4076	2672s (+0.4s)	1000	1000	64	34	83	9	0	126
4077	2673s (+0.8s)	3488	3488	256	63	217	11	0	291
4078	2674s (+0.7s)	2912	2912	256	75	166	12	1	254
4079	2675s (+0.9s)	4772	4772	512	86	228	17	0	331
4080	2675s (+0.8s)	3548	3548	256	80	204	14	0	298
4081	2676s (+0.4s)	1404	1404	128	47	92	8	0	147
4082	2677s (+1.0s)	4108	4108	256	95	230	19	0	344
4083	2677s (+0.5s)	1860	1860	128	50	130	8	0	188
4084	2678s (+0.7s)	2816	2816	256	59	178	9	0	246
4085	2679s (+0.9s)	3956	3956	256	84	223	16	0	323
4086	2680s (+0.7s)	3168	3168	256	69	177	13	1	260
4087	2680s (+0.4s)	1396	1396	128	33	106	0	7	146
4088	2680s (+0.2s)	360	360	32	16	45	0	3	64
4089	2681s (+0.6s)	2500	2500	256	43	152	0	11	206
4090	2682s (+0.8s)	3216	3216	256	70	184	0	14	268
4091	2682s (+0.6s)	2516	2516	256	40	171	0	9	220
4092	2683s (+0.5s)	1620	1620	128	41	122	0	9	172
4093	2683s (+0.5s)	1868	1868	128	33	147	0	10	190
4094	2684s (+0.7s)	2904	2904	256	55	183	14	0	252
4095	2685s (+0.5s)	1736	1736	128	56	115	8	0	179
4096	2685s (+0.7s)	2904	2904	256	66	174	12	0	252
4097	2686s (+1.0s)	4280	4280	256	92	250	17	1	360
4098	2688s (+1.2s)	6304	6304	512	131	264	26	0	421
4099	2688s (+0.3s)	852	852	64	25	81	4	0	110
Episode	Time	Reward	Score	Highest	L	U	R	D	Steps
4100	2688s (+0.3s)	1020	1020	128	17	90	2	0	109
4101	2689s (+0.5s)	1684	1684	128	41	118	7	0	166
4102	2689s (+0.6s)	2592	2592	256	56	156	11	0	223
4103	2690s (+1.0s)	5144	5144	512	92	239	20	0	351
4104	2691s (+0.4s)	1312	1312	128	24	110	1	0	135
4105	2691s (+0.5s)	1784	1784	128	37	132	12	0	181
4106	2692s (+1.1s)	4492	4492	256	104	253	12	0	369
4107	2693s (+0.6s)	2588	2588	256	58	148	16	0	222
4108	2694s (+0.5s)	1840	1840	128	47	141	2	0	190
4109	2694s (+0.5s)	1664	1664	128	40	120	8	0	168
4110	2695s (+0.8s)	3244	3244	256	67	198	9	0	274
4111	2695s (+0.5s)	1668	1668	128	44	119	6	0	169
4112	2696s (+0.9s)	3696	3696	256	83	216	12	0	311
4113	2697s (+0.5s)	1624	1624	128	44	113	5	1	163
4114	2697s (+0.5s)	1500	1500	64	50	110	7	0	167
4115	2698s (+1.1s)	5768	5768	512	103	281	24	0	408
4116	2699s (+0.5s)	1796	1796	128	44	130	10	0	184
4117	2700s (+1.1s)	4600	4600	256	115	242	23	0	380
4118	2700s (+0.6s)	2396	2396	256	49	145	6	0	200
4119	2701s (+0.3s)	948	948	64	36	76	5	0	117
4120	2701s (+0.5s)	1772	1772	128	43	129	10	0	182
4121	2702s (+0.4s)	1436	1436	128	39	99	10	0	148
4122	2702s (+0.3s)	1012	1012	128	16	86	0	5	107
4123	2702s (+0.3s)	808	808	64	24	79	0	6	109
4124	2703s (+0.5s)	1524	1524	128	30	119	0	11	160
4125	2703s (+0.4s)	1444	1444	128	29	116	0	5	150
4126	2704s (+0.3s)	1056	1056	64	35	88	4	0	127
4127	2704s (+0.5s)	1616	1616	128	31	137	3	0	171
4128	2705s (+1.0s)	5316	5316	512	72	282	0	22	376
4129	2706s (+0.4s)	1208	1208	128	17	112	2	0	131
4130	2706s (+0.6s)	1984	1984	128	46	149	8	0	203
4131	2707s (+0.5s)	1612	1612	128	38	128	4	0	170
4132	2707s (+0.6s)	2504	2504	256	55	149	9	0	213
4133	2708s (+0.4s)	1320	1320	128	35	105	5	0	145
4134	2708s (+0.4s)	1048	1048	64	26	92	6	2	126
4135	2709s (+0.6s)	2364	2364	128	50	157	11	0	218
4136	2709s (+0.6s)	2572	2572	256	45	166	0	12	223
4137	2709s (+0.2s)	560	560	64	13	62	0	1	76
4138	2710s (+0.7s)	3160	3160	256	56	197	0	11	264
4139	2711s (+0.7s)	2820	2820	256	53	185	10	0	248
4140	2712s (+0.8s)	3332	3332	256	70	193	16	0	279
4141	2712s (+0.2s)	556	556	64	11	64	1	0	76
4142	2713s (+0.6s)	2212	2212	128	46	155	0	8	209
4143	2713s (+0.7s)	2972	2972	256	50	187	0	13	250
4144	2714s (+1.0s)	4192	4192	256	68	264	0	18	350
4145	2715s (+0.4s)	1152	1152	64	31	96	0	9	136
4146	2715s (+0.7s)	2796	2796	256	58	168	0	16	242
4147	2716s (+0.3s)	844	844	64	24	80	3	0	107
4148	2716s (+0.3s)	976	976	64	24	90	6	0	120
4149	2717s (+0.7s)	3100	3100	256	68	173	14	0	255
4150	2718s (+0.8s)	3464	3464	256	66	206	13	0	285
4151	2718s (+0.3s)	916	916	64	23	83	7	0	113
4152	2718s (+0.4s)	1264	1264	128	34	94	8	0	136
4153	2719s (+0.7s)	2896	2896	256	40	190	0	8	238
4154	2719s (+0.5s)	1632	1632	128	29	134	0	3	166
4155	2720s (+0.4s)	1528	1528	128	36	110	0	10	156
4156	2721s (+0.6s)	2264	2264	128	42	161	0	14	217
4157	2721s (+0.6s)	2632	2632	256	51	160	0	12	223
4158	2722s (+0.5s)	1660	1660	128	49	110	8	0	167
4159	2722s (+0.4s)	1396	1396	128	40	95	7	1	143
4160	2722s (+0.3s)	880	880	64	25	73	5	0	103
4161	2723s (+0.6s)	2308	2308	128	52	159	7	1	219
4162	2724s (+0.9s)	3644	3644	256	80	207	12	0	299
4163	2725s (+0.8s)	3344	3344	256	69	198	15	0	282
4164	2725s (+0.3s)	920	920	64	25	91	5	0	121
4165	2726s (+0.7s)	2872	2872	256	61	181	11	0	253
4166	2726s (+0.4s)	1284	1284	128	36	93	8	0	137
4167	2727s (+1.0s)	4288	4288	256	100	232	23	0	355
4168	2728s (+0.4s)	1464	1464	128	35	114	6	0	155
4169	2728s (+0.8s)	3232	3232	256	45	211	15	0	271
4170	2729s (+0.8s)	3380	3380	256	72	196	13	0	281
4171	2730s (+0.7s)	3348	3348	256	68	195	11	0	274
4172	2731s (+0.6s)	2500	2500	256	57	145	15	0	217
4173	2731s (+0.7s)	2792	2792	256	61	169	11	0	241
4174	2732s (+0.7s)	3288	3288	256	61	199	13	1	274
4175	2733s (+1.0s)	5292	5292	512	88	267	14	1	370
4176	2734s (+0.7s)	3124	3124	256	60	189	12	0	261
4177	2735s (+0.8s)	3372	3372	256	77	185	17	0	279
4178	2735s (+0.4s)	1220	1220	128	31	96	9	0	136
4179	2736s (+1.3s)	6212	6212	512	121	297	21	0	439
4180	2737s (+0.5s)	1532	1532	128	56	95	11	0	162
4181	2738s (+1.0s)	4112	4112	256	80	242	13	0	335
4182	2738s (+0.7s)	3112	3112	256	50	194	0	13	257
4183	2739s (+0.5s)	1756	1756	128	33	134	0	7	174
4184	2739s (+0.4s)	1436	1436	128	35	100	0	13	148
4185	2740s (+0.3s)	1148	1148	128	26	90	0	5	121
4186	2740s (+0.5s)	1580	1580	128	36	130	3	0	169
4187	2742s (+1.4s)	7104	7104	512	151	332	23	0	506
4188	2742s (+0.3s)	1092	1092	128	30	85	6	0	121
4189	2743s (+0.7s)	3080	3080	256	74	158	18	1	251
4190	2743s (+0.7s)	2720	2720	256	50	182	7	0	239
4191	2744s (+0.6s)	2700	2700	256	51	174	4	0	229
4192	2745s (+0.8s)	3496	3496	256	73	204	16	0	293
4193	2746s (+0.7s)	2888	2888	256	60	167	12	0	239
4194	2746s (+1.0s)	4292	4292	256	108	235	15	0	358
4195	2747s (+0.5s)	1780	1780	128	42	133	6	0	181
4196	2748s (+1.2s)	6016	6016	512	104	297	21	1	423
4197	2749s (+0.6s)	1888	1888	128	29	158	3	0	190
4198	2749s (+0.7s)	2784	2784	256	55	174	10	0	239
4199	2750s (+0.8s)	3524	3524	256	71	205	12	0	288
Episode	Time	Reward	Score	Highest	L	U	R	D	Steps
4200	2751s (+0.7s)	2760	2760	256	59	167	12	0	238
4201	2751s (+0.3s)	816	816	64	29	76	6	0	111
4202	2752s (+0.5s)	1680	1680	128	54	110	7	0	171
4203	2752s (+0.5s)	1516	1516	128	44	107	7	0	158
4204	2753s (+0.4s)	1320	1320	128	37	104	5	0	146
4205	2753s (+0.5s)	2092	2092	256	41	127	6	0	174
4206	2753s (+0.3s)	1060	1060	128	18	92	4	1	115
4207	2754s (+0.4s)	1336	1336	128	29	104	5	0	138
4208	2754s (+0.6s)	1964	1964	128	51	148	5	0	204
4209	2755s (+0.8s)	3408	3408	256	75	199	9	0	283
4210	2756s (+0.7s)	3268	3268	256	63	191	11	0	265
4211	2756s (+0.4s)	1160	1160	128	20	105	2	0	127
4212	2757s (+0.8s)	3500	3500	256	70	193	19	0	282
4213	2758s (+0.3s)	796	796	64	27	77	2	0	106
4214	2759s (+1.0s)	4412	4412	256	78	260	22	1	361
4215	2759s (+0.6s)	2348	2348	128	41	172	6	0	219
4216	2760s (+0.6s)	2672	2672	256	49	165	13	1	228
4217	2760s (+0.5s)	1660	1660	128	38	121	9	0	168
4218	2761s (+0.7s)	2644	2644	256	50	174	7	0	231
4219	2762s (+1.0s)	4040	4040	256	85	235	19	0	339
4220	2762s (+0.4s)	1176	1176	128	36	82	7	1	126
4221	2763s (+1.0s)	4028	4028	256	96	227	13	0	336
4222	2764s (+0.7s)	2760	2760	256	42	191	5	0	238
4223	2764s (+0.4s)	1056	1056	64	33	84	9	1	127
4224	2765s (+0.8s)	3388	3388	256	76	196	14	1	287
4225	2766s (+1.1s)	4764	4764	256	115	241	18	0	374
4226	2767s (+0.8s)	3464	3464	256	71	210	11	0	292
4227	2768s (+0.7s)	2944	2944	256	57	177	13	0	247
4228	2769s (+0.8s)	3384	3384	256	62	218	12	0	292
4229	2769s (+0.6s)	1940	1940	128	51	140	7	0	198
4230	2770s (+0.5s)	1576	1576	128	40	113	8	0	161
4231	2770s (+0.6s)	1972	1972	128	44	141	10	0	195
4232	2771s (+0.5s)	1612	1612	128	37	129	4	0	170
4233	2771s (+0.4s)	1392	1392	64	46	104	6	0	156
4234	2772s (+0.7s)	3092	3092	256	57	192	7	1	257
4235	2773s (+0.8s)	3488	3488	256	72	199	24	0	295
4236	2773s (+0.4s)	1604	1604	128	26	130	3	0	159
4237	2774s (+0.5s)	1672	1672	128	41	118	11	0	170
4238	2775s (+1.0s)	4368	4368	256	91	259	16	0	366
4239	2775s (+0.7s)	2648	2648	256	40	187	3	0	230
4240	2776s (+0.5s)	1796	1796	128	44	127	13	0	184
4241	2777s (+0.9s)	4252	4252	256	94	232	19	0	345
4242	2777s (+0.5s)	1560	1560	128	48	103	10	0	161
4243	2778s (+0.7s)	2944	2944	256	68	174	13	0	255
4244	2779s (+0.6s)	2380	2380	256	56	141	7	0	204
4245	2779s (+0.4s)	1396	1396	128	45	99	5	0	149
4246	2780s (+0.6s)	2348	2348	128	61	154	9	1	225
4247	2780s (+0.4s)	1484	1484	128	28	122	5	0	155
4248	2780s (+0.3s)	936	936	64	26	84	4	0	114
4249	2781s (+0.4s)	1352	1352	128	43	88	11	0	142
4250	2781s (+0.6s)	2212	2212	128	61	130	10	0	201
4251	2782s (+0.5s)	1740	1740	128	49	117	0	8	174
4252	2783s (+0.6s)	2604	2604	256	35	178	0	8	221
4253	2783s (+0.4s)	1444	1444	128	26	118	0	5	149
4254	2784s (+0.6s)	2760	2760	256	47	180	0	6	233
4255	2784s (+0.3s)	1112	1112	128	20	96	0	1	117
4256	2785s (+0.9s)	3876	3876	256	71	238	0	10	319
4257	2786s (+0.6s)	2540	2540	256	44	158	0	10	212
4258	2786s (+0.7s)	3028	3028	256	51	188	0	12	251
4259	2787s (+0.5s)	1676	1676	128	33	128	0	11	172
4260	2787s (+0.7s)	2768	2768	256	46	180	0	13	239
4261	2788s (+0.7s)	2900	2900	256	59	175	0	9	243
4262	2789s (+0.7s)	2880	2880	256	56	172	9	0	237
4263	2789s (+0.4s)	1388	1388	128	30	115	3	0	148
4264	2790s (+0.5s)	1868	1868	128	50	129	12	0	191
4265	2790s (+0.5s)	1776	1776	128	54	117	8	0	179
4266	2791s (+0.8s)	3592	3592	256	64	210	13	0	287
4267	2792s (+0.9s)	3548	3548	256	69	215	16	1	301
4268	2792s (+0.5s)	1604	1604	128	40	114	9	1	164
4269	2793s (+0.4s)	1176	1176	64	39	95	7	0	141
4270	2794s (+0.9s)	3856	3856	256	79	219	15	0	313
4271	2795s (+0.8s)	3408	3408	256	73	195	15	0	283
4272	2795s (+0.3s)	884	884	64	31	78	6	1	116
4273	2796s (+0.9s)	3932	3932	256	85	216	15	1	317
4274	2796s (+0.5s)	1652	1652	128	33	131	0	6	170
4275	2797s (+0.5s)	1596	1596	128	37	121	0	7	165
4276	2797s (+0.3s)	1004	1004	64	21	93	0	6	120
4277	2798s (+1.1s)	5468	5468	512	91	272	20	0	383
4278	2799s (+0.3s)	1076	1076	128	23	91	4	0	118
4279	2799s (+0.4s)	1408	1408	128	32	103	7	0	142
4280	2800s (+0.8s)	3320	3320	256	72	195	14	1	282
4281	2801s (+0.8s)	3308	3308	256	74	189	15	0	278
4282	2801s (+0.4s)	1488	1488	128	38	112	6	0	156
4283	2802s (+1.1s)	5656	5656	512	94	283	20	0	397
4284	2803s (+0.8s)	3612	3612	256	66	215	10	0	291
4285	2804s (+0.5s)	1852	1852	128	41	133	9	0	183
4286	2804s (+0.4s)	1512	1512	128	30	119	6	0	155
4287	2805s (+0.5s)	1592	1592	128	45	114	7	0	166
4288	2805s (+0.6s)	2252	2252	128	70	131	10	0	211
4289	2806s (+0.6s)	2564	2564	256	49	163	9	0	221
4290	2807s (+0.8s)	3260	3260	256	69	196	12	1	278
4291	2807s (+0.4s)	1184	1184	128	24	105	3	0	132
4292	2808s (+0.6s)	1860	1860	128	46	143	6	0	195
4293	2809s (+1.3s)	6484	6484	512	135	307	26	0	468
4294	2810s (+0.6s)	1940	1940	128	55	132	11	0	198
4295	2810s (+0.3s)	1076	1076	64	18	96	7	1	122
4296	2811s (+0.9s)	4052	4052	256	78	242	15	0	335
4297	2811s (+0.4s)	1484	1484	128	33	113	8	0	154
4298	2812s (+0.8s)	3452	3452	256	71	196	16	0	283
4299	2813s (+0.8s)	3436	3436	256	81	193	16	0	290
Episode	Time	Reward	Score	Highest	L	U	R	D	Steps
4300	2814s (+0.6s)	2164	2164	128	52	139	10	0	201
4301	2815s (+1.2s)	6372	6372	512	124	299	29	0	452
4302	2816s (+0.6s)	1904	1904	128	35	156	3	0	194
4303	2817s (+0.9s)	3704	3704	256	82	206	18	0	306
4304	2817s (+0.4s)	1524	1524	128	41	112	7	0	160
4305	2818s (+0.8s)	3320	3320	256	87	175	20	0	282
4306	2819s (+0.6s)	2524	2524	256	42	170	9	0	221
4307	2819s (+0.5s)	1556	1556	128	39	122	6	0	167
4308	2820s (+1.0s)	4124	4124	256	70	267	11	0	348
4309	2820s (+0.3s)	908	908	64	30	84	4	0	118
4310	2821s (+0.4s)	1396	1396	128	27	116	6	0	149
4311	2821s (+0.5s)	1752	1752	128	36	133	7	0	176
4312	2822s (+0.5s)	2052	2052	128	56	125	9	0	190
4313	2823s (+0.7s)	3172	3172	256	46	206	10	0	262
4314	2823s (+0.8s)	3364	3364	256	65	201	10	1	277
4315	2824s (+0.7s)	2932	2932	256	62	189	8	0	259
4316	2825s (+0.7s)	2928	2928	256	64	181	13	0	258
4317	2825s (+0.6s)	2020	2020	128	57	131	8	0	196
4318	2826s (+0.4s)	1312	1312	128	25	116	3	0	144
4319	2826s (+0.3s)	844	844	64	21	80	0	6	107
4320	2827s (+0.7s)	3080	3080	256	55	185	0	13	253
4321	2827s (+0.4s)	1484	1484	128	35	116	0	5	156
4322	2828s (+0.8s)	4372	4372	512	65	214	0	11	290
4323	2828s (+0.2s)	564	564	32	22	60	0	3	85
4324	2829s (+0.8s)	3220	3220	256	53	198	1	11	263
4325	2830s (+0.9s)	3780	3780	256	69	229	0	13	311
4326	2831s (+0.7s)	3080	3080	256	52	189	0	14	255
4327	2831s (+0.6s)	2756	2756	256	45	180	0	13	238
4328	2832s (+0.9s)	3848	3848	256	76	219	15	0	310
4329	2833s (+1.0s)	4296	4296	256	107	227	18	1	353
4330	2834s (+0.7s)	3048	3048	256	72	172	13	0	257
4331	2834s (+0.4s)	1496	1496	128	41	109	8	0	158
4332	2835s (+0.7s)	3028	3028	256	53	182	8	0	243
4333	2836s (+0.4s)	1228	1228	64	26	104	8	0	138
4334	2836s (+0.4s)	1388	1388	128	39	104	4	0	147
4335	2837s (+0.9s)	3548	3548	256	75	213	13	0	301
4336	2838s (+0.8s)	3316	3316	256	69	198	13	0	280
4337	2838s (+0.5s)	1496	1496	64	62	98	9	0	169
4338	2839s (+0.7s)	3048	3048	256	54	186	11	0	251
4339	2840s (+0.9s)	3732	3732	256	85	220	15	0	320
4340	2840s (+0.7s)	2724	2724	256	52	177	7	0	236
4341	2841s (+0.6s)	2404	2404	256	56	140	9	0	205
4342	2841s (+0.3s)	888	888	64	31	83	3	0	117
4343	2842s (+0.4s)	1064	1064	64	30	92	8	0	130
4344	2842s (+0.5s)	1580	1580	128	44	107	11	0	162
4345	2843s (+0.5s)	2032	2032	128	45	132	9	0	186
4346	2843s (+0.5s)	1872	1872	128	38	145	8	0	191
4347	2844s (+0.8s)	3360	3360	256	72	201	13	0	286
4348	2845s (+0.5s)	1648	1648	128	41	119	9	0	169
4349	2845s (+0.7s)	2672	2672	256	55	173	10	0	238
4350	2846s (+0.6s)	2592	2592	256	46	166	0	11	223
4351	2846s (+0.5s)	1780	1780	128	39	135	0	6	180
4352	2847s (+0.7s)	2748	2748	256	49	177	0	6	232
4353	2848s (+0.7s)	2476	2476	128	51	166	0	11	228
4354	2848s (+0.3s)	740	740	64	17	74	0	5	96
4355	2848s (+0.5s)	1588	1588	128	34	125	0	6	165
4356	2849s (+0.4s)	1292	1292	128	25	107	0	6	138
4357	2850s (+0.8s)	3476	3476	256	61	214	0	13	288
4358	2851s (+0.9s)	4144	4144	256	72	245	0	21	338
4359	2851s (+0.6s)	2360	2360	256	45	146	0	8	199
4360	2852s (+1.0s)	4044	4044	256	62	260	0	18	340
4361	2853s (+0.7s)	3108	3108	256	69	173	14	2	258
4362	2853s (+0.6s)	1772	1772	64	53	131	9	0	193
4363	2854s (+0.8s)	3220	3220	256	70	183	15	0	268
4364	2855s (+0.8s)	3608	3608	256	69	210	14	1	294
4365	2856s (+0.5s)	1752	1752	128	36	136	6	0	178
4366	2856s (+0.5s)	1568	1568	128	37	129	4	0	170
4367	2857s (+0.5s)	1808	1808	128	38	143	5	0	186
4368	2857s (+0.8s)	3428	3428	256	68	205	13	1	287
4369	2858s (+0.5s)	1684	1684	128	43	118	12	0	173
4370	2859s (+0.8s)	3212	3212	256	75	183	12	0	270
4371	2860s (+0.9s)	4752	4752	512	87	230	14	0	331
4372	2861s (+0.9s)	4012	4012	256	83	231	16	0	330
4373	2861s (+0.4s)	1476	1476	128	38	112	6	0	156
4374	2861s (+0.3s)	900	900	64	27	83	6	0	116
4375	2862s (+0.7s)	3072	3072	256	44	188	0	18	250
4376	2863s (+0.8s)	3164	3164	256	52	201	0	12	265
4377	2864s (+0.7s)	2796	2796	256	49	185	0	8	242
4378	2865s (+1.1s)	5372	5372	512	63	306	0	15	384
4379	2865s (+0.5s)	1788	1788	128	35	144	0	3	182
4380	2866s (+0.7s)	2860	2860	256	46	187	0	13	246
4381	2867s (+0.8s)	3536	3536	256	62	224	0	7	293
4382	2867s (+0.6s)	2572	2572	256	49	164	0	9	222
4383	2868s (+0.8s)	3436	3436	256	62	212	0	16	290
4384	2868s (+0.2s)	620	620	64	20	60	0	5	85
4385	2869s (+0.4s)	1168	1168	64	31	103	0	6	140
4386	2870s (+0.8s)	3548	3548	256	68	218	0	15	301
4387	2870s (+0.5s)	1796	1796	128	43	135	0	6	184
4388	2870s (+0.2s)	572	572	64	13	63	0	2	78
4389	2871s (+0.6s)	2520	2520	256	47	169	0	5	221
4390	2871s (+0.5s)	1552	1552	128	37	122	8	0	167
4391	2872s (+0.4s)	1268	1268	64	36	108	8	0	152
4392	2873s (+0.7s)	2644	2644	256	51	176	8	0	235
4393	2874s (+1.1s)	5700	5700	512	94	299	15	0	408
4394	2874s (+0.3s)	756	756	64	28	69	4	0	101
4395	2875s (+0.7s)	2752	2752	256	65	158	13	0	236
4396	2875s (+0.5s)	1764	1764	128	46	125	9	0	180
4397	2876s (+0.5s)	1796	1796	128	37	130	7	1	175
4398	2876s (+0.4s)	1456	1456	128	26	122	4	0	152
4399	2877s (+1.0s)	4320	4320	256	91	253	14	0	358
Episode	Time	Reward	Score	Highest	L	U	R	D	Steps
4400	2878s (+0.8s)	3548	3548	256	81	208	13	0	302
4401	2879s (+1.3s)	6488	6488	512	114	323	28	0	465
4402	2880s (+0.5s)	1516	1516	128	44	111	7	0	162
4403	2881s (+0.8s)	3196	3196	256	65	190	12	0	267
4404	2882s (+0.8s)	3452	3452	256	70	205	18	0	293
4405	2883s (+0.9s)	3864	3864	256	97	214	14	0	325
4406	2883s (+0.6s)	2516	2516	256	54	151	15	0	220
4407	2884s (+0.5s)	1800	1800	128	41	137	7	0	185
4408	2884s (+0.4s)	1392	1392	128	33	111	3	0	147
4409	2885s (+0.7s)	3156	3156	256	58	189	14	0	261
4410	2886s (+0.9s)	4116	4116	256	83	231	21	0	335
4411	2887s (+0.8s)	3416	3416	256	59	215	11	0	285
4412	2888s (+1.0s)	4144	4144	256	105	220	22	0	347
4413	2888s (+0.6s)	1920	1920	128	60	127	11	0	198
4414	2889s (+0.3s)	1260	1260	128	30	94	5	0	129
4415	2889s (+0.8s)	3464	3464	256	81	203	12	0	296
4416	2890s (+0.4s)	1348	1348	128	26	106	7	0	139
4417	2891s (+0.8s)	3484	3484	256	96	179	22	0	297
4418	2891s (+0.8s)	3472	3472	256	79	202	11	0	292
4419	2892s (+1.0s)	4212	4212	256	92	237	15	0	344
4420	2893s (+0.5s)	1572	1572	128	37	119	9	0	165
4421	2893s (+0.3s)	892	892	128	18	75	2	0	95
4422	2894s (+0.3s)	840	840	64	31	73	6	0	110
4423	2894s (+0.8s)	3352	3352	256	62	212	10	0	284
4424	2895s (+1.0s)	4232	4232	256	97	232	19	0	348
4425	2896s (+0.8s)	3300	3300	256	72	189	12	0	273
4426	2897s (+0.5s)	1624	1624	128	47	120	6	0	173
4427	2897s (+0.4s)	1444	1444	128	36	104	9	0	149
4428	2898s (+0.5s)	1800	1800	128	42	130	0	13	185
4429	2898s (+0.7s)	2792	2792	256	45	190	0	6	241
4430	2899s (+1.1s)	5464	5464	512	81	283	0	16	380
4431	2900s (+0.4s)	992	992	64	32	84	0	7	123
4432	2900s (+0.3s)	996	996	64	25	84	0	9	118
4433	2901s (+0.5s)	1788	1788	128	41	133	0	8	182
4434	2902s (+1.0s)	4280	4280	256	95	245	17	0	357
4435	2903s (+0.9s)	4140	4140	256	80	240	11	0	331
4436	2903s (+0.5s)	1480	1480	64	41	108	12	1	162
4437	2904s (+0.7s)	3216	3216	256	75	183	9	0	267
4438	2904s (+0.4s)	1408	1408	128	43	96	8	1	148
4439	2905s (+0.7s)	2760	2760	256	48	178	8	0	234
4440	2906s (+0.7s)	2928	2928	256	57	186	15	0	258
4441	2906s (+0.7s)	2988	2988	256	79	163	16	0	258
4442	2907s (+0.5s)	1916	1916	128	56	130	11	0	197
4443	2908s (+0.9s)	3912	3912	256	85	229	19	0	333
4444	2909s (+0.7s)	2676	2676	256	62	157	10	0	229
4445	2909s (+0.5s)	1696	1696	128	34	134	7	1	176
4446	2909s (+0.3s)	796	796	64	26	68	6	0	100
4447	2910s (+0.5s)	1788	1788	128	47	126	8	0	181
4448	2910s (+0.4s)	1140	1140	128	17	105	0	2	124
4449	2911s (+0.3s)	1116	1116	128	19	94	0	4	117
4450	2911s (+0.5s)	1972	1972	128	47	143	0	6	196
4451	2911s (+0.3s)	904	904	64	16	91	0	4	111
4452	2912s (+0.5s)	1712	1712	128	40	125	0	7	172
4453	2912s (+0.5s)	1584	1584	128	31	123	9	0	163
4454	2913s (+0.6s)	2604	2604	256	47	173	6	0	226
4455	2914s (+0.9s)	3756	3756	256	91	197	21	1	310
4456	2914s (+0.5s)	1500	1500	128	36	116	6	0	158
4457	2915s (+0.5s)	1780	1780	128	48	121	11	0	180
4458	2916s (+1.0s)	4228	4228	256	103	224	20	0	347
4459	2917s (+0.6s)	2516	2516	256	59	149	12	0	220
4460	2917s (+0.6s)	2232	2232	128	58	141	13	1	213
4461	2918s (+0.5s)	1612	1612	128	46	116	8	0	170
4462	2918s (+0.3s)	808	808	64	32	74	4	0	110
4463	2919s (+0.7s)	3016	3016	256	65	185	14	0	264
4464	2919s (+0.5s)	1652	1652	128	51	113	0	11	175
4465	2920s (+0.4s)	1460	1460	128	26	120	0	5	151
4466	2920s (+0.4s)	1456	1456	128	29	116	7	0	152
4467	2921s (+0.8s)	3264	3264	256	69	202	8	0	279
4468	2922s (+0.9s)	4116	4116	256	89	225	20	1	335
4469	2923s (+0.8s)	3368	3368	256	76	196	14	0	286
4470	2923s (+0.5s)	1612	1612	128	37	130	3	0	170
4471	2924s (+0.7s)	2964	2964	256	70	174	16	0	260
4472	2925s (+0.7s)	3036	3036	256	56	189	9	0	254
4473	2925s (+0.6s)	2456	2456	256	57	149	10	0	216
4474	2926s (+0.8s)	3488	3488	256	89	188	15	0	292
4475	2926s (+0.3s)	1152	1152	128	27	93	5	0	125
4476	2927s (+0.7s)	3048	3048	256	64	176	14	0	254
4477	2928s (+0.5s)	1592	1592	128	42	121	6	0	169
4478	2928s (+0.3s)	720	720	64	20	74	2	0	96
4479	2928s (+0.3s)	892	892	64	21	82	3	0	106
4480	2929s (+0.5s)	1460	1460	128	34	119	6	0	159
4481	2929s (+0.8s)	3456	3456	256	70	199	16	0	285
4482	2930s (+0.5s)	1672	1672	128	55	108	6	0	169
4483	2930s (+0.5s)	1920	1920	128	51	127	10	0	188
4484	2931s (+0.7s)	2872	2872	256	48	182	5	0	235
4485	2932s (+0.6s)	2312	2312	256	54	136	11	0	201
4486	2932s (+0.7s)	3056	3056	256	67	175	17	0	259
4487	2933s (+0.4s)	992	992	64	34	84	8	1	127
4488	2934s (+0.9s)	3564	3564	256	68	220	17	0	305
4489	2934s (+0.5s)	1884	1884	128	63	119	8	0	190
4490	2935s (+1.2s)	5700	5700	512	119	271	18	0	408
4491	2936s (+0.6s)	2556	2556	256	54	166	6	0	226
4492	2937s (+0.6s)	2476	2476	256	52	154	8	0	214
4493	2937s (+0.5s)	1556	1556	128	45	113	9	0	167
4494	2938s (+0.3s)	1108	1108	128	31	85	5	0	121
4495	2938s (+0.7s)	3224	3224	256	72	189	0	12	273
4496	2939s (+0.3s)	1008	1008	128	30	77	0	5	112
4497	2939s (+0.5s)	1616	1616	128	34	125	0	12	171
4498	2940s (+0.7s)	2812	2812	256	53	185	0	7	245
4499	2940s (+0.3s)	884	884	64	24	85	0	4	113
Episode	Time	Reward	Score	Highest	L	U	R	D	Steps
4500	2941s (+0.8s)	3400	3400	256	60	209	0	12	281
4501	2942s (+0.7s)	3160	3160	256	50	196	0	16	262
4502	2942s (+0.4s)	1448	1448	128	30	113	0	8	151
4503	2943s (+0.9s)	3820	3820	256	66	226	0	18	310
4504	2944s (+0.7s)	3104	3104	256	58	183	0	11	252
4505	2944s (+0.3s)	692	692	64	16	71	0	4	91
4506	2945s (+0.7s)	2476	2476	128	48	165	0	17	230
4507	2945s (+0.4s)	1572	1572	128	32	119	0	4	155
4508	2946s (+0.5s)	1592	1592	128	31	129	5	0	165
4509	2946s (+0.5s)	2332	2332	256	53	131	10	0	194
4510	2947s (+0.7s)	3124	3124	256	66	185	9	0	260
4511	2948s (+0.8s)	3548	3548	256	74	209	13	0	296
4512	2949s (+1.0s)	4200	4200	256	81	247	13	0	341
4513	2949s (+0.6s)	2636	2636	256	43	171	7	0	221
4514	2950s (+0.5s)	1596	1596	128	38	121	7	0	166
4515	2950s (+0.5s)	1828	1828	128	54	124	7	0	185
4516	2951s (+0.8s)	3372	3372	256	66	202	11	0	279
4517	2952s (+0.7s)	3044	3044	256	69	173	14	0	256
4518	2953s (+0.7s)	2468	2468	128	64	153	16	0	233
4519	2953s (+0.8s)	3200	3200	256	67	184	15	1	267
4520	2954s (+0.6s)	1968	1968	128	61	132	12	0	205
4521	2954s (+0.5s)	1904	1904	128	51	130	13	0	194
4522	2955s (+0.6s)	2684	2684	256	52	162	12	0	226
4523	2956s (+0.8s)	3252	3252	256	55	211	10	0	276
4524	2956s (+0.6s)	2100	2100	128	40	151	7	1	199
4525	2958s (+1.2s)	5932	5932	512	104	309	19	0	432
4526	2958s (+0.8s)	3456	3456	256	70	202	13	0	285
4527	2959s (+0.5s)	1796	1796	128	41	138	5	0	184
4528	2960s (+0.5s)	1632	1632	128	45	122	8	0	175
4529	2960s (+0.8s)	3400	3400	256	74	209	8	0	291
4530	2961s (+0.3s)	696	696	64	19	68	5	0	92
4531	2961s (+0.5s)	1792	1792	128	41	138	4	0	183
4532	2962s (+0.5s)	1908	1908	128	45	134	8	0	187
4533	2962s (+0.6s)	2492	2492	256	45	162	8	0	215
4534	2963s (+1.0s)	4320	4320	256	83	261	14	0	358
4535	2964s (+0.4s)	1108	1108	64	46	84	6	0	136
4536	2964s (+0.6s)	1908	1908	128	44	146	5	0	195
4537	2965s (+0.5s)	1752	1752	128	44	122	11	0	177
4538	2966s (+0.8s)	3712	3712	256	75	212	11	0	298
4539	2967s (+0.9s)	3988	3988	256	86	227	18	0	331
4540	2967s (+0.4s)	1592	1592	128	31	117	9	0	157
4541	2968s (+0.5s)	1872	1872	128	32	158	1	0	191
4542	2968s (+0.4s)	1452	1452	128	29	117	3	0	149
4543	2969s (+0.6s)	1876	1876	128	41	146	6	0	193
4544	2969s (+0.9s)	3544	3544	256	82	208	10	0	300
4545	2970s (+0.7s)	2816	2816	256	72	159	16	0	247
4546	2971s (+0.7s)	2796	2796	256	49	180	11	0	240
4547	2972s (+1.0s)	4188	4188	256	102	225	15	0	342
4548	2973s (+0.8s)	3492	3492	256	67	206	14	0	287
4549	2974s (+0.9s)	3972	3972	256	83	227	11	0	321
4550	2974s (+0.7s)	3108	3108	256	64	182	15	0	261
4551	2975s (+0.6s)	2620	2620	256	52	159	11	0	222
4552	2975s (+0.3s)	792	792	64	31	70	4	0	105
4553	2976s (+0.8s)	3372	3372	256	68	197	14	0	279
4554	2977s (+0.7s)	3076	3076	256	55	182	16	0	253
4555	2978s (+1.1s)	5580	5580	512	88	279	21	0	388
4556	2978s (+0.3s)	976	976	64	25	85	4	0	114
4557	2979s (+0.4s)	1316	1316	128	31	104	6	0	141
4558	2979s (+0.7s)	2788	2788	256	60	170	10	0	240
4559	2980s (+0.5s)	1892	1892	128	39	145	7	0	191
4560	2980s (+0.5s)	1684	1684	128	39	126	8	0	173
4561	2981s (+0.8s)	3572	3572	256	87	194	16	0	297
4562	2982s (+1.0s)	4240	4240	256	86	246	22	0	354
4563	2983s (+0.7s)	3028	3028	256	63	177	12	0	252
4564	2984s (+1.4s)	6600	6600	512	132	314	26	0	472
4565	2986s (+1.1s)	5180	5180	512	89	270	14	0	373
4566	2986s (+0.7s)	2956	2956	256	68	184	8	0	260
4567	2987s (+0.9s)	3724	3724	256	77	220	19	1	317
4568	2988s (+1.0s)	4324	4324	256	91	244	21	0	356
4569	2989s (+0.8s)	3368	3368	256	81	193	14	0	288
4570	2989s (+0.4s)	1420	1420	128	32	107	6	0	145
4571	2990s (+0.8s)	3232	3232	256	65	194	12	0	271
4572	2991s (+0.9s)	3976	3976	256	83	227	18	0	328
4573	2992s (+0.6s)	2468	2468	256	40	163	3	0	206
4574	2992s (+0.4s)	1480	1480	128	37	106	11	0	154
4575	2993s (+0.7s)	2812	2812	256	57	176	8	0	241
4576	2994s (+0.6s)	2232	2232	128	61	147	9	0	217
4577	2994s (+0.8s)	3452	3452	256	78	190	15	0	283
4578	2995s (+0.5s)	1880	1880	128	41	149	3	0	193
4579	2996s (+0.7s)	3044	3044	256	61	192	7	0	260
4580	2996s (+0.4s)	1360	1360	64	41	102	5	0	148
4581	2997s (+0.6s)	2376	2376	128	49	164	0	10	223
4582	2997s (+0.7s)	3184	3184	256	55	191	0	18	264
4583	2998s (+0.8s)	3364	3364	256	59	206	0	12	277
4584	2999s (+0.7s)	2856	2856	256	54	188	0	9	251
4585	2999s (+0.5s)	2068	2068	256	36	126	0	8	170
4586	3000s (+0.7s)	2796	2796	256	43	189	0	10	242
4587	3001s (+0.5s)	1568	1568	128	42	112	0	6	160
4588	3001s (+0.8s)	3412	3412	256	61	206	0	17	284
4589	3002s (+0.4s)	1156	1156	64	30	97	0	11	138
4590	3002s (+0.6s)	2576	2576	256	48	164	0	7	219
4591	3003s (+0.8s)	3372	3372	256	73	191	16	0	280
4592	3004s (+0.8s)	3152	3152	256	60	203	8	0	271
4593	3005s (+0.7s)	3180	3180	256	61	182	15	0	258
4594	3006s (+0.8s)	3432	3432	256	67	198	14	0	279
4595	3006s (+0.4s)	1448	1448	128	30	106	4	0	140
4596	3006s (+0.5s)	1684	1684	128	38	129	6	0	173
4597	3007s (+0.6s)	2212	2212	128	61	137	11	0	209
4598	3007s (+0.3s)	1104	1104	128	25	91	5	0	121
4599	3008s (+0.5s)	1520	1520	128	35	119	9	0	163
Episode	Time	Reward	Score	Highest	L	U	R	D	Steps
4600	3009s (+0.8s)	3348	3348	256	68	204	12	0	284
4601	3010s (+1.1s)	5460	5460	512	106	260	21	0	387
4602	3011s (+0.9s)	3972	3972	256	89	224	14	0	327
4603	3011s (+0.4s)	1172	1172	128	36	85	5	0	126
4604	3012s (+1.1s)	4532	4532	256	101	259	19	0	379
4605	3013s (+0.4s)	1272	1272	64	40	99	6	0	145
4606	3013s (+0.8s)	3620	3620	256	84	208	15	0	307
4607	3014s (+0.5s)	1584	1584	128	50	113	6	0	169
4608	3015s (+0.8s)	4536	4536	512	76	206	23	0	305
4609	3015s (+0.5s)	1840	1840	128	43	128	13	0	184
4610	3016s (+0.6s)	2528	2528	256	53	153	10	0	216
4611	3017s (+0.7s)	3076	3076	256	47	201	6	0	254
4612	3017s (+0.4s)	972	972	64	33	87	4	0	124
4613	3018s (+0.8s)	3480	3480	256	63	216	10	0	289
4614	3019s (+0.7s)	2572	2572	128	64	162	12	0	238
4615	3019s (+0.6s)	2460	2460	256	48	157	6	1	212
4616	3020s (+0.4s)	1232	1232	128	23	102	8	0	133
4617	3020s (+0.5s)	2224	2224	256	39	144	3	0	186
4618	3021s (+0.6s)	2604	2604	256	57	159	10	0	226
4619	3021s (+0.5s)	1560	1560	128	37	118	7	0	162
4620	3022s (+1.1s)	4596	4596	256	119	245	14	1	379
4621	3023s (+0.9s)	3560	3560	256	77	216	11	0	304
4622	3024s (+0.4s)	1288	1288	128	47	88	7	0	142
4623	3025s (+1.0s)	4864	4864	512	92	236	15	0	343
4624	3025s (+0.7s)	3008	3008	256	60	178	14	0	252
4625	3026s (+0.5s)	1804	1804	128	51	128	6	1	186
4626	3026s (+0.2s)	528	528	64	11	63	0	4	78
4627	3027s (+0.7s)	2820	2820	256	63	162	15	0	240
4628	3027s (+0.4s)	1356	1356	128	29	103	8	0	140
4629	3028s (+0.3s)	1128	1128	128	24	90	5	0	119
4630	3028s (+0.9s)	3888	3888	256	87	220	11	0	318
4631	3029s (+0.8s)	3656	3656	256	80	212	17	0	309
4632	3030s (+0.6s)	2512	2512	256	47	162	10	0	219
4633	3031s (+0.9s)	3860	3860	256	73	229	14	0	316
4634	3031s (+0.6s)	1980	1980	128	44	159	5	0	208
4635	3032s (+0.4s)	1204	1204	128	23	102	8	0	133
4636	3032s (+0.6s)	2620	2620	256	55	161	12	0	228
4637	3033s (+0.9s)	3952	3952	256	82	225	15	0	322
4638	3034s (+0.4s)	1376	1376	128	31	110	4	0	145
4639	3034s (+0.6s)	1912	1912	128	41	146	9	0	196
4640	3035s (+0.2s)	612	612	64	15	65	2	0	82
4641	3035s (+0.5s)	1808	1808	128	32	148	7	0	187
4642	3036s (+0.4s)	1140	1140	64	27	105	4	0	136
4643	3036s (+0.6s)	2552	2552	256	45	155	9	0	209
4644	3037s (+1.0s)	4240	4240	256	91	239	20	0	350
4645	3038s (+0.5s)	1744	1744	128	44	124	8	0	176
4646	3038s (+0.5s)	1832	1832	128	49	127	10	0	186
4647	3039s (+0.4s)	1420	1420	128	23	119	0	4	146
4648	3039s (+0.5s)	1752	1752	128	32	139	0	8	179
4649	3040s (+0.5s)	1888	1888	128	47	136	0	8	191
4650	3040s (+0.4s)	1496	1496	128	31	120	0	7	158
4651	3041s (+0.9s)	4008	4008	256	85	217	18	1	321
4652	3042s (+0.5s)	1692	1692	128	36	125	9	0	170
4653	3042s (+0.5s)	2036	2036	128	60	114	14	0	188
4654	3043s (+0.7s)	3196	3196	256	71	179	13	0	263
4655	3043s (+0.7s)	2952	2952	256	55	184	10	0	249
4656	3044s (+0.8s)	3768	3768	256	72	210	16	0	298
4657	3045s (+0.5s)	1680	1680	128	32	134	5	0	171
4658	3045s (+0.4s)	1096	1096	128	23	94	6	0	123
4659	3046s (+0.4s)	1492	1492	128	45	106	5	0	156
4660	3046s (+0.5s)	1636	1636	128	38	113	10	0	161
4661	3047s (+0.8s)	3232	3232	256	64	196	11	0	271
4662	3048s (+0.8s)	3408	3408	256	74	211	8	0	293
4663	3048s (+0.8s)	3256	3256	256	63	198	15	1	277
4664	3049s (+0.5s)	1904	1904	128	48	142	4	0	194
4665	3050s (+0.7s)	2736	2736	256	59	157	14	1	231
4666	3050s (+0.6s)	2540	2540	256	50	154	11	0	215
4667	3051s (+1.0s)	4208	4208	256	77	250	14	2	343
4668	3052s (+1.0s)	4304	4304	256	96	247	16	0	359
4669	3053s (+0.4s)	1180	1180	64	24	115	0	4	143
4670	3053s (+0.3s)	868	868	64	23	77	5	0	105
4671	3054s (+0.8s)	3460	3460	256	89	184	16	0	289
4672	3054s (+0.5s)	1736	1736	128	44	126	8	0	178
4673	3055s (+0.7s)	3236	3236	256	64	184	13	0	261
4674	3056s (+0.5s)	1900	1900	128	51	134	8	0	193
4675	3056s (+0.7s)	3168	3168	256	65	182	0	13	260
4676	3057s (+0.6s)	2512	2512	256	46	162	0	8	216
4677	3058s (+0.5s)	1796	1796	128	38	136	0	10	184
4678	3058s (+0.3s)	732	732	64	28	64	4	0	96
4679	3058s (+0.5s)	1680	1680	128	46	116	10	0	172
4680	3059s (+0.7s)	2820	2820	256	61	178	9	0	248
4681	3060s (+0.6s)	2396	2396	256	48	149	9	1	207
4682	3060s (+0.5s)	1816	1816	128	47	131	6	1	185
4683	3061s (+1.0s)	4336	4336	256	94	242	21	1	358
4684	3062s (+0.4s)	1524	1524	128	34	116	4	0	154
4685	3062s (+0.8s)	3536	3536	256	61	223	0	14	298
4686	3063s (+0.8s)	3364	3364	256	55	217	0	15	287
4687	3064s (+0.5s)	1956	1956	128	37	131	0	14	182
4688	3064s (+0.5s)	1532	1532	128	36	119	0	11	166
4689	3065s (+1.0s)	4336	4336	256	93	247	18	0	358
4690	3066s (+0.8s)	3444	3444	256	73	206	13	0	292
4691	3067s (+0.7s)	2992	2992	256	58	185	14	1	258
4692	3067s (+0.4s)	1052	1052	64	29	90	8	0	127
4693	3068s (+0.9s)	4096	4096	256	96	222	13	0	331
4694	3069s (+0.7s)	3044	3044	256	72	171	14	0	257
4695	3070s (+1.4s)	7200	7200	512	148	323	28	1	500
4696	3071s (+0.7s)	2948	2948	256	59	179	11	0	249
4697	3072s (+0.5s)	1628	1628	128	40	110	13	0	163
4698	3072s (+0.5s)	1552	1552	128	33	121	5	1	160
4699	3073s (+0.8s)	3552	3552	256	70	217	15	0	302
Episode	Time	Reward	Score	Highest	L	U	R	D	Steps
4700	3074s (+0.8s)	2952	2952	256	58	194	12	0	264
4701	3074s (+0.5s)	1816	1816	128	52	129	8	0	189
4702	3075s (+0.4s)	1508	1508	128	49	104	7	0	160
4703	3075s (+0.5s)	1752	1752	128	45	131	4	0	180
4704	3076s (+0.5s)	1692	1692	128	41	126	7	0	174
4705	3077s (+0.6s)	2600	2600	256	63	150	11	0	224
4706	3077s (+0.7s)	3084	3084	256	79	162	12	0	253
4707	3078s (+0.7s)	3144	3144	256	53	196	5	0	254
4708	3079s (+0.9s)	3724	3724	256	68	220	15	0	303
4709	3079s (+0.4s)	1376	1376	128	38	101	6	0	145
4710	3080s (+0.4s)	1156	1156	64	31	99	6	0	136
4711	3080s (+0.3s)	792	792	64	26	72	5	0	103
4712	3081s (+0.9s)	4116	4116	256	71	249	13	0	333
4713	3081s (+0.5s)	1816	1816	128	37	145	7	0	189
4714	3082s (+0.7s)	3056	3056	256	54	184	11	0	249
4715	3083s (+0.5s)	1524	1524	128	25	128	0	5	158
4716	3083s (+0.6s)	2432	2432	256	36	160	0	9	205
4717	3084s (+0.7s)	2748	2748	256	57	168	10	0	235
4718	3084s (+0.6s)	1936	1936	128	49	139	14	0	202
4719	3085s (+0.5s)	1836	1836	128	40	142	0	5	187
4720	3086s (+0.5s)	1772	1772	128	39	126	0	10	175
4721	3086s (+0.8s)	3252	3252	256	59	206	11	0	276
4722	3087s (+0.5s)	1456	1456	128	44	109	6	0	159
4723	3088s (+0.8s)	3528	3528	256	90	184	18	1	293
4724	3088s (+0.6s)	2384	2384	128	44	171	9	0	224
4725	3089s (+0.4s)	1424	1424	128	33	118	4	0	155
4726	3090s (+1.1s)	5596	5596	512	106	268	23	0	397
4727	3091s (+0.7s)	2736	2736	256	59	162	11	0	232
4728	3091s (+0.5s)	1904	1904	128	46	141	7	0	194
4729	3092s (+0.7s)	3212	3212	256	62	192	9	0	263
4730	3092s (+0.6s)	2404	2404	128	62	151	11	0	224
4731	3093s (+0.4s)	1012	1012	64	32	93	3	0	128
4732	3093s (+0.5s)	1668	1668	128	45	116	7	1	169
4733	3094s (+0.6s)	1980	1980	128	56	134	11	0	201
4734	3095s (+0.8s)	3252	3252	256	66	191	18	1	276
4735	3095s (+0.7s)	3180	3180	256	59	192	11	0	262
4736	3096s (+0.8s)	3388	3388	256	68	199	16	0	283
4737	3097s (+0.8s)	3436	3436	256	72	208	10	0	290
4738	3098s (+0.9s)	3908	3908	256	85	209	18	1	313
4739	3099s (+0.5s)	1888	1888	128	44	143	4	0	191
4740	3099s (+0.6s)	2680	2680	256	58	160	11	0	229
4741	3100s (+0.4s)	1488	1488	128	31	120	6	0	157
4742	3101s (+1.0s)	4236	4236	256	80	255	18	0	353
4743	3102s (+1.0s)	4500	4500	256	103	241	22	1	367
4744	3102s (+0.2s)	348	348	32	8	52	2	0	62
4745	3103s (+0.7s)	2892	2892	256	60	177	12	0	249
4746	3103s (+0.4s)	1316	1316	128	25	106	4	0	135
4747	3104s (+0.5s)	2260	2260	256	44	138	8	0	190
4748	3104s (+0.5s)	1612	1612	128	46	114	10	0	170
4749	3105s (+0.7s)	2884	2884	256	62	179	6	0	247
4750	3106s (+0.8s)	3604	3604	256	74	213	21	0	308
4751	3106s (+0.4s)	1156	1156	64	30	100	6	0	136
4752	3107s (+0.7s)	2776	2776	256	62	166	0	10	238
4753	3107s (+0.2s)	396	396	32	12	53	0	0	65
4754	3107s (+0.4s)	1476	1476	128	27	122	0	4	153
4755	3108s (+0.2s)	580	580	64	17	58	0	4	79
4756	3108s (+0.7s)	3124	3124	256	48	200	0	13	261
4757	3109s (+0.3s)	948	948	64	20	82	0	9	111
4758	3109s (+0.8s)	3340	3340	256	63	208	0	14	285
4759	3110s (+0.4s)	1504	1504	128	32	120	0	7	159
4760	3110s (+0.5s)	1724	1724	128	22	152	0	4	178
4761	3111s (+0.8s)	3432	3432	256	82	193	0	14	289
4762	3112s (+0.6s)	2476	2476	256	47	160	0	8	215
4763	3112s (+0.6s)	2208	2208	256	48	134	0	11	193
4764	3113s (+0.6s)	2488	2488	256	45	160	0	9	214
4765	3113s (+0.4s)	1336	1336	128	32	97	0	11	140
4766	3114s (+0.8s)	3252	3252	256	50	210	0	16	276
4767	3115s (+0.9s)	3820	3820	256	70	218	0	19	307
4768	3116s (+1.3s)	6588	6588	512	81	352	0	26	459
4769	3117s (+0.9s)	3560	3560	256	73	217	13	1	304
4770	3118s (+0.8s)	3668	3668	256	67	211	15	1	294
4771	3119s (+0.4s)	1056	1056	64	26	99	3	0	128
4772	3120s (+0.9s)	3984	3984	256	86	227	17	0	330
4773	3120s (+0.8s)	3232	3232	256	71	190	10	0	271
4774	3121s (+0.3s)	808	808	64	30	74	6	0	110
4775	3121s (+0.7s)	2764	2764	256	58	170	9	0	237
4776	3122s (+0.5s)	1616	1616	128	39	125	6	0	170
4777	3123s (+0.7s)	2692	2692	256	48	173	11	0	232
4778	3123s (+0.8s)	3284	3284	256	72	194	12	0	278
4779	3124s (+0.8s)	3308	3308	256	82	182	15	0	279
4780	3125s (+0.7s)	2748	2748	256	59	159	15	2	235
4781	3126s (+0.8s)	3476	3476	256	65	210	14	0	289
4782	3126s (+0.5s)	1672	1672	128	40	124	6	0	170
4783	3127s (+1.0s)	4200	4200	256	76	254	16	0	346
4784	3128s (+0.4s)	1532	1532	128	40	112	4	0	156
4785	3128s (+0.6s)	1960	1960	128	51	150	7	0	208
4786	3129s (+0.5s)	1540	1540	128	50	100	11	0	161
4787	3130s (+1.0s)	4512	4512	256	91	261	19	0	371
4788	3130s (+0.6s)	2508	2508	256	56	148	14	1	219
4789	3131s (+0.5s)	1664	1664	128	37	135	0	6	178
4790	3132s (+0.7s)	2772	2772	256	48	181	0	9	238
4791	3132s (+0.8s)	3336	3336	256	48	205	0	17	270
4792	3133s (+0.4s)	1364	1364	128	29	109	0	4	142
4793	3133s (+0.5s)	1568	1568	128	31	125	0	5	161
4794	3134s (+0.8s)	3248	3248	256	67	194	11	0	272
4795	3135s (+0.6s)	1924	1924	128	42	148	9	0	199
4796	3136s (+1.0s)	4304	4304	256	84	247	18	1	350
4797	3136s (+0.7s)	2656	2656	256	70	154	10	0	234
4798	3137s (+0.6s)	2156	2156	128	65	136	13	0	214
4799	3137s (+0.4s)	1400	1400	128	34	106	7	0	147
Episode	Time	Reward	Score	Highest	L	U	R	D	Steps
4800	3138s (+0.4s)	1104	1104	64	36	96	6	0	138
4801	3138s (+0.3s)	672	672	64	16	66	0	6	88
4802	3139s (+0.8s)	3216	3216	256	54	204	0	14	272
4803	3139s (+0.7s)	3116	3116	256	49	198	0	12	259
4804	3140s (+0.4s)	1440	1440	128	26	118	0	6	150
4805	3141s (+0.8s)	3268	3268	256	62	203	0	9	274
4806	3141s (+0.4s)	1328	1328	128	20	112	0	5	137
4807	3142s (+0.6s)	2376	2376	256	42	156	0	5	203
4808	3142s (+0.7s)	2732	2732	256	38	188	0	6	232
4809	3143s (+0.6s)	2492	2492	256	39	157	0	9	205
4810	3143s (+0.5s)	1724	1724	128	41	116	0	15	172
4811	3144s (+0.8s)	3360	3360	256	75	188	17	0	280
4812	3145s (+0.8s)	3564	3564	256	76	213	13	0	302
4813	3145s (+0.4s)	1100	1100	64	36	88	7	0	131
4814	3146s (+0.4s)	1460	1460	128	42	107	10	0	159
4815	3146s (+0.5s)	1744	1744	128	49	118	9	0	176
4816	3147s (+0.4s)	1408	1408	128	32	109	7	0	148
4817	3148s (+0.8s)	3504	3504	256	71	209	12	0	292
4818	3148s (+0.7s)	2960	2960	256	65	172	11	1	249
4819	3149s (+0.3s)	856	856	64	24	80	6	0	110
4820	3149s (+0.2s)	668	668	64	14	71	5	0	90
4821	3150s (+0.7s)	3232	3232	256	72	182	17	0	271
4822	3151s (+0.9s)	3704	3704	256	89	202	25	0	316
4823	3151s (+0.8s)	3700	3700	256	73	214	11	0	298
4824	3152s (+0.4s)	1128	1128	64	28	103	3	0	134
4825	3152s (+0.6s)	1988	1988	128	50	134	10	0	194
4826	3153s (+0.8s)	3400	3400	256	67	195	19	0	281
4827	3154s (+0.7s)	2500	2500	128	68	152	10	1	231
4828	3155s (+0.7s)	2916	2916	256	60	184	11	0	255
4829	3155s (+0.8s)	3548	3548	256	78	202	16	0	296
4830	3156s (+0.8s)	3356	3356	256	66	198	12	0	276
4831	3157s (+0.4s)	1472	1472	128	32	113	7	0	152
4832	3157s (+0.8s)	3272	3272	256	61	205	14	0	280
4833	3158s (+0.7s)	3104	3104	256	53	194	5	0	252
4834	3159s (+0.4s)	1216	1216	128	35	97	4	0	136
4835	3159s (+0.8s)	3248	3248	256	84	174	16	1	275
4836	3160s (+0.7s)	2792	2792	256	55	178	9	0	242
4837	3160s (+0.4s)	1368	1368	128	32	106	6	0	144
4838	3161s (+0.6s)	2200	2200	128	50	152	7	1	210
4839	3162s (+0.7s)	2880	2880	256	71	166	14	0	251
4840	3163s (+0.9s)	3880	3880	256	97	209	23	0	329
4841	3164s (+0.8s)	3448	3448	256	74	199	13	0	286
4842	3164s (+0.6s)	1992	1992	128	39	154	8	0	201
4843	3165s (+0.4s)	1220	1220	64	38	99	8	0	145
4844	3165s (+0.4s)	1480	1480	128	42	107	6	0	155
4845	3165s (+0.3s)	680	680	64	19	70	2	0	91
4846	3166s (+0.5s)	2136	2136	256	29	144	0	7	180
4847	3166s (+0.4s)	1444	1444	128	32	110	0	7	149
4848	3167s (+0.5s)	2184	2184	256	42	127	0	8	177
4849	3167s (+0.4s)	1236	1236	128	20	104	0	6	130
4850	3167s (+0.4s)	1380	1380	128	24	111	0	4	139
4851	3168s (+0.5s)	1692	1692	128	39	123	0	4	166
4852	3169s (+0.5s)	1828	1828	128	41	137	0	8	186
4853	3169s (+0.6s)	2448	2448	256	52	149	0	7	208
4854	3170s (+0.6s)	2368	2368	256	49	152	0	5	206
4855	3170s (+0.4s)	1276	1276	128	33	91	0	11	135
4856	3171s (+0.4s)	1452	1452	128	27	118	0	5	150
4857	3171s (+0.7s)	2476	2476	128	47	170	0	14	231
4858	3172s (+0.7s)	2892	2892	256	44	182	0	14	240
4859	3172s (+0.4s)	1340	1340	128	25	109	0	7	141
4860	3173s (+0.4s)	1464	1464	128	41	104	6	0	151
4861	3173s (+0.4s)	1564	1564	128	43	105	7	1	156
4862	3174s (+0.6s)	2488	2488	256	45	157	6	0	208
4863	3174s (+0.5s)	1604	1604	128	38	126	4	0	168
4864	3175s (+0.5s)	1768	1768	128	36	138	4	0	178
4865	3175s (+0.6s)	2228	2228	128	64	139	8	0	211
4866	3176s (+0.8s)	3388	3388	256	72	190	14	1	277
4867	3177s (+0.8s)	3220	3220	256	60	201	7	0	268
4868	3177s (+0.4s)	1308	1308	64	36	103	7	0	146
4869	3178s (+0.8s)	3504	3504	256	93	195	13	0	301
4870	3179s (+0.6s)	2764	2764	256	49	170	14	0	233
4871	3180s (+1.0s)	4048	4048	256	79	243	12	0	334
4872	3181s (+1.0s)	4168	4168	256	85	243	16	0	344
4873	3181s (+0.5s)	1776	1776	128	41	133	5	0	179
4874	3182s (+0.7s)	2576	2576	128	74	155	13	1	243
4875	3183s (+0.8s)	3428	3428	256	83	188	18	0	289
4876	3183s (+0.4s)	1224	1224	128	40	90	4	0	134
4877	3184s (+0.5s)	1544	1544	128	46	110	9	0	165
4878	3184s (+0.5s)	1500	1500	128	36	116	7	0	159
4879	3185s (+0.7s)	3160	3160	256	64	186	9	0	259
4880	3186s (+0.9s)	3944	3944	256	89	219	17	0	325
4881	3186s (+0.5s)	1816	1816	128	53	130	6	0	189
4882	3187s (+0.5s)	1848	1848	128	51	136	5	0	192
4883	3188s (+1.0s)	4204	4204	256	98	226	22	0	346
4884	3189s (+0.7s)	2844	2844	256	66	175	8	0	249
4885	3189s (+0.9s)	4004	4004	256	72	239	12	0	323
4886	3190s (+0.5s)	1624	1624	128	41	123	8	1	173
4887	3191s (+0.9s)	3868	3868	256	75	233	14	0	322
4888	3191s (+0.5s)	1600	1600	128	45	112	10	0	167
4889	3192s (+0.5s)	1652	1652	128	33	116	10	0	159
4890	3193s (+0.8s)	3444	3444	256	72	202	13	0	287
4891	3193s (+0.3s)	1092	1092	64	45	75	6	0	126
4892	3193s (+0.4s)	1012	1012	64	32	95	5	0	132
4893	3194s (+0.4s)	988	988	64	27	95	4	0	126
4894	3194s (+0.4s)	1320	1320	128	34	100	6	1	141
4895	3195s (+0.7s)	2724	2724	256	43	177	9	0	229
4896	3195s (+0.6s)	2620	2620	256	48	174	7	0	229
4897	3196s (+0.5s)	2324	2324	256	41	145	0	7	193
4898	3196s (+0.2s)	444	444	32	12	58	0	2	72
4899	3197s (+0.4s)	1108	1108	64	27	99	0	9	135
Episode	Time	Reward	Score	Highest	L	U	R	D	Steps
4900	3197s (+0.7s)	2832	2832	256	74	156	0	10	240
4901	3198s (+0.5s)	2076	2076	256	37	126	0	9	172
4902	3198s (+0.5s)	1604	1604	128	38	118	0	11	167
4903	3199s (+0.5s)	2244	2244	256	35	143	0	12	190
4904	3200s (+0.7s)	2812	2812	256	54	183	0	9	246
4905	3200s (+0.7s)	2840	2840	256	56	182	0	11	249
4906	3201s (+0.4s)	1104	1104	64	27	97	0	4	128
4907	3201s (+0.5s)	1784	1784	128	39	119	0	8	166
4908	3202s (+0.4s)	1144	1144	64	32	101	0	7	140
4909	3202s (+0.8s)	3628	3628	256	63	214	0	17	294
4910	3203s (+0.3s)	992	992	64	24	92	5	0	121
4911	3203s (+0.5s)	1760	1760	128	57	115	8	0	180
4912	3205s (+1.4s)	6896	6896	512	148	329	28	0	505
4913	3205s (+0.7s)	3068	3068	256	66	181	12	0	259
4914	3206s (+0.5s)	1836	1836	128	48	129	9	1	187
4915	3207s (+0.5s)	2304	2304	256	41	144	6	0	191
4916	3207s (+0.9s)	3700	3700	256	90	221	11	0	322
4917	3208s (+0.4s)	1332	1332	128	25	109	4	0	138
4918	3209s (+0.8s)	3352	3352	256	76	190	10	0	276
4919	3210s (+0.9s)	3648	3648	256	76	221	12	0	309
4920	3210s (+0.5s)	1640	1640	128	39	116	9	0	164
4921	3211s (+0.5s)	1760	1760	128	49	115	14	1	179
4922	3211s (+0.5s)	1816	1816	128	54	118	10	0	182
4923	3212s (+0.8s)	3396	3396	256	72	199	13	1	285
4924	3213s (+0.8s)	3140	3140	256	69	184	20	1	274
4925	3213s (+0.5s)	1760	1760	128	40	128	10	0	178
4926	3214s (+0.8s)	3548	3548	256	75	197	16	0	288
4927	3215s (+0.9s)	3548	3548	256	79	206	16	0	301
4928	3215s (+0.4s)	1504	1504	128	35	120	5	0	160
4929	3216s (+0.9s)	3632	3632	256	73	220	12	0	305
4930	3217s (+0.7s)	2708	2708	256	41	181	0	9	231
4931	3217s (+0.3s)	880	880	64	28	84	0	4	116
4932	3218s (+0.4s)	1180	1180	64	35	102	0	5	142
4933	3218s (+0.8s)	3356	3356	256	75	181	12	1	269
4934	3219s (+0.8s)	3376	3376	256	74	201	15	0	290
4935	3220s (+0.5s)	1524	1524	128	41	115	8	0	164
4936	3220s (+0.7s)	3188	3188	256	66	188	11	0	265
4937	3221s (+0.5s)	1668	1668	128	46	121	10	0	177
4938	3221s (+0.4s)	1484	1484	128	32	114	8	0	154
4939	3222s (+0.5s)	1912	1912	128	51	125	6	0	182
4940	3223s (+1.0s)	4612	4612	256	99	247	29	0	375
4941	3224s (+0.7s)	2856	2856	256	61	180	10	0	251
4942	3224s (+0.5s)	1496	1496	128	31	118	9	0	158
4943	3225s (+0.6s)	2140	2140	128	46	158	10	0	214
4944	3226s (+0.7s)	3188	3188	256	75	176	13	1	265
4945	3226s (+0.3s)	768	768	64	31	74	2	0	107
4946	3226s (+0.4s)	1324	1324	128	27	107	2	0	136
4947	3227s (+1.2s)	5960	5960	512	118	271	24	0	413
4948	3228s (+0.4s)	1284	1284	128	39	100	5	0	144
4949	3228s (+0.6s)	2528	2528	256	45	160	0	8	213
4950	3229s (+0.6s)	2620	2620	256	47	176	0	7	230
4951	3230s (+0.5s)	1752	1752	128	33	133	0	12	178
4952	3230s (+0.8s)	3360	3360	256	56	199	15	1	271
4953	3231s (+0.7s)	2748	2748	256	68	148	19	0	235
4954	3232s (+0.5s)	1504	1504	128	30	124	5	0	159
4955	3232s (+0.5s)	1676	1676	128	54	109	5	0	168
4956	3233s (+0.9s)	3908	3908	256	102	207	20	3	332
4957	3234s (+0.5s)	1784	1784	128	48	123	10	0	181
4958	3234s (+0.5s)	1824	1824	128	42	132	5	0	179
4959	3235s (+0.8s)	3500	3500	256	63	218	13	0	294
4960	3236s (+0.6s)	2492	2492	256	38	170	0	7	215
4961	3236s (+0.8s)	3536	3536	256	61	225	0	12	298
4962	3237s (+0.6s)	2700	2700	256	53	168	0	10	231
4963	3238s (+0.6s)	2620	2620	256	45	162	13	0	220
4964	3238s (+0.5s)	1728	1728	128	38	125	9	1	173
4965	3239s (+0.6s)	2152	2152	128	54	136	11	0	201
4966	3239s (+0.4s)	1164	1164	64	33	100	5	0	138
4967	3239s (+0.3s)	960	960	64	22	94	0	5	121
4968	3240s (+0.7s)	3096	3096	256	56	182	8	1	247
4969	3241s (+0.5s)	1784	1784	128	51	128	8	0	187
4970	3241s (+0.7s)	2768	2768	256	59	172	9	0	240
4971	3242s (+0.6s)	2244	2244	128	50	156	9	1	216
4972	3243s (+0.5s)	1768	1768	128	49	129	4	0	182
4973	3243s (+0.7s)	2876	2876	256	58	177	14	1	250
4974	3244s (+0.7s)	2496	2496	128	58	166	14	0	238
4975	3244s (+0.6s)	1924	1924	128	43	152	4	0	199
4976	3245s (+0.6s)	2344	2344	128	64	152	8	0	224
4977	3245s (+0.3s)	1164	1164	128	24	97	4	0	125
4978	3246s (+0.8s)	3240	3240	256	65	192	15	1	273
4979	3247s (+0.9s)	4124	4124	256	85	231	17	0	333
4980	3248s (+0.7s)	3172	3172	256	69	177	15	0	261
4981	3249s (+0.9s)	3656	3656	256	76	203	19	0	298
4982	3250s (+0.8s)	3372	3372	256	69	204	16	0	289
4983	3251s (+1.0s)	4320	4320	256	86	255	17	0	358
4984	3251s (+0.6s)	2176	2176	128	52	155	8	0	215
4985	3252s (+0.3s)	848	848	64	24	75	6	0	105
4986	3252s (+0.8s)	3344	3344	256	67	191	14	0	272
4987	3253s (+0.7s)	2832	2832	256	46	193	4	0	243
4988	3254s (+0.9s)	3792	3792	256	82	217	16	1	316
4989	3255s (+0.6s)	1944	1944	128	54	140	6	0	200
4990	3255s (+0.6s)	2516	2516	256	39	166	5	0	210
4991	3256s (+0.4s)	1172	1172	128	40	82	4	0	126
4992	3256s (+0.6s)	1944	1944	128	42	154	0	3	199
4993	3257s (+0.5s)	1620	1620	128	38	129	0	5	172
4994	3258s (+1.0s)	4176	4176	256	73	255	0	18	346
4995	3258s (+0.7s)	3184	3184	256	48	208	8	0	264
4996	3259s (+0.6s)	2012	2012	128	55	141	9	0	205
4997	3259s (+0.4s)	1288	1288	128	34	106	3	1	144
4998	3260s (+0.4s)	1372	1372	128	32	118	4	0	154
4999	3260s (+0.6s)	1896	1896	128	63	121	9	0	193
Episode	Time	Reward	Score	Highest	L	U	R	D	Steps
5000	3261s (+0.8s)	3316	3316	256	62	204	9	0	275
5001	3262s (+0.8s)	3244	3244	256	59	203	12	0	274
5002	3263s (+1.0s)	4216	4216	256	98	227	20	0	345
5003	3264s (+0.9s)	3860	3860	256	87	220	17	0	324
5004	3264s (+0.5s)	1664	1664	64	55	111	11	0	177
5005	3265s (+1.1s)	5744	5744	512	110	270	22	0	402
5006	3266s (+0.7s)	2872	2872	256	55	180	14	0	249
5007	3267s (+0.9s)	4664	4664	512	85	220	17	0	322
5008	3267s (+0.4s)	1052	1052	64	30	90	7	0	127
5009	3268s (+1.0s)	4168	4168	256	93	239	12	0	344
5010	3269s (+0.6s)	1900	1900	128	43	144	6	0	193
5011	3270s (+0.6s)	2632	2632	256	46	171	9	0	226
5012	3270s (+0.7s)	2956	2956	256	66	168	12	0	246
5013	3271s (+0.5s)	1656	1656	128	37	125	4	0	166
5014	3271s (+0.6s)	1920	1920	128	31	162	0	6	199
5015	3272s (+0.3s)	1096	1096	128	21	86	0	6	113
5016	3272s (+0.3s)	696	696	64	15	73	0	3	91
5017	3273s (+0.8s)	3204	3204	256	67	193	9	0	269
5018	3273s (+0.6s)	2432	2432	256	57	134	14	0	205
5019	3274s (+0.5s)	1456	1456	64	47	105	11	0	163
5020	3275s (+1.0s)	4236	4236	256	91	240	18	0	349
5021	3276s (+0.8s)	3388	3388	256	75	188	20	0	283
5022	3277s (+0.8s)	3544	3544	256	68	216	10	0	294
5023	3277s (+0.8s)	3252	3252	256	66	195	14	0	275
5024	3278s (+0.7s)	2912	2912	256	59	173	12	0	244
5025	3279s (+0.5s)	2188	2188	256	47	132	8	0	187
5026	3279s (+0.9s)	4036	4036	256	92	221	23	0	336
5027	3280s (+0.5s)	1648	1648	128	51	116	7	0	174
5028	3280s (+0.4s)	1540	1540	128	41	112	5	0	158
5029	3281s (+0.7s)	3128	3128	256	53	199	8	0	260
5030	3282s (+0.9s)	3640	3640	256	69	214	0	15	298
5031	3283s (+0.5s)	1616	1616	128	38	122	0	7	167
5032	3283s (+0.3s)	744	744	64	19	73	0	7	99
5033	3284s (+0.7s)	2924	2924	256	49	198	10	0	257
5034	3284s (+0.5s)	1800	1800	128	51	125	9	0	185
5035	3285s (+0.5s)	1804	1804	128	40	143	4	0	187
5036	3285s (+0.9s)	3768	3768	256	75	224	10	0	309
5037	3286s (+1.0s)	4040	4040	256	75	243	14	0	332
5038	3287s (+0.7s)	2932	2932	256	65	179	10	0	254
5039	3287s (+0.3s)	1016	1016	128	26	82	3	0	111
5040	3288s (+0.3s)	788	788	64	29	71	5	0	105
5041	3289s (+0.8s)	3488	3488	256	64	215	12	0	291
5042	3289s (+0.4s)	1308	1308	128	30	101	5	0	136
5043	3290s (+0.5s)	1780	1780	128	47	122	11	0	180
5044	3290s (+0.3s)	1060	1060	128	20	82	7	1	110
5045	3290s (+0.4s)	1428	1428	128	47	97	3	0	147
5046	3291s (+0.8s)	3632	3632	256	87	188	19	1	295
5047	3292s (+0.8s)	3248	3248	256	54	211	10	0	275
5048	3293s (+0.9s)	3828	3828	256	77	229	11	1	318
5049	3294s (+0.9s)	3912	3912	256	81	220	16	0	317
5050	3294s (+0.6s)	1936	1936	128	56	135	10	1	202
5051	3295s (+0.5s)	1740	1740	128	28	130	4	0	162
5052	3295s (+0.3s)	984	984	64	28	82	5	1	116
5053	3296s (+0.4s)	1184	1184	64	33	106	4	0	143
5054	3296s (+0.5s)	1748	1748	128	36	133	8	0	177
5055	3297s (+0.8s)	3680	3680	256	76	215	11	0	302
5056	3297s (+0.6s)	2476	2476	256	50	158	10	0	218
5057	3298s (+0.9s)	3884	3884	256	75	229	17	0	321
5058	3299s (+0.7s)	2856	2856	256	66	169	17	0	252
5059	3300s (+0.7s)	2760	2760	256	56	165	12	0	233
5060	3300s (+0.6s)	1928	1928	128	43	145	12	0	200
5061	3301s (+1.0s)	4464	4464	256	101	240	21	0	362
5062	3302s (+0.6s)	2304	2304	256	57	133	10	0	200
5063	3303s (+0.5s)	1856	1856	128	34	133	5	1	173
5064	3303s (+0.7s)	2816	2816	256	59	173	8	0	240
5065	3304s (+1.1s)	4476	4476	256	99	259	19	0	377
5066	3305s (+0.3s)	880	880	64	35	75	5	0	115
5067	3305s (+0.5s)	1656	1656	128	33	133	5	0	171
5068	3306s (+0.4s)	1032	1032	64	30	85	7	0	122
5069	3306s (+0.5s)	1504	1504	128	38	117	5	0	160
5070	3307s (+0.9s)	3524	3524	256	72	205	18	0	295
5071	3307s (+0.3s)	1100	1100	128	22	94	2	0	118
5072	3308s (+0.8s)	3428	3428	256	67	211	10	0	288
5073	3309s (+0.8s)	3348	3348	256	67	195	10	2	274
5074	3309s (+0.3s)	888	888	64	33	75	9	0	117
5075	3310s (+0.7s)	3164	3164	256	54	195	9	0	258
5076	3310s (+0.5s)	1696	1696	128	31	138	6	0	175
5077	3311s (+0.9s)	3784	3784	256	74	218	14	0	306
5078	3312s (+0.6s)	2488	2488	256	55	153	5	0	213
5079	3313s (+0.7s)	2720	2720	256	71	150	14	0	235
5080	3313s (+0.9s)	3968	3968	256	77	231	0	18	326
5081	3314s (+0.6s)	2484	2484	256	37	158	0	8	203
5082	3315s (+0.5s)	1788	1788	128	37	137	0	8	182
5083	3315s (+0.8s)	3316	3316	256	60	210	0	11	281
5084	3316s (+0.8s)	3604	3604	256	57	219	0	12	288
5085	3317s (+0.6s)	2516	2516	256	42	164	0	9	215
5086	3317s (+0.5s)	1584	1584	128	34	122	0	7	163
5087	3318s (+0.8s)	3292	3292	256	45	227	0	9	281
5088	3319s (+1.0s)	4120	4120	256	71	243	0	18	332
5089	3320s (+0.4s)	1448	1448	128	30	113	0	7	150
5090	3320s (+0.9s)	4700	4700	512	66	240	0	18	324
5091	3321s (+0.7s)	2824	2824	256	52	184	0	12	248
5092	3322s (+0.6s)	2600	2600	256	45	165	0	15	225
5093	3323s (+0.9s)	3692	3692	256	93	195	16	1	305
5094	3323s (+0.5s)	1800	1800	128	43	135	7	0	185
5095	3324s (+1.0s)	4496	4496	256	101	250	19	0	370
5096	3325s (+0.8s)	2884	2884	128	76	170	22	0	268
5097	3326s (+0.5s)	1856	1856	128	40	137	10	0	187
5098	3326s (+0.8s)	3804	3804	256	81	208	18	0	307
5099	3327s (+1.0s)	4428	4428	256	100	241	23	1	365
Episode	Time	Reward	Score	Highest	L	U	R	D	Steps
5100	3328s (+0.7s)	2940	2940	256	69	178	13	1	261
5101	3329s (+0.6s)	2752	2752	256	56	169	10	1	236
5102	3330s (+0.9s)	3604	3604	256	63	235	9	0	307
5103	3330s (+0.6s)	2324	2324	256	44	151	8	0	203
5104	3331s (+0.5s)	1684	1684	128	38	127	7	0	172
5105	3331s (+0.5s)	1684	1684	128	40	128	5	0	173
5106	3332s (+1.0s)	5324	5324	512	81	273	13	0	367
5107	3333s (+0.4s)	1516	1516	128	33	119	8	0	160
5108	3333s (+0.5s)	1896	1896	128	36	151	5	0	192
5109	3334s (+0.7s)	2496	2496	128	63	153	18	1	235
5110	3335s (+0.8s)	3460	3460	256	74	209	13	0	296
5111	3336s (+0.7s)	2496	2496	128	66	156	12	1	235
5112	3336s (+0.5s)	1644	1644	128	37	122	8	0	167
5113	3337s (+1.1s)	5428	5428	512	87	280	13	1	381
5114	3338s (+0.4s)	1588	1588	128	28	121	0	5	154
5115	3339s (+0.7s)	2424	2424	128	47	171	0	11	229
5116	3339s (+0.7s)	2644	2644	256	45	182	0	4	231
5117	3340s (+0.7s)	2640	2640	256	39	181	0	10	230
5118	3341s (+0.7s)	3076	3076	256	56	186	0	8	250
5119	3341s (+0.5s)	1628	1628	128	36	121	0	7	164
5120	3342s (+0.7s)	3072	3072	256	52	192	0	9	253
5121	3343s (+0.7s)	2872	2872	256	52	186	0	11	249
5122	3343s (+0.9s)	3784	3784	256	67	230	0	15	312
5123	3344s (+0.8s)	3716	3716	256	74	221	0	16	311
5124	3345s (+0.8s)	3436	3436	256	61	211	0	12	284
5125	3346s (+0.7s)	2596	2596	128	61	165	0	14	240
5126	3346s (+0.6s)	2260	2260	128	41	163	0	12	216
5127	3347s (+0.4s)	1404	1404	128	27	108	0	6	141
5128	3347s (+0.6s)	2468	2468	256	45	160	0	5	210
5129	3348s (+0.6s)	2188	2188	128	53	143	10	1	207
5130	3349s (+0.9s)	4104	4104	256	87	241	15	0	343
5131	3349s (+0.3s)	1112	1112	128	27	89	5	0	121
5132	3350s (+0.4s)	1472	1472	128	32	116	5	0	153
5133	3350s (+0.5s)	1796	1796	128	31	152	5	0	188
5134	3351s (+0.5s)	1828	1828	128	39	141	11	0	191
5135	3351s (+0.4s)	1304	1304	128	28	108	6	0	142
5136	3352s (+0.5s)	1660	1660	128	30	134	3	0	167
5137	3353s (+0.8s)	3480	3480	256	76	197	16	0	289
5138	3353s (+0.3s)	672	672	64	19	63	5	0	87
5139	3353s (+0.6s)	2216	2216	128	57	141	10	0	208
5140	3354s (+0.8s)	3080	3080	256	65	185	19	0	269
5141	3355s (+0.6s)	2616	2616	256	48	164	12	0	224
5142	3355s (+0.4s)	1124	1124	64	29	99	5	0	133
5143	3356s (+0.6s)	1912	1912	128	47	143	6	0	196
5144	3356s (+0.7s)	2848	2848	256	52	179	0	13	244
5145	3357s (+0.5s)	1832	1832	128	35	145	0	8	188
5146	3358s (+0.7s)	2780	2780	256	58	161	0	13	232
5147	3358s (+0.7s)	2452	2452	128	53	165	0	10	228
5148	3359s (+0.5s)	1664	1664	128	33	121	0	14	168
5149	3360s (+0.8s)	3328	3328	256	99	170	14	0	283
5150	3361s (+0.9s)	3756	3756	256	61	238	11	0	310
5151	3361s (+0.4s)	1224	1224	128	25	106	3	0	134
5152	3362s (+0.7s)	3104	3104	256	62	179	14	0	255
5153	3362s (+0.5s)	1908	1908	128	41	139	0	10	190
5154	3363s (+0.5s)	1524	1524	128	29	124	0	7	160
5155	3363s (+0.7s)	2764	2764	256	59	164	11	0	234
5156	3364s (+0.5s)	1876	1876	128	57	123	11	1	192
5157	3364s (+0.5s)	1776	1776	128	42	131	6	0	179
5158	3365s (+0.8s)	3512	3512	256	84	195	17	1	297
5159	3366s (+0.5s)	1612	1612	128	37	127	6	0	170
5160	3367s (+0.9s)	4000	4000	256	71	247	11	0	329
5161	3368s (+0.8s)	3260	3260	256	80	177	16	0	273
5162	3368s (+0.5s)	1788	1788	128	42	133	7	0	182
5163	3368s (+0.4s)	1516	1516	128	34	111	6	0	151
5164	3369s (+0.5s)	1724	1724	128	48	115	8	0	171
5165	3370s (+0.9s)	3972	3972	256	95	210	15	1	321
5166	3371s (+0.7s)	2868	2868	256	72	164	13	0	249
5167	3371s (+0.7s)	3176	3176	256	71	178	13	0	262
5168	3372s (+0.4s)	1448	1448	128	34	110	6	0	150
5169	3372s (+0.4s)	1196	1196	128	37	86	8	0	131
5170	3373s (+0.6s)	1964	1964	128	55	142	7	0	204
5171	3373s (+0.4s)	1460	1460	128	44	101	4	0	149
5172	3374s (+1.2s)	6056	6056	512	101	305	26	0	432
5173	3375s (+0.8s)	3636	3636	256	77	201	14	0	292
5174	3376s (+1.0s)	4240	4240	256	92	239	19	0	350
5175	3377s (+0.3s)	880	880	64	23	89	3	0	115
5176	3377s (+0.5s)	1836	1836	128	48	126	12	0	186
5177	3378s (+0.4s)	1460	1460	128	39	106	9	0	154
5178	3378s (+0.7s)	3176	3176	256	62	191	8	0	261
5179	3379s (+0.5s)	1564	1564	128	34	123	5	0	162
5180	3380s (+0.9s)	4160	4160	256	74	228	14	1	317
5181	3380s (+0.6s)	2352	2352	256	47	135	0	14	196
5182	3381s (+0.5s)	1752	1752	128	28	135	0	11	174
5183	3382s (+0.8s)	3468	3468	256	56	229	0	12	297
5184	3383s (+1.0s)	4240	4240	256	74	271	0	12	357
5185	3383s (+0.8s)	3536	3536	256	53	230	0	15	298
5186	3384s (+0.4s)	1528	1528	128	24	126	0	6	156
5187	3384s (+0.5s)	1500	1500	128	40	112	6	0	158
5188	3385s (+1.1s)	5224	5224	512	97	265	17	0	379
5189	3386s (+1.0s)	4180	4180	256	91	242	14	0	347
5190	3387s (+0.4s)	1416	1416	128	47	90	8	1	146
5191	3388s (+0.8s)	3300	3300	256	71	196	9	0	276
5192	3388s (+0.5s)	1764	1764	128	45	127	8	1	181
5193	3389s (+0.9s)	4024	4024	256	106	202	22	0	330
5194	3390s (+0.7s)	2816	2816	256	63	176	8	0	247
5195	3391s (+0.9s)	3960	3960	256	87	222	20	0	329
5196	3392s (+0.8s)	3344	3344	256	85	178	14	0	277
5197	3392s (+0.9s)	3940	3940	256	87	217	19	1	324
5198	3393s (+0.5s)	1532	1532	128	35	123	4	0	162
5199	3394s (+0.9s)	4712	4712	512	88	209	22	0	319
Episode	Time	Reward	Score	Highest	L	U	R	D	Steps
5200	3394s (+0.6s)	2028	2028	128	38	158	13	0	209
5201	3395s (+1.0s)	4180	4180	256	96	229	22	0	347
5202	3396s (+0.5s)	1864	1864	128	52	127	9	1	189
5203	3397s (+0.9s)	3780	3780	256	79	205	17	0	301
5204	3397s (+0.4s)	1084	1084	64	34	90	6	0	130
5205	3398s (+0.8s)	3548	3548	256	90	197	14	0	301
5206	3399s (+0.5s)	1832	1832	128	33	153	6	0	192
5207	3400s (+0.9s)	4004	4004	256	77	234	17	0	328
5208	3400s (+0.7s)	2608	2608	256	58	159	10	0	227
5209	3401s (+1.1s)	5176	5176	512	94	259	19	0	372
5210	3402s (+0.4s)	1308	1308	64	42	97	8	0	147
5211	3402s (+0.5s)	1828	1828	128	37	136	8	0	181
5212	3403s (+0.6s)	2360	2360	128	52	155	11	0	218
5213	3403s (+0.4s)	1512	1512	128	25	126	4	0	155
5214	3404s (+0.4s)	1500	1500	128	43	101	0	8	152
5215	3405s (+0.8s)	3204	3204	256	78	183	10	0	271
5216	3405s (+0.7s)	2720	2720	256	69	155	11	0	235
5217	3406s (+0.8s)	3240	3240	256	64	198	11	0	273
5218	3407s (+0.9s)	3580	3580	256	74	210	17	0	301
5219	3408s (+0.9s)	3748	3748	256	91	203	18	0	312
5220	3408s (+0.4s)	1452	1452	128	32	112	5	0	149
5221	3409s (+0.3s)	1016	1016	64	27	89	4	0	120
5222	3409s (+0.6s)	2508	2508	256	51	158	9	0	218
5223	3410s (+0.5s)	1728	1728	128	51	113	8	1	173
5224	3410s (+0.7s)	3188	3188	256	66	182	16	0	264
5225	3411s (+0.7s)	3128	3128	256	65	184	13	0	262
5226	3412s (+0.5s)	1628	1628	128	42	120	8	0	170
5227	3412s (+0.4s)	1180	1180	64	25	113	4	0	142
5228	3413s (+0.8s)	3532	3532	256	80	198	19	0	297
5229	3413s (+0.2s)	340	340	32	7	48	2	0	57
5230	3414s (+0.9s)	3836	3836	256	67	226	16	1	310
5231	3414s (+0.3s)	920	920	64	22	85	5	0	112
5232	3415s (+0.4s)	1228	1228	128	22	107	5	0	134
5233	3415s (+0.5s)	1724	1724	128	34	132	7	0	173
5234	3416s (+0.5s)	1652	1652	128	31	132	0	12	175
5235	3416s (+0.4s)	1084	1084	64	23	98	0	3	124
5236	3417s (+0.7s)	2912	2912	256	64	182	0	9	255
5237	3417s (+0.6s)	2464	2464	256	34	166	0	9	209
5238	3418s (+0.4s)	1472	1472	128	24	124	0	4	152
5239	3419s (+0.8s)	3236	3236	256	55	204	0	12	271
5240	3419s (+0.4s)	1172	1172	64	27	106	0	7	140
5241	3419s (+0.5s)	1516	1516	128	34	117	0	11	162
5242	3420s (+0.9s)	3968	3968	256	75	234	17	0	326
5243	3421s (+0.6s)	2512	2512	256	53	149	8	0	210
5244	3421s (+0.3s)	1136	1136	128	27	91	4	0	122
5245	3422s (+0.7s)	2888	2888	256	61	170	8	0	239
5246	3423s (+0.8s)	3124	3124	256	75	177	12	0	264
5247	3423s (+0.6s)	2060	2060	128	51	147	8	0	206
5248	3424s (+0.6s)	2320	2320	256	45	147	8	0	200
5249	3424s (+0.4s)	1468	1468	128	28	114	9	0	151
5250	3425s (+0.8s)	3304	3304	256	66	198	13	0	277
5251	3426s (+0.5s)	1924	1924	128	44	131	8	2	185
5252	3426s (+0.7s)	2824	2824	256	74	153	14	0	241
5253	3427s (+1.0s)	4228	4228	256	87	245	15	0	347
5254	3428s (+0.9s)	3580	3580	256	81	211	12	0	304
5255	3429s (+0.7s)	2856	2856	256	64	169	12	0	245
5256	3430s (+0.8s)	2872	2872	128	78	176	14	1	269
5257	3430s (+0.6s)	1960	1960	128	57	131	9	1	198
5258	3431s (+0.6s)	2456	2456	256	49	151	10	0	210
5259	3431s (+0.2s)	528	528	32	31	47	6	0	84
5260	3432s (+0.8s)	3208	3208	256	60	201	8	1	270
5261	3432s (+0.4s)	1164	1164	128	28	91	5	0	124
5262	3433s (+0.6s)	2088	2088	128	54	146	10	0	210
5263	3433s (+0.5s)	1520	1520	128	36	123	5	0	164
5264	3434s (+0.8s)	3252	3252	256	75	179	16	0	270
5265	3434s (+0.3s)	1008	1008	128	34	76	2	0	112
5266	3435s (+0.9s)	3780	3780	256	83	217	16	0	316
5267	3436s (+0.6s)	2492	2492	256	47	162	9	0	218
5268	3437s (+0.6s)	2596	2596	256	63	150	9	2	224
5269	3437s (+0.8s)	3224	3224	256	90	159	16	1	266
5270	3438s (+0.5s)	1496	1496	64	49	102	11	0	162
5271	3439s (+0.7s)	3172	3172	256	69	190	9	0	268
5272	3439s (+0.7s)	2924	2924	256	61	170	12	0	243
5273	3440s (+0.7s)	3056	3056	256	64	175	9	0	248
5274	3440s (+0.4s)	1320	1320	128	22	111	3	0	136
5275	3441s (+0.6s)	2436	2436	256	38	159	10	0	207
5276	3442s (+0.5s)	1792	1792	128	42	128	13	0	183
5277	3442s (+0.5s)	1776	1776	128	48	126	9	0	183
5278	3443s (+0.7s)	2756	2756	256	53	176	8	0	237
5279	3443s (+0.7s)	3132	3132	256	54	195	0	8	257
5280	3444s (+0.8s)	3204	3204	256	52	201	0	13	266
5281	3445s (+0.3s)	1004	1004	128	21	86	0	3	110
5282	3445s (+0.5s)	1700	1700	128	31	133	0	7	171
5283	3446s (+0.6s)	1888	1888	128	39	145	0	8	192
5284	3446s (+0.3s)	760	760	64	15	81	0	3	99
5285	3447s (+0.8s)	3540	3540	256	62	227	0	10	299
5286	3447s (+0.5s)	1804	1804	128	33	133	0	6	172
5287	3448s (+0.5s)	1584	1584	128	36	119	0	9	164
5288	3448s (+0.6s)	2624	2624	256	40	174	0	8	222
5289	3449s (+0.9s)	4032	4032	256	83	235	13	0	331
5290	3450s (+0.8s)	3528	3528	256	93	189	14	0	296
5291	3451s (+0.8s)	3344	3344	256	52	212	9	0	273
5292	3451s (+0.5s)	1768	1768	128	44	123	14	1	182
5293	3452s (+0.4s)	1140	1140	64	36	93	8	0	137
5294	3452s (+0.4s)	1428	1428	64	46	105	6	0	157
5295	3453s (+0.5s)	1856	1856	128	45	134	8	0	187
5296	3454s (+0.9s)	3972	3972	256	88	225	14	0	327
5297	3454s (+0.6s)	2336	2336	256	43	145	8	0	196
5298	3455s (+0.4s)	1368	1368	128	30	107	6	0	143
5299	3455s (+0.4s)	1176	1176	64	37	101	3	0	141
Episode	Time	Reward	Score	Highest	L	U	R	D	Steps
5300	3456s (+0.8s)	3452	3452	256	63	218	13	0	294
5301	3456s (+0.5s)	1632	1632	128	40	119	5	0	164
5302	3457s (+0.3s)	980	980	64	35	76	4	0	115
5303	3458s (+0.9s)	3940	3940	256	81	220	19	0	320
5304	3458s (+0.4s)	1344	1344	128	30	105	4	0	139
5305	3459s (+0.5s)	1788	1788	128	52	110	15	0	177
5306	3459s (+0.7s)	2836	2836	256	53	180	12	0	245
5307	3460s (+0.3s)	1016	1016	64	29	85	8	0	122
5308	3460s (+0.4s)	1420	1420	128	31	105	8	0	144
5309	3461s (+0.5s)	2032	2032	128	57	130	8	0	195
5310	3461s (+0.5s)	1552	1552	128	47	112	8	0	167
5311	3462s (+0.6s)	1936	1936	128	42	150	0	10	202
5312	3462s (+0.5s)	2344	2344	256	49	138	0	8	195
5313	3463s (+0.4s)	1448	1448	128	40	101	0	6	147
5314	3463s (+0.7s)	2812	2812	256	59	175	0	11	245
5315	3464s (+0.5s)	2396	2396	256	46	142	1	9	198
5316	3464s (+0.3s)	980	980	64	31	83	0	7	121
5317	3465s (+0.6s)	2228	2228	128	42	157	0	13	212
5318	3465s (+0.5s)	1748	1748	128	28	127	0	8	163
5319	3466s (+0.3s)	720	720	64	26	64	0	3	93
5320	3466s (+0.7s)	2764	2764	256	47	175	0	14	236
5321	3467s (+0.6s)	2104	2104	128	44	144	0	10	198
5322	3468s (+0.6s)	2532	2532	256	49	162	0	9	220
5323	3468s (+0.3s)	924	924	64	14	93	0	5	112
5324	3468s (+0.6s)	2464	2464	256	50	150	0	12	212
5325	3469s (+0.8s)	3216	3216	256	69	190	0	12	271
5326	3470s (+0.7s)	2940	2940	256	46	192	8	0	246
5327	3470s (+0.2s)	376	376	32	12	46	3	1	62
5328	3471s (+1.0s)	4176	4176	256	104	225	17	0	346
5329	3472s (+0.6s)	1912	1912	128	50	137	10	0	197
5330	3472s (+0.7s)	2772	2772	128	85	164	11	0	260
5331	3473s (+0.3s)	1084	1084	128	33	84	2	0	119
5332	3473s (+0.4s)	1480	1480	128	43	101	10	0	154
5333	3474s (+0.3s)	760	760	64	27	68	7	0	102
5334	3474s (+0.8s)	3352	3352	256	74	195	12	0	281
5335	3475s (+0.7s)	3068	3068	256	64	179	9	0	252
5336	3476s (+0.5s)	2084	2084	128	42	139	12	0	193
5337	3477s (+1.3s)	6180	6180	512	119	291	25	1	436
5338	3477s (+0.3s)	836	836	64	30	73	6	0	109
5339	3478s (+0.6s)	2288	2288	128	75	128	12	0	215
5340	3478s (+0.6s)	2480	2480	256	49	158	9	0	216
5341	3479s (+0.3s)	872	872	64	30	80	4	0	114
5342	3479s (+0.4s)	1556	1556	128	27	125	0	7	159
5343	3480s (+0.6s)	2392	2392	128	45	163	0	14	222
5344	3480s (+0.5s)	1852	1852	128	42	140	0	5	187
5345	3481s (+0.2s)	568	568	64	14	59	0	5	78
5346	3481s (+0.4s)	1252	1252	128	26	100	0	7	133
5347	3482s (+0.8s)	3536	3536	256	59	225	0	14	298
5348	3483s (+0.8s)	3348	3348	256	71	197	15	0	283
5349	3483s (+0.9s)	3872	3872	256	81	226	11	0	318
5350	3484s (+0.4s)	1428	1428	128	35	105	6	0	146
5351	3485s (+0.8s)	3552	3552	256	71	209	11	0	291
5352	3485s (+0.4s)	1296	1296	128	28	107	5	0	140
5353	3486s (+0.6s)	2308	2308	128	72	143	15	1	231
5354	3487s (+0.8s)	2940	2940	256	67	184	10	0	261
5355	3487s (+0.8s)	3672	3672	256	60	231	10	0	301
5356	3489s (+1.3s)	6484	6484	512	117	320	30	0	467
5357	3489s (+0.5s)	1804	1804	128	51	125	10	0	186
5358	3490s (+0.5s)	1628	1628	128	45	110	9	0	164
5359	3491s (+0.7s)	2796	2796	256	53	179	10	0	242
5360	3491s (+0.5s)	1876	1876	128	49	132	11	0	192
5361	3492s (+0.9s)	3740	3740	256	81	223	12	0	316
5362	3493s (+1.1s)	5724	5724	512	96	287	21	0	404
5363	3494s (+0.5s)	1620	1620	128	49	116	7	0	172
5364	3494s (+0.6s)	2576	2576	256	55	152	13	0	220
5365	3495s (+0.8s)	3348	3348	256	69	196	18	0	283
5366	3496s (+0.4s)	1180	1180	64	45	88	9	0	142
5367	3496s (+0.7s)	2512	2512	128	51	174	14	0	239
5368	3497s (+0.4s)	1360	1360	128	26	115	1	0	142
5369	3497s (+0.5s)	2104	2104	128	44	147	6	1	198
5370	3498s (+0.5s)	1880	1880	128	48	134	12	0	194
5371	3498s (+0.5s)	1828	1828	128	47	136	8	0	191
5372	3499s (+0.2s)	488	488	32	12	64	2	0	78
5373	3499s (+0.5s)	1900	1900	128	41	138	11	0	190
5374	3500s (+0.9s)	3620	3620	256	83	207	17	0	307
5375	3501s (+0.9s)	3832	3832	256	52	239	0	18	309
5376	3501s (+0.2s)	416	416	32	10	50	0	9	69
5377	3502s (+0.8s)	3244	3244	256	54	207	0	12	273
5378	3503s (+0.9s)	3832	3832	256	76	219	14	0	309
5379	3504s (+0.8s)	3552	3552	256	77	216	9	0	302
5380	3504s (+0.5s)	1788	1788	128	42	134	6	0	182
5381	3505s (+0.5s)	1800	1800	128	42	134	10	0	186
5382	3505s (+0.6s)	2420	2420	256	45	150	8	0	203
5383	3506s (+1.3s)	6464	6464	512	126	302	30	0	458
5384	3507s (+0.9s)	3980	3980	256	85	229	15	0	329
5385	3508s (+0.9s)	3896	3896	256	73	226	14	1	314
5386	3509s (+0.4s)	1420	1420	128	31	112	7	0	150
5387	3509s (+0.7s)	3176	3176	256	61	194	7	0	262
5388	3510s (+0.6s)	2636	2636	256	48	166	10	0	224
5389	3511s (+0.5s)	1516	1516	128	43	111	7	0	161
5390	3511s (+0.5s)	2156	2156	256	47	126	10	0	183
5391	3512s (+0.5s)	2088	2088	256	49	117	9	0	175
5392	3512s (+0.4s)	1264	1264	128	32	89	6	0	127
5393	3513s (+0.7s)	3016	3016	256	56	178	16	0	250
5394	3513s (+0.5s)	1824	1824	128	43	142	2	0	187
5395	3514s (+0.8s)	3312	3312	256	85	170	20	0	275
5396	3515s (+0.6s)	1916	1916	128	65	120	13	0	198
5397	3515s (+0.6s)	2724	2724	256	59	161	9	1	230
5398	3516s (+0.3s)	752	752	64	23	75	2	0	100
5399	3516s (+0.8s)	3360	3360	256	59	215	12	0	286
Episode	Time	Reward	Score	Highest	L	U	R	D	Steps
5400	3517s (+0.3s)	872	872	64	25	84	5	0	114
5401	3517s (+0.4s)	1552	1552	128	27	125	3	0	155
5402	3518s (+0.5s)	1900	1900	128	47	130	13	0	190
5403	3518s (+0.6s)	2160	2160	128	74	132	13	0	219
5404	3519s (+0.5s)	2188	2188	256	40	138	7	0	185
5405	3520s (+0.7s)	3096	3096	256	68	178	0	11	257
5406	3520s (+0.5s)	1616	1616	128	34	130	0	7	171
5407	3521s (+0.6s)	1932	1932	128	37	157	0	7	201
5408	3521s (+0.8s)	3252	3252	256	62	194	0	15	271
5409	3522s (+0.3s)	1032	1032	64	13	106	4	0	123
5410	3522s (+0.5s)	2248	2248	256	50	131	10	0	191
5411	3523s (+0.5s)	1636	1636	128	39	120	6	0	165
5412	3524s (+0.7s)	3332	3332	256	58	198	13	0	269
5413	3524s (+0.5s)	1672	1672	128	36	128	9	1	174
5414	3525s (+0.9s)	4188	4188	256	102	213	24	0	339
5415	3525s (+0.4s)	1396	1396	128	45	90	7	1	143
5416	3526s (+0.4s)	1432	1432	128	39	96	11	1	147
5417	3526s (+0.4s)	1484	1484	128	42	103	10	0	155
5418	3527s (+0.4s)	1188	1188	64	32	106	6	0	144
5419	3527s (+0.7s)	2780	2780	256	65	163	10	1	239
5420	3528s (+0.7s)	3236	3236	256	63	200	9	0	272
5421	3529s (+0.9s)	4040	4040	256	92	200	21	1	314
5422	3530s (+1.0s)	4284	4284	256	90	242	18	0	350
5423	3531s (+0.5s)	1676	1676	128	37	116	0	14	167
5424	3531s (+0.7s)	2908	2908	256	55	175	10	0	240
5425	3532s (+0.8s)	3312	3312	256	60	206	12	1	279
5426	3533s (+0.6s)	2652	2652	256	61	152	13	0	226
5427	3533s (+0.5s)	1912	1912	128	44	139	10	0	193
5428	3534s (+0.4s)	1160	1160	64	34	98	5	0	137
5429	3535s (+1.4s)	6876	6876	512	137	327	31	2	497
5430	3536s (+0.8s)	3136	3136	256	70	188	13	0	271
5431	3537s (+0.6s)	2588	2588	256	57	153	10	2	222
5432	3537s (+0.3s)	996	996	128	19	83	5	0	107
5433	3538s (+0.7s)	3084	3084	256	59	196	0	10	265
5434	3539s (+1.1s)	6020	6020	512	95	299	20	0	414
5435	3539s (+0.6s)	1900	1900	128	57	129	8	0	194
5436	3540s (+0.5s)	1820	1820	128	42	142	5	0	189
5437	3541s (+0.5s)	1776	1776	128	51	119	12	1	183
5438	3542s (+1.0s)	4332	4332	256	98	239	24	0	361
5439	3542s (+0.7s)	2728	2728	256	59	168	7	0	234
5440	3543s (+0.9s)	3716	3716	256	60	228	0	18	306
5441	3544s (+0.7s)	2656	2656	128	44	196	0	15	255
5442	3545s (+0.7s)	2796	2796	256	58	173	0	11	242
5443	3545s (+0.5s)	1608	1608	128	51	106	12	0	169
5444	3546s (+0.7s)	2960	2960	256	50	186	11	0	247
5445	3546s (+0.3s)	972	972	64	33	84	5	0	122
5446	3547s (+0.4s)	1356	1356	128	43	101	6	0	150
5447	3547s (+0.3s)	700	700	64	26	60	7	0	93
5448	3547s (+0.6s)	2548	2548	256	51	167	6	0	224
5449	3548s (+0.7s)	2988	2988	256	81	166	14	0	261
5450	3549s (+0.7s)	3144	3144	256	72	180	9	0	261
5451	3550s (+0.7s)	2924	2924	256	72	171	14	0	257
5452	3550s (+0.3s)	1184	1184	128	19	99	3	0	121
5453	3551s (+0.6s)	1972	1972	128	49	141	10	0	200
5454	3551s (+0.3s)	804	804	64	24	75	2	0	101
5455	3552s (+0.8s)	3444	3444	256	54	222	13	0	289
5456	3552s (+0.3s)	1016	1016	64	25	88	0	6	119
5457	3552s (+0.3s)	736	736	64	16	75	0	6	97
5458	3553s (+0.4s)	1544	1544	128	27	123	0	5	155
5459	3553s (+0.6s)	2720	2720	256	51	174	5	0	230
5460	3554s (+1.0s)	4876	4876	512	81	245	20	0	346
5461	3555s (+0.8s)	3264	3264	256	65	200	13	0	278
5462	3556s (+0.4s)	1248	1248	128	37	88	7	0	132
5463	3556s (+0.8s)	3228	3228	256	59	198	11	2	270
5464	3557s (+0.5s)	1660	1660	128	50	117	8	0	175
5465	3558s (+0.9s)	3968	3968	256	77	224	15	0	316
5466	3559s (+1.0s)	4536	4536	256	98	260	18	0	376
5467	3560s (+0.8s)	3336	3336	256	76	191	22	0	289
5468	3560s (+0.5s)	1624	1624	128	41	113	8	0	162
5469	3561s (+0.9s)	3756	3756	256	82	213	15	0	310
5470	3562s (+1.2s)	6104	6104	512	133	275	31	0	439
5471	3563s (+1.0s)	5476	5476	512	101	261	23	0	385
5472	3565s (+1.3s)	6600	6600	512	144	306	30	0	480
5473	3565s (+0.4s)	1408	1408	128	39	103	6	0	148
5474	3566s (+0.3s)	684	684	64	15	70	5	0	90
5475	3566s (+0.5s)	1788	1788	128	52	123	10	0	185
5476	3567s (+0.8s)	3488	3488	256	64	219	9	0	292
5477	3568s (+0.8s)	3476	3476	256	82	197	16	0	295
5478	3569s (+0.7s)	3148	3148	256	65	196	12	0	273
5479	3569s (+0.7s)	2716	2716	256	45	178	9	0	232
5480	3570s (+0.5s)	1504	1504	128	46	104	9	0	159
5481	3571s (+0.9s)	4044	4044	256	79	239	15	0	333
5482	3571s (+0.5s)	1916	1916	128	47	143	7	0	197
5483	3572s (+0.6s)	1916	1916	128	41	145	11	0	197
5484	3572s (+0.5s)	1652	1652	128	38	123	5	0	166
5485	3573s (+1.1s)	4580	4580	256	85	264	25	1	375
5486	3574s (+0.3s)	1124	1124	128	26	89	4	0	119
5487	3574s (+0.3s)	756	756	64	17	82	1	0	100
5488	3575s (+0.6s)	2240	2240	128	58	143	13	0	214
5489	3575s (+0.4s)	1400	1400	64	38	111	8	1	158
5490	3576s (+1.3s)	6404	6404	512	122	307	20	0	449
5491	3577s (+0.9s)	3584	3584	256	71	212	17	0	300
5492	3578s (+0.4s)	1060	1060	64	32	90	6	0	128
5493	3578s (+0.6s)	2548	2548	256	49	169	5	0	223
5494	3579s (+0.8s)	3256	3256	256	82	180	15	0	277
5495	3579s (+0.5s)	1724	1724	128	48	121	6	0	175
5496	3580s (+0.6s)	2680	2680	256	41	176	0	6	223
5497	3581s (+0.5s)	1836	1836	128	39	140	0	10	189
5498	3581s (+0.4s)	1468	1468	128	29	114	0	9	152
5499	3582s (+0.5s)	1784	1784	128	34	142	0	6	182
Episode	Time	Reward	Score	Highest	L	U	R	D	Steps
5500	3583s (+0.9s)	3740	3740	256	62	234	0	10	306
5501	3583s (+0.8s)	3356	3356	256	54	207	0	11	272
5502	3584s (+0.7s)	2636	2636	128	45	186	0	12	243
5503	3584s (+0.3s)	684	684	64	17	69	0	3	89
5504	3585s (+0.6s)	2060	2060	128	45	146	0	11	202
5505	3586s (+0.8s)	3536	3536	256	57	226	0	15	298
5506	3586s (+0.4s)	1032	1032	64	32	84	0	6	122
5507	3586s (+0.2s)	504	504	64	11	57	3	1	72
5508	3587s (+0.8s)	3252	3252	256	68	187	13	1	269
5509	3588s (+0.8s)	3308	3308	256	78	178	22	0	278
5510	3588s (+0.6s)	2472	2472	256	55	151	7	1	214
5511	3589s (+0.6s)	2060	2060	128	49	148	9	0	206
5512	3589s (+0.5s)	1624	1624	128	53	111	8	0	172
5513	3590s (+0.8s)	3328	3328	256	57	203	13	1	274
5514	3591s (+0.7s)	2476	2476	128	64	152	14	0	230
5515	3591s (+0.3s)	908	908	64	32	81	5	0	118
5516	3592s (+1.0s)	4192	4192	256	92	240	18	0	350
5517	3593s (+0.6s)	2720	2720	256	66	147	15	0	228
5518	3594s (+0.7s)	2632	2632	256	45	177	0	10	232
5519	3594s (+0.5s)	1812	1812	128	33	148	0	7	188
5520	3594s (+0.3s)	780	780	64	27	73	0	3	103
5521	3595s (+0.6s)	2596	2596	256	46	168	0	10	224
5522	3596s (+0.6s)	2108	2108	128	43	137	1	15	196
5523	3596s (+0.3s)	1024	1024	64	30	84	0	7	121
5524	3597s (+0.8s)	3308	3308	256	60	207	0	8	275
5525	3597s (+0.7s)	2908	2908	256	61	182	10	0	253
5526	3598s (+0.8s)	3268	3268	256	62	208	9	0	279
5527	3599s (+0.6s)	2204	2204	128	57	139	10	0	206
5528	3599s (+0.3s)	760	760	64	26	71	5	0	102
5529	3600s (+0.7s)	3052	3052	256	55	182	11	0	248
5530	3601s (+0.7s)	3152	3152	256	86	160	10	0	256
5531	3602s (+0.9s)	3884	3884	256	103	212	14	0	329
5532	3602s (+0.4s)	1016	1016	64	20	96	6	1	123
5533	3603s (+0.5s)	1840	1840	128	42	142	3	0	187
5534	3603s (+0.7s)	2868	2868	256	61	173	13	0	247
5535	3604s (+1.2s)	5972	5972	512	117	280	23	0	420
5536	3605s (+0.6s)	2684	2684	256	55	163	12	0	230
5537	3605s (+0.3s)	880	880	64	23	85	7	0	115
5538	3606s (+0.7s)	3008	3008	256	71	173	11	1	256
5539	3607s (+0.6s)	2488	2488	256	43	161	10	0	214
5540	3608s (+1.2s)	5812	5812	512	107	292	20	0	419
5541	3609s (+0.7s)	2780	2780	256	58	172	12	0	242
5542	3609s (+0.3s)	592	592	32	21	66	4	1	92
5543	3609s (+0.5s)	1760	1760	128	47	132	7	0	186
5544	3610s (+0.5s)	1712	1712	128	45	117	12	0	174
5545	3611s (+0.9s)	3620	3620	256	82	206	12	0	300
5546	3612s (+0.9s)	4720	4720	512	70	249	10	1	330
5547	3612s (+0.4s)	1316	1316	128	28	99	5	0	132
5548	3613s (+0.8s)	3580	3580	256	70	212	15	0	297
5549	3613s (+0.5s)	1640	1640	128	33	121	9	0	163
5550	3614s (+0.5s)	1572	1572	128	46	109	6	0	161
5551	3615s (+0.7s)	2552	2552	128	51	170	16	1	238
5552	3616s (+1.0s)	4252	4252	256	78	263	12	0	353
5553	3616s (+0.6s)	2044	2044	128	49	141	16	0	206
5554	3617s (+0.7s)	2776	2776	256	61	169	0	7	237
5555	3617s (+0.6s)	2444	2444	256	44	155	0	9	208
5556	3618s (+0.7s)	2492	2492	128	51	169	0	14	234
5557	3619s (+0.5s)	1760	1760	128	43	121	0	6	170
5558	3619s (+0.7s)	3056	3056	256	52	192	0	15	259
5559	3620s (+0.2s)	648	648	64	13	68	0	3	84
5560	3620s (+0.5s)	1736	1736	128	29	141	0	4	174
5561	3620s (+0.4s)	1052	1052	64	22	98	0	7	127
5562	3621s (+0.7s)	3044	3044	256	52	191	0	8	251
5563	3622s (+0.4s)	1312	1312	128	29	97	0	8	134
5564	3622s (+0.6s)	2436	2436	256	44	146	0	13	203
5565	3623s (+0.4s)	1488	1488	128	22	127	0	7	156
5566	3623s (+0.3s)	908	908	64	23	82	0	7	112
5567	3624s (+0.6s)	2504	2504	256	45	164	0	8	217
5568	3624s (+0.4s)	1364	1364	128	23	112	0	7	142
5569	3625s (+1.0s)	5056	5056	512	99	240	19	0	358
5570	3626s (+0.8s)	3264	3264	256	63	195	14	0	272
5571	3626s (+0.5s)	1496	1496	128	34	115	8	0	157
5572	3627s (+0.4s)	1388	1388	128	39	98	9	1	147
5573	3627s (+0.8s)	3400	3400	256	70	193	17	0	280
5574	3628s (+0.8s)	3520	3520	256	73	216	10	0	299
5575	3629s (+0.4s)	1384	1384	128	29	106	6	0	141
5576	3630s (+0.8s)	3304	3304	256	60	205	13	1	279
5577	3630s (+0.7s)	2924	2924	256	62	184	11	0	257
5578	3631s (+0.4s)	1204	1204	128	35	96	2	0	133
5579	3631s (+0.5s)	1716	1716	128	48	121	7	0	176
5580	3631s (+0.2s)	604	604	64	23	57	4	0	84
5581	3632s (+0.5s)	1924	1924	128	41	135	8	1	185
5582	3633s (+0.7s)	2932	2932	256	55	177	12	0	244
5583	3633s (+0.4s)	1260	1260	64	43	97	5	1	146
5584	3633s (+0.3s)	940	940	64	31	77	7	0	115
5585	3634s (+0.7s)	2576	2576	128	74	152	13	1	240
5586	3635s (+0.7s)	3184	3184	256	59	192	12	0	263
5587	3635s (+0.4s)	1412	1412	128	44	103	7	0	154
5588	3636s (+0.8s)	3252	3252	256	62	205	9	0	276
5589	3637s (+0.8s)	3336	3336	256	79	196	10	0	285
5590	3637s (+0.5s)	1524	1524	128	45	109	6	0	160
5591	3638s (+0.8s)	3196	3196	256	80	168	16	0	264
5592	3638s (+0.4s)	936	936	64	36	83	5	0	124
5593	3639s (+0.4s)	1488	1488	128	29	123	5	0	157
5594	3639s (+0.5s)	1744	1744	128	42	124	0	10	176
5595	3640s (+0.5s)	1708	1708	128	29	139	0	6	174
5596	3640s (+0.2s)	340	340	32	14	47	0	1	62
5597	3641s (+0.5s)	1692	1692	128	26	135	0	7	168
5598	3641s (+0.9s)	3800	3800	256	100	207	13	0	320
5599	3642s (+0.8s)	3176	3176	256	57	196	9	1	263
Episode	Time	Reward	Score	Highest	L	U	R	D	Steps
5600	3643s (+1.0s)	4312	4312	256	87	251	18	0	356
5601	3644s (+0.5s)	1808	1808	128	43	131	13	0	187
5602	3644s (+0.7s)	3128	3128	256	62	188	7	0	257
5603	3645s (+0.3s)	708	708	64	21	72	1	0	94
5604	3646s (+0.8s)	3224	3224	256	67	191	11	0	269
5605	3646s (+0.8s)	3472	3472	256	61	210	17	0	288
5606	3647s (+0.4s)	1056	1056	64	36	83	8	0	127
5607	3648s (+0.8s)	3664	3664	256	78	213	8	0	299
5608	3648s (+0.3s)	924	924	64	34	85	2	0	121
5609	3648s (+0.6s)	2376	2376	256	54	135	8	0	197
5610	3650s (+1.1s)	5760	5760	512	112	281	19	0	412
5611	3651s (+1.0s)	4296	4296	256	100	235	16	1	352
5612	3651s (+0.5s)	1632	1632	128	33	120	11	0	164
5613	3652s (+0.6s)	1920	1920	128	43	147	8	0	198
5614	3652s (+0.5s)	2088	2088	256	31	139	9	0	179
5615	3653s (+0.4s)	1184	1184	64	24	99	9	1	133
5616	3653s (+0.7s)	3136	3136	256	61	189	14	0	264
5617	3654s (+0.7s)	2920	2920	256	58	185	13	0	256
5618	3655s (+0.5s)	1600	1600	128	35	121	7	0	163
5619	3655s (+0.5s)	1532	1532	128	40	116	6	0	162
5620	3656s (+0.5s)	1752	1752	128	48	123	7	0	178
5621	3656s (+0.5s)	1664	1664	128	51	120	7	0	178
5622	3657s (+0.9s)	3564	3564	256	81	207	12	0	300
5623	3657s (+0.5s)	1876	1876	128	49	130	0	9	188
5624	3658s (+0.6s)	1960	1960	128	46	147	0	10	203
5625	3658s (+0.4s)	1204	1204	128	22	101	0	7	130
5626	3659s (+0.5s)	1904	1904	128	31	150	0	6	187
5627	3659s (+0.4s)	1084	1084	64	29	97	0	4	130
5628	3660s (+0.9s)	3804	3804	256	53	252	0	12	317
5629	3661s (+0.5s)	1768	1768	128	39	127	0	12	178
5630	3661s (+0.7s)	2708	2708	256	45	179	0	6	230
5631	3662s (+0.5s)	1836	1836	128	36	142	0	6	184
5632	3662s (+0.5s)	1656	1656	128	34	134	0	8	176
5633	3663s (+0.2s)	516	516	32	15	58	4	1	78
5634	3663s (+0.6s)	2600	2600	256	50	165	7	0	222
5635	3664s (+0.6s)	2516	2516	256	53	154	13	0	220
5636	3665s (+0.7s)	2896	2896	256	79	159	13	0	251
5637	3665s (+0.7s)	2792	2792	256	76	147	18	0	241
5638	3666s (+0.5s)	1904	1904	128	46	141	7	0	194
5639	3666s (+0.6s)	1928	1928	128	56	133	12	0	201
5640	3667s (+0.8s)	3412	3412	256	74	196	14	0	284
5641	3668s (+0.7s)	2552	2552	128	60	164	13	1	238
5642	3668s (+0.5s)	2128	2128	256	39	135	9	1	184
5643	3669s (+0.4s)	1024	1024	64	27	92	5	0	124
5644	3669s (+0.7s)	2804	2804	256	60	175	9	0	244
5645	3670s (+1.0s)	4172	4172	256	94	231	20	0	345
5646	3671s (+0.8s)	3688	3688	256	87	203	19	0	309
5647	3672s (+0.6s)	2776	2776	256	48	171	11	0	230
5648	3672s (+0.5s)	1684	1684	128	44	127	2	0	173
5649	3673s (+0.5s)	1804	1804	128	46	127	6	0	179
5650	3674s (+0.7s)	2988	2988	256	70	171	10	0	251
5651	3674s (+0.5s)	1548	1548	128	40	120	0	5	165
5652	3675s (+0.5s)	1816	1816	128	30	150	0	4	184
5653	3675s (+0.4s)	1428	1428	128	27	111	0	8	146
5654	3676s (+0.6s)	2572	2572	256	48	169	0	12	229
5655	3677s (+0.8s)	3496	3496	256	66	214	0	13	293
5656	3677s (+0.6s)	2508	2508	256	45	156	0	12	213
5657	3678s (+0.4s)	1452	1452	128	27	115	0	10	152
5658	3678s (+0.8s)	3480	3480	256	56	228	0	11	295
5659	3679s (+0.7s)	2988	2988	256	57	178	0	9	244
5660	3680s (+0.4s)	1184	1184	64	33	90	0	11	134
5661	3680s (+0.4s)	1320	1320	128	24	110	0	2	136
5662	3681s (+0.7s)	3108	3108	256	52	189	0	9	250
5663	3681s (+0.5s)	1828	1828	128	32	146	0	8	186
5664	3682s (+0.7s)	2776	2776	256	60	169	0	8	237
5665	3683s (+0.7s)	2908	2908	256	67	177	9	0	253
5666	3683s (+0.5s)	1828	1828	128	40	146	6	0	192
5667	3684s (+0.8s)	3532	3532	256	70	199	14	0	283
5668	3685s (+0.8s)	3400	3400	256	71	197	14	0	282
5669	3685s (+0.6s)	1912	1912	128	44	147	5	0	196
5670	3686s (+0.9s)	4084	4084	256	96	216	16	0	328
5671	3687s (+0.9s)	4124	4124	256	81	240	11	1	333
5672	3688s (+0.4s)	1276	1276	64	40	101	8	0	149
5673	3688s (+0.4s)	1512	1512	128	26	126	4	1	157
5674	3689s (+0.5s)	1776	1776	128	45	130	9	0	184
5675	3689s (+0.5s)	1800	1800	128	50	127	8	0	185
5676	3690s (+0.7s)	3116	3116	256	57	189	13	0	259
5677	3691s (+0.6s)	2756	2756	256	55	171	11	0	237
5678	3691s (+0.7s)	2804	2804	256	56	180	7	0	243
5679	3692s (+0.5s)	1792	1792	128	42	131	0	10	183
5680	3692s (+0.2s)	584	584	64	10	65	1	2	78
5681	3693s (+0.5s)	1796	1796	128	43	135	0	6	184
5682	3693s (+0.6s)	2544	2544	256	50	167	0	6	223
5683	3694s (+0.4s)	1152	1152	64	30	94	0	11	135
5684	3694s (+0.7s)	2904	2904	256	55	183	0	14	252
5685	3695s (+0.7s)	2704	2704	256	42	181	0	12	235
5686	3696s (+0.6s)	2356	2356	128	34	173	0	15	222
5687	3696s (+0.6s)	2520	2520	256	42	160	0	13	215
5688	3697s (+1.0s)	4000	4000	256	81	239	13	1	334
5689	3698s (+0.5s)	1836	1836	128	48	118	8	1	175
5690	3699s (+0.8s)	3276	3276	256	64	199	15	0	278
5691	3699s (+0.8s)	3552	3552	256	79	204	13	0	296
5692	3700s (+0.5s)	1732	1732	128	46	118	11	0	175
5693	3701s (+0.8s)	3544	3544	256	88	193	12	0	293
5694	3702s (+0.8s)	3536	3536	256	70	219	9	0	298
5695	3702s (+0.5s)	1652	1652	128	45	125	5	0	175
5696	3703s (+0.5s)	2060	2060	256	44	124	5	0	173
5697	3703s (+0.7s)	2664	2664	256	43	175	9	0	227
5698	3704s (+0.4s)	1228	1228	128	25	107	3	0	135
5699	3704s (+0.5s)	1624	1624	128	48	118	7	0	173
Episode	Time	Reward	Score	Highest	L	U	R	D	Steps
5700	3705s (+0.8s)	3392	3392	256	75	196	12	0	283
5701	3706s (+0.8s)	3272	3272	256	60	212	9	0	281
5702	3707s (+0.9s)	4704	4704	512	79	231	17	0	327
5703	3707s (+0.7s)	2800	2800	256	60	169	14	0	243
5704	3708s (+0.5s)	1772	1772	128	45	124	10	0	179
5705	3708s (+0.5s)	1696	1696	128	33	130	6	0	169
5706	3709s (+0.4s)	1436	1436	128	41	105	8	0	154
5707	3710s (+0.8s)	3432	3432	256	62	210	9	0	281
5708	3710s (+0.5s)	1664	1664	128	42	121	5	0	168
5709	3711s (+1.0s)	4316	4316	256	79	263	15	0	357
5710	3711s (+0.4s)	1124	1124	128	34	84	7	0	125
5711	3712s (+0.5s)	1528	1528	128	35	122	2	2	161
5712	3713s (+0.7s)	3212	3212	256	59	189	8	0	256
5713	3713s (+0.5s)	1568	1568	128	35	119	9	0	163
5714	3714s (+0.9s)	3604	3604	256	81	213	16	0	310
5715	3715s (+1.0s)	4256	4256	256	95	236	20	0	351
5716	3715s (+0.4s)	1128	1128	128	21	99	5	1	126
5717	3716s (+0.4s)	1144	1144	64	32	97	8	0	137
5718	3717s (+0.9s)	4968	4968	512	86	222	19	1	328
5719	3717s (+0.5s)	1820	1820	128	39	144	7	0	190
5720	3718s (+0.5s)	1508	1508	128	30	124	5	0	159
5721	3718s (+0.5s)	1628	1628	128	36	121	3	0	160
5722	3719s (+0.5s)	1656	1656	128	40	127	0	9	176
5723	3719s (+0.3s)	1048	1048	128	25	82	0	5	112
5724	3719s (+0.5s)	1936	1936	128	39	131	0	12	182
5725	3720s (+0.5s)	1732	1732	128	39	125	0	9	173
5726	3721s (+0.7s)	2832	2832	256	52	186	0	9	247
5727	3721s (+0.8s)	3404	3404	256	62	208	0	13	283
5728	3722s (+0.4s)	1036	1036	64	26	94	3	0	123
5729	3722s (+0.3s)	1016	1016	128	20	84	4	0	108
5730	3722s (+0.3s)	788	788	64	28	72	5	0	105
5731	3723s (+0.3s)	548	548	32	19	67	2	1	89
5732	3723s (+0.5s)	1572	1572	128	38	119	7	0	164
5733	3724s (+0.5s)	1832	1832	128	43	129	7	1	180
5734	3724s (+0.8s)	3200	3200	256	73	184	10	0	267
5735	3725s (+0.7s)	2476	2476	128	57	157	16	0	230
5736	3726s (+0.5s)	2264	2264	256	53	126	12	0	191
5737	3726s (+0.6s)	2740	2740	256	54	169	7	0	230
5738	3727s (+0.5s)	2192	2192	256	33	147	4	0	184
5739	3727s (+0.4s)	1484	1484	128	30	119	7	0	156
5740	3728s (+0.7s)	2968	2968	256	59	182	12	0	253
5741	3729s (+0.5s)	1680	1680	128	38	125	9	0	172
5742	3729s (+0.7s)	3052	3052	256	57	184	7	0	248
5743	3730s (+1.1s)	4508	4508	256	95	261	18	0	374
5744	3731s (+0.6s)	1940	1940	128	56	134	7	0	197
5745	3732s (+0.7s)	3028	3028	256	56	186	9	1	252
5746	3733s (+1.0s)	5364	5364	512	80	278	0	14	372
5747	3733s (+0.5s)	1688	1688	128	27	131	0	9	167
5748	3733s (+0.2s)	476	476	64	18	49	2	0	69
5749	3734s (+0.7s)	3072	3072	256	48	187	8	0	243
5750	3735s (+0.9s)	4012	4012	256	104	207	19	0	330
5751	3736s (+0.7s)	3028	3028	256	74	169	6	0	249
5752	3736s (+0.5s)	1660	1660	128	44	117	7	0	168
5753	3737s (+0.6s)	2396	2396	256	40	159	8	0	207
5754	3737s (+0.6s)	2588	2588	256	53	161	8	0	222
5755	3738s (+0.7s)	3116	3116	256	55	188	15	0	258
5756	3738s (+0.3s)	760	760	64	16	83	3	0	102
5757	3739s (+0.9s)	3700	3700	256	72	225	0	15	312
5758	3740s (+0.5s)	1892	1892	128	45	138	0	9	192
5759	3740s (+0.3s)	1096	1096	128	26	85	0	5	116
5760	3741s (+0.3s)	1020	1020	64	21	94	0	6	121
5761	3741s (+0.5s)	1580	1580	128	38	124	0	5	167
5762	3741s (+0.3s)	752	752	64	26	70	4	0	100
5763	3742s (+0.7s)	2692	2692	256	47	178	8	0	233
5764	3742s (+0.3s)	752	752	64	21	77	3	0	101
5765	3743s (+0.8s)	3296	3296	256	83	178	11	0	272
5766	3744s (+0.6s)	2328	2328	256	60	130	9	0	199
5767	3745s (+0.9s)	3932	3932	256	84	227	11	0	322
5768	3745s (+0.5s)	1788	1788	128	43	131	8	1	183
5769	3746s (+0.7s)	3224	3224	256	58	202	0	9	269
5770	3747s (+0.7s)	3168	3168	256	53	197	0	17	267
5771	3747s (+0.4s)	1212	1212	64	25	114	0	6	145
5772	3747s (+0.3s)	980	980	64	25	93	0	3	121
5773	3748s (+0.9s)	3696	3696	256	66	228	0	17	311
5774	3749s (+0.3s)	1000	1000	64	30	83	0	6	119
5775	3749s (+0.5s)	1648	1648	128	37	124	0	7	168
5776	3750s (+0.9s)	4624	4624	512	77	221	18	0	316
5777	3750s (+0.6s)	2444	2444	256	50	141	7	0	198
5778	3751s (+0.6s)	2648	2648	256	60	150	12	0	222
5779	3752s (+0.4s)	1472	1472	128	41	109	8	0	158
5780	3752s (+0.4s)	1468	1468	128	32	116	6	0	154
5781	3753s (+0.8s)	3408	3408	256	69	212	12	0	293
5782	3754s (+0.8s)	3316	3316	256	76	190	14	0	280
5783	3754s (+0.4s)	1356	1356	128	44	100	6	0	150
5784	3754s (+0.3s)	732	732	64	14	78	4	0	96
5785	3755s (+0.3s)	736	736	64	22	75	0	0	97
5786	3755s (+0.8s)	3464	3464	256	74	201	15	0	290
5787	3756s (+0.4s)	1028	1028	64	26	93	5	1	125
5788	3756s (+0.4s)	1196	1196	128	21	106	0	5	132
5789	3757s (+0.4s)	1516	1516	128	35	110	0	8	153
5790	3757s (+0.7s)	2624	2624	256	45	174	0	11	230
5791	3758s (+0.8s)	3484	3484	256	62	213	15	0	290
5792	3759s (+0.4s)	1408	1408	128	38	103	7	0	148
5793	3759s (+0.6s)	2596	2596	256	56	160	8	0	224
5794	3760s (+0.7s)	3280	3280	256	54	211	6	0	271
5795	3761s (+0.6s)	2408	2408	128	61	151	0	13	225
5796	3761s (+0.2s)	292	292	32	12	41	2	0	55
5797	3761s (+0.5s)	1752	1752	128	41	128	8	1	178
5798	3762s (+0.5s)	1784	1784	128	42	132	0	7	181
5799	3762s (+0.6s)	2484	2484	256	36	166	10	1	213
Episode	Time	Reward	Score	Highest	L	U	R	D	Steps
5800	3763s (+0.3s)	992	992	64	27	84	6	0	117
5801	3763s (+0.3s)	868	868	64	24	84	5	0	113
5802	3764s (+0.7s)	2812	2812	256	49	187	0	10	246
5803	3764s (+0.4s)	1528	1528	128	44	112	0	5	161
5804	3765s (+0.3s)	856	856	64	20	83	0	6	109
5805	3765s (+0.4s)	1368	1368	128	33	97	0	7	137
5806	3765s (+0.5s)	1884	1884	128	49	128	13	0	190
5807	3766s (+0.6s)	2616	2616	256	59	148	12	0	219
5808	3767s (+0.9s)	4076	4076	256	75	240	16	0	331
5809	3767s (+0.4s)	1308	1308	128	38	97	8	0	143
5810	3768s (+1.0s)	4244	4244	256	95	237	19	0	351
5811	3770s (+1.2s)	5800	5800	512	103	288	25	0	416
5812	3770s (+0.5s)	1608	1608	128	52	113	4	0	169
5813	3771s (+0.4s)	1536	1536	128	34	116	5	1	156
5814	3771s (+0.8s)	3372	3372	256	66	208	15	0	289
5815	3772s (+0.6s)	2468	2468	256	58	146	6	0	210
5816	3773s (+1.1s)	5492	5492	512	104	266	17	0	387
5817	3773s (+0.4s)	1368	1368	128	28	111	3	0	142
5818	3774s (+0.5s)	1860	1860	128	47	135	6	0	188
5819	3774s (+0.4s)	1492	1492	128	44	103	9	0	156
5820	3775s (+1.0s)	4952	4952	512	89	245	15	1	350
5821	3776s (+0.5s)	1472	1472	64	51	107	9	0	167
5822	3776s (+0.6s)	2012	2012	128	56	128	11	0	195
5823	3777s (+0.5s)	1616	1616	128	45	118	8	0	171
5824	3777s (+0.3s)	1016	1016	64	28	87	5	0	120
5825	3778s (+0.7s)	2576	2576	128	60	171	12	0	243
5826	3779s (+0.9s)	3684	3684	256	95	194	18	1	308
5827	3779s (+0.5s)	1760	1760	128	35	131	0	9	175
5828	3780s (+0.7s)	3208	3208	256	53	202	0	10	265
5829	3781s (+1.0s)	4164	4164	256	100	226	17	0	343
5830	3782s (+0.5s)	1760	1760	128	42	129	8	0	179
5831	3782s (+0.7s)	3048	3048	256	66	180	14	1	261
5832	3783s (+0.9s)	3996	3996	256	79	235	19	0	333
5833	3784s (+0.8s)	3252	3252	256	57	197	12	1	267
5834	3785s (+0.6s)	1976	1976	128	51	149	7	0	207
5835	3785s (+0.3s)	1032	1032	128	26	80	6	0	112
5836	3786s (+1.0s)	4408	4408	256	89	250	21	0	360
5837	3787s (+0.9s)	4080	4080	256	95	218	13	1	327
5838	3788s (+0.7s)	2820	2820	256	58	180	10	0	248
5839	3788s (+0.8s)	3340	3340	256	61	208	12	0	281
5840	3790s (+1.0s)	4492	4492	256	91	262	15	1	369
5841	3790s (+0.9s)	3968	3968	256	79	237	10	0	326
5842	3791s (+0.7s)	2816	2816	256	60	179	8	0	247
5843	3792s (+0.8s)	3248	3248	256	75	184	12	0	271
5844	3792s (+0.4s)	1072	1072	64	32	92	7	0	131
5845	3793s (+0.6s)	1928	1928	128	59	126	13	0	198
5846	3793s (+0.5s)	2308	2308	256	35	149	0	7	191
5847	3794s (+1.0s)	5416	5416	512	92	267	0	17	376
5848	3795s (+0.6s)	2616	2616	256	36	185	0	8	229
5849	3795s (+0.3s)	1052	1052	128	20	91	0	3	114
5850	3796s (+0.4s)	1388	1388	128	36	98	0	9	143
5851	3797s (+0.8s)	3412	3412	256	56	218	0	10	284
5852	3797s (+0.7s)	2808	2808	256	51	173	0	14	238
5853	3798s (+1.1s)	5500	5500	512	93	275	21	0	389
5854	3799s (+0.4s)	1140	1140	128	34	83	6	0	123
5855	3799s (+0.5s)	1768	1768	128	44	129	8	0	181
5856	3800s (+0.4s)	1472	1472	128	33	110	9	1	153
5857	3801s (+0.8s)	3416	3416	256	67	204	14	0	285
5858	3802s (+1.2s)	5832	5832	512	121	268	28	0	417
5859	3803s (+1.0s)	4168	4168	256	100	220	24	0	344
5860	3803s (+0.4s)	1292	1292	128	28	103	5	0	136
5861	3804s (+0.8s)	3676	3676	256	67	219	15	1	302
5862	3805s (+0.8s)	3412	3412	256	78	190	10	0	278
5863	3806s (+1.0s)	5376	5376	512	92	260	18	1	371
5864	3806s (+0.6s)	1932	1932	128	52	144	5	0	201
5865	3807s (+0.4s)	1204	1204	128	27	95	7	1	130
5866	3807s (+0.5s)	1784	1784	128	49	126	6	0	181
5867	3808s (+0.6s)	1884	1884	128	58	124	12	0	194
5868	3809s (+0.8s)	2868	2868	128	75	181	16	0	272
5869	3809s (+0.7s)	3112	3112	256	77	164	16	0	257
5870	3810s (+0.4s)	1416	1416	128	35	104	4	0	143
5871	3811s (+1.0s)	4324	4324	256	91	251	18	0	360
5872	3811s (+0.4s)	1292	1292	128	34	99	6	0	139
5873	3812s (+0.6s)	2536	2536	256	52	156	12	0	220
5874	3813s (+0.7s)	2876	2876	256	74	160	13	0	247
5875	3813s (+0.6s)	2244	2244	128	57	135	13	1	206
5876	3814s (+0.9s)	4004	4004	256	98	209	17	1	325
5877	3815s (+0.5s)	1944	1944	128	52	132	10	0	194
5878	3815s (+0.6s)	1968	1968	128	56	139	10	0	205
5879	3816s (+0.4s)	1476	1476	128	41	104	1	8	154
5880	3816s (+0.5s)	1528	1528	128	31	126	0	5	162
5881	3817s (+0.8s)	3272	3272	256	56	207	0	13	276
5882	3817s (+0.5s)	1984	1984	128	44	129	0	11	184
5883	3818s (+0.6s)	2612	2612	256	39	180	0	9	228
5884	3819s (+0.5s)	1728	1728	128	37	129	0	6	172
5885	3819s (+0.2s)	464	464	32	13	54	0	6	73
5886	3819s (+0.3s)	828	828	64	27	75	0	2	104
5887	3820s (+0.6s)	2404	2404	256	36	153	0	9	198
5888	3821s (+0.9s)	3528	3528	256	66	222	0	9	297
5889	3821s (+0.4s)	1504	1504	128	28	122	0	10	160
5890	3822s (+0.7s)	2720	2720	256	36	189	0	10	235
5891	3823s (+0.8s)	3360	3360	256	57	214	0	15	286
5892	3823s (+0.3s)	744	744	64	16	73	0	6	95
5893	3824s (+1.4s)	6828	6828	512	136	328	26	0	490
5894	3826s (+1.3s)	6864	6864	512	130	309	23	1	463
5895	3827s (+0.8s)	3628	3628	256	60	217	17	1	295
5896	3827s (+0.7s)	3168	3168	256	79	165	16	0	260
5897	3828s (+0.4s)	1336	1336	128	30	102	7	0	139
5898	3828s (+0.6s)	1908	1908	128	52	134	9	0	195
5899	3829s (+0.7s)	3168	3168	256	73	176	11	0	260
Episode	Time	Reward	Score	Highest	L	U	R	D	Steps
5900	3830s (+0.5s)	1824	1824	128	36	147	7	0	190
5901	3830s (+0.8s)	3412	3412	256	69	199	16	0	284
5902	3831s (+0.5s)	1608	1608	128	36	129	4	0	169
5903	3831s (+0.5s)	1612	1612	128	44	115	11	0	170
5904	3832s (+0.8s)	3580	3580	256	82	214	13	0	309
5905	3834s (+1.4s)	7308	7308	512	127	357	26	0	510
5906	3835s (+0.6s)	2672	2672	256	69	146	13	0	228
5907	3836s (+1.0s)	4348	4348	256	78	263	0	16	357
5908	3836s (+0.6s)	2668	2668	256	51	177	0	8	236
5909	3837s (+0.4s)	1168	1168	128	30	87	0	8	125
5910	3837s (+0.9s)	3592	3592	256	70	217	0	13	300
5911	3838s (+0.6s)	2052	2052	128	43	145	0	16	204
5912	3839s (+0.5s)	1800	1800	128	31	148	0	7	186
5913	3839s (+0.5s)	2148	2148	256	36	138	0	5	179
5914	3840s (+0.8s)	2940	2940	256	55	195	0	11	261
5915	3840s (+0.3s)	876	876	64	25	73	0	7	105
5916	3841s (+1.0s)	4220	4220	256	99	234	13	0	346
5917	3842s (+0.7s)	3084	3084	256	61	177	14	0	252
5918	3843s (+1.0s)	4356	4356	256	92	249	18	0	359
5919	3844s (+0.6s)	2500	2500	128	60	161	14	1	236
5920	3844s (+0.5s)	1604	1604	128	48	114	7	0	169
5921	3845s (+0.8s)	3412	3412	256	83	194	12	0	289
5922	3846s (+0.9s)	4044	4044	256	76	235	13	0	324
5923	3847s (+0.8s)	3424	3424	256	72	201	14	0	287
5924	3847s (+0.5s)	1588	1588	128	40	118	7	0	165
5925	3848s (+0.8s)	3436	3436	256	59	217	13	0	289
5926	3848s (+0.5s)	1820	1820	128	33	152	5	0	190
5927	3849s (+0.6s)	2188	2188	128	53	143	10	1	207
5928	3850s (+1.4s)	7012	7012	512	149	306	29	0	484
5929	3852s (+1.1s)	5480	5480	512	99	252	24	0	375
5930	3852s (+0.7s)	2852	2852	256	72	162	11	0	245
5931	3853s (+0.6s)	2000	2000	128	58	127	11	0	196
5932	3854s (+0.5s)	2084	2084	256	44	119	9	0	172
5933	3854s (+0.6s)	2584	2584	256	53	163	9	0	225
5934	3855s (+0.4s)	1432	1432	128	35	109	4	0	148
5935	3855s (+0.9s)	3748	3748	256	83	218	11	0	312
5936	3856s (+0.7s)	2900	2900	256	56	170	11	0	237
5937	3857s (+0.6s)	2144	2144	128	64	133	15	0	212
5938	3858s (+0.8s)	3420	3420	256	67	202	15	2	286
5939	3858s (+0.8s)	3216	3216	256	73	182	16	0	271
5940	3859s (+0.4s)	1332	1332	128	33	95	9	0	137
5941	3859s (+0.4s)	1308	1308	128	28	100	6	0	134
5942	3860s (+0.8s)	3236	3236	256	66	199	11	1	277
5943	3861s (+0.9s)	3856	3856	256	90	216	16	0	322
5944	3861s (+0.5s)	1580	1580	128	55	101	11	0	167
5945	3862s (+0.9s)	3872	3872	256	77	226	13	0	316
5946	3863s (+0.7s)	3128	3128	256	63	174	14	0	251
5947	3863s (+0.5s)	1600	1600	128	42	119	7	0	168
5948	3864s (+0.8s)	3752	3752	256	79	212	10	0	301
5949	3865s (+0.7s)	3048	3048	256	60	176	0	16	252
5950	3866s (+0.7s)	3052	3052	256	56	192	0	11	259
5951	3867s (+0.7s)	3208	3208	256	61	192	0	12	265
5952	3867s (+0.6s)	2644	2644	256	42	177	0	7	226
5953	3867s (+0.3s)	1148	1148	128	20	94	0	7	121
5954	3868s (+0.8s)	3468	3468	256	69	211	7	0	287
5955	3869s (+0.3s)	748	748	64	20	75	3	0	98
5956	3869s (+0.4s)	976	976	64	34	82	7	0	123
5957	3869s (+0.4s)	1520	1520	128	24	128	1	0	153
5958	3870s (+0.8s)	3356	3356	256	66	206	12	1	285
5959	3870s (+0.3s)	696	696	64	25	61	6	0	92
5960	3871s (+0.4s)	1492	1492	128	42	105	8	1	156
5961	3872s (+0.7s)	2832	2832	256	71	157	9	0	237
5962	3873s (+0.9s)	4036	4036	256	78	236	17	0	331
5963	3873s (+0.5s)	1492	1492	128	36	111	0	9	156
5964	3874s (+0.5s)	1944	1944	128	36	134	0	13	183
5965	3874s (+0.8s)	2964	2964	256	72	182	8	0	262
5966	3875s (+0.8s)	3260	3260	256	75	188	10	0	273
5967	3876s (+0.6s)	2664	2664	256	60	158	7	0	225
5968	3876s (+0.5s)	1608	1608	128	36	130	4	0	170
5969	3877s (+0.4s)	1320	1320	128	34	97	3	1	135
5970	3877s (+0.7s)	2508	2508	128	61	168	9	0	238
5971	3878s (+0.7s)	2776	2776	256	60	165	12	0	237
5972	3879s (+0.8s)	3236	3236	256	60	205	6	0	271
5973	3879s (+0.5s)	1880	1880	128	40	144	9	0	193
5974	3880s (+0.4s)	1212	1212	128	32	94	5	0	131
5975	3881s (+0.9s)	3972	3972	256	87	222	18	0	327
5976	3881s (+0.7s)	3172	3172	256	70	177	13	1	261
5977	3882s (+0.6s)	2164	2164	128	56	144	8	0	208
5978	3883s (+0.8s)	3508	3508	256	70	209	12	1	292
5979	3884s (+0.8s)	3300	3300	256	78	183	15	0	276
5980	3884s (+0.7s)	3060	3060	256	43	199	8	0	250
5981	3885s (+0.5s)	1580	1580	128	37	118	8	0	163
5982	3886s (+0.8s)	3224	3224	256	93	160	17	0	270
5983	3886s (+0.7s)	2604	2604	128	82	153	14	0	249
5984	3887s (+0.9s)	3780	3780	256	77	209	16	0	302
5985	3887s (+0.4s)	1096	1096	64	30	96	5	0	131
5986	3888s (+0.8s)	3480	3480	256	71	206	12	0	289
5987	3889s (+0.3s)	788	788	64	32	66	6	0	104
5988	3889s (+0.4s)	1304	1304	128	25	102	4	0	131
5989	3889s (+0.5s)	1532	1532	128	37	119	6	0	162
5990	3890s (+0.6s)	2420	2420	256	49	145	9	0	203
5991	3891s (+1.0s)	5144	5144	512	97	236	19	2	354
5992	3891s (+0.4s)	1280	1280	64	35	97	8	0	140
5993	3892s (+0.8s)	3340	3340	256	61	199	11	0	271
5994	3893s (+0.4s)	1612	1612	128	35	119	5	1	160
5995	3893s (+0.5s)	1804	1804	128	37	126	0	9	172
5996	3894s (+0.7s)	2864	2864	256	44	198	0	9	251
5997	3895s (+0.6s)	2368	2368	128	58	154	0	9	221
5998	3895s (+0.4s)	1328	1328	128	23	114	0	4	141
5999	3896s (+0.7s)	2884	2884	256	60	185	0	7	252
Episode	Time	Reward	Score	Highest	L	U	R	D	Steps
6000	3896s (+0.4s)	1460	1460	128	36	113	3	0	152
6001	3897s (+0.7s)	2584	2584	128	68	157	16	0	241
6002	3897s (+0.5s)	1840	1840	128	42	136	5	0	183
6003	3898s (+0.5s)	1824	1824	128	56	116	14	0	186
6004	3899s (+0.8s)	3288	3288	256	70	194	9	0	273
6005	3899s (+0.4s)	1188	1188	64	24	103	5	1	133
6006	3900s (+0.8s)	3400	3400	256	70	199	13	0	282
6007	3900s (+0.6s)	2516	2516	256	58	149	12	1	220
6008	3901s (+0.5s)	1812	1812	128	38	129	6	0	173
6009	3901s (+0.5s)	1544	1544	128	37	125	4	0	166
6010	3902s (+0.8s)	3216	3216	256	82	177	8	0	267
6011	3903s (+0.4s)	1492	1492	128	33	115	8	0	156
6012	3903s (+0.7s)	2832	2832	256	58	182	0	7	247
6013	3904s (+0.5s)	1824	1824	128	45	140	0	5	190
6014	3905s (+0.7s)	2824	2824	256	60	182	0	7	249
6015	3905s (+0.3s)	660	660	32	20	77	0	3	100
6016	3906s (+0.8s)	3540	3540	256	64	211	0	13	288
6017	3906s (+0.6s)	1940	1940	128	48	145	10	0	203
6018	3907s (+0.7s)	2672	2672	128	74	164	10	0	248
6019	3907s (+0.5s)	2136	2136	256	39	133	5	0	177
6020	3908s (+0.5s)	1564	1564	128	33	123	7	0	163
6021	3908s (+0.4s)	1380	1380	128	29	114	2	1	146
6022	3909s (+0.8s)	3384	3384	256	56	218	9	0	283
6023	3910s (+0.5s)	1796	1796	128	49	124	10	1	184
6024	3910s (+0.7s)	2880	2880	256	67	168	14	2	251
6025	3911s (+0.6s)	2616	2616	256	56	167	6	0	229
6026	3912s (+0.8s)	3104	3104	256	71	188	7	0	266
6027	3913s (+0.6s)	2528	2528	256	44	156	13	0	213
6028	3913s (+0.4s)	1460	1460	128	43	102	8	0	153
6029	3914s (+0.9s)	3936	3936	256	80	226	17	0	323
6030	3914s (+0.5s)	1788	1788	128	50	123	9	0	182
6031	3916s (+1.2s)	5784	5784	512	103	289	20	0	412
6032	3916s (+0.6s)	2096	2096	128	61	137	13	0	211
6033	3917s (+0.6s)	1944	1944	128	42	143	12	0	197
6034	3917s (+0.3s)	928	928	64	31	77	5	0	113
6035	3918s (+0.7s)	3168	3168	256	65	184	11	0	260
6036	3918s (+0.6s)	2472	2472	256	48	155	7	0	210
6037	3919s (+0.5s)	1800	1800	128	43	129	12	0	184
6038	3920s (+0.7s)	3264	3264	256	65	186	12	1	264
6039	3921s (+0.8s)	3508	3508	256	69	207	0	15	291
6040	3921s (+0.6s)	2504	2504	256	41	169	0	8	218
6041	3922s (+0.4s)	1524	1524	128	27	127	0	5	159
6042	3922s (+0.5s)	1752	1752	128	40	131	0	7	178
6043	3923s (+0.8s)	3768	3768	256	63	232	0	13	308
6044	3924s (+0.7s)	3124	3124	256	44	210	0	7	261
6045	3924s (+0.3s)	924	924	64	28	80	0	4	112
6046	3925s (+0.5s)	1800	1800	128	37	141	0	8	186
6047	3925s (+0.6s)	2332	2332	128	42	159	0	12	213
6048	3926s (+0.4s)	1148	1148	128	27	90	0	7	124
6049	3926s (+0.6s)	1904	1904	128	38	148	0	8	194
6050	3927s (+0.7s)	2808	2808	256	54	172	15	0	241
6051	3927s (+0.3s)	1080	1080	128	22	91	5	0	118
6052	3928s (+0.6s)	2188	2188	128	70	139	8	0	217
6053	3929s (+0.8s)	3704	3704	256	71	200	16	0	287
6054	3929s (+0.4s)	1276	1276	128	28	96	7	0	131
6055	3930s (+1.0s)	4228	4228	256	92	244	12	0	348
6056	3930s (+0.3s)	836	836	64	25	79	5	0	109
6057	3931s (+0.4s)	1568	1568	128	31	124	5	0	160
6058	3931s (+0.4s)	1148	1148	128	27	95	3	0	125
6059	3932s (+0.5s)	1924	1924	128	48	130	12	0	190
6060	3932s (+0.6s)	2568	2568	256	60	152	10	0	222
6061	3933s (+0.6s)	1956	1956	128	45	148	7	0	200
6062	3934s (+0.9s)	3920	3920	256	94	209	15	1	319
6063	3935s (+0.8s)	3392	3392	256	73	198	13	0	284
6064	3935s (+0.7s)	3172	3172	256	80	165	15	0	260
6065	3936s (+0.8s)	3216	3216	256	62	194	12	0	268
6066	3937s (+0.8s)	3536	3536	256	71	207	14	0	292
6067	3938s (+0.8s)	3440	3440	256	75	195	14	0	284
6068	3938s (+0.6s)	2492	2492	256	63	138	14	0	215
6069	3939s (+0.8s)	2856	2856	128	71	187	13	1	272
6070	3940s (+1.1s)	5548	5548	512	103	273	14	0	390
6071	3941s (+0.4s)	1312	1312	128	29	105	10	0	144
6072	3942s (+0.8s)	3424	3424	256	77	208	12	0	297
6073	3942s (+0.8s)	3440	3440	256	86	187	18	0	291
6074	3943s (+0.5s)	1784	1784	128	37	137	6	0	180
6075	3944s (+0.8s)	3588	3588	256	86	198	12	0	296
6076	3944s (+0.4s)	1456	1456	128	31	112	4	0	147
6077	3945s (+0.6s)	2228	2228	128	54	150	8	0	212
6078	3945s (+0.6s)	2304	2304	128	59	148	12	0	219
6079	3946s (+0.9s)	4908	4908	512	81	238	19	1	339
6080	3947s (+0.6s)	2384	2384	128	68	147	9	0	224
6081	3948s (+0.8s)	3304	3304	256	63	205	9	0	277
6082	3949s (+0.8s)	3456	3456	256	78	205	8	0	291
6083	3949s (+0.7s)	2796	2796	256	60	173	9	1	243
6084	3950s (+0.5s)	1612	1612	128	47	120	3	0	170
6085	3950s (+0.4s)	1188	1188	64	38	102	4	0	144
6086	3951s (+0.8s)	3536	3536	256	70	218	11	0	299
6087	3952s (+0.9s)	4148	4148	256	83	247	9	0	339
6088	3952s (+0.4s)	1052	1052	64	34	88	5	0	127
6089	3953s (+0.9s)	3600	3600	256	58	237	12	0	307
6090	3954s (+0.9s)	3684	3684	256	95	213	10	0	318
6091	3955s (+0.4s)	1396	1396	128	23	111	0	9	143
6092	3955s (+0.7s)	2760	2760	256	70	152	16	0	238
6093	3956s (+1.0s)	4168	4168	256	88	237	19	0	344
6094	3957s (+0.4s)	1236	1236	128	23	102	2	0	127
6095	3958s (+0.9s)	3848	3848	256	88	211	21	1	321
6096	3958s (+0.6s)	2584	2584	256	71	137	12	1	221
6097	3959s (+0.8s)	3140	3140	256	81	173	18	0	272
6098	3960s (+0.6s)	2204	2204	128	59	146	14	0	219
6099	3960s (+0.6s)	1892	1892	128	54	127	11	0	192
Episode	Time	Reward	Score	Highest	L	U	R	D	Steps
6100	3961s (+1.0s)	4316	4316	256	91	249	17	0	357
6101	3962s (+0.7s)	2664	2664	256	48	177	5	1	231
6102	3963s (+0.8s)	3560	3560	256	95	188	14	0	297
6103	3964s (+0.9s)	3692	3692	256	66	230	13	0	309
6104	3965s (+1.1s)	5572	5572	512	98	273	19	1	391
6105	3965s (+0.5s)	1724	1724	128	47	115	11	0	173
6106	3966s (+0.3s)	612	612	32	25	63	4	0	92
6107	3966s (+0.5s)	1908	1908	128	45	141	9	0	195
6108	3967s (+0.6s)	2044	2044	128	58	129	11	0	198
6109	3968s (+0.8s)	3360	3360	256	76	191	12	0	279
6110	3968s (+0.3s)	1016	1016	128	25	77	6	0	108
6111	3968s (+0.3s)	884	884	64	30	77	3	0	110
6112	3969s (+0.4s)	1172	1172	64	28	103	0	9	140
6113	3970s (+1.1s)	5328	5328	512	84	270	0	15	369
6114	3970s (+0.4s)	1460	1460	128	24	119	0	8	151
6115	3970s (+0.2s)	260	260	32	11	38	0	3	52
6116	3971s (+0.5s)	1752	1752	128	39	128	0	11	178
6117	3971s (+0.7s)	2712	2712	128	53	187	0	12	252
6118	3972s (+0.6s)	1880	1880	128	34	149	0	7	190
6119	3972s (+0.4s)	1220	1220	128	30	94	9	0	133
6120	3973s (+0.5s)	1836	1836	128	60	118	15	0	193
6121	3974s (+0.5s)	1556	1556	64	46	125	8	0	179
6122	3974s (+0.3s)	808	808	64	28	71	4	0	103
6123	3974s (+0.5s)	1708	1708	128	43	113	11	0	167
6124	3975s (+0.5s)	1428	1428	64	49	99	13	0	161
6125	3975s (+0.5s)	1744	1744	128	49	127	4	0	180
6126	3976s (+0.6s)	2580	2580	256	56	157	10	2	225
6127	3977s (+0.7s)	2804	2804	256	48	184	0	12	244
6128	3977s (+0.3s)	1228	1228	128	19	105	0	2	126
6129	3977s (+0.4s)	1100	1100	64	31	96	0	8	135
6130	3978s (+0.8s)	3320	3320	256	67	199	0	15	281
6131	3979s (+0.9s)	3536	3536	256	47	235	0	16	298
6132	3980s (+0.8s)	3228	3228	256	61	193	0	13	267
6133	3980s (+0.5s)	1824	1824	128	36	147	0	8	191
6134	3981s (+0.6s)	2264	2264	128	67	142	7	0	216
6135	3982s (+0.8s)	3396	3396	256	61	205	13	0	279
6136	3982s (+0.3s)	792	792	64	15	88	3	0	106
6137	3983s (+0.7s)	2968	2968	256	72	167	13	1	253
6138	3984s (+1.1s)	4648	4648	256	97	271	20	0	388
6139	3985s (+1.0s)	4204	4204	256	90	231	21	0	342
6140	3985s (+0.5s)	1540	1540	128	42	118	4	0	164
6141	3986s (+0.8s)	3496	3496	256	84	194	15	0	293
6142	3987s (+0.9s)	3796	3796	256	72	229	14	0	315
6143	3988s (+0.8s)	3220	3220	256	70	187	11	0	268
6144	3989s (+0.7s)	3124	3124	256	54	195	8	0	257
6145	3989s (+0.6s)	2508	2508	256	45	155	10	0	210
6146	3990s (+0.7s)	2920	2920	256	69	157	16	0	242
6147	3990s (+0.4s)	1356	1356	128	38	97	5	0	140
6148	3991s (+0.8s)	3280	3280	256	64	189	16	2	271
6149	3992s (+0.5s)	2348	2348	256	50	138	8	0	196
6150	3992s (+0.7s)	3096	3096	256	61	181	12	0	254
6151	3993s (+0.9s)	4028	4028	256	84	236	10	0	330
6152	3994s (+0.5s)	1616	1616	128	38	127	6	0	171
6153	3994s (+0.6s)	2268	2268	128	52	154	9	0	215
6154	3995s (+0.5s)	1828	1828	128	39	136	9	1	185
6155	3996s (+0.9s)	3632	3632	256	82	208	16	0	306
6156	3996s (+0.6s)	2620	2620	256	54	153	12	0	219
6157	3997s (+0.4s)	1504	1504	128	42	112	6	0	160
6158	3998s (+0.7s)	3044	3044	256	77	165	14	0	256
6159	3998s (+0.8s)	3504	3504	256	64	218	13	0	295
6160	3999s (+0.9s)	3844	3844	256	75	222	15	0	312
6161	4000s (+0.6s)	2424	2424	256	60	139	10	0	209
6162	4000s (+0.4s)	1632	1632	128	38	100	11	1	150
6163	4001s (+0.7s)	2992	2992	256	50	182	7	0	239
6164	4002s (+0.5s)	1916	1916	128	44	149	4	0	197
6165	4002s (+0.4s)	1160	1160	128	19	102	3	0	124
6166	4003s (+0.8s)	3216	3216	256	66	189	11	0	266
6167	4003s (+0.5s)	1896	1896	128	47	136	14	0	197
6168	4004s (+0.9s)	3832	3832	256	78	214	16	0	308
6169	4005s (+0.9s)	3836	3836	256	80	215	15	0	310
6170	4006s (+0.5s)	1752	1752	128	45	122	8	0	175
6171	4006s (+0.4s)	1552	1552	128	49	104	7	0	160
6172	4007s (+0.7s)	2744	2744	256	47	182	7	0	236
6173	4007s (+0.7s)	2532	2532	128	70	157	13	0	240
6174	4008s (+1.1s)	4528	4528	256	107	250	17	0	374
6175	4010s (+1.4s)	7184	7184	512	135	334	27	0	496
6176	4011s (+0.4s)	1496	1496	128	33	113	11	0	157
6177	4011s (+0.5s)	2272	2272	256	43	133	11	0	187
6178	4012s (+0.6s)	1940	1940	128	58	136	9	0	203
6179	4012s (+0.5s)	1776	1776	128	42	130	8	0	180
6180	4013s (+0.5s)	1584	1584	128	45	108	10	0	163
6181	4013s (+0.7s)	2644	2644	256	49	179	8	0	236
6182	4014s (+0.4s)	1472	1472	128	32	114	1	5	152
6183	4015s (+0.8s)	3260	3260	256	53	206	0	15	274
6184	4015s (+0.6s)	2600	2600	256	46	166	0	13	225
6185	4016s (+0.9s)	3976	3976	256	63	246	0	19	328
6186	4017s (+0.6s)	2604	2604	256	46	170	0	10	226
6187	4017s (+0.3s)	864	864	64	20	84	0	8	112
6188	4018s (+0.5s)	2184	2184	256	39	138	0	10	187
6189	4018s (+0.3s)	892	892	64	28	83	0	4	115
6190	4019s (+0.5s)	1608	1608	128	42	126	0	5	173
6191	4019s (+0.8s)	3392	3392	256	82	191	10	1	284
6192	4020s (+0.6s)	2256	2256	128	61	143	8	2	214
6193	4021s (+0.8s)	3456	3456	256	64	210	16	0	290
6194	4021s (+0.4s)	1432	1432	128	31	114	6	0	151
6195	4022s (+0.8s)	3356	3356	256	86	181	18	0	285
6196	4022s (+0.4s)	1372	1372	128	38	101	8	0	147
6197	4023s (+0.6s)	2208	2208	128	67	140	15	0	222
6198	4024s (+0.9s)	3992	3992	256	79	227	21	2	329
6199	4025s (+0.6s)	2484	2484	256	45	159	8	0	212
Episode	Time	Reward	Score	Highest	L	U	R	D	Steps
6200	4026s (+0.9s)	4084	4084	256	84	229	16	0	329
6201	4027s (+1.0s)	4860	4860	512	84	238	16	0	338
6202	4028s (+1.0s)	4544	4544	256	112	239	26	1	378
6203	4028s (+0.6s)	2292	2292	128	55	152	10	0	217
6204	4029s (+0.5s)	1496	1496	128	39	112	7	0	158
6205	4030s (+1.2s)	6140	6140	512	117	291	21	0	429
6206	4031s (+0.9s)	4060	4060	256	79	234	16	0	329
6207	4031s (+0.4s)	1388	1388	128	32	111	3	0	146
6208	4032s (+0.3s)	860	860	64	26	77	8	0	111
6209	4032s (+0.6s)	2432	2432	256	48	148	5	0	201
6210	4033s (+0.5s)	1748	1748	128	36	133	8	0	177
6211	4033s (+0.3s)	808	808	64	20	77	6	0	103
6212	4034s (+0.6s)	1920	1920	128	46	144	8	0	198
6213	4034s (+0.6s)	1960	1960	128	54	140	14	0	208
6214	4035s (+0.4s)	1616	1616	128	46	104	11	0	161
6215	4035s (+0.3s)	960	960	64	25	84	6	1	116
6216	4035s (+0.3s)	740	740	64	26	67	4	0	97
6217	4036s (+0.9s)	3700	3700	256	77	211	19	0	307
6218	4037s (+0.8s)	3356	3356	256	61	210	0	15	286
6219	4038s (+0.9s)	3792	3792	256	59	241	0	14	314
6220	4039s (+0.8s)	3360	3360	256	52	212	0	12	276
6221	4039s (+0.7s)	2672	2672	256	50	165	0	13	228
6222	4040s (+0.7s)	2764	2764	256	62	161	0	11	234
6223	4040s (+0.5s)	1688	1688	128	31	127	0	9	167
6224	4041s (+0.6s)	2528	2528	256	39	176	0	6	221
6225	4042s (+0.7s)	2804	2804	256	49	184	0	11	244
6226	4042s (+0.4s)	980	980	64	27	90	7	0	124
6227	4043s (+0.7s)	2796	2796	256	55	177	10	0	242
6228	4044s (+0.8s)	3544	3544	256	80	206	14	0	300
6229	4044s (+0.4s)	1336	1336	128	33	95	5	0	133
6230	4044s (+0.4s)	1464	1464	128	47	101	6	0	154
6231	4045s (+0.7s)	2564	2564	128	66	159	14	1	240
6232	4046s (+0.8s)	3356	3356	256	65	210	10	0	285
6233	4047s (+0.6s)	2624	2624	256	51	156	11	0	218
6234	4047s (+0.5s)	1820	1820	128	47	134	9	0	190
6235	4048s (+0.8s)	3540	3540	256	71	217	12	0	300
6236	4048s (+0.4s)	1240	1240	128	23	102	3	0	128
6237	4049s (+0.8s)	3372	3372	256	67	205	12	0	284
6238	4050s (+0.7s)	3088	3088	256	50	193	9	0	252
6239	4051s (+0.7s)	2840	2840	256	65	172	9	0	246
6240	4051s (+0.4s)	1592	1592	128	30	125	6	0	161
6241	4052s (+0.8s)	3480	3480	256	84	191	14	0	289
6242	4052s (+0.5s)	1796	1796	128	48	126	10	0	184
6243	4053s (+0.8s)	3392	3392	256	85	180	17	0	282
6244	4054s (+0.4s)	1484	1484	128	30	122	3	0	155
6245	4054s (+0.5s)	1500	1500	128	51	96	11	1	159
6246	4055s (+0.6s)	2716	2716	256	45	172	11	0	228
6247	4055s (+0.5s)	1784	1784	128	39	131	12	0	182
6248	4056s (+0.3s)	704	704	64	16	77	1	0	94
6249	4056s (+0.7s)	2936	2936	256	55	180	11	0	246
6250	4057s (+0.5s)	1780	1780	128	40	134	6	0	180
6251	4057s (+0.7s)	2340	2340	128	71	150	14	0	235
6252	4058s (+0.9s)	3932	3932	256	76	229	17	0	322
6253	4059s (+0.4s)	1304	1304	128	30	102	2	1	135
6254	4060s (+0.7s)	2988	2988	256	57	190	10	0	257
6255	4060s (+0.4s)	1040	1040	64	31	86	7	0	124
6256	4060s (+0.4s)	1288	1288	128	36	101	5	0	142
6257	4061s (+0.4s)	1012	1012	64	32	83	7	0	122
6258	4061s (+0.4s)	1224	1224	128	28	95	10	0	133
6259	4061s (+0.4s)	1052	1052	64	37	85	3	1	126
6260	4062s (+0.6s)	1872	1872	128	36	151	0	5	192
6261	4063s (+0.7s)	3112	3112	256	46	196	0	10	252
6262	4063s (+0.4s)	1168	1168	128	24	101	0	2	127
6263	4064s (+0.5s)	1728	1728	128	44	116	0	9	169
6264	4064s (+0.6s)	1912	1912	128	45	145	0	7	197
6265	4065s (+0.8s)	3252	3252	256	69	192	15	0	276
6266	4065s (+0.3s)	884	884	64	19	94	4	0	117
6267	4066s (+1.0s)	4352	4352	256	92	247	19	0	358
6268	4067s (+1.0s)	5164	5164	512	102	251	17	0	370
6269	4068s (+0.3s)	1168	1168	128	24	95	2	0	121
6270	4068s (+0.6s)	2476	2476	256	57	143	11	0	211
6271	4069s (+0.9s)	3596	3596	256	75	218	12	0	305
6272	4070s (+0.8s)	3248	3248	256	64	198	13	0	275
6273	4070s (+0.3s)	956	956	64	32	80	8	0	120
6274	4071s (+0.8s)	3396	3396	256	49	213	0	18	280
6275	4072s (+0.5s)	1504	1504	128	46	106	0	8	160
6276	4072s (+0.5s)	1540	1540	128	37	118	0	9	164
6277	4073s (+0.8s)	3356	3356	256	46	221	0	8	275
6278	4073s (+0.3s)	924	924	64	30	86	5	0	121
6279	4074s (+0.4s)	1176	1176	128	20	104	3	0	127
6280	4074s (+0.3s)	840	840	64	24	78	8	0	110
6281	4074s (+0.5s)	1532	1532	128	31	121	9	1	162
6282	4075s (+0.5s)	1736	1736	128	58	103	13	0	174
6283	4076s (+0.7s)	2916	2916	256	55	174	12	1	242
6284	4076s (+0.4s)	1236	1236	128	31	99	6	1	137
6285	4077s (+0.7s)	2620	2620	128	73	158	17	0	248
6286	4077s (+0.8s)	3452	3452	256	70	202	14	1	287
6287	4078s (+0.8s)	3324	3324	256	55	211	12	0	278
6288	4079s (+0.3s)	884	884	64	24	87	5	0	116
6289	4080s (+1.1s)	5416	5416	512	128	238	22	0	388
6290	4080s (+0.6s)	2452	2452	256	50	154	6	0	210
6291	4081s (+0.5s)	1640	1640	128	39	130	4	0	173
6292	4082s (+0.9s)	3696	3696	256	66	221	0	16	303
6293	4083s (+0.9s)	3848	3848	256	63	236	0	14	313
6294	4083s (+0.5s)	1828	1828	128	44	141	0	7	192
6295	4084s (+0.6s)	2432	2432	128	49	163	0	12	224
6296	4084s (+0.5s)	1556	1556	128	34	121	6	0	161
6297	4085s (+1.0s)	4468	4468	256	93	231	24	1	349
6298	4086s (+0.5s)	1820	1820	128	42	127	11	0	180
6299	4086s (+0.6s)	2100	2100	128	57	137	14	0	208
Episode	Time	Reward	Score	Highest	L	U	R	D	Steps
6300	4087s (+0.4s)	1164	1164	128	20	107	1	0	128
6301	4087s (+0.5s)	1756	1756	128	32	134	11	1	178
6302	4088s (+0.8s)	3420	3420	256	70	200	15	0	285
6303	4089s (+0.8s)	3544	3544	256	64	223	0	13	300
6304	4090s (+0.8s)	3192	3192	256	53	201	0	11	265
6305	4090s (+0.5s)	1708	1708	128	40	128	0	5	173
6306	4091s (+0.7s)	2996	2996	256	51	200	0	10	261
6307	4092s (+0.6s)	2636	2636	256	46	170	0	8	224
6308	4092s (+0.7s)	2780	2780	256	45	185	0	9	239
6309	4093s (+0.3s)	800	800	64	14	88	0	5	107
6310	4093s (+0.6s)	2560	2560	256	45	172	0	9	226
6311	4094s (+0.5s)	1620	1620	128	31	129	0	8	168
6312	4094s (+0.8s)	3332	3332	256	59	206	0	14	279
6313	4095s (+0.5s)	1712	1712	128	34	125	1	9	169
6314	4096s (+1.0s)	4188	4188	256	83	248	0	18	349
6315	4097s (+0.6s)	2592	2592	256	51	164	8	0	223
6316	4097s (+0.5s)	1652	1652	128	38	117	11	0	166
6317	4098s (+0.7s)	3152	3152	256	66	185	6	0	257
6318	4099s (+0.8s)	3288	3288	256	62	203	11	1	277
6319	4099s (+0.3s)	808	808	64	23	79	7	0	109
6320	4099s (+0.4s)	1220	1220	128	30	93	8	1	132
6321	4100s (+0.4s)	1200	1200	128	30	96	3	0	129
6322	4100s (+0.3s)	748	748	64	15	83	0	2	100
6323	4101s (+0.6s)	1904	1904	128	38	147	9	0	194
6324	4101s (+0.4s)	1208	1208	128	35	91	4	0	130
6325	4102s (+0.8s)	3320	3320	256	75	186	20	0	281
6326	4102s (+0.7s)	2872	2872	256	57	176	16	0	249
6327	4103s (+0.3s)	720	720	64	22	70	0	5	97
6328	4103s (+0.3s)	740	740	64	18	73	0	7	98
6329	4104s (+1.0s)	4312	4312	256	95	241	20	0	356
6330	4105s (+0.6s)	1880	1880	128	46	140	7	0	193
6331	4105s (+0.5s)	1620	1620	128	41	115	6	0	162
6332	4106s (+0.7s)	2764	2764	256	61	163	13	1	238
6333	4106s (+0.6s)	2864	2864	256	44	182	0	8	234
6334	4107s (+0.5s)	1624	1624	128	30	126	0	7	163
6335	4107s (+0.4s)	1492	1492	128	30	110	0	7	147
6336	4108s (+1.0s)	4344	4344	256	107	241	13	0	361
6337	4109s (+0.3s)	856	856	64	27	76	7	0	110
6338	4110s (+1.0s)	5044	5044	512	107	227	16	0	350
6339	4110s (+0.2s)	628	628	64	17	66	3	0	86
6340	4110s (+0.5s)	1784	1784	128	46	128	6	0	180
6341	4111s (+0.5s)	1868	1868	128	39	142	10	0	191
6342	4111s (+0.5s)	1580	1580	128	35	118	5	0	158
6343	4112s (+0.9s)	3712	3712	256	74	219	11	0	304
6344	4113s (+0.9s)	4036	4036	256	80	236	16	0	332
6345	4114s (+0.9s)	3660	3660	256	84	214	14	0	312
6346	4115s (+0.8s)	3508	3508	256	52	224	15	0	291
6347	4116s (+0.9s)	4020	4020	256	84	226	17	0	327
6348	4116s (+0.6s)	2024	2024	128	59	135	8	0	202
6349	4117s (+0.7s)	3124	3124	256	58	190	13	0	261
6350	4118s (+0.7s)	2576	2576	128	66	166	11	0	243
6351	4118s (+0.6s)	1912	1912	128	45	146	5	0	196
6352	4120s (+1.1s)	4504	4504	256	104	246	22	0	372
6353	4120s (+0.6s)	1880	1880	128	41	148	4	0	193
6354	4121s (+0.6s)	1920	1920	128	42	148	8	0	198
6355	4121s (+0.5s)	1820	1820	128	48	126	9	0	183
6356	4122s (+0.6s)	2508	2508	256	54	153	9	0	216
6357	4122s (+0.4s)	1476	1476	128	37	111	5	0	153
6358	4123s (+0.4s)	1484	1484	128	32	118	6	0	156
6359	4123s (+0.5s)	1804	1804	128	33	145	0	8	186
6360	4124s (+0.8s)	3240	3240	256	58	203	1	11	273
6361	4125s (+0.9s)	4196	4196	256	73	255	0	12	340
6362	4126s (+0.8s)	3152	3152	256	43	219	0	11	273
6363	4126s (+0.5s)	1872	1872	128	43	143	0	5	191
6364	4127s (+1.0s)	4164	4164	256	82	240	0	21	343
6365	4128s (+0.6s)	2584	2584	256	37	171	0	13	221
6366	4128s (+0.6s)	2324	2324	256	33	154	1	7	195
6367	4129s (+0.4s)	1460	1460	128	29	117	7	0	153
6368	4130s (+0.7s)	3204	3204	256	60	194	9	0	263
6369	4130s (+0.4s)	1552	1552	128	34	117	4	0	155
6370	4131s (+0.8s)	3424	3424	256	76	195	15	1	287
6371	4132s (+0.6s)	2548	2548	256	53	161	8	1	223
6372	4132s (+0.6s)	2636	2636	256	57	153	14	0	224
6373	4133s (+0.5s)	1808	1808	128	43	135	5	0	183
6374	4134s (+1.0s)	4200	4200	256	83	244	18	0	345
6375	4134s (+0.7s)	3164	3164	256	67	174	17	1	259
6376	4135s (+0.3s)	752	752	64	16	79	3	0	98
6377	4135s (+0.6s)	1928	1928	128	49	144	7	0	200
6378	4136s (+0.7s)	2532	2532	128	59	164	11	0	234
6379	4136s (+0.3s)	1184	1184	128	19	100	3	0	122
6380	4137s (+0.4s)	1216	1216	128	28	93	6	0	127
6381	4137s (+0.6s)	1908	1908	128	50	134	12	0	196
6382	4138s (+0.6s)	2432	2432	256	47	153	6	0	206
6383	4139s (+0.6s)	2492	2492	256	56	143	14	2	215
6384	4139s (+0.7s)	2756	2756	256	50	177	10	0	237
6385	4140s (+0.6s)	2444	2444	256	53	142	12	0	207
6386	4140s (+0.6s)	2604	2604	256	60	156	10	0	226
6387	4141s (+0.5s)	1576	1576	128	29	125	5	0	159
6388	4142s (+0.7s)	2896	2896	256	60	177	13	0	250
6389	4142s (+0.5s)	1824	1824	128	41	139	10	0	190
6390	4143s (+0.9s)	3724	3724	256	73	236	12	0	321
6391	4144s (+1.0s)	4168	4168	256	89	244	11	0	344
6392	4144s (+0.3s)	872	872	64	31	79	4	0	114
6393	4145s (+0.3s)	820	820	64	21	86	5	0	112
6394	4145s (+0.4s)	1180	1180	64	42	91	9	0	142
6395	4146s (+0.4s)	1040	1040	64	26	91	0	7	124
6396	4146s (+0.5s)	1508	1508	128	27	126	0	8	161
6397	4147s (+0.6s)	2220	2220	128	38	160	0	13	211
6398	4147s (+0.7s)	2944	2944	256	52	182	0	13	247
6399	4148s (+0.4s)	1444	1444	128	23	123	0	5	151
Episode	Time	Reward	Score	Highest	L	U	R	D	Steps
6400	4148s (+0.4s)	1260	1260	128	24	105	0	4	133
6401	4149s (+1.1s)	5696	5696	512	90	293	0	24	407
6402	4150s (+0.6s)	2472	2472	256	50	152	8	0	210
6403	4151s (+0.4s)	1480	1480	128	41	108	5	0	154
6404	4151s (+0.8s)	3552	3552	256	75	208	14	0	297
6405	4152s (+0.6s)	2404	2404	128	70	143	11	0	224
6406	4152s (+0.4s)	1168	1168	128	27	92	6	0	125
6407	4153s (+0.5s)	2332	2332	256	42	151	7	0	200
6408	4154s (+0.7s)	3272	3272	256	64	195	13	0	272
6409	4154s (+0.4s)	1292	1292	128	34	101	4	0	139
6410	4155s (+0.8s)	3380	3380	256	69	196	16	0	281
6411	4156s (+0.7s)	2848	2848	256	79	162	9	0	250
6412	4157s (+1.0s)	4288	4288	256	100	235	16	0	351
6413	4157s (+0.6s)	2084	2084	128	50	132	16	0	198
6414	4158s (+0.6s)	1880	1880	128	51	131	11	0	193
6415	4159s (+1.2s)	5744	5744	512	123	263	21	0	407
6416	4160s (+0.8s)	3552	3552	256	82	204	10	0	296
6417	4160s (+0.5s)	1876	1876	128	44	126	7	0	177
6418	4161s (+0.7s)	2828	2828	256	66	171	12	0	249
6419	4162s (+0.4s)	1496	1496	128	36	112	5	1	154
6420	4162s (+0.6s)	2616	2616	256	48	163	9	0	220
6421	4163s (+0.7s)	2864	2864	256	67	170	10	0	247
6422	4164s (+0.7s)	2796	2796	256	60	172	10	0	242
6423	4164s (+0.6s)	2560	2560	256	31	176	4	0	211
6424	4165s (+0.6s)	2140	2140	128	53	136	9	1	199
6425	4165s (+0.4s)	1208	1208	64	39	90	5	1	135
6426	4166s (+0.5s)	1748	1748	128	47	118	12	0	177
6427	4166s (+0.7s)	3144	3144	256	61	188	10	0	259
6428	4167s (+0.5s)	1784	1784	128	37	126	11	0	174
6429	4167s (+0.4s)	1100	1100	128	31	86	6	0	123
6430	4168s (+0.4s)	1164	1164	128	36	81	6	0	123
6431	4168s (+0.6s)	2196	2196	128	53	145	18	0	216
6432	4169s (+0.5s)	1652	1652	128	38	123	8	0	169
6433	4169s (+0.6s)	2872	2872	256	65	153	13	0	231
6434	4170s (+0.9s)	3668	3668	256	80	224	15	0	319
6435	4172s (+1.3s)	6324	6324	512	111	310	24	1	446
6436	4172s (+0.7s)	2908	2908	256	57	188	8	0	253
6437	4173s (+0.3s)	712	712	64	22	69	0	5	96
6438	4173s (+0.4s)	1280	1280	128	24	113	0	3	140
6439	4174s (+0.8s)	3176	3176	256	49	209	0	12	270
6440	4175s (+0.8s)	3524	3524	256	76	207	11	1	295
6441	4175s (+0.5s)	1588	1588	128	44	111	9	0	164
6442	4176s (+1.1s)	5416	5416	512	100	259	15	0	374
6443	4177s (+0.4s)	1064	1064	64	29	91	10	0	130
6444	4177s (+0.6s)	2208	2208	128	52	147	12	1	212
6445	4178s (+0.4s)	1432	1432	128	35	112	6	0	153
6446	4178s (+0.8s)	3388	3388	256	65	200	14	0	279
6447	4179s (+0.4s)	1468	1468	128	39	106	6	0	151
6448	4180s (+0.6s)	2724	2724	256	60	148	10	1	219
6449	4180s (+0.2s)	292	292	32	8	48	0	0	56
6450	4180s (+0.4s)	1336	1336	128	25	108	6	0	139
6451	4181s (+0.8s)	3244	3244	256	54	205	0	14	273
6452	4181s (+0.4s)	1492	1492	128	39	114	0	4	157
6453	4182s (+0.6s)	2916	2916	256	46	181	0	7	234
6454	4183s (+0.8s)	3308	3308	256	55	217	0	12	284
6455	4183s (+0.4s)	1484	1484	128	33	115	0	6	154
6456	4184s (+0.8s)	3512	3512	256	63	212	0	17	292
6457	4185s (+0.8s)	3520	3520	256	53	228	0	13	294
6458	4185s (+0.5s)	1816	1816	128	48	130	10	0	188
6459	4186s (+0.3s)	664	664	64	21	66	3	1	91
6460	4186s (+0.6s)	1924	1924	128	52	141	6	0	199
6461	4187s (+0.8s)	3476	3476	256	81	199	15	0	295
6462	4188s (+0.5s)	1836	1836	128	42	140	0	7	189
6463	4189s (+1.0s)	5108	5108	512	87	250	0	14	351
6464	4190s (+1.0s)	4152	4152	256	76	249	0	16	341
6465	4190s (+0.5s)	1848	1848	128	41	134	0	7	182
6466	4190s (+0.3s)	712	712	64	20	66	0	6	92
6467	4191s (+0.4s)	1408	1408	128	35	101	0	7	143
6468	4192s (+0.9s)	3808	3808	256	65	237	0	11	313
6469	4192s (+0.7s)	2944	2944	256	59	170	0	16	245
6470	4193s (+0.7s)	2856	2856	256	72	157	17	0	246
6471	4194s (+0.4s)	1372	1372	128	37	109	6	1	153
6472	4194s (+0.5s)	1664	1664	128	40	121	7	0	168
6473	4195s (+0.5s)	1548	1548	128	33	120	6	0	159
6474	4195s (+0.5s)	1872	1872	128	44	140	7	0	191
6475	4196s (+0.9s)	4100	4100	256	95	221	16	0	332
6476	4196s (+0.4s)	1028	1028	64	23	96	4	0	123
6477	4197s (+0.5s)	1684	1684	128	33	127	0	7	167
6478	4197s (+0.5s)	1776	1776	128	32	144	0	8	184
6479	4198s (+0.9s)	3936	3936	256	89	220	14	0	323
6480	4199s (+0.3s)	916	916	64	27	89	4	0	120
6481	4200s (+0.8s)	3216	3216	256	70	186	11	0	267
6482	4200s (+0.8s)	3360	3360	256	55	204	0	18	277
6483	4201s (+0.7s)	2680	2680	256	46	175	0	9	230
6484	4201s (+0.4s)	1184	1184	128	23	105	0	1	129
6485	4202s (+0.6s)	2692	2692	256	58	153	0	4	215
6486	4203s (+0.8s)	3252	3252	256	64	201	0	10	275
6487	4203s (+0.6s)	2136	2136	128	44	156	0	16	216
6488	4204s (+0.4s)	1484	1484	128	41	108	6	0	155
6489	4204s (+0.6s)	1940	1940	128	46	150	7	0	203
6490	4205s (+0.9s)	3688	3688	256	89	216	15	0	320
6491	4206s (+0.8s)	3396	3396	256	66	206	13	0	285
6492	4207s (+0.5s)	2112	2112	256	38	136	7	0	181
6493	4207s (+0.7s)	2996	2996	256	72	151	15	1	239
6494	4208s (+0.7s)	3120	3120	256	77	176	14	0	267
6495	4209s (+0.8s)	3324	3324	256	57	214	11	0	282
6496	4210s (+0.8s)	3512	3512	256	72	208	12	0	292
6497	4210s (+0.4s)	1432	1432	128	39	101	7	0	147
6498	4211s (+0.9s)	3856	3856	256	78	221	16	0	315
6499	4212s (+0.7s)	2792	2792	256	57	170	14	0	241
Episode	Time	Reward	Score	Highest	L	U	R	D	Steps
6500	4212s (+0.5s)	1732	1732	128	40	134	5	0	179
6501	4213s (+0.9s)	3672	3672	256	75	229	11	0	315
6502	4214s (+0.4s)	1216	1216	128	40	91	5	0	136
6503	4214s (+0.5s)	1732	1732	128	44	129	7	0	180
6504	4215s (+0.4s)	1400	1400	128	30	110	5	0	145
6505	4216s (+1.0s)	4392	4392	256	109	242	16	0	367
6506	4216s (+0.6s)	1904	1904	128	53	131	10	0	194
6507	4217s (+0.5s)	1596	1596	128	46	116	0	5	167
6508	4217s (+0.7s)	2800	2800	256	52	181	0	10	243
6509	4218s (+0.7s)	2480	2480	128	36	182	0	13	231
6510	4219s (+0.5s)	1588	1588	128	35	126	0	4	165
6511	4219s (+0.4s)	1120	1120	64	23	93	0	8	124
6512	4219s (+0.5s)	1700	1700	128	28	134	0	8	170
6513	4220s (+0.4s)	1428	1428	128	26	115	0	5	146
6514	4220s (+0.6s)	2268	2268	128	38	163	0	11	212
6515	4221s (+0.8s)	3220	3220	256	67	186	0	15	268
6516	4222s (+0.5s)	1652	1652	128	48	118	9	0	175
6517	4222s (+0.6s)	1924	1924	128	48	139	12	0	199
6518	4223s (+0.8s)	3524	3524	256	88	192	15	0	295
6519	4224s (+0.9s)	3672	3672	256	77	214	14	0	305
6520	4225s (+0.9s)	3796	3796	256	77	232	15	0	324
6521	4225s (+0.5s)	1628	1628	128	47	109	5	0	161
6522	4226s (+0.5s)	1500	1500	128	55	98	5	0	158
6523	4226s (+0.6s)	2000	2000	128	53	132	17	0	202
6524	4227s (+0.7s)	3276	3276	256	61	199	11	0	271
6525	4228s (+0.5s)	1820	1820	128	48	127	7	0	182
6526	4228s (+0.5s)	1824	1824	128	50	129	6	0	185
6527	4229s (+0.5s)	1668	1668	128	36	126	7	0	169
6528	4229s (+0.7s)	2764	2764	256	50	179	9	0	238
6529	4230s (+0.7s)	2744	2744	256	49	175	9	0	233
6530	4231s (+0.7s)	2840	2840	256	60	169	13	0	242
6531	4231s (+0.6s)	2360	2360	256	43	149	7	0	199
6532	4232s (+0.5s)	1868	1868	128	43	130	10	0	183
6533	4233s (+0.7s)	2776	2776	256	58	168	15	0	241
6534	4233s (+0.3s)	864	864	64	23	83	6	0	112
6535	4234s (+0.8s)	3376	3376	256	84	177	19	0	280
6536	4235s (+0.8s)	3416	3416	256	75	199	11	0	285
6537	4235s (+0.3s)	828	828	64	21	76	5	0	102
6538	4236s (+0.9s)	4080	4080	256	77	237	13	0	327
6539	4236s (+0.6s)	2612	2612	256	58	158	12	0	228
6540	4237s (+0.4s)	1236	1236	128	38	93	4	1	136
6541	4237s (+0.5s)	1668	1668	128	41	135	3	0	179
6542	4239s (+1.2s)	6172	6172	512	118	296	19	0	433
6543	4239s (+0.8s)	3316	3316	256	65	202	13	0	280
6544	4240s (+0.8s)	3540	3540	256	77	207	15	0	299
6545	4241s (+0.7s)	2860	2860	256	52	186	8	0	246
6546	4242s (+0.7s)	3056	3056	256	68	168	13	0	249
6547	4242s (+0.3s)	924	924	64	27	79	6	0	112
6548	4243s (+0.8s)	3400	3400	256	84	178	18	0	280
6549	4244s (+0.8s)	3368	3368	256	68	201	9	0	278
6550	4244s (+0.4s)	1372	1372	128	27	111	6	0	144
6551	4244s (+0.5s)	1548	1548	128	48	100	10	1	159
6552	4245s (+0.9s)	3956	3956	256	81	228	13	0	322
6553	4246s (+0.8s)	3500	3500	256	98	175	21	0	294
6554	4247s (+0.3s)	944	944	128	23	77	3	0	103
6555	4247s (+0.8s)	3140	3140	256	66	183	16	0	265
6556	4248s (+0.6s)	1944	1944	128	38	160	6	0	204
6557	4248s (+0.4s)	1412	1412	128	37	105	7	0	149
6558	4249s (+0.7s)	2908	2908	256	74	166	13	0	253
6559	4250s (+0.4s)	1504	1504	128	32	121	7	0	160
6560	4250s (+0.3s)	936	936	64	30	81	7	0	118
6561	4250s (+0.2s)	544	544	64	22	51	5	0	78
6562	4250s (+0.3s)	876	876	64	29	81	5	0	115
6563	4251s (+0.9s)	3820	3820	256	93	214	19	0	326
6564	4252s (+0.5s)	2188	2188	256	46	138	4	0	188
6565	4253s (+0.7s)	2912	2912	256	61	182	11	0	254
6566	4253s (+0.7s)	2696	2696	256	71	152	11	0	234
6567	4254s (+0.5s)	1492	1492	128	42	106	0	9	157
6568	4254s (+0.3s)	980	980	64	31	85	0	5	121
6569	4255s (+0.7s)	2964	2964	256	59	188	0	7	254
6570	4256s (+0.9s)	3544	3544	256	62	223	0	16	301
6571	4257s (+0.9s)	3640	3640	256	61	250	0	8	319
6572	4257s (+0.3s)	848	848	64	23	79	0	6	108
6573	4258s (+0.7s)	2876	2876	256	50	189	0	11	250
6574	4258s (+0.5s)	2028	2028	128	31	152	0	12	195
6575	4259s (+0.8s)	3372	3372	256	67	199	0	9	275
6576	4260s (+0.6s)	2780	2780	256	59	161	8	0	228
6577	4260s (+0.4s)	1392	1392	128	41	96	5	0	142
6578	4261s (+0.5s)	2084	2084	128	50	132	12	0	194
6579	4261s (+0.7s)	2760	2760	256	53	166	14	0	233
6580	4262s (+0.4s)	948	948	64	34	82	7	0	123
6581	4263s (+1.0s)	4136	4136	256	67	260	13	0	340
6582	4263s (+0.8s)	3140	3140	256	69	186	10	0	265
6583	4264s (+0.9s)	3720	3720	256	92	209	16	0	317
6584	4265s (+0.8s)	3228	3228	256	62	191	15	1	269
6585	4265s (+0.3s)	780	780	64	22	80	1	0	103
6586	4266s (+0.6s)	1916	1916	128	54	137	6	0	197
6587	4266s (+0.3s)	876	876	64	30	80	5	0	115
6588	4267s (+0.9s)	4228	4228	256	100	234	18	0	352
6589	4268s (+0.7s)	3108	3108	256	73	185	8	0	266
6590	4269s (+1.0s)	4248	4248	256	84	252	16	0	352
6591	4270s (+0.8s)	3344	3344	256	77	191	14	0	282
6592	4270s (+0.5s)	1956	1956	128	45	142	9	0	196
6593	4271s (+0.4s)	1192	1192	64	36	103	6	0	145
6594	4271s (+0.6s)	2492	2492	256	42	162	11	0	215
6595	4272s (+0.6s)	1964	1964	128	59	140	5	0	204
6596	4272s (+0.3s)	740	740	64	19	73	6	0	98
6597	4273s (+0.4s)	1436	1436	128	38	110	6	0	154
6598	4273s (+0.4s)	1172	1172	64	40	93	7	0	140
6599	4274s (+0.5s)	1792	1792	128	41	132	9	0	182
Episode	Time	Reward	Score	Highest	L	U	R	D	Steps
6600	4274s (+0.4s)	1528	1528	128	43	113	5	0	161
6601	4275s (+0.3s)	888	888	64	27	84	6	0	117
6602	4275s (+0.9s)	3496	3496	256	71	223	6	0	300
6603	4276s (+0.5s)	1652	1652	128	29	140	1	0	170
6604	4277s (+0.7s)	2916	2916	256	64	179	11	1	255
6605	4277s (+0.5s)	1604	1604	128	34	122	0	6	162
6606	4278s (+0.5s)	1636	1636	128	36	125	0	5	166
6607	4278s (+0.7s)	2968	2968	256	51	200	0	12	263
6608	4279s (+0.6s)	2480	2480	256	46	157	0	9	212
6609	4280s (+1.0s)	5200	5200	512	62	272	0	21	355
6610	4280s (+0.6s)	2424	2424	256	35	162	0	6	203
6611	4281s (+0.4s)	1428	1428	128	33	111	8	0	152
6612	4281s (+0.5s)	2128	2128	256	36	137	5	1	179
6613	4282s (+0.4s)	1344	1344	128	29	106	3	0	138
6614	4282s (+0.6s)	2244	2244	256	34	155	0	8	197
6615	4283s (+0.6s)	2608	2608	256	42	178	0	7	227
6616	4284s (+0.6s)	2532	2532	256	38	178	0	3	219
6617	4285s (+1.0s)	5304	5304	512	76	272	0	18	366
6618	4285s (+0.5s)	2188	2188	256	33	152	2	0	187
6619	4286s (+0.7s)	2796	2796	256	58	172	12	0	242
6620	4287s (+1.0s)	4372	4372	256	92	254	17	0	363
6621	4288s (+0.8s)	3240	3240	256	62	189	20	1	272
6622	4288s (+0.6s)	2024	2024	128	54	144	6	0	204
6623	4289s (+0.6s)	1964	1964	128	52	132	14	0	198
6624	4290s (+0.6s)	2684	2684	256	48	161	8	0	217
6625	4290s (+0.7s)	2656	2656	256	61	152	12	0	225
6626	4291s (+0.6s)	2712	2712	256	57	149	9	1	216
6627	4292s (+0.8s)	3420	3420	256	62	213	12	1	288
6628	4292s (+0.5s)	1724	1724	128	44	121	11	0	176
6629	4293s (+0.9s)	4416	4416	512	91	200	13	0	304
6630	4293s (+0.4s)	1424	1424	128	37	105	3	0	145
6631	4294s (+1.0s)	4912	4912	512	90	242	18	0	350
6632	4295s (+0.9s)	3952	3952	256	78	230	14	0	322
6633	4296s (+0.7s)	2848	2848	256	50	187	6	0	243
6634	4297s (+0.7s)	2628	2628	128	52	183	13	0	248
6635	4297s (+0.5s)	2088	2088	256	51	116	8	0	175
6636	4298s (+0.8s)	3272	3272	256	71	194	15	0	280
6637	4298s (+0.2s)	484	484	64	15	55	1	0	71
6638	4299s (+0.6s)	2472	2472	256	46	152	11	1	210
6639	4300s (+0.9s)	3972	3972	256	92	222	13	0	327
6640	4301s (+0.8s)	3440	3440	256	70	207	14	0	291
6641	4302s (+1.0s)	4052	4052	256	101	217	17	0	335
6642	4302s (+0.5s)	1800	1800	128	38	137	9	0	184
6643	4303s (+0.8s)	3156	3156	256	71	190	11	0	272
6644	4304s (+0.7s)	2800	2800	256	66	164	13	0	243
6645	4304s (+0.7s)	2892	2892	256	57	188	4	0	249
6646	4305s (+0.4s)	1472	1472	128	35	108	9	0	152
6647	4305s (+0.5s)	1788	1788	128	42	131	9	0	182
6648	4306s (+0.8s)	3364	3364	256	62	200	15	1	278
6649	4307s (+0.5s)	1660	1660	128	51	117	9	0	177
6650	4307s (+0.7s)	2696	2696	256	42	179	5	0	226
6651	4308s (+0.7s)	2760	2760	256	67	160	11	0	238
6652	4308s (+0.4s)	1444	1444	128	33	112	5	0	150
6653	4309s (+0.7s)	3124	3124	256	71	170	13	0	254
6654	4310s (+0.8s)	3212	3212	256	75	182	14	0	271
6655	4310s (+0.4s)	1332	1332	128	34	98	6	0	138
6656	4311s (+0.6s)	1936	1936	128	47	143	12	0	202
6657	4312s (+0.9s)	3984	3984	256	84	225	21	0	330
6658	4313s (+0.7s)	2616	2616	128	75	161	12	0	248
6659	4313s (+0.5s)	1592	1592	128	28	129	5	0	162
6660	4313s (+0.3s)	808	808	64	23	82	4	0	109
6661	4314s (+0.7s)	3096	3096	256	52	198	0	8	258
6662	4315s (+0.7s)	2888	2888	256	53	187	0	9	249
6663	4315s (+0.5s)	1736	1736	128	23	150	0	2	175
6664	4316s (+1.0s)	4024	4024	256	63	259	0	13	335
6665	4317s (+0.7s)	2812	2812	256	57	174	0	14	245
6666	4318s (+0.5s)	1612	1612	128	38	118	0	14	170
6667	4319s (+1.2s)	5960	5960	512	86	312	0	25	423
6668	4320s (+0.8s)	3144	3144	256	55	195	0	11	261
6669	4320s (+0.8s)	3516	3516	256	74	205	18	0	297
6670	4321s (+0.8s)	3308	3308	256	80	178	19	1	278
6671	4322s (+0.9s)	3596	3596	256	92	195	15	0	302
6672	4323s (+0.5s)	1864	1864	128	37	145	8	0	190
6673	4324s (+0.9s)	4516	4516	256	117	199	29	0	345
6674	4324s (+0.6s)	2496	2496	256	45	163	7	0	215
6675	4325s (+0.9s)	3952	3952	256	82	230	15	0	327
6676	4326s (+0.5s)	1800	1800	128	42	134	0	8	184
6677	4326s (+0.6s)	2648	2648	256	42	169	0	12	223
6678	4327s (+0.5s)	1780	1780	128	40	134	0	10	184
6679	4327s (+0.5s)	1852	1852	128	27	139	0	7	173
6680	4328s (+0.9s)	4224	4224	256	82	240	18	0	340
6681	4329s (+0.8s)	3376	3376	256	73	201	16	0	290
6682	4330s (+0.8s)	3420	3420	256	67	200	11	1	279
6683	4330s (+0.5s)	1808	1808	128	40	128	0	11	179
6684	4331s (+0.4s)	1420	1420	128	37	111	6	0	154
6685	4332s (+0.8s)	3496	3496	256	67	211	15	0	293
6686	4333s (+0.8s)	3416	3416	256	65	203	17	0	285
6687	4333s (+0.5s)	1856	1856	128	46	134	8	0	188
6688	4334s (+0.6s)	2288	2288	256	41	143	12	0	196
6689	4335s (+1.0s)	4156	4156	256	88	237	19	1	345
6690	4335s (+0.4s)	1252	1252	128	28	109	3	0	140
6691	4336s (+0.7s)	3212	3212	256	65	182	18	1	266
6692	4337s (+1.0s)	4120	4120	256	73	251	13	0	337
6693	4337s (+0.7s)	2864	2864	256	67	172	8	0	247
6694	4338s (+0.4s)	1412	1412	128	38	101	7	0	146
6695	4339s (+0.7s)	3084	3084	256	72	162	11	1	246
6696	4339s (+0.5s)	1572	1572	128	48	96	12	1	157
6697	4340s (+0.7s)	3012	3012	256	47	192	9	1	249
6698	4341s (+0.7s)	2876	2876	256	61	179	10	0	250
6699	4341s (+0.4s)	1156	1156	128	27	92	7	0	126
Episode	Time	Reward	Score	Highest	L	U	R	D	Steps
6700	4342s (+0.7s)	2748	2748	256	49	181	6	0	236
6701	4342s (+0.7s)	2880	2880	256	52	181	0	14	247
6702	4343s (+0.4s)	1112	1112	64	24	101	0	11	136
6703	4343s (+0.5s)	1640	1640	128	41	126	0	5	172
6704	4344s (+0.7s)	3092	3092	256	50	205	0	7	262
6705	4344s (+0.5s)	1796	1796	128	43	131	0	10	184
6706	4345s (+0.9s)	3528	3528	256	62	224	0	10	296
6707	4346s (+0.8s)	3304	3304	256	52	217	0	12	281
6708	4346s (+0.3s)	992	992	64	27	83	0	4	114
6709	4347s (+0.8s)	3524	3524	256	59	227	0	12	298
6710	4348s (+0.3s)	664	664	64	14	74	0	3	91
6711	4348s (+0.4s)	1072	1072	64	26	99	0	6	131
6712	4348s (+0.5s)	1700	1700	128	32	142	0	8	182
6713	4349s (+0.8s)	3460	3460	256	62	213	0	13	288
6714	4350s (+0.5s)	2108	2108	256	37	134	0	8	179
6715	4351s (+0.7s)	3140	3140	256	49	203	9	0	261
6716	4351s (+0.6s)	1904	1904	128	52	135	8	0	195
6717	4353s (+1.5s)	7592	7592	512	130	372	30	0	532
6718	4353s (+0.5s)	1700	1700	128	36	138	6	0	180
6719	4354s (+0.4s)	1312	1312	128	30	109	4	0	143
6720	4355s (+0.9s)	4024	4024	256	81	231	16	0	328
6721	4355s (+0.6s)	1928	1928	128	54	135	11	0	200
6722	4356s (+0.8s)	3224	3224	256	64	196	9	0	269
6723	4357s (+0.7s)	2836	2836	256	56	182	13	0	251
6724	4357s (+0.5s)	1800	1800	128	48	129	8	0	185
6725	4358s (+0.4s)	1220	1220	128	35	91	7	0	133
6726	4359s (+1.0s)	4268	4268	256	105	234	18	0	357
6727	4359s (+0.5s)	1784	1784	128	41	132	8	0	181
6728	4360s (+0.3s)	952	952	64	39	72	8	0	119
6729	4361s (+0.9s)	3988	3988	256	95	218	18	0	331
6730	4361s (+0.4s)	1432	1432	128	33	109	5	0	147
6731	4361s (+0.3s)	776	776	64	22	76	4	0	102
6732	4362s (+0.8s)	3772	3772	256	70	220	16	0	306
6733	4363s (+0.8s)	3504	3504	256	74	202	15	0	291
6734	4364s (+0.6s)	2460	2460	256	41	153	0	8	202
6735	4364s (+0.6s)	2616	2616	256	40	178	0	11	229
6736	4365s (+0.9s)	3920	3920	256	62	246	0	12	320
6737	4366s (+0.6s)	2552	2552	256	43	159	0	12	214
6738	4366s (+0.3s)	688	688	64	18	70	0	3	91
6739	4367s (+0.5s)	1772	1772	128	49	120	9	0	178
6740	4367s (+0.7s)	3104	3104	256	58	180	11	0	249
6741	4368s (+1.0s)	4132	4132	256	99	218	18	0	335
6742	4369s (+0.6s)	2060	2060	128	52	142	7	1	202
6743	4369s (+0.5s)	1672	1672	128	36	132	2	0	170
6744	4370s (+0.8s)	3340	3340	256	62	195	14	0	271
6745	4371s (+1.0s)	4360	4360	256	108	231	21	0	360
6746	4372s (+0.8s)	3496	3496	256	80	196	17	0	293
6747	4373s (+1.0s)	4236	4236	256	86	240	23	0	349
6748	4373s (+0.5s)	1712	1712	128	41	129	5	0	175
6749	4374s (+0.9s)	4552	4552	512	90	211	12	1	314
6750	4375s (+0.7s)	2728	2728	256	57	163	10	0	230
6751	4376s (+0.8s)	3356	3356	256	81	186	15	0	282
6752	4376s (+0.6s)	2312	2312	256	46	151	5	0	202
6753	4377s (+0.6s)	2560	2560	256	64	149	13	0	226
6754	4377s (+0.5s)	1736	1736	128	39	125	10	0	174
6755	4378s (+0.2s)	656	656	64	22	56	5	0	83
6756	4378s (+0.4s)	1492	1492	128	33	119	6	0	158
6757	4379s (+0.4s)	1396	1396	128	54	82	9	0	145
6758	4379s (+0.8s)	3564	3564	256	78	214	13	0	305
6759	4380s (+0.5s)	1572	1572	128	48	103	9	1	161
6760	4380s (+0.3s)	784	784	64	31	71	2	0	104
6761	4381s (+0.4s)	1488	1488	128	39	111	6	0	156
6762	4382s (+1.2s)	5824	5824	512	109	295	18	0	422
6763	4383s (+0.9s)	3796	3796	256	88	196	20	0	304
6764	4384s (+1.0s)	4168	4168	256	99	227	18	0	344
6765	4384s (+0.3s)	964	964	64	26	82	0	6	114
6766	4385s (+0.9s)	3944	3944	256	58	252	0	15	325
6767	4386s (+0.6s)	2124	2124	128	50	137	0	14	201
6768	4386s (+0.7s)	3272	3272	256	64	194	11	0	269
6769	4387s (+0.9s)	3724	3724	256	89	214	14	0	317
6770	4388s (+0.4s)	1388	1388	128	25	111	4	0	140
6771	4389s (+0.9s)	3976	3976	256	84	227	17	0	328
6772	4389s (+0.8s)	3296	3296	256	74	195	13	0	282
6773	4390s (+0.5s)	1580	1580	128	40	113	10	0	163
6774	4390s (+0.5s)	1764	1764	128	38	129	9	0	176
6775	4391s (+0.3s)	968	968	64	29	80	8	1	118
6776	4392s (+0.9s)	3956	3956	256	57	250	0	20	327
6777	4392s (+0.4s)	1312	1312	128	21	109	0	7	137
6778	4393s (+0.6s)	2604	2604	256	44	166	0	7	217
6779	4394s (+0.8s)	3452	3452	256	60	221	0	13	294
6780	4394s (+0.5s)	1888	1888	128	49	135	6	0	190
6781	4395s (+0.7s)	3080	3080	256	52	194	0	9	255
6782	4395s (+0.6s)	2616	2616	256	55	158	10	0	223
6783	4397s (+1.2s)	5868	5868	512	125	272	24	0	421
6784	4397s (+0.7s)	2904	2904	256	54	175	9	0	238
6785	4398s (+1.0s)	4456	4456	256	90	254	17	0	361
6786	4399s (+0.3s)	1132	1132	128	25	90	6	0	121
6787	4399s (+0.8s)	3428	3428	256	80	191	16	0	287
6788	4400s (+0.6s)	2560	2560	256	52	166	3	0	221
6789	4400s (+0.3s)	676	676	64	20	69	4	0	93
6790	4401s (+1.0s)	4288	4288	256	85	250	15	0	350
6791	4402s (+0.4s)	1064	1064	64	21	96	0	6	123
6792	4402s (+0.2s)	504	504	64	16	51	1	4	72
6793	4403s (+0.8s)	3496	3496	256	64	215	15	0	294
6794	4404s (+1.6s)	7944	7944	512	157	364	35	0	556
6795	4405s (+0.8s)	3244	3244	256	77	185	13	0	275
6796	4406s (+1.1s)	4540	4540	256	100	260	17	0	377
6797	4407s (+0.8s)	3424	3424	256	66	205	15	0	286
6798	4408s (+0.7s)	2852	2852	256	63	166	15	0	244
6799	4409s (+0.5s)	1976	1976	128	47	134	5	0	186
Episode	Time	Reward	Score	Highest	L	U	R	D	Steps
6800	4409s (+0.8s)	3420	3420	256	80	182	19	0	281
6801	4410s (+0.6s)	1984	1984	128	62	130	9	0	201
6802	4410s (+0.4s)	1144	1144	64	33	91	11	0	135
6803	4411s (+0.5s)	1732	1732	128	38	127	8	0	173
6804	4411s (+0.5s)	1828	1828	128	54	122	9	0	185
6805	4412s (+0.2s)	640	640	64	17	64	3	0	84
6806	4412s (+0.4s)	1476	1476	128	36	112	5	0	153
6807	4412s (+0.4s)	1060	1060	64	28	96	6	0	130
6808	4413s (+0.5s)	1624	1624	128	24	136	3	0	163
6809	4413s (+0.5s)	1700	1700	128	44	122	5	0	171
6810	4414s (+0.7s)	2828	2828	256	57	167	10	0	234
6811	4415s (+0.5s)	1692	1692	128	41	118	9	1	169
6812	4415s (+0.8s)	3200	3200	256	56	206	9	0	271
6813	4416s (+0.6s)	2104	2104	128	64	135	9	0	208
6814	4416s (+0.3s)	952	952	128	12	88	0	1	101
6815	4417s (+0.4s)	1180	1180	64	28	110	0	5	143
6816	4417s (+0.4s)	1412	1412	128	30	117	1	0	148
6817	4418s (+0.5s)	1792	1792	128	52	119	11	0	182
6818	4418s (+0.6s)	1884	1884	128	47	137	10	0	194
6819	4419s (+0.4s)	1324	1324	128	29	96	0	5	130
6820	4419s (+0.4s)	1044	1044	64	34	88	7	0	129
6821	4419s (+0.5s)	1920	1920	128	41	131	0	12	184
6822	4420s (+0.6s)	2540	2540	256	47	161	7	0	215
6823	4421s (+0.5s)	1896	1896	128	47	132	7	0	186
6824	4422s (+1.3s)	7056	7056	512	137	309	27	0	473
6825	4423s (+0.7s)	3188	3188	256	55	197	13	0	265
6826	4423s (+0.2s)	412	412	32	20	48	3	0	71
6827	4423s (+0.3s)	1100	1100	128	29	82	5	1	117
6828	4424s (+0.9s)	3816	3816	256	83	224	17	0	324
6829	4425s (+1.0s)	5072	5072	512	92	227	24	0	343
6830	4426s (+1.0s)	4212	4212	256	90	238	14	1	343
6831	4427s (+0.4s)	1216	1216	128	25	104	7	0	136
6832	4427s (+0.5s)	1904	1904	128	60	109	11	0	180
6833	4428s (+0.8s)	3552	3552	256	80	195	16	0	291
6834	4429s (+0.6s)	1916	1916	128	46	144	7	0	197
6835	4429s (+0.7s)	2608	2608	256	76	143	9	0	228
6836	4430s (+0.7s)	3316	3316	256	43	211	0	11	265
6837	4430s (+0.2s)	384	384	32	12	48	0	3	63
6838	4431s (+0.5s)	1588	1588	128	36	115	0	13	164
6839	4431s (+0.5s)	1780	1780	128	41	131	0	8	180
6840	4432s (+0.3s)	748	748	64	23	72	5	0	100
6841	4432s (+0.7s)	2408	2408	128	51	171	7	1	230
6842	4433s (+0.7s)	3188	3188	256	76	166	15	1	258
6843	4433s (+0.3s)	748	748	64	13	84	3	0	100
6844	4434s (+0.7s)	2948	2948	256	66	190	7	0	263
6845	4435s (+0.7s)	2756	2756	256	54	175	8	0	237
6846	4435s (+0.6s)	2652	2652	256	67	153	7	0	227
6847	4436s (+0.7s)	3196	3196	256	81	173	13	0	267
6848	4437s (+0.6s)	2508	2508	256	46	167	6	0	219
6849	4438s (+1.2s)	6200	6200	512	107	315	19	0	441
6850	4438s (+0.3s)	1036	1036	128	21	88	4	0	113
6851	4439s (+1.0s)	4240	4240	256	93	236	21	0	350
6852	4440s (+0.8s)	3236	3236	256	69	189	14	0	272
6853	4441s (+1.0s)	4252	4252	256	109	229	15	0	353
6854	4442s (+0.6s)	2540	2540	256	54	154	13	0	221
6855	4442s (+0.8s)	3236	3236	256	71	190	10	0	271
6856	4443s (+0.6s)	2136	2136	128	50	154	9	0	213
6857	4444s (+0.8s)	3488	3488	256	70	201	15	0	286
6858	4444s (+0.3s)	748	748	32	23	82	0	5	110
6859	4445s (+0.6s)	2076	2076	128	31	162	0	8	201
6860	4445s (+0.2s)	580	580	64	15	59	0	5	79
6861	4445s (+0.4s)	1364	1364	128	27	111	0	4	142
6862	4446s (+0.5s)	1848	1848	128	40	145	0	7	192
6863	4447s (+0.6s)	2344	2344	256	45	152	0	9	206
6864	4447s (+0.3s)	1140	1140	128	20	94	0	5	119
6865	4448s (+0.7s)	2924	2924	256	62	184	11	0	257
6866	4448s (+0.6s)	2572	2572	256	52	159	9	0	220
6867	4449s (+0.8s)	3432	3432	256	63	214	12	0	289
6868	4450s (+0.6s)	1956	1956	128	44	153	5	0	202
6869	4450s (+0.5s)	1540	1540	128	42	115	7	0	164
6870	4451s (+0.6s)	2200	2200	128	53	143	9	0	205
6871	4451s (+0.6s)	2076	2076	128	42	151	10	0	203
6872	4452s (+0.4s)	1392	1392	128	32	102	9	0	143
6873	4452s (+0.6s)	2144	2144	128	59	128	11	0	198
6874	4453s (+0.9s)	4188	4188	256	76	230	15	1	322
6875	4454s (+0.5s)	1856	1856	128	49	129	10	0	188
6876	4455s (+0.8s)	3488	3488	256	92	187	12	0	291
6877	4455s (+0.9s)	3764	3764	256	83	211	22	0	316
6878	4456s (+0.6s)	2132	2132	128	67	121	16	1	205
6879	4457s (+0.6s)	1884	1884	128	37	152	5	0	194
6880	4457s (+0.5s)	1740	1740	128	44	126	6	0	176
6881	4458s (+0.7s)	3000	3000	256	58	180	0	7	245
6882	4458s (+0.5s)	1552	1552	128	28	134	0	5	167
6883	4459s (+0.9s)	3740	3740	256	78	217	0	13	308
6884	4460s (+0.6s)	2496	2496	256	61	143	0	8	212
6885	4460s (+0.6s)	1908	1908	128	41	149	0	5	195
6886	4461s (+0.3s)	856	856	64	27	78	0	5	110
6887	4461s (+0.6s)	1912	1912	128	39	149	0	9	197
6888	4462s (+0.9s)	3964	3964	256	83	227	15	0	325
6889	4463s (+0.8s)	3488	3488	256	72	214	10	0	296
6890	4464s (+0.6s)	2348	2348	128	53	166	7	0	226
6891	4464s (+0.3s)	956	956	64	23	90	5	0	118
6892	4464s (+0.3s)	800	800	64	35	69	3	0	107
6893	4465s (+0.5s)	1756	1756	128	45	133	7	0	185
6894	4465s (+0.6s)	2464	2464	256	52	147	2	1	202
6895	4466s (+0.8s)	3392	3392	256	70	198	15	0	283
6896	4467s (+0.4s)	1200	1200	64	36	91	9	0	136
6897	4467s (+0.4s)	1436	1436	128	34	104	9	0	147
6898	4468s (+0.4s)	1504	1504	128	45	102	7	1	155
6899	4468s (+0.5s)	1616	1616	128	34	132	5	0	171
Episode	Time	Reward	Score	Highest	L	U	R	D	Steps
6900	4469s (+0.7s)	2796	2796	256	53	180	9	0	242
6901	4470s (+0.8s)	3504	3504	256	68	214	13	0	295
6902	4470s (+0.3s)	804	804	64	35	70	3	0	108
6903	4470s (+0.4s)	1312	1312	128	36	101	6	0	143
6904	4471s (+0.5s)	1780	1780	128	40	137	4	0	181
6905	4472s (+0.8s)	3368	3368	256	59	211	8	0	278
6906	4472s (+0.5s)	1596	1596	128	39	121	6	0	166
6907	4473s (+0.4s)	1548	1548	128	46	103	11	0	160
6908	4473s (+0.6s)	2372	2372	128	56	155	10	0	221
6909	4474s (+0.6s)	2676	2676	256	46	174	0	9	229
6910	4475s (+0.8s)	3348	3348	256	55	211	0	17	283
6911	4475s (+0.5s)	1616	1616	128	33	120	0	8	161
6912	4476s (+0.8s)	3444	3444	256	65	213	0	13	291
6913	4476s (+0.5s)	1640	1640	128	42	115	9	0	166
6914	4477s (+0.8s)	3384	3384	256	72	208	12	0	292
6915	4478s (+0.7s)	2532	2532	128	59	169	11	0	239
6916	4479s (+0.7s)	2756	2756	256	59	165	8	0	232
6917	4479s (+0.5s)	1792	1792	128	32	140	6	0	178
6918	4480s (+0.7s)	3268	3268	256	68	184	14	0	266
6919	4480s (+0.3s)	824	824	64	16	88	2	1	107
6920	4481s (+0.5s)	1508	1508	128	47	104	9	0	160
6921	4481s (+0.5s)	1612	1612	128	47	119	4	0	170
6922	4482s (+0.8s)	3552	3552	256	78	216	8	0	302
6923	4483s (+0.5s)	1792	1792	128	37	139	8	0	184
6924	4483s (+0.5s)	2000	2000	256	32	126	0	6	164
6925	4484s (+0.7s)	2644	2644	256	49	179	0	7	235
6926	4484s (+0.8s)	3332	3332	256	55	206	0	18	279
6927	4485s (+0.5s)	1800	1800	128	35	138	0	12	185
6928	4486s (+0.8s)	3660	3660	256	75	209	15	0	299
6929	4486s (+0.4s)	1428	1428	128	39	100	8	0	147
6930	4487s (+0.5s)	1544	1544	128	42	117	6	0	165
6931	4487s (+0.5s)	1704	1704	128	49	111	7	0	167
6932	4488s (+0.5s)	1792	1792	128	46	129	8	0	183
6933	4488s (+0.5s)	1860	1860	128	45	122	11	0	178
6934	4489s (+1.0s)	4348	4348	256	92	242	16	0	350
6935	4490s (+1.0s)	4008	4008	256	91	232	13	0	336
6936	4491s (+0.7s)	2836	2836	256	69	165	11	0	245
6937	4492s (+0.6s)	2688	2688	256	61	158	11	1	231
6938	4492s (+0.8s)	3376	3376	256	72	209	9	0	290
6939	4493s (+0.4s)	1304	1304	64	55	80	11	0	146
6940	4494s (+0.7s)	2876	2876	256	52	188	9	1	250
6941	4495s (+1.0s)	4424	4424	256	115	227	22	0	364
6942	4495s (+0.4s)	1336	1336	128	28	110	2	0	140
6943	4496s (+0.7s)	3208	3208	256	83	166	16	0	265
6944	4496s (+0.6s)	2188	2188	128	68	128	11	0	207
6945	4497s (+0.5s)	1584	1584	128	39	119	9	0	167
6946	4498s (+0.9s)	3616	3616	256	73	222	11	0	306
6947	4498s (+0.7s)	2572	2572	128	72	153	17	0	242
6948	4499s (+0.3s)	684	684	64	20	67	0	2	89
6949	4499s (+0.5s)	1580	1580	128	31	126	0	10	167
6950	4500s (+0.5s)	1812	1812	128	30	149	0	9	188
6951	4500s (+0.5s)	1824	1824	128	41	144	0	5	190
6952	4501s (+0.5s)	1876	1876	128	36	143	0	10	189
6953	4501s (+0.4s)	1164	1164	64	37	95	6	0	138
6954	4502s (+0.5s)	1720	1720	128	54	114	7	2	177
6955	4503s (+1.1s)	5348	5348	512	118	247	18	1	384
6956	4504s (+0.8s)	3340	3340	256	76	189	17	0	282
6957	4504s (+0.7s)	3052	3052	256	67	173	14	0	254
6958	4505s (+0.4s)	1400	1400	128	37	91	12	0	140
6959	4505s (+0.6s)	2104	2104	128	43	148	11	0	202
6960	4506s (+0.4s)	1292	1292	128	26	108	5	0	139
6961	4506s (+0.8s)	3196	3196	256	59	195	12	0	266
6962	4507s (+0.5s)	1720	1720	128	48	121	3	0	172
6963	4507s (+0.4s)	1032	1032	64	38	86	8	0	132
6964	4508s (+0.5s)	1712	1712	128	32	138	5	0	175
6965	4509s (+1.0s)	4300	4300	256	88	248	17	0	353
6966	4509s (+0.7s)	2860	2860	256	70	166	10	0	246
6967	4510s (+0.8s)	3268	3268	256	70	192	13	0	275
6968	4511s (+0.7s)	3152	3152	256	69	177	17	0	263
6969	4511s (+0.4s)	1180	1180	128	25	97	5	0	127
6970	4512s (+0.4s)	1452	1452	128	41	103	8	0	152
6971	4512s (+0.4s)	1016	1016	64	24	92	5	1	122
6972	4513s (+0.9s)	3908	3908	256	73	229	14	0	316
6973	4514s (+0.5s)	1744	1744	128	41	127	8	0	176
6974	4515s (+1.4s)	7248	7248	512	121	348	27	1	497
6975	4516s (+0.9s)	3856	3856	256	63	238	14	0	315
6976	4517s (+0.8s)	3664	3664	256	80	205	14	0	299
6977	4517s (+0.1s)	236	236	32	8	34	0	4	46
6978	4518s (+0.7s)	3084	3084	256	50	193	0	12	255
6979	4518s (+0.7s)	3092	3092	256	50	206	0	7	263
6980	4519s (+0.8s)	3640	3640	256	50	232	0	15	297
6981	4520s (+0.8s)	3356	3356	256	69	192	14	0	275
6982	4520s (+0.3s)	748	748	64	21	71	7	1	100
6983	4521s (+0.3s)	796	796	64	24	74	4	0	102
6984	4521s (+0.4s)	1272	1272	128	26	104	4	1	135
6985	4522s (+0.6s)	2448	2448	256	50	150	8	1	209
6986	4523s (+0.8s)	3616	3616	256	94	198	15	0	307
6987	4524s (+1.0s)	4164	4164	256	75	257	11	0	343
6988	4524s (+0.7s)	3128	3128	256	81	166	14	0	261
6989	4525s (+0.4s)	1144	1144	64	38	89	6	0	133
6990	4525s (+0.6s)	2492	2492	256	56	149	9	0	214
6991	4526s (+1.0s)	4980	4980	512	81	252	12	0	345
6992	4527s (+0.9s)	3976	3976	256	85	229	14	0	328
6993	4528s (+0.6s)	1908	1908	128	51	132	12	0	195
6994	4528s (+0.4s)	1476	1476	128	38	101	5	0	144
6995	4529s (+0.8s)	3512	3512	256	66	212	14	0	292
6996	4529s (+0.5s)	1612	1612	128	34	131	5	0	170
6997	4530s (+0.5s)	1844	1844	128	50	128	7	0	185
6998	4530s (+0.5s)	1512	1512	128	38	119	4	0	161
6999	4531s (+0.4s)	1380	1380	128	28	114	7	0	149
Episode	Time	Reward	Score	Highest	L	U	R	D	Steps
7000	4532s (+0.8s)	3356	3356	256	65	213	7	0	285
7001	4533s (+0.9s)	3684	3684	256	78	205	21	0	304
7002	4533s (+0.7s)	2796	2796	256	61	169	0	12	242
7003	4534s (+0.6s)	2704	2704	256	45	177	0	13	235
7004	4535s (+0.8s)	3508	3508	256	63	214	0	14	291
7005	4536s (+0.8s)	3376	3376	256	63	206	0	11	280
7006	4536s (+0.6s)	2496	2496	256	42	165	0	8	215
7007	4537s (+0.8s)	3524	3524	256	50	229	0	17	296
7008	4538s (+0.8s)	3272	3272	256	62	203	0	11	276
7009	4539s (+1.1s)	5536	5536	512	87	283	0	18	388
7010	4539s (+0.3s)	760	760	64	17	78	0	4	99
7011	4540s (+0.6s)	2220	2220	128	46	156	8	0	210
7012	4540s (+0.5s)	1744	1744	128	38	127	12	0	177
7013	4541s (+0.5s)	1756	1756	128	41	130	4	0	175
7014	4542s (+0.6s)	2060	2060	128	55	145	13	0	213
7015	4542s (+0.3s)	964	964	64	27	85	0	5	117
7016	4542s (+0.4s)	1348	1348	128	31	100	0	7	138
7017	4543s (+0.4s)	1432	1432	128	24	119	0	4	147
7018	4543s (+0.7s)	3136	3136	256	57	192	14	0	263
7019	4544s (+0.3s)	768	768	64	24	70	6	0	100
7020	4545s (+0.9s)	3732	3732	256	80	207	17	0	304
7021	4545s (+0.7s)	2920	2920	256	51	198	7	0	256
7022	4546s (+1.0s)	4268	4268	256	67	275	0	11	353
7023	4547s (+0.6s)	2176	2176	128	40	150	0	14	204
7024	4547s (+0.4s)	1064	1064	64	34	90	0	5	129
7025	4548s (+0.7s)	3088	3088	256	53	187	10	1	251
7026	4549s (+0.6s)	2424	2424	256	46	154	9	0	209
7027	4550s (+1.0s)	4372	4372	256	88	258	10	0	356
7028	4550s (+0.6s)	2472	2472	256	42	167	6	0	215
7029	4551s (+0.7s)	3088	3088	256	57	183	13	0	253
7030	4551s (+0.5s)	1652	1652	128	39	120	8	1	168
7031	4552s (+0.5s)	1792	1792	128	42	136	4	1	183
7032	4552s (+0.5s)	2156	2156	256	34	141	5	1	181
7033	4553s (+1.0s)	4164	4164	256	101	219	17	0	337
7034	4554s (+1.0s)	4588	4588	256	100	241	22	0	363
7035	4555s (+0.4s)	1120	1120	128	21	95	3	0	119
7036	4555s (+0.5s)	1816	1816	128	51	122	12	0	185
7037	4556s (+1.0s)	4484	4484	256	104	244	19	0	367
7038	4557s (+0.9s)	3812	3812	256	88	221	14	0	323
7039	4558s (+0.6s)	1940	1940	128	55	139	9	0	203
7040	4558s (+0.4s)	1436	1436	128	36	108	5	0	149
7041	4560s (+1.3s)	6432	6432	512	106	321	28	0	455
7042	4560s (+0.6s)	2544	2544	256	47	171	5	0	223
7043	4561s (+0.4s)	1544	1544	128	31	113	0	5	149
7044	4561s (+0.7s)	2776	2776	256	52	173	0	12	237
7045	4562s (+0.7s)	2732	2732	128	49	188	0	13	250
7046	4563s (+1.0s)	4508	4508	256	97	251	21	0	369
7047	4565s (+1.4s)	6808	6808	512	139	333	28	0	500
7048	4566s (+1.0s)	4280	4280	256	90	233	22	0	345
7049	4566s (+0.5s)	2288	2288	256	42	139	10	0	191
7050	4567s (+0.8s)	3520	3520	256	67	213	19	0	299
7051	4567s (+0.5s)	1868	1868	128	39	147	5	0	191
7052	4568s (+0.8s)	3252	3252	256	87	172	17	0	276
7053	4569s (+0.4s)	1300	1300	128	24	105	3	0	132
7054	4569s (+0.5s)	1728	1728	128	37	126	9	1	173
7055	4570s (+1.2s)	5780	5780	512	91	293	27	0	411
7056	4571s (+0.5s)	1924	1924	128	36	144	9	0	189
7057	4572s (+1.3s)	6560	6560	512	128	312	30	1	471
7058	4573s (+0.4s)	1224	1224	128	28	100	5	0	133
7059	4573s (+0.4s)	1472	1472	128	43	105	8	0	156
7060	4574s (+0.4s)	1236	1236	64	32	100	9	0	141
7061	4574s (+0.7s)	2844	2844	256	61	167	15	0	243
7062	4575s (+0.7s)	2928	2928	256	62	169	13	0	244
7063	4576s (+0.7s)	2868	2868	256	62	173	13	0	248
7064	4577s (+0.8s)	3368	3368	256	74	202	13	0	289
7065	4577s (+0.8s)	3516	3516	256	60	219	14	0	293
7066	4579s (+1.1s)	4640	4640	256	114	252	19	0	385
7067	4580s (+1.0s)	4304	4304	256	92	252	18	0	362
7068	4580s (+0.7s)	2576	2576	256	53	168	9	0	230
7069	4581s (+0.8s)	3476	3476	256	55	221	0	13	289
7070	4582s (+0.7s)	2900	2900	256	53	194	0	5	252
7071	4582s (+0.4s)	1472	1472	128	31	112	0	6	149
7072	4583s (+0.4s)	1420	1420	128	34	101	0	10	145
7073	4583s (+0.6s)	2372	2372	256	43	146	6	0	195
7074	4584s (+0.4s)	1252	1252	128	38	90	6	0	134
7075	4585s (+1.1s)	5512	5512	512	84	292	16	0	392
7076	4585s (+0.5s)	1600	1600	128	46	102	13	0	161
7077	4586s (+0.7s)	2780	2780	256	73	151	13	1	238
7078	4587s (+0.8s)	3532	3532	256	69	212	16	0	297
7079	4587s (+0.5s)	1804	1804	128	55	122	9	0	186
7080	4588s (+0.7s)	2808	2808	256	57	171	12	0	240
7081	4588s (+0.6s)	2116	2116	128	45	137	13	0	195
7082	4589s (+0.7s)	2784	2784	256	54	179	7	0	240
7083	4590s (+1.0s)	4144	4144	256	79	241	19	0	339
7084	4590s (+0.4s)	1240	1240	128	32	97	4	0	133
7085	4591s (+0.6s)	2608	2608	256	58	158	11	0	227
7086	4592s (+0.5s)	1732	1732	128	40	127	7	0	174
7087	4592s (+0.8s)	3376	3376	256	70	208	12	0	290
7088	4593s (+0.6s)	1860	1860	128	51	140	4	0	195
7089	4593s (+0.4s)	1408	1408	128	44	93	4	0	141
7090	4594s (+0.4s)	1408	1408	128	37	104	7	0	148
7091	4594s (+0.5s)	1648	1648	128	33	128	7	0	168
7092	4595s (+0.8s)	3484	3484	256	58	219	13	0	290
7093	4596s (+0.8s)	3624	3624	256	79	205	13	0	297
7094	4596s (+0.3s)	676	676	64	18	72	0	4	94
7095	4597s (+0.8s)	3472	3472	256	65	205	0	18	288
7096	4597s (+0.3s)	744	744	64	25	67	0	6	98
7097	4598s (+0.9s)	3760	3760	256	63	236	0	16	315
7098	4599s (+0.5s)	1924	1924	128	46	127	0	12	185
7099	4600s (+0.6s)	2468	2468	128	69	150	10	0	229
Episode	Time	Reward	Score	Highest	L	U	R	D	Steps
7100	4600s (+0.3s)	824	824	64	19	85	3	0	107
7101	4600s (+0.6s)	2060	2060	128	54	141	10	0	205
7102	4601s (+0.5s)	1640	1640	128	43	124	5	0	172
7103	4602s (+0.6s)	2168	2168	128	48	153	11	0	212
7104	4602s (+0.5s)	1900	1900	128	49	138	6	0	193
7105	4602s (+0.4s)	1256	1256	128	34	95	6	0	135
7106	4603s (+0.5s)	1864	1864	128	52	124	13	1	190
7107	4604s (+0.8s)	3420	3420	256	62	211	13	0	286
7108	4604s (+0.6s)	2108	2108	128	52	141	13	0	206
7109	4605s (+0.5s)	1624	1624	128	44	116	13	0	173
7110	4606s (+0.9s)	3716	3716	256	82	197	18	0	297
7111	4607s (+1.0s)	4180	4180	256	110	209	20	1	340
7112	4608s (+0.8s)	3424	3424	256	81	191	10	0	282
7113	4608s (+0.3s)	780	780	64	19	77	7	1	104
7114	4609s (+0.8s)	3200	3200	256	59	196	13	0	268
7115	4609s (+0.8s)	3380	3380	256	67	205	12	0	284
7116	4610s (+0.3s)	840	840	64	22	82	6	0	110
7117	4610s (+0.5s)	1868	1868	128	51	131	8	0	190
7118	4611s (+0.5s)	1872	1872	128	54	121	13	0	188
7119	4612s (+0.8s)	3212	3212	256	66	195	10	0	271
7120	4612s (+0.7s)	2908	2908	256	52	173	14	0	239
7121	4613s (+0.5s)	1548	1548	128	39	115	7	0	161
7122	4613s (+0.5s)	1536	1536	128	35	117	6	0	158
7123	4614s (+0.5s)	1780	1780	128	48	113	16	0	177
7124	4615s (+0.9s)	4100	4100	256	81	225	27	0	333
7125	4615s (+0.5s)	1836	1836	128	46	130	11	0	187
7126	4615s (+0.2s)	348	348	32	9	46	1	0	56
7127	4616s (+0.5s)	1688	1688	128	39	129	6	0	174
7128	4617s (+0.6s)	2652	2652	256	49	163	11	0	223
7129	4617s (+0.4s)	1412	1412	128	39	96	8	0	143
7130	4617s (+0.4s)	1436	1436	128	44	96	7	0	147
7131	4618s (+0.2s)	460	460	64	13	48	0	5	66
7132	4618s (+0.2s)	324	324	32	9	47	0	3	59
7133	4618s (+0.5s)	2228	2228	256	36	141	1	7	185
7134	4619s (+0.5s)	1732	1732	128	30	137	0	7	174
7135	4619s (+0.6s)	2076	2076	128	45	159	0	7	211
7136	4620s (+0.6s)	2040	2040	128	39	147	0	11	197
7137	4621s (+0.9s)	3976	3976	256	71	241	0	16	328
7138	4622s (+0.7s)	3020	3020	256	68	173	9	0	250
7139	4622s (+0.6s)	2128	2128	128	50	152	9	0	211
7140	4623s (+0.4s)	1148	1148	64	31	95	7	1	134
7141	4624s (+0.8s)	3548	3548	256	81	196	17	0	294
7142	4624s (+0.8s)	3020	3020	256	49	195	0	21	265
7143	4625s (+0.5s)	1852	1852	128	29	151	0	3	183
7144	4625s (+0.2s)	488	488	32	20	56	0	3	79
7145	4626s (+0.9s)	3980	3980	256	52	263	0	14	329
7146	4627s (+0.7s)	2720	2720	256	53	169	9	1	232
7147	4627s (+0.7s)	3360	3360	256	79	184	13	0	276
7148	4628s (+0.5s)	1620	1620	64	44	122	10	0	176
7149	4629s (+0.8s)	3388	3388	256	78	195	15	0	288
7150	4629s (+0.5s)	1688	1688	128	37	129	8	0	174
7151	4630s (+0.6s)	2300	2300	256	46	149	8	0	203
7152	4630s (+0.3s)	716	716	64	19	73	3	1	96
7153	4631s (+0.5s)	1788	1788	128	48	123	5	0	176
7154	4631s (+0.7s)	3224	3224	256	76	176	16	1	269
7155	4632s (+0.4s)	1344	1344	128	32	100	4	0	136
7156	4632s (+0.6s)	2492	2492	256	48	157	9	0	214
7157	4633s (+0.4s)	1160	1160	64	34	97	6	0	137
7158	4634s (+0.8s)	3544	3544	256	68	217	15	0	300
7159	4634s (+0.5s)	1928	1928	128	51	140	9	0	200
7160	4635s (+0.6s)	2172	2172	128	50	149	5	0	204
7161	4636s (+0.8s)	3476	3476	256	83	191	14	0	288
7162	4636s (+0.5s)	1464	1464	64	55	101	6	0	162
7163	4637s (+0.5s)	1848	1848	128	48	132	5	0	185
7164	4637s (+0.5s)	1652	1652	128	42	128	5	0	175
7165	4638s (+0.9s)	3824	3824	256	91	213	18	0	322
7166	4638s (+0.5s)	1668	1668	128	35	126	3	0	164
7167	4639s (+0.8s)	3976	3976	256	95	187	17	2	301
7168	4640s (+1.1s)	5856	5856	512	102	298	18	0	418
7169	4642s (+0.9s)	3880	3880	256	87	213	20	0	320
7170	4642s (+0.4s)	1520	1520	128	29	113	7	0	149
7171	4643s (+0.9s)	4164	4164	256	77	246	14	0	337
7172	4644s (+0.7s)	3040	3040	256	58	187	10	0	255
7173	4644s (+0.8s)	3432	3432	256	78	195	15	0	288
7174	4645s (+0.6s)	2640	2640	256	52	160	9	0	221
7175	4646s (+0.6s)	2396	2396	256	48	145	10	0	203
7176	4646s (+0.4s)	1452	1452	128	27	117	4	0	148
7177	4647s (+1.0s)	4152	4152	256	94	226	20	0	340
7178	4648s (+0.9s)	3956	3956	256	78	229	16	0	323
7179	4649s (+1.1s)	5444	5444	512	99	260	21	0	380
7180	4650s (+0.5s)	1836	1836	128	43	135	8	0	186
7181	4650s (+0.4s)	1228	1228	128	24	98	0	4	126
7182	4650s (+0.5s)	1532	1532	128	28	127	0	6	161
7183	4651s (+0.7s)	3264	3264	256	57	202	0	6	265
7184	4652s (+0.5s)	1692	1692	128	30	138	0	7	175
7185	4653s (+0.9s)	3592	3592	256	68	219	0	17	304
7186	4653s (+0.5s)	2024	2024	128	33	141	0	11	185
7187	4654s (+0.5s)	1596	1596	128	37	116	0	6	159
7188	4655s (+1.0s)	4184	4184	256	76	252	0	20	348
7189	4655s (+0.4s)	988	988	64	33	80	0	9	122
7190	4656s (+0.9s)	3548	3548	256	69	221	0	11	301
7191	4657s (+0.9s)	4212	4212	256	84	246	13	0	343
7192	4657s (+0.6s)	2440	2440	256	53	144	10	0	207
7193	4658s (+0.5s)	1984	1984	128	53	130	12	0	195
7194	4658s (+0.3s)	1160	1160	128	29	95	2	0	126
7195	4659s (+0.5s)	1784	1784	128	55	118	12	0	185
7196	4659s (+0.3s)	1120	1120	128	37	82	6	0	125
7197	4660s (+0.6s)	2524	2524	256	46	167	9	0	222
7198	4661s (+0.8s)	3820	3820	256	90	201	15	0	306
7199	4661s (+0.8s)	3320	3320	256	71	195	15	0	281
Episode	Time	Reward	Score	Highest	L	U	R	D	Steps
7200	4662s (+0.6s)	2464	2464	256	47	154	7	0	208
7201	4663s (+0.5s)	1860	1860	128	45	123	9	0	177
7202	4663s (+0.5s)	1736	1736	128	52	115	8	0	175
7203	4664s (+0.5s)	1608	1608	128	48	113	8	0	169
7204	4665s (+1.0s)	4304	4304	256	88	243	23	0	354
7205	4665s (+0.7s)	2644	2644	256	47	177	0	8	232
7206	4666s (+0.5s)	1648	1648	128	43	123	0	8	174
7207	4666s (+0.5s)	1800	1800	128	37	139	0	9	185
7208	4667s (+0.4s)	1308	1308	128	31	102	9	0	142
7209	4667s (+0.6s)	2608	2608	256	57	152	11	1	221
7210	4668s (+1.0s)	4316	4316	256	97	237	22	1	357
7211	4669s (+0.7s)	2836	2836	256	63	166	16	0	245
7212	4669s (+0.4s)	1420	1420	128	29	110	6	0	145
7213	4670s (+0.7s)	2788	2788	256	52	179	9	0	240
7214	4670s (+0.2s)	396	396	32	13	48	4	0	65
7215	4671s (+0.7s)	3168	3168	256	66	178	15	0	259
7216	4672s (+0.5s)	1900	1900	128	44	138	11	0	193
7217	4672s (+0.7s)	3072	3072	256	55	188	9	0	252
7218	4673s (+0.3s)	740	740	64	26	68	3	0	97
7219	4674s (+0.9s)	3920	3920	256	82	225	13	0	320
7220	4674s (+0.9s)	3596	3596	256	80	206	14	1	301
7221	4675s (+0.8s)	3196	3196	256	67	186	13	0	266
7222	4675s (+0.3s)	696	696	64	24	59	5	0	88
7223	4676s (+0.8s)	3512	3512	256	85	196	16	0	297
7224	4677s (+0.4s)	1184	1184	64	34	104	4	0	142
7225	4677s (+0.6s)	1900	1900	128	44	145	4	0	193
7226	4678s (+0.9s)	4108	4108	256	86	231	17	1	335
7227	4679s (+1.0s)	4256	4256	256	83	254	17	0	354
7228	4680s (+0.4s)	1300	1300	128	30	103	4	0	137
7229	4680s (+0.6s)	2528	2528	256	62	152	10	0	224
7230	4681s (+0.5s)	1560	1560	128	48	107	7	0	162
7231	4681s (+0.4s)	1552	1552	128	38	116	0	6	160
7232	4682s (+0.5s)	1788	1788	128	32	141	0	9	182
7233	4683s (+0.9s)	3940	3940	256	64	243	0	17	324
7234	4683s (+0.7s)	2840	2840	256	51	191	0	10	252
7235	4684s (+0.7s)	3224	3224	256	58	193	0	13	264
7236	4685s (+0.8s)	3308	3308	256	71	200	0	14	285
7237	4685s (+0.5s)	1744	1744	128	45	128	10	0	183
7238	4686s (+0.3s)	860	860	64	34	67	9	0	110
7239	4686s (+0.6s)	2204	2204	128	61	131	15	0	207
7240	4687s (+0.6s)	1940	1940	128	46	138	9	0	193
7241	4687s (+0.5s)	1872	1872	128	41	143	7	0	191
7242	4688s (+0.5s)	1640	1640	128	45	111	9	1	166
7243	4689s (+0.8s)	3452	3452	256	69	205	13	0	287
7244	4690s (+1.0s)	4224	4224	256	94	235	21	0	350
7245	4690s (+0.5s)	1800	1800	128	46	131	8	0	185
7246	4691s (+0.5s)	1632	1632	128	47	107	9	1	164
7247	4691s (+0.5s)	1700	1700	128	42	116	0	7	165
7248	4692s (+0.7s)	2752	2752	256	49	174	0	13	236
7249	4693s (+0.7s)	3208	3208	256	62	189	13	1	265
7250	4693s (+0.9s)	3592	3592	256	78	214	20	0	312
7251	4694s (+0.4s)	1476	1476	128	31	117	5	0	153
7252	4694s (+0.3s)	896	896	64	26	76	7	0	109
7253	4694s (+0.2s)	628	628	64	14	70	2	0	86
7254	4695s (+0.6s)	2604	2604	256	51	164	11	0	226
7255	4695s (+0.3s)	704	704	64	18	70	0	3	91
7256	4696s (+0.3s)	684	684	32	19	74	0	3	96
7257	4696s (+0.8s)	3412	3412	256	60	212	0	13	285
7258	4697s (+0.5s)	1764	1764	128	37	139	0	5	181
7259	4698s (+0.7s)	2788	2788	256	56	173	11	0	240
7260	4699s (+0.9s)	3596	3596	256	81	203	17	0	301
7261	4699s (+0.4s)	1276	1276	128	30	103	7	0	140
7262	4699s (+0.4s)	1368	1368	128	43	101	4	0	148
7263	4700s (+0.4s)	1204	1204	128	34	93	4	1	132
7264	4700s (+0.3s)	888	888	64	24	76	0	7	107
7265	4701s (+0.6s)	2228	2228	128	36	163	0	13	212
7266	4701s (+0.6s)	2264	2264	128	42	169	0	9	220
7267	4702s (+0.5s)	1916	1916	128	43	126	0	13	182
7268	4703s (+0.9s)	3956	3956	256	78	224	0	20	322
7269	4703s (+0.5s)	1688	1688	128	29	131	0	8	168
7270	4704s (+0.4s)	1324	1324	128	38	103	1	0	142
7271	4704s (+0.8s)	3220	3220	256	78	175	13	0	266
7272	4705s (+0.7s)	2964	2964	256	69	173	10	0	252
7273	4706s (+0.6s)	2000	2000	128	65	129	9	0	203
7274	4706s (+0.6s)	2484	2484	256	63	137	11	1	212
7275	4707s (+1.0s)	4196	4196	256	78	251	16	0	345
7276	4708s (+0.8s)	3384	3384	256	71	198	14	0	283
7277	4708s (+0.4s)	1220	1220	128	35	82	7	0	124
7278	4709s (+1.0s)	4184	4184	256	78	251	19	0	348
7279	4710s (+1.0s)	4252	4252	256	88	243	21	1	353
7280	4711s (+0.7s)	2816	2816	256	64	168	8	0	240
7281	4711s (+0.4s)	1364	1364	128	27	110	6	0	143
7282	4712s (+0.6s)	2444	2444	128	67	151	9	0	227
7283	4713s (+0.6s)	2384	2384	256	51	146	8	0	205
7284	4713s (+0.2s)	676	676	64	20	63	4	1	88
7285	4714s (+0.9s)	3720	3720	256	79	224	13	0	316
7286	4715s (+0.8s)	3256	3256	256	81	177	19	0	277
7287	4715s (+0.5s)	1800	1800	128	47	130	7	0	184
7288	4716s (+0.8s)	3520	3520	256	58	226	10	0	294
7289	4716s (+0.3s)	1148	1148	128	27	94	4	0	125
7290	4717s (+0.5s)	1876	1876	128	46	135	7	0	188
7291	4718s (+0.7s)	2364	2364	128	73	145	14	0	232
7292	4718s (+0.8s)	4452	4452	512	71	221	11	1	304
7293	4719s (+0.8s)	3572	3572	256	75	208	17	0	300
7294	4720s (+0.9s)	3552	3552	256	55	234	0	13	302
7295	4721s (+0.6s)	2648	2648	256	39	173	0	14	226
7296	4721s (+0.2s)	496	496	64	14	53	1	0	68
7297	4722s (+0.5s)	1628	1628	64	51	118	9	0	178
7298	4722s (+0.4s)	1388	1388	128	33	110	5	0	148
7299	4723s (+0.5s)	1780	1780	128	53	121	6	0	180
Episode	Time	Reward	Score	Highest	L	U	R	D	Steps
7300	4723s (+0.8s)	3384	3384	256	62	208	18	1	289
7301	4724s (+0.8s)	3440	3440	256	70	207	12	1	290
7302	4725s (+0.6s)	2452	2452	128	67	154	9	1	231
7303	4726s (+0.7s)	3240	3240	256	76	173	18	0	267
7304	4726s (+0.4s)	1508	1508	128	31	113	5	0	149
7305	4727s (+0.7s)	2828	2828	256	45	182	11	0	238
7306	4727s (+0.8s)	3288	3288	256	79	187	12	0	278
7307	4728s (+0.7s)	3112	3112	256	60	188	10	0	258
7308	4729s (+0.3s)	1128	1128	128	37	83	5	1	126
7309	4729s (+0.3s)	740	740	64	24	68	5	1	98
7310	4730s (+1.0s)	3992	3992	256	83	230	19	0	332
7311	4731s (+0.7s)	2900	2900	256	60	182	9	0	251
7312	4731s (+0.8s)	3396	3396	256	73	196	11	0	280
7313	4732s (+0.6s)	2400	2400	128	52	159	11	1	223
7314	4733s (+0.8s)	3476	3476	256	79	191	18	0	288
7315	4734s (+1.0s)	4180	4180	256	90	241	16	0	347
7316	4734s (+0.4s)	1332	1332	128	35	97	6	0	138
7317	4735s (+0.9s)	3924	3924	256	94	218	12	0	324
7318	4736s (+0.4s)	1372	1372	128	37	98	8	0	143
7319	4736s (+0.5s)	1668	1668	128	26	139	4	0	169
7320	4736s (+0.4s)	1176	1176	64	34	99	0	8	141
7321	4737s (+0.3s)	740	740	64	15	79	0	4	98
7322	4738s (+0.8s)	3388	3388	256	58	205	0	17	280
7323	4738s (+0.6s)	2612	2612	256	45	164	0	9	218
7324	4739s (+0.4s)	1468	1468	128	30	113	0	9	152
7325	4739s (+0.7s)	2596	2596	256	43	179	0	7	229
7326	4740s (+0.4s)	1448	1448	128	30	111	0	7	148
7327	4740s (+0.7s)	3100	3100	256	46	206	0	4	256
7328	4741s (+0.3s)	776	776	64	20	78	1	3	102
7329	4742s (+0.8s)	3420	3420	256	52	222	0	11	285
7330	4742s (+0.8s)	3612	3612	256	62	217	0	12	291
7331	4743s (+0.9s)	3760	3760	256	66	228	1	12	307
7332	4744s (+0.4s)	1484	1484	128	36	111	0	8	155
7333	4744s (+0.5s)	1916	1916	128	34	155	0	8	197
7334	4744s (+0.2s)	340	340	32	15	44	0	3	62
7335	4745s (+0.8s)	3368	3368	256	82	194	12	0	288
7336	4746s (+0.8s)	3196	3196	256	55	195	17	0	267
7337	4746s (+0.4s)	1040	1040	64	27	93	5	0	125
7338	4747s (+1.0s)	4240	4240	256	98	237	12	0	347
7339	4748s (+0.5s)	1856	1856	128	53	122	12	0	187
7340	4749s (+0.7s)	3116	3116	256	75	166	17	0	258
7341	4749s (+0.4s)	1136	1136	64	51	72	9	0	132
7342	4750s (+0.6s)	2360	2360	256	57	133	8	0	198
7343	4750s (+0.4s)	1436	1436	128	47	93	8	0	148
7344	4751s (+0.8s)	3580	3580	256	76	209	10	0	295
7345	4752s (+1.2s)	5752	5752	512	119	266	24	0	409
7346	4753s (+0.5s)	1760	1760	128	30	140	6	0	176
7347	4753s (+0.5s)	1948	1948	128	49	138	11	0	198
7348	4754s (+0.8s)	3204	3204	256	64	187	13	1	265
7349	4755s (+0.8s)	3352	3352	256	57	221	6	0	284
7350	4755s (+0.5s)	1612	1612	128	30	136	4	0	170
7351	4756s (+0.8s)	3540	3540	256	76	200	17	0	293
7352	4757s (+0.9s)	3872	3872	256	95	201	18	1	315
7353	4758s (+0.8s)	3492	3492	256	98	170	20	0	288
7354	4759s (+0.9s)	3984	3984	256	81	232	10	0	323
7355	4760s (+0.8s)	3608	3608	256	76	213	15	0	304
7356	4760s (+0.5s)	1768	1768	128	35	137	7	0	179
7357	4761s (+0.8s)	3300	3300	256	71	199	13	0	283
7358	4761s (+0.5s)	1748	1748	128	52	121	5	0	178
7359	4762s (+0.7s)	3068	3068	256	52	186	13	0	251
7360	4763s (+0.6s)	2376	2376	256	43	151	8	0	202
7361	4763s (+0.6s)	2480	2480	256	46	154	11	0	211
7362	4764s (+0.9s)	3560	3560	256	79	206	13	0	298
7363	4765s (+0.5s)	1784	1784	128	45	129	8	0	182
7364	4765s (+0.4s)	1332	1332	128	38	94	2	0	134
7365	4765s (+0.4s)	1488	1488	128	38	111	6	0	155
7366	4766s (+0.8s)	3188	3188	256	62	194	10	0	266
7367	4767s (+1.0s)	4064	4064	256	96	224	14	0	334
7368	4768s (+0.8s)	3344	3344	256	76	180	21	0	277
7369	4769s (+0.7s)	3064	3064	256	63	174	12	1	250
7370	4770s (+0.8s)	3260	3260	256	60	207	11	0	278
7371	4770s (+0.9s)	4056	4056	256	103	217	17	0	337
7372	4771s (+0.8s)	3212	3212	256	61	195	10	0	266
7373	4772s (+0.6s)	2244	2244	128	53	154	8	1	216
7374	4772s (+0.6s)	2628	2628	256	58	156	8	0	222
7375	4773s (+0.9s)	4768	4768	512	86	235	14	0	335
7376	4774s (+0.8s)	3004	3004	256	72	179	15	0	266
7377	4775s (+0.5s)	1736	1736	128	50	118	6	0	174
7378	4775s (+0.7s)	3100	3100	256	69	179	10	0	258
7379	4776s (+0.4s)	1424	1424	128	43	103	5	0	151
7380	4776s (+0.3s)	876	876	64	27	81	7	0	115
7381	4777s (+0.6s)	2564	2564	256	62	149	12	0	223
7382	4777s (+0.5s)	1540	1540	128	44	109	8	0	161
7383	4778s (+0.6s)	2412	2412	256	53	137	11	0	201
7384	4778s (+0.5s)	1532	1532	128	46	106	9	0	161
7385	4779s (+0.6s)	2436	2436	256	46	149	10	0	205
7386	4779s (+0.5s)	1680	1680	128	39	125	8	0	172
7387	4780s (+0.6s)	2300	2300	128	56	146	16	1	219
7388	4781s (+0.5s)	1900	1900	128	40	150	3	0	193
7389	4781s (+0.3s)	756	756	64	26	69	6	0	101
7390	4782s (+0.7s)	2816	2816	256	44	179	0	10	233
7391	4782s (+0.4s)	1572	1572	128	29	120	0	6	155
7392	4782s (+0.5s)	1604	1604	128	39	121	0	8	168
7393	4783s (+0.6s)	2656	2656	256	55	161	0	12	228
7394	4784s (+0.4s)	1456	1456	128	34	108	7	0	149
7395	4784s (+0.9s)	3804	3804	256	79	225	17	0	321
7396	4785s (+0.5s)	1600	1600	128	52	108	7	0	167
7397	4786s (+0.6s)	2548	2548	256	63	150	11	0	224
7398	4786s (+0.7s)	2976	2976	256	75	158	16	0	249
7399	4787s (+0.4s)	1196	1196	128	31	95	5	0	131
Episode	Time	Reward	Score	Highest	L	U	R	D	Steps
7400	4787s (+0.3s)	812	812	64	21	85	4	0	110
7401	4788s (+0.8s)	3532	3532	256	56	219	0	12	287
7402	4788s (+0.4s)	1276	1276	64	32	103	0	9	144
7403	4789s (+0.9s)	3604	3604	256	74	223	0	14	311
7404	4790s (+0.9s)	3892	3892	256	60	232	0	20	312
7405	4791s (+0.6s)	2248	2248	128	52	154	0	11	217
7406	4791s (+0.5s)	1900	1900	128	54	131	8	0	193
7407	4792s (+0.6s)	2604	2604	256	66	152	8	0	226
7408	4792s (+0.4s)	1092	1092	64	34	95	7	0	136
7409	4793s (+0.8s)	3600	3600	256	74	209	14	0	297
7410	4794s (+0.6s)	2144	2144	128	56	154	8	0	218
7411	4794s (+0.4s)	1344	1344	128	34	103	9	0	146
7412	4795s (+0.4s)	1220	1220	128	32	96	6	0	134
7413	4796s (+0.9s)	4076	4076	256	85	243	10	0	338
7414	4796s (+0.9s)	3876	3876	256	66	238	0	12	316
7415	4797s (+0.9s)	3796	3796	256	67	235	0	13	315
7416	4798s (+0.6s)	2588	2588	256	43	178	0	8	229
7417	4799s (+0.7s)	2792	2792	256	50	180	0	10	240
7418	4799s (+0.6s)	2548	2548	256	52	161	0	10	223
7419	4800s (+1.0s)	5140	5140	512	83	268	0	14	365
7420	4801s (+0.4s)	1516	1516	128	27	121	0	4	152
7421	4801s (+0.4s)	1384	1384	128	23	108	0	8	139
7422	4802s (+0.5s)	1604	1604	128	48	114	6	0	168
7423	4802s (+0.5s)	1752	1752	128	43	118	13	0	174
7424	4803s (+1.0s)	4164	4164	256	68	250	19	0	337
7425	4804s (+0.4s)	1236	1236	128	24	95	5	0	124
7426	4804s (+0.8s)	3404	3404	256	73	200	9	0	282
7427	4805s (+0.9s)	4096	4096	256	77	244	11	0	332
7428	4806s (+0.8s)	3608	3608	256	78	211	15	1	305
7429	4806s (+0.3s)	1072	1072	128	35	75	7	0	117
7430	4807s (+0.7s)	2968	2968	256	56	191	10	0	257
7431	4808s (+0.8s)	3144	3144	256	84	164	21	0	269
7432	4808s (+0.3s)	776	776	64	29	66	7	0	102
7433	4809s (+0.6s)	2120	2120	128	54	154	8	0	216
7434	4810s (+1.0s)	4476	4476	256	78	273	14	0	365
7435	4811s (+0.6s)	1968	1968	128	50	146	7	0	203
7436	4811s (+0.9s)	3680	3680	256	84	204	15	0	303
7437	4812s (+0.3s)	1024	1024	128	25	81	4	0	110
7438	4813s (+0.9s)	4844	4844	512	98	221	19	0	338
7439	4813s (+0.5s)	2164	2164	256	52	123	8	0	183
7440	4814s (+0.8s)	3408	3408	256	69	198	11	0	278
7441	4815s (+0.9s)	3544	3544	256	73	217	10	0	300
7442	4815s (+0.4s)	1496	1496	128	33	114	10	1	158
7443	4816s (+0.6s)	1928	1928	128	58	134	8	0	200
7444	4816s (+0.4s)	1412	1412	128	36	101	7	1	145
7445	4818s (+1.1s)	5576	5576	512	133	247	17	0	397
7446	4818s (+0.3s)	804	804	64	22	79	7	0	108
7447	4819s (+0.7s)	3040	3040	256	56	187	12	0	255
7448	4819s (+0.4s)	1500	1500	128	45	109	4	0	158
7449	4819s (+0.4s)	1340	1340	128	39	91	10	0	140
7450	4820s (+0.4s)	1168	1168	64	28	104	0	7	139
7451	4820s (+0.5s)	1656	1656	128	46	126	4	0	176
7452	4821s (+0.8s)	3316	3316	256	82	181	17	0	280
7453	4821s (+0.3s)	668	668	64	34	54	3	0	91
7454	4822s (+0.5s)	1752	1752	128	48	124	6	0	178
7455	4823s (+0.7s)	2900	2900	256	59	181	11	0	251
7456	4823s (+0.8s)	3252	3252	256	70	196	10	0	276
7457	4824s (+0.3s)	756	756	64	21	77	4	0	102
7458	4824s (+0.8s)	3372	3372	256	60	206	13	0	279
7459	4825s (+0.7s)	2604	2604	128	73	156	14	0	243
7460	4826s (+0.5s)	1712	1712	128	42	125	7	1	175
7461	4826s (+0.4s)	1460	1460	128	34	114	6	0	154
7462	4827s (+0.8s)	3324	3324	256	82	180	12	0	274
7463	4828s (+0.7s)	2800	2800	256	46	186	11	0	243
7464	4829s (+0.9s)	4176	4176	256	86	239	15	0	340
7465	4829s (+0.7s)	2888	2888	256	45	199	0	5	249
7466	4830s (+0.5s)	1816	1816	128	38	145	0	6	189
7467	4830s (+0.7s)	2652	2652	256	43	183	0	7	233
7468	4831s (+0.8s)	3512	3512	256	60	217	0	15	292
7469	4832s (+0.6s)	2256	2256	128	61	148	10	0	219
7470	4833s (+1.3s)	6728	6728	512	147	291	22	1	461
7471	4834s (+0.3s)	980	980	128	21	78	4	1	104
7472	4835s (+0.8s)	3492	3492	256	74	205	13	0	292
7473	4836s (+0.9s)	4040	4040	256	89	240	10	0	339
7474	4836s (+0.6s)	2596	2596	256	46	175	5	0	226
7475	4837s (+0.3s)	1020	1020	64	25	93	3	0	121
7476	4837s (+0.9s)	4024	4024	256	101	211	18	0	330
7477	4838s (+0.4s)	1492	1492	128	44	107	4	1	156
7478	4838s (+0.2s)	576	576	64	13	61	2	0	76
7479	4839s (+0.7s)	3204	3204	256	71	178	15	0	264
7480	4839s (+0.4s)	1036	1036	64	33	85	5	0	123
7481	4840s (+0.8s)	3548	3548	256	75	198	14	0	287
7482	4841s (+0.7s)	3180	3180	256	67	185	11	0	263
7483	4841s (+0.6s)	1880	1880	128	44	141	8	0	193
7484	4842s (+1.0s)	4340	4340	256	94	247	18	0	359
7485	4843s (+0.6s)	2616	2616	256	55	158	11	1	225
7486	4844s (+0.8s)	3396	3396	256	68	200	12	0	280
7487	4844s (+0.3s)	772	772	64	20	76	5	0	101
7488	4844s (+0.4s)	1328	1328	128	23	109	3	0	135
7489	4845s (+1.0s)	4304	4304	256	101	234	19	0	354
7490	4846s (+0.5s)	1748	1748	128	40	129	7	1	177
7491	4847s (+1.0s)	4336	4336	256	97	244	17	0	358
7492	4848s (+0.9s)	3684	3684	256	71	221	12	0	304
7493	4849s (+0.7s)	2688	2688	128	70	169	12	0	251
7494	4849s (+0.2s)	336	336	32	8	49	0	3	60
7495	4850s (+1.1s)	5436	5436	512	80	276	0	19	375
7496	4851s (+0.6s)	2360	2360	256	37	154	1	6	198
7497	4851s (+0.6s)	2228	2228	128	43	158	0	12	213
7498	4852s (+0.5s)	1792	1792	128	32	144	0	8	184
7499	4852s (+0.6s)	2432	2432	256	58	145	8	0	211
Episode	Time	Reward	Score	Highest	L	U	R	D	Steps
7500	4853s (+0.7s)	2788	2788	256	67	156	17	0	240
7501	4854s (+1.0s)	4364	4364	256	87	256	18	0	361
7502	4854s (+0.3s)	932	932	64	19	91	3	0	113
7503	4855s (+0.4s)	1160	1160	64	39	95	4	0	138
7504	4855s (+0.8s)	3224	3224	256	71	185	13	0	269
7505	4856s (+0.8s)	3548	3548	256	79	205	17	0	301
7506	4857s (+0.4s)	1148	1148	64	29	101	4	0	134
7507	4857s (+0.7s)	2784	2784	256	60	169	10	0	239
7508	4858s (+0.5s)	1664	1664	128	32	135	4	0	171
7509	4859s (+0.8s)	3332	3332	256	76	190	13	0	279
7510	4860s (+0.9s)	3844	3844	256	63	238	11	0	312
7511	4860s (+0.4s)	1332	1332	128	26	107	5	0	138
7512	4860s (+0.4s)	1508	1508	128	35	118	7	0	160
7513	4861s (+0.5s)	1784	1784	128	47	126	8	0	181
7514	4862s (+0.6s)	1944	1944	128	50	128	17	1	196
7515	4862s (+0.6s)	1952	1952	128	46	152	3	0	201
7516	4863s (+0.6s)	2032	2032	128	51	139	11	0	201
7517	4864s (+0.8s)	3232	3232	256	75	181	14	1	271
7518	4864s (+0.7s)	2896	2896	256	52	181	6	0	239
7519	4865s (+0.4s)	1352	1352	128	37	106	6	0	149
7520	4865s (+0.5s)	1764	1764	128	39	130	12	0	181
7521	4866s (+0.7s)	2752	2752	256	47	176	0	10	233
7522	4866s (+0.6s)	2192	2192	128	41	157	0	10	208
7523	4867s (+0.7s)	3128	3128	256	50	195	0	10	255
7524	4868s (+0.4s)	1228	1228	128	19	103	0	4	126
7525	4868s (+0.8s)	3416	3416	256	55	219	0	11	285
7526	4869s (+0.3s)	1160	1160	128	24	97	0	2	123
7527	4869s (+0.5s)	1792	1792	128	45	134	0	4	183
7528	4870s (+0.5s)	1596	1596	128	35	123	0	9	167
7529	4871s (+0.8s)	3240	3240	256	51	204	0	18	273
7530	4871s (+0.6s)	2668	2668	256	66	148	0	12	226
7531	4872s (+0.9s)	3772	3772	256	90	202	18	0	310
7532	4872s (+0.4s)	1232	1232	128	37	93	6	0	136
7533	4873s (+0.4s)	1496	1496	128	35	118	4	1	158
7534	4873s (+0.4s)	1332	1332	128	35	104	9	0	148
7535	4874s (+0.5s)	1668	1668	128	40	124	6	0	170
7536	4874s (+0.5s)	1660	1660	128	40	123	5	0	168
7537	4875s (+0.5s)	1576	1576	128	43	111	11	0	165
7538	4876s (+0.9s)	3740	3740	256	77	214	8	0	299
7539	4876s (+0.5s)	1588	1588	128	36	119	11	0	166
7540	4877s (+0.4s)	1448	1448	128	32	116	4	0	152
7541	4877s (+0.6s)	2512	2512	256	60	152	6	1	219
7542	4878s (+0.6s)	2324	2324	256	57	132	10	0	199
7543	4879s (+0.7s)	3260	3260	256	59	199	9	1	268
7544	4879s (+0.4s)	1480	1480	128	42	103	9	0	154
7545	4880s (+0.6s)	2500	2500	256	45	164	7	0	216
7546	4880s (+0.5s)	1668	1668	128	37	125	7	0	169
7547	4881s (+0.7s)	2944	2944	256	59	174	9	0	242
7548	4881s (+0.5s)	1596	1596	128	40	120	6	0	166
7549	4882s (+0.5s)	1844	1844	128	38	139	7	0	184
7550	4883s (+0.8s)	4300	4300	512	69	204	12	1	286
7551	4883s (+0.4s)	1616	1616	128	36	118	7	0	161
7552	4884s (+0.6s)	2480	2480	256	51	151	10	0	212
7553	4884s (+0.8s)	3400	3400	256	70	197	14	0	281
7554	4885s (+0.7s)	2916	2916	256	59	179	11	0	249
7555	4886s (+0.5s)	1856	1856	128	42	139	6	0	187
7556	4887s (+1.1s)	5556	5556	512	93	271	18	1	383
7557	4887s (+0.6s)	2228	2228	128	56	149	12	0	217
7558	4888s (+0.7s)	2916	2916	256	57	186	12	0	255
7559	4889s (+0.7s)	2928	2928	256	57	170	16	0	243
7560	4889s (+0.5s)	1600	1600	128	41	123	4	0	168
7561	4890s (+0.7s)	2788	2788	256	50	180	10	0	240
7562	4890s (+0.3s)	844	844	64	20	84	3	0	107
7563	4891s (+0.5s)	1612	1612	128	55	107	8	0	170
7564	4891s (+0.5s)	1768	1768	128	33	143	2	0	178
7565	4892s (+0.4s)	1508	1508	128	28	123	0	5	156
7566	4892s (+0.6s)	2380	2380	256	33	160	0	8	201
7567	4893s (+0.4s)	1440	1440	128	34	103	0	11	148
7568	4894s (+0.9s)	3796	3796	256	64	224	0	17	305
7569	4894s (+0.4s)	1400	1400	128	43	94	0	6	143
7570	4895s (+0.5s)	1676	1676	128	41	115	0	9	165
7571	4895s (+0.3s)	884	884	64	22	78	0	7	107
7572	4895s (+0.4s)	1228	1228	128	20	98	0	5	123
7573	4896s (+0.7s)	2896	2896	256	44	176	0	13	233
7574	4897s (+0.8s)	3388	3388	256	69	198	16	0	283
7575	4898s (+1.0s)	4164	4164	256	84	237	15	0	336
7576	4899s (+0.8s)	3344	3344	256	56	207	12	0	275
7577	4899s (+0.5s)	2112	2112	256	46	125	6	0	177
7578	4900s (+0.7s)	2592	2592	256	63	158	9	0	230
7579	4901s (+0.8s)	3568	3568	256	76	211	15	0	302
7580	4901s (+0.6s)	1920	1920	128	36	159	3	0	198
7581	4902s (+0.6s)	1908	1908	128	61	123	11	0	195
7582	4902s (+0.5s)	1732	1732	128	46	121	7	0	174
7583	4903s (+0.5s)	1572	1572	128	44	116	4	1	165
7584	4903s (+0.8s)	3504	3504	256	88	187	16	0	291
7585	4904s (+0.7s)	3200	3200	256	69	183	11	0	263
7586	4905s (+0.8s)	3300	3300	256	58	195	12	1	266
7587	4905s (+0.3s)	688	688	64	19	67	4	0	90
7588	4906s (+0.9s)	4112	4112	256	72	252	11	0	335
7589	4907s (+0.9s)	3804	3804	256	98	201	15	0	314
7590	4908s (+0.8s)	3576	3576	256	83	193	21	0	297
7591	4909s (+0.6s)	1912	1912	128	55	129	12	0	196
7592	4910s (+1.0s)	4276	4276	256	101	235	18	0	354
7593	4910s (+0.5s)	1652	1652	128	48	120	7	0	175
7594	4911s (+0.8s)	3416	3416	256	72	213	10	0	295
7595	4912s (+0.7s)	3288	3288	256	64	194	11	0	269
7596	4912s (+0.4s)	1072	1072	128	49	61	7	0	117
7597	4912s (+0.3s)	628	628	32	19	74	3	0	96
7598	4913s (+0.8s)	3500	3500	256	55	226	13	0	294
7599	4914s (+0.5s)	1496	1496	128	33	117	7	0	157
Episode	Time	Reward	Score	Highest	L	U	R	D	Steps
7600	4914s (+0.6s)	1912	1912	128	49	139	8	0	196
7601	4915s (+0.6s)	1916	1916	128	48	140	9	0	197
7602	4915s (+0.6s)	2652	2652	256	54	156	13	1	224
7603	4916s (+0.6s)	2624	2624	256	72	151	8	0	231
7604	4916s (+0.4s)	1392	1392	128	29	109	4	0	142
7605	4917s (+0.7s)	2800	2800	256	63	167	13	0	243
7606	4918s (+0.5s)	1608	1608	128	39	123	7	0	169
7607	4918s (+0.5s)	1656	1656	128	35	133	8	0	176
7608	4919s (+0.6s)	2380	2380	256	42	147	9	2	200
7609	4920s (+0.8s)	3300	3300	256	69	205	9	0	283
7610	4920s (+0.5s)	1796	1796	128	44	135	5	0	184
7611	4921s (+0.8s)	3652	3652	256	76	205	15	0	296
7612	4922s (+0.9s)	4136	4136	256	74	248	14	0	336
7613	4922s (+0.6s)	2584	2584	256	44	175	7	0	226
7614	4923s (+0.6s)	2400	2400	256	47	147	10	0	204
7615	4924s (+0.5s)	1888	1888	128	42	134	9	0	185
7616	4924s (+0.7s)	2828	2828	256	53	180	9	0	242
7617	4925s (+0.4s)	1520	1520	128	33	122	8	0	163
7618	4926s (+1.1s)	4580	4580	256	105	251	19	0	375
7619	4926s (+0.6s)	2276	2276	128	51	158	8	0	217
7620	4927s (+0.6s)	2372	2372	256	42	150	7	0	199
7621	4928s (+0.7s)	2652	2652	256	58	159	10	1	228
7622	4928s (+0.6s)	1960	1960	128	59	137	7	0	203
7623	4929s (+0.5s)	1516	1516	128	33	117	7	1	158
7624	4930s (+0.8s)	3412	3412	256	53	223	0	8	284
7625	4930s (+0.9s)	3808	3808	256	72	225	0	11	308
7626	4931s (+0.3s)	688	688	64	14	77	0	5	96
7627	4931s (+0.6s)	1944	1944	128	35	163	0	6	204
7628	4932s (+0.5s)	2180	2180	256	49	127	0	9	185
7629	4932s (+0.4s)	1444	1444	128	30	118	0	5	153
7630	4933s (+0.9s)	3964	3964	256	69	246	0	11	326
7631	4934s (+0.4s)	992	992	64	29	92	6	0	127
7632	4934s (+0.3s)	940	940	64	26	85	5	0	116
7633	4935s (+0.7s)	2944	2944	256	53	184	10	0	247
7634	4935s (+0.8s)	3376	3376	256	70	192	13	0	275
7635	4936s (+0.6s)	2496	2496	256	42	165	0	8	215
7636	4936s (+0.3s)	796	796	64	18	78	0	5	101
7637	4937s (+0.9s)	3892	3892	256	67	239	12	0	318
7638	4938s (+0.6s)	2500	2500	256	42	168	7	0	217
7639	4939s (+0.6s)	2464	2464	256	45	161	6	0	212
7640	4939s (+0.4s)	1480	1480	128	32	112	4	0	148
7641	4940s (+0.7s)	3100	3100	256	68	177	11	0	256
7642	4940s (+0.4s)	984	984	64	21	95	6	0	122
7643	4941s (+0.8s)	2904	2904	128	95	166	11	0	272
7644	4941s (+0.5s)	1760	1760	128	46	127	0	6	179
7645	4942s (+0.9s)	4040	4040	256	89	219	16	0	324
7646	4943s (+0.4s)	1400	1400	128	33	103	4	0	140
7647	4943s (+0.7s)	2660	2660	256	50	173	0	12	235
7648	4944s (+0.3s)	632	632	32	19	69	0	5	93
7649	4945s (+1.0s)	4248	4248	256	74	263	0	15	352
7650	4945s (+0.6s)	2020	2020	128	43	142	0	8	193
7651	4946s (+0.4s)	1512	1512	128	28	123	0	8	159
7652	4947s (+0.9s)	3568	3568	256	59	236	0	11	306
7653	4947s (+0.4s)	1396	1396	128	45	98	6	0	149
7654	4948s (+0.7s)	3080	3080	256	54	185	15	1	255
7655	4948s (+0.3s)	904	904	128	21	65	5	0	91
7656	4949s (+0.7s)	2660	2660	128	76	164	15	0	255
7657	4949s (+0.5s)	1748	1748	128	34	134	9	0	177
7658	4950s (+0.3s)	676	676	64	23	60	4	1	88
7659	4950s (+0.6s)	2308	2308	256	36	154	5	0	195
7660	4951s (+0.5s)	1508	1508	128	35	119	5	0	159
7661	4951s (+0.6s)	2440	2440	256	41	163	4	0	208
7662	4952s (+0.6s)	1944	1944	128	64	130	5	0	199
7663	4952s (+0.6s)	2660	2660	256	56	162	6	1	225
7664	4953s (+0.4s)	1340	1340	128	24	112	4	0	140
7665	4953s (+0.4s)	1344	1344	128	38	101	8	0	147
7666	4954s (+0.8s)	3356	3356	256	79	187	9	0	275
7667	4954s (+0.4s)	1292	1292	128	33	102	4	0	139
7668	4955s (+1.0s)	4072	4072	256	93	228	14	0	335
7669	4956s (+0.7s)	3108	3108	256	52	190	0	13	255
7670	4957s (+0.5s)	1812	1812	128	35	144	0	8	187
7671	4957s (+0.6s)	1928	1928	128	48	144	8	0	200
7672	4958s (+1.0s)	5016	5016	512	88	247	15	0	350
7673	4959s (+0.5s)	1724	1724	128	32	135	6	0	173
7674	4960s (+1.0s)	4260	4260	256	100	239	16	0	355
7675	4961s (+0.8s)	3516	3516	256	85	197	13	0	295
7676	4961s (+0.6s)	2320	2320	256	31	160	7	0	198
7677	4962s (+0.7s)	3080	3080	256	58	189	9	0	256
7678	4963s (+0.7s)	2988	2988	256	54	184	11	0	249
7679	4964s (+0.9s)	4128	4128	256	77	243	14	0	334
7680	4964s (+0.7s)	2596	2596	128	60	171	13	0	244
7681	4965s (+0.5s)	1680	1680	128	35	127	0	10	172
7682	4965s (+0.6s)	2472	2472	256	45	159	0	10	214
7683	4966s (+0.4s)	1352	1352	128	31	102	0	5	138
7684	4966s (+0.4s)	1384	1384	128	30	106	0	4	140
7685	4966s (+0.3s)	1156	1156	128	19	96	0	5	120
7686	4967s (+0.4s)	1200	1200	128	19	102	0	6	127
7687	4967s (+0.5s)	1612	1612	128	34	125	0	11	170
7688	4968s (+0.4s)	1456	1456	128	28	120	0	6	154
7689	4968s (+0.4s)	1500	1500	128	35	109	7	0	151
7690	4969s (+1.0s)	4180	4180	256	87	245	15	0	347
7691	4970s (+0.6s)	2288	2288	128	51	159	9	0	219
7692	4971s (+0.9s)	3792	3792	256	81	225	13	0	319
7693	4972s (+1.1s)	5716	5716	512	93	286	21	0	400
7694	4973s (+0.7s)	3100	3100	256	55	187	12	0	254
7695	4973s (+0.7s)	3100	3100	256	63	181	10	1	255
7696	4974s (+0.8s)	3184	3184	256	71	187	12	0	270
7697	4975s (+0.4s)	1172	1172	64	36	98	6	0	140
7698	4975s (+0.6s)	2476	2476	256	54	152	10	0	216
7699	4976s (+0.5s)	1768	1768	128	45	128	6	0	179
Episode	Time	Reward	Score	Highest	L	U	R	D	Steps
7700	4976s (+0.3s)	780	780	64	26	70	6	1	103
7701	4977s (+0.4s)	1436	1436	128	36	113	5	0	154
7702	4977s (+0.7s)	2800	2800	256	69	164	9	0	242
7703	4978s (+0.6s)	2592	2592	256	51	159	13	0	223
7704	4978s (+0.6s)	2040	2040	128	57	134	10	0	201
7705	4979s (+0.7s)	3068	3068	256	51	202	6	0	259
7706	4980s (+0.5s)	1832	1832	128	60	108	13	0	181
7707	4980s (+0.6s)	2652	2652	256	53	160	10	0	223
7708	4981s (+0.5s)	1504	1504	128	50	96	13	0	159
7709	4981s (+0.5s)	1540	1540	128	37	115	9	0	161
7710	4982s (+0.7s)	2916	2916	256	64	183	8	0	255
7711	4983s (+0.8s)	3216	3216	256	83	170	18	0	271
7712	4984s (+0.7s)	3116	3116	256	52	200	6	0	258
7713	4984s (+0.4s)	1528	1528	128	27	120	0	6	153
7714	4984s (+0.3s)	1072	1072	128	21	88	0	3	112
7715	4985s (+0.8s)	3656	3656	256	59	221	0	8	288
7716	4985s (+0.2s)	524	524	64	13	61	0	3	77
7717	4986s (+0.3s)	700	700	64	19	70	4	0	93
7718	4986s (+0.8s)	3368	3368	256	78	197	13	0	288
7719	4987s (+0.4s)	920	920	64	29	88	4	0	121
7720	4988s (+0.8s)	3492	3492	256	79	192	20	1	292
7721	4988s (+0.5s)	1684	1684	128	36	127	8	1	172
7722	4989s (+0.4s)	1236	1236	64	29	101	5	0	135
7723	4989s (+0.5s)	1920	1920	128	43	135	12	1	191
7724	4990s (+0.7s)	2284	2284	128	67	148	13	1	229
7725	4991s (+0.8s)	3404	3404	256	66	208	11	0	285
7726	4991s (+0.4s)	988	988	64	34	84	4	0	122
7727	4992s (+0.6s)	2048	2048	128	50	142	7	0	199
7728	4992s (+0.7s)	2796	2796	256	50	184	8	0	242
7729	4993s (+1.0s)	4224	4224	256	98	232	17	0	347
7730	4994s (+0.7s)	2692	2692	256	54	176	6	0	236
7731	4994s (+0.6s)	1788	1788	128	43	135	8	0	186
7732	4995s (+0.5s)	1588	1588	128	48	108	8	0	164
7733	4996s (+0.8s)	3404	3404	256	66	199	17	1	283
7734	4996s (+0.7s)	2788	2788	256	66	168	10	0	244
7735	4997s (+0.5s)	1876	1876	128	42	146	4	0	192
7736	4998s (+0.8s)	3408	3408	256	54	216	13	0	283
7737	4999s (+0.8s)	3416	3416	256	78	196	15	0	289
7738	4999s (+0.3s)	1116	1116	128	31	88	0	4	123
7739	5000s (+0.8s)	3160	3160	256	44	211	0	10	265
7740	5001s (+0.8s)	3488	3488	256	61	215	0	15	291
7741	5001s (+0.5s)	1856	1856	128	35	148	0	5	188
7742	5002s (+0.8s)	3332	3332	256	61	210	0	8	279
7743	5003s (+0.8s)	3244	3244	256	60	202	0	12	274
7744	5003s (+0.4s)	1312	1312	128	32	97	0	4	133
7745	5004s (+0.9s)	4072	4072	256	66	252	0	14	332
7746	5005s (+0.5s)	1576	1576	128	35	125	0	7	167
7747	5005s (+0.5s)	1844	1844	128	41	134	0	6	181
7748	5005s (+0.4s)	1272	1272	128	22	104	0	3	129
7749	5006s (+0.8s)	3340	3340	256	51	219	0	12	282
7750	5007s (+0.6s)	2184	2184	128	48	149	0	10	207
7751	5007s (+0.3s)	1004	1004	128	23	79	0	5	107
7752	5008s (+0.6s)	2604	2604	256	46	167	0	11	224
7753	5008s (+0.3s)	592	592	32	27	59	0	2	88
7754	5009s (+0.6s)	2600	2600	256	51	151	0	13	215
7755	5010s (+0.8s)	3512	3512	256	71	209	0	17	297
7756	5010s (+0.7s)	3204	3204	256	67	189	0	8	264
7757	5011s (+0.5s)	1812	1812	128	39	140	0	9	188
7758	5012s (+0.7s)	2968	2968	256	71	169	17	0	257
7759	5012s (+0.4s)	1280	1280	128	30	93	5	0	128
7760	5012s (+0.3s)	836	836	64	30	76	4	0	110
7761	5013s (+0.3s)	956	956	64	26	80	7	0	113
7762	5013s (+0.9s)	3676	3676	256	81	213	13	0	307
7763	5014s (+0.5s)	1620	1620	128	36	131	5	0	172
7764	5014s (+0.4s)	1076	1076	64	31	97	4	0	132
7765	5015s (+0.6s)	2744	2744	256	51	160	9	0	220
7766	5016s (+0.8s)	3332	3332	256	69	200	10	0	279
7767	5017s (+0.8s)	3244	3244	256	74	183	17	0	274
7768	5017s (+0.6s)	2252	2252	128	46	157	8	0	211
7769	5018s (+1.0s)	4292	4292	256	89	242	19	1	351
7770	5019s (+0.7s)	2776	2776	256	49	176	0	12	237
7771	5019s (+0.4s)	1492	1492	128	35	117	0	5	157
7772	5020s (+0.7s)	3052	3052	256	50	184	0	14	248
7773	5021s (+0.6s)	2376	2376	256	49	138	8	0	195
7774	5021s (+0.7s)	3072	3072	256	72	176	14	0	262
7775	5022s (+0.7s)	2468	2468	128	66	154	13	0	233
7776	5023s (+1.1s)	5388	5388	512	77	281	0	15	373
7777	5023s (+0.4s)	1320	1320	64	26	119	0	5	150
7778	5024s (+0.6s)	2524	2524	256	43	170	0	10	223
7779	5024s (+0.3s)	1052	1052	64	37	84	5	0	126
7780	5025s (+0.9s)	4132	4132	256	80	238	18	0	336
7781	5026s (+0.5s)	1824	1824	128	49	122	9	0	180
7782	5027s (+1.0s)	4516	4516	256	117	240	18	0	375
7783	5028s (+1.0s)	4248	4248	256	87	249	16	0	352
7784	5029s (+0.9s)	3972	3972	256	69	244	0	14	327
7785	5030s (+0.8s)	3460	3460	256	47	229	0	13	289
7786	5030s (+0.6s)	1864	1864	128	39	154	0	3	196
7787	5031s (+0.6s)	2348	2348	128	56	149	8	1	214
7788	5032s (+0.9s)	3872	3872	256	89	227	13	0	329
7789	5032s (+0.5s)	2156	2156	256	47	128	0	5	180
7790	5033s (+0.8s)	3524	3524	256	60	226	0	10	296
7791	5034s (+0.4s)	1496	1496	128	29	121	0	7	157
7792	5034s (+0.7s)	2796	2796	256	59	173	11	0	243
7793	5035s (+0.6s)	2556	2556	256	53	159	8	0	220
7794	5036s (+0.7s)	2772	2772	256	67	160	12	1	240
7795	5036s (+0.7s)	2752	2752	256	58	170	7	2	237
7796	5037s (+0.6s)	2552	2552	256	48	162	6	0	216
7797	5038s (+0.7s)	2776	2776	256	61	167	9	0	237
7798	5038s (+0.5s)	1648	1648	128	33	127	5	0	165
7799	5039s (+0.7s)	3100	3100	256	60	189	10	0	259
Episode	Time	Reward	Score	Highest	L	U	R	D	Steps
7800	5039s (+0.6s)	1908	1908	128	43	141	11	0	195
7801	5040s (+0.7s)	2896	2896	256	56	189	6	0	251
7802	5041s (+0.5s)	1652	1652	128	42	127	6	0	175
7803	5041s (+0.6s)	2368	2368	256	51	143	6	0	200
7804	5042s (+0.8s)	3248	3248	256	58	207	9	0	274
7805	5043s (+0.8s)	3516	3516	256	75	204	15	0	294
7806	5043s (+0.5s)	2100	2100	128	58	130	9	0	197
7807	5044s (+0.3s)	1160	1160	128	32	89	3	0	124
7808	5045s (+0.7s)	2936	2936	256	61	186	13	0	260
7809	5045s (+0.5s)	1688	1688	128	51	112	10	0	173
7810	5046s (+0.7s)	2744	2744	256	55	169	10	0	234
7811	5046s (+0.3s)	1152	1152	128	29	91	5	0	125
7812	5047s (+0.4s)	1484	1484	128	33	112	6	1	152
7813	5047s (+0.3s)	964	964	64	26	81	3	0	110
7814	5047s (+0.5s)	2312	2312	256	38	144	0	9	191
7815	5048s (+0.5s)	1780	1780	128	37	135	0	8	180
7816	5049s (+0.6s)	2696	2696	256	46	174	0	7	227
7817	5049s (+0.5s)	1620	1620	128	36	128	0	8	172
7818	5050s (+0.4s)	1424	1424	128	29	111	0	5	145
7819	5050s (+0.3s)	1012	1012	128	19	89	0	1	109
7820	5050s (+0.5s)	1688	1688	128	33	130	0	4	167
7821	5051s (+0.5s)	1520	1520	128	33	122	0	8	163
7822	5052s (+0.8s)	3300	3300	256	51	217	0	15	283
7823	5052s (+0.5s)	1864	1864	128	33	149	0	5	187
7824	5053s (+0.6s)	2628	2628	256	49	170	7	0	226
7825	5054s (+0.9s)	3672	3672	256	70	220	15	0	305
7826	5055s (+0.8s)	3480	3480	256	65	214	11	0	290
7827	5055s (+0.4s)	1420	1420	128	26	117	8	0	151
7828	5056s (+0.7s)	2744	2744	256	67	161	7	0	235
7829	5056s (+0.6s)	2184	2184	128	44	153	9	0	206
7830	5057s (+0.7s)	2888	2888	256	53	178	8	0	239
7831	5057s (+0.5s)	1524	1524	128	34	117	9	0	160
7832	5058s (+0.6s)	1912	1912	128	43	145	8	0	196
7833	5059s (+0.7s)	2784	2784	128	74	172	13	0	259
7834	5060s (+0.8s)	3640	3640	256	90	198	12	1	301
7835	5060s (+0.4s)	1540	1540	128	31	126	6	0	163
7836	5061s (+0.7s)	2808	2808	256	65	170	10	0	245
7837	5062s (+1.1s)	5368	5368	512	84	272	18	0	374
7838	5063s (+0.9s)	3524	3524	256	82	201	13	0	296
7839	5063s (+0.5s)	1776	1776	128	37	136	6	0	179
7840	5064s (+0.4s)	1168	1168	64	38	92	9	0	139
7841	5064s (+0.6s)	2488	2488	256	36	161	12	0	209
7842	5065s (+0.7s)	2796	2796	256	67	161	14	0	242
7843	5066s (+0.8s)	3212	3212	256	73	181	12	0	266
7844	5066s (+0.8s)	3272	3272	256	59	208	0	9	276
7845	5067s (+0.5s)	1584	1584	128	36	121	0	7	164
7846	5067s (+0.6s)	1964	1964	128	39	154	0	11	204
7847	5068s (+0.5s)	1704	1704	128	33	125	0	10	168
7848	5069s (+0.7s)	3068	3068	256	51	184	1	16	252
7849	5069s (+0.5s)	1616	1616	128	25	134	0	12	171
7850	5070s (+0.7s)	3100	3100	256	56	185	0	14	255
7851	5070s (+0.3s)	1076	1076	128	18	98	0	3	119
7852	5071s (+0.6s)	2392	2392	256	41	145	0	10	196
7853	5072s (+0.9s)	3772	3772	256	76	218	0	15	309
7854	5073s (+1.5s)	7488	7488	512	155	339	33	0	527
7855	5074s (+0.5s)	2204	2204	256	43	137	11	0	191
7856	5075s (+0.5s)	1984	1984	128	47	125	11	1	184
7857	5075s (+0.5s)	1836	1836	128	43	133	6	0	182
7858	5076s (+0.5s)	1544	1544	128	49	107	9	0	165
7859	5076s (+0.3s)	780	780	64	20	76	6	1	103
7860	5077s (+0.9s)	4696	4696	512	69	235	14	1	319
7861	5077s (+0.3s)	672	672	64	29	61	2	0	92
7862	5077s (+0.3s)	852	852	64	29	75	5	0	109
7863	5078s (+0.6s)	2144	2144	128	59	139	13	0	211
7864	5079s (+0.7s)	2956	2956	256	60	185	15	0	260
7865	5079s (+0.7s)	2828	2828	256	77	159	9	0	245
7866	5080s (+0.5s)	1612	1612	128	35	128	8	0	171
7867	5080s (+0.4s)	1160	1160	64	22	111	0	5	138
7868	5081s (+0.7s)	2908	2908	256	50	191	0	12	253
7869	5081s (+0.4s)	1340	1340	128	30	102	7	1	140
7870	5082s (+0.4s)	1196	1196	128	29	100	3	0	132
7871	5082s (+0.7s)	2768	2768	256	51	173	11	0	235
7872	5083s (+0.8s)	3552	3552	256	79	203	15	0	297
7873	5084s (+0.4s)	1428	1428	128	30	109	6	0	145
7874	5084s (+0.4s)	1468	1468	128	26	118	2	0	146
7875	5085s (+0.6s)	1932	1932	128	32	162	0	7	201
7876	5085s (+0.2s)	604	604	64	23	60	4	0	87
7877	5085s (+0.4s)	1304	1304	128	42	92	8	0	142
7878	5086s (+0.5s)	1532	1532	128	41	114	6	1	162
7879	5086s (+0.4s)	1508	1508	128	41	111	8	0	160
7880	5087s (+0.8s)	3372	3372	256	64	206	0	9	279
7881	5088s (+0.8s)	3624	3624	256	45	239	0	9	293
7882	5089s (+0.8s)	3444	3444	256	70	207	0	14	291
7883	5090s (+0.8s)	3552	3552	256	66	216	12	1	295
7884	5090s (+0.6s)	2492	2492	256	49	159	7	0	215
7885	5091s (+0.9s)	3828	3828	256	86	203	23	0	312
7886	5092s (+0.5s)	1824	1824	128	50	133	7	0	190
7887	5092s (+0.4s)	1228	1228	128	35	92	6	1	134
7888	5093s (+0.9s)	4036	4036	256	93	221	17	0	331
7889	5093s (+0.5s)	1884	1884	128	48	126	16	0	190
7890	5094s (+0.9s)	3956	3956	256	57	255	0	16	328
7891	5095s (+0.3s)	816	816	64	20	80	0	5	105
7892	5095s (+0.8s)	3556	3556	256	54	230	0	15	299
7893	5096s (+0.7s)	2860	2860	256	60	164	9	0	233
7894	5097s (+0.4s)	1204	1204	64	43	93	5	0	141
7895	5098s (+1.3s)	6948	6948	512	138	305	26	1	470
7896	5099s (+0.4s)	1308	1308	64	35	112	6	0	153
7897	5100s (+1.0s)	4204	4204	256	90	235	20	0	345
7898	5100s (+0.4s)	1360	1360	64	37	108	6	1	152
7899	5101s (+0.6s)	2436	2436	128	62	159	11	0	232
Episode	Time	Reward	Score	Highest	L	U	R	D	Steps
7900	5101s (+0.4s)	1388	1388	64	42	101	8	0	151
7901	5102s (+0.5s)	1700	1700	128	49	112	8	0	169
7902	5102s (+0.7s)	3008	3008	256	40	195	3	0	238
7903	5103s (+0.8s)	3140	3140	256	73	175	20	0	268
7904	5104s (+0.6s)	2636	2636	256	35	182	0	7	224
7905	5104s (+0.5s)	2108	2108	256	34	135	0	8	177
7906	5105s (+1.0s)	4160	4160	256	70	253	0	20	343
7907	5106s (+0.7s)	2448	2448	128	41	184	0	6	231
7908	5106s (+0.4s)	1324	1324	128	22	108	0	7	137
7909	5107s (+0.8s)	2976	2976	256	38	223	0	4	265
7910	5108s (+0.7s)	3096	3096	256	50	192	0	12	254
7911	5108s (+0.3s)	868	868	64	30	74	0	9	113
7912	5109s (+0.4s)	1292	1292	64	33	104	9	0	146
7913	5109s (+0.9s)	3716	3716	256	79	208	14	0	301
7914	5110s (+0.8s)	3552	3552	256	70	209	16	0	295
7915	5111s (+0.4s)	1424	1424	128	30	113	8	0	151
7916	5111s (+0.6s)	2188	2188	128	52	141	14	0	207
7917	5112s (+0.8s)	3504	3504	256	74	198	18	0	290
7918	5113s (+0.4s)	1432	1432	128	30	115	6	0	151
7919	5113s (+0.5s)	1820	1820	128	56	119	9	0	184
7920	5114s (+0.7s)	2720	2720	256	45	176	8	0	229
7921	5114s (+0.2s)	452	452	64	10	53	1	0	64
7922	5115s (+0.5s)	1760	1760	128	42	127	10	0	179
7923	5115s (+0.5s)	1848	1848	128	62	123	7	0	192
7924	5115s (+0.4s)	1412	1412	128	32	106	6	0	144
7925	5116s (+0.5s)	1712	1712	128	39	126	9	0	174
7926	5116s (+0.4s)	1340	1340	128	27	110	3	0	140
7927	5117s (+0.7s)	3148	3148	256	69	185	17	0	271
7928	5117s (+0.3s)	1016	1016	64	29	79	9	0	117
7929	5118s (+0.8s)	3488	3488	256	81	193	18	0	292
7930	5119s (+0.9s)	3968	3968	256	102	209	14	1	326
7931	5120s (+0.5s)	1680	1680	128	43	124	8	0	175
7932	5120s (+0.5s)	2196	2196	256	35	146	7	0	188
7933	5121s (+0.8s)	3260	3260	256	58	207	0	12	277
7934	5122s (+0.8s)	3224	3224	256	60	197	0	12	269
7935	5122s (+0.4s)	1436	1436	128	29	114	0	6	149
7936	5123s (+0.3s)	1088	1088	64	29	86	0	7	122
7937	5123s (+0.4s)	1288	1288	128	34	93	0	9	136
7938	5124s (+0.7s)	2752	2752	256	42	188	0	6	236
7939	5124s (+0.4s)	1456	1456	128	34	116	6	0	156
7940	5125s (+0.5s)	1592	1592	128	36	128	6	0	170
7941	5125s (+0.7s)	2744	2744	256	49	174	12	0	235
7942	5126s (+0.4s)	1452	1452	128	37	105	5	0	147
7943	5126s (+0.5s)	1520	1520	128	31	125	8	0	164
7944	5127s (+0.4s)	1356	1356	128	33	104	6	1	144
7945	5127s (+0.6s)	2644	2644	256	46	167	0	9	222
7946	5127s (+0.2s)	280	280	32	9	41	0	3	53
7947	5128s (+0.7s)	2892	2892	256	56	186	0	12	254
7948	5128s (+0.2s)	464	464	32	15	53	0	5	73
7949	5129s (+0.7s)	2780	2780	256	55	179	1	7	242
7950	5130s (+0.4s)	1564	1564	128	32	117	0	5	154
7951	5130s (+0.4s)	1480	1480	128	32	111	6	0	149
7952	5130s (+0.2s)	512	512	32	14	62	0	2	78
7953	5131s (+0.6s)	2584	2584	256	60	149	12	0	221
7954	5132s (+0.8s)	3300	3300	256	63	199	15	0	277
7955	5132s (+0.6s)	2520	2520	256	52	153	12	0	217
7956	5133s (+1.1s)	5760	5760	512	91	290	24	1	406
7957	5134s (+0.8s)	3424	3424	256	75	197	14	0	286
7958	5135s (+0.7s)	3104	3104	256	74	172	10	0	256
7959	5136s (+0.8s)	3216	3216	256	55	205	7	0	267
7960	5136s (+0.6s)	1916	1916	128	51	135	11	0	197
7961	5137s (+0.9s)	3840	3840	256	69	233	16	1	319
7962	5137s (+0.2s)	504	504	64	16	48	4	0	68
7963	5138s (+0.5s)	1764	1764	128	50	123	8	0	181
7964	5139s (+0.7s)	3144	3144	256	77	166	16	0	259
7965	5139s (+0.7s)	3064	3064	256	75	169	11	0	255
7966	5140s (+0.5s)	1856	1856	128	46	133	8	0	187
7967	5141s (+0.9s)	4004	4004	256	92	212	20	1	325
7968	5142s (+0.6s)	2260	2260	128	63	130	14	1	208
7969	5142s (+0.3s)	840	840	64	25	78	4	0	107
7970	5143s (+0.8s)	3308	3308	256	81	183	14	0	278
7971	5143s (+0.4s)	1216	1216	128	31	96	5	0	132
7972	5144s (+0.6s)	1928	1928	128	48	144	8	0	200
7973	5144s (+0.5s)	1808	1808	128	52	131	0	4	187
7974	5145s (+0.5s)	1676	1676	128	38	123	0	10	171
7975	5145s (+0.4s)	1128	1128	64	32	91	0	7	130
7976	5146s (+0.7s)	2772	2772	256	78	151	0	7	236
7977	5146s (+0.2s)	620	620	64	13	68	0	2	83
7978	5147s (+0.8s)	3296	3296	256	61	209	0	12	282
7979	5147s (+0.6s)	2544	2544	256	44	170	0	10	224
7980	5148s (+0.5s)	1820	1820	128	30	154	0	6	190
7981	5148s (+0.3s)	864	864	64	24	84	0	4	112
7982	5149s (+0.6s)	2372	2372	256	38	156	0	9	203
7983	5149s (+0.5s)	1788	1788	128	37	133	0	4	174
7984	5150s (+0.7s)	2792	2792	256	53	174	0	14	241
7985	5150s (+0.2s)	484	484	64	9	60	0	3	72
7986	5151s (+0.8s)	3304	3304	256	58	212	0	14	284
7987	5151s (+0.5s)	1540	1540	128	38	116	6	0	160
7988	5152s (+0.9s)	4020	4020	256	74	236	17	0	327
7989	5153s (+0.7s)	2676	2676	256	57	160	12	0	229
7990	5153s (+0.4s)	1208	1208	128	35	91	4	0	130
7991	5154s (+0.4s)	1304	1304	64	33	109	4	0	146
7992	5154s (+0.5s)	1828	1828	128	56	119	8	1	184
7993	5156s (+1.1s)	4628	4628	256	98	274	15	0	387
7994	5156s (+0.7s)	3180	3180	256	77	175	11	0	263
7995	5157s (+0.7s)	2804	2804	256	74	155	15	0	244
7996	5158s (+0.5s)	1836	1836	128	46	135	8	0	189
7997	5158s (+0.6s)	2232	2232	128	64	133	11	0	208
7998	5159s (+0.4s)	1504	1504	128	38	114	7	0	159
7999	5159s (+0.3s)	864	864	64	26	82	4	0	112
Episode	Time	Reward	Score	Highest	L	U	R	D	Steps
8000	5160s (+0.8s)	3352	3352	256	80	184	18	0	282
8001	5161s (+0.9s)	3768	3768	256	86	215	16	0	317
8002	5161s (+0.5s)	1840	1840	128	41	135	8	0	184
8003	5162s (+0.6s)	2340	2340	128	67	146	10	0	223
8004	5163s (+0.8s)	3264	3264	256	56	206	0	16	278
8005	5163s (+0.5s)	1840	1840	128	44	123	0	10	177
8006	5163s (+0.4s)	1436	1436	128	32	109	0	7	148
8007	5164s (+0.9s)	4756	4756	512	76	241	0	16	333
8008	5165s (+0.5s)	1868	1868	128	30	154	0	6	190
8009	5165s (+0.5s)	1588	1588	128	37	117	6	0	160
8010	5166s (+0.4s)	1496	1496	128	47	103	7	0	157
8011	5167s (+0.9s)	4040	4040	256	73	245	14	0	332
8012	5167s (+0.3s)	668	668	64	21	67	4	0	92
8013	5168s (+0.4s)	1340	1340	128	33	107	6	0	146
8014	5168s (+0.7s)	2812	2812	256	51	186	0	9	246
8015	5169s (+0.5s)	1924	1924	128	38	136	0	11	185
8016	5170s (+0.8s)	3484	3484	256	62	216	0	12	290
8017	5170s (+0.3s)	952	952	64	23	84	7	0	114
8018	5170s (+0.4s)	1472	1472	128	37	109	6	0	152
8019	5171s (+0.5s)	1696	1696	128	45	123	7	0	175
8020	5172s (+1.1s)	5228	5228	512	116	246	18	0	380
8021	5173s (+0.6s)	2412	2412	256	53	144	10	0	207
8022	5173s (+0.6s)	2640	2640	256	65	156	9	0	230
8023	5174s (+0.4s)	1492	1492	128	36	111	9	0	156
8024	5174s (+0.8s)	3480	3480	256	63	217	10	0	290
8025	5175s (+0.5s)	1476	1476	128	31	108	14	0	153
8026	5176s (+0.6s)	2492	2492	256	59	145	10	0	214
8027	5176s (+0.4s)	1212	1212	128	19	102	3	1	125
8028	5176s (+0.5s)	1828	1828	128	63	114	7	1	185
8029	5177s (+0.7s)	2976	2976	256	48	193	0	10	251
8030	5178s (+0.5s)	1696	1696	128	28	134	0	7	169
8031	5178s (+0.3s)	920	920	64	24	84	0	6	114
8032	5179s (+0.8s)	3600	3600	256	67	215	21	0	303
8033	5179s (+0.2s)	560	560	64	17	60	4	0	81
8034	5179s (+0.3s)	872	872	64	36	69	4	0	109
8035	5180s (+0.8s)	3432	3432	256	65	210	13	0	288
8036	5181s (+1.1s)	4396	4396	256	107	242	20	0	369
8037	5181s (+0.2s)	488	488	32	14	60	3	1	78
8038	5182s (+0.5s)	1772	1772	128	39	131	0	9	179
8039	5182s (+0.4s)	1336	1336	128	31	106	0	2	139
8040	5183s (+0.8s)	3588	3588	256	49	230	0	16	295
8041	5184s (+0.5s)	1720	1720	128	40	122	0	8	170
8042	5184s (+0.5s)	1508	1508	128	39	115	6	0	160
8043	5185s (+0.9s)	3552	3552	256	74	213	11	1	299
8044	5186s (+0.7s)	2556	2556	128	67	157	18	0	242
8045	5186s (+0.5s)	1544	1544	128	42	118	5	0	165
8046	5187s (+0.5s)	1532	1532	128	43	117	2	0	162
8047	5187s (+0.3s)	1140	1140	128	36	80	6	0	122
8048	5187s (+0.4s)	1260	1260	64	38	98	6	0	142
8049	5188s (+0.5s)	1884	1884	128	48	127	11	0	186
8050	5189s (+0.7s)	2896	2896	256	62	175	10	0	247
8051	5189s (+0.8s)	3304	3304	256	66	193	8	0	267
8052	5190s (+0.3s)	856	856	64	23	82	5	0	110
8053	5190s (+0.6s)	1968	1968	128	59	137	9	0	205
8054	5191s (+0.4s)	1264	1264	128	33	96	7	0	136
8055	5192s (+0.8s)	3312	3312	256	72	190	16	1	279
8056	5192s (+0.5s)	1968	1968	256	22	139	0	4	165
8057	5193s (+0.9s)	3944	3944	256	63	248	1	13	325
8058	5194s (+0.7s)	2696	2696	256	47	170	0	16	233
8059	5194s (+0.5s)	1840	1840	128	36	148	0	6	190
8060	5195s (+0.5s)	2068	2068	256	44	126	0	3	173
8061	5196s (+0.8s)	3652	3652	256	58	227	0	11	296
8062	5197s (+1.0s)	4440	4440	256	91	254	0	19	364
8063	5197s (+0.4s)	1524	1524	128	33	116	0	5	154
8064	5197s (+0.4s)	1040	1040	64	27	89	0	8	124
8065	5198s (+0.5s)	1496	1496	128	33	117	0	8	158
8066	5199s (+0.6s)	2612	2612	256	42	175	0	11	228
8067	5199s (+0.6s)	2556	2556	256	34	182	0	4	220
8068	5200s (+0.5s)	1800	1800	128	42	134	0	9	185
8069	5200s (+0.7s)	2940	2940	256	52	191	0	13	256
8070	5201s (+0.7s)	3184	3184	256	60	194	0	9	263
8071	5202s (+0.8s)	3288	3288	256	57	212	0	11	280
8072	5202s (+0.5s)	1616	1616	128	36	116	0	9	161
8073	5203s (+0.7s)	2488	2488	128	59	161	0	13	233
8074	5204s (+0.8s)	3216	3216	256	49	204	0	13	266
8075	5205s (+0.8s)	3300	3300	256	62	213	0	8	283
8076	5205s (+0.3s)	864	864	64	27	81	3	0	111
8077	5205s (+0.4s)	1388	1388	128	43	97	6	0	146
8078	5206s (+0.4s)	1140	1140	128	30	83	10	0	123
8079	5206s (+0.5s)	2048	2048	128	46	144	9	0	199
8080	5207s (+0.4s)	1456	1456	128	34	113	6	0	153
8081	5207s (+0.5s)	1804	1804	128	36	143	7	0	186
8082	5208s (+0.8s)	3548	3548	256	62	227	12	0	301
8083	5209s (+0.6s)	2236	2236	128	54	147	13	0	214
8084	5209s (+0.6s)	2340	2340	256	51	147	6	0	204
8085	5210s (+0.9s)	3956	3956	256	79	223	21	0	323
8086	5211s (+0.5s)	1804	1804	128	40	139	7	0	186
8087	5211s (+0.3s)	716	716	64	19	70	5	0	94
8088	5211s (+0.3s)	840	840	64	17	85	4	0	106
8089	5212s (+0.5s)	1788	1788	128	40	130	0	12	182
8090	5213s (+0.8s)	3380	3380	256	56	212	0	13	281
8091	5214s (+1.0s)	4432	4432	256	79	273	0	14	366
8092	5214s (+0.5s)	1788	1788	128	41	134	0	7	182
8093	5215s (+0.6s)	1948	1948	128	45	148	0	7	200
8094	5215s (+0.4s)	1504	1504	128	29	115	0	6	150
8095	5216s (+0.7s)	2888	2888	256	61	176	0	13	250
8096	5216s (+0.5s)	1616	1616	128	42	121	8	0	171
8097	5217s (+0.7s)	2644	2644	128	75	167	9	0	251
8098	5218s (+0.8s)	3228	3228	256	60	197	13	0	270
8099	5219s (+0.6s)	2540	2540	256	45	167	10	0	222
Episode	Time	Reward	Score	Highest	L	U	R	D	Steps
8100	5219s (+0.4s)	1464	1464	128	30	119	5	1	155
8101	5220s (+0.7s)	2916	2916	256	59	187	10	0	256
8102	5221s (+0.8s)	3312	3312	256	78	186	16	0	280
8103	5221s (+0.5s)	1708	1708	128	54	104	10	0	168
8104	5222s (+0.7s)	3160	3160	256	70	183	11	0	264
8105	5222s (+0.4s)	1248	1248	64	38	99	7	0	144
8106	5223s (+0.9s)	3940	3940	256	70	243	11	0	324
8107	5223s (+0.3s)	1036	1036	128	24	85	5	0	114
8108	5224s (+0.8s)	3428	3428	256	80	197	12	0	289
8109	5225s (+0.6s)	1968	1968	128	63	137	5	0	205
8110	5225s (+0.2s)	592	592	64	18	61	3	0	82
8111	5226s (+0.6s)	2276	2276	128	54	145	13	0	212
8112	5226s (+0.5s)	1804	1804	128	52	121	7	0	180
8113	5227s (+1.0s)	5392	5392	512	109	253	17	0	379
8114	5228s (+0.3s)	864	864	64	22	81	3	0	106
8115	5229s (+1.1s)	5372	5372	512	101	252	21	0	374
8116	5229s (+0.8s)	3536	3536	256	57	218	10	0	285
8117	5230s (+0.4s)	1488	1488	128	37	97	11	1	146
8118	5230s (+0.6s)	2404	2404	256	54	137	13	0	204
8119	5231s (+0.8s)	3300	3300	256	72	187	22	0	281
8120	5232s (+0.4s)	1388	1388	64	45	99	10	0	154
8121	5232s (+0.7s)	2852	2852	256	64	171	9	0	244
8122	5233s (+0.3s)	868	868	64	25	74	5	0	104
8123	5234s (+1.2s)	6384	6384	512	107	301	20	1	429
8124	5235s (+0.8s)	2932	2932	128	75	175	14	1	265
8125	5235s (+0.4s)	1484	1484	128	35	109	10	0	154
8126	5236s (+0.6s)	2352	2352	256	42	150	6	0	198
8127	5236s (+0.5s)	2212	2212	256	33	146	10	0	189
8128	5237s (+0.6s)	2204	2204	128	62	131	13	0	206
8129	5237s (+0.4s)	1396	1396	128	29	106	8	0	143
8130	5238s (+0.5s)	1868	1868	128	43	143	4	0	190
8131	5238s (+0.6s)	2508	2508	256	61	148	10	0	219
8132	5239s (+0.8s)	3324	3324	256	66	201	11	0	278
8133	5240s (+0.5s)	1608	1608	128	49	108	12	0	169
8134	5240s (+0.7s)	3044	3044	256	45	196	5	0	246
8135	5241s (+0.3s)	584	584	32	19	68	3	0	90
8136	5241s (+0.3s)	804	804	64	21	71	0	8	100
8137	5242s (+0.5s)	1752	1752	128	35	136	0	8	179
8138	5242s (+0.4s)	1316	1316	128	27	101	0	7	135
8139	5243s (+0.7s)	2856	2856	256	56	165	13	0	234
8140	5243s (+0.5s)	1608	1608	128	37	124	8	0	169
8141	5244s (+0.6s)	2500	2500	256	51	155	9	1	216
8142	5244s (+0.6s)	2356	2356	256	54	146	8	0	208
8143	5245s (+0.7s)	2840	2840	256	52	179	11	0	242
8144	5246s (+0.7s)	2952	2952	256	57	177	13	0	247
8145	5246s (+0.5s)	2088	2088	256	43	127	8	0	178
8146	5248s (+1.4s)	6576	6576	512	128	328	25	0	481
8147	5248s (+0.4s)	1456	1456	128	35	103	5	0	143
8148	5249s (+0.5s)	1660	1660	128	50	118	9	0	177
8149	5250s (+1.0s)	4292	4292	256	100	230	18	0	348
8150	5251s (+0.9s)	3652	3652	256	106	193	12	0	311
8151	5251s (+0.7s)	2828	2828	256	57	182	10	0	249
8152	5252s (+0.4s)	1308	1308	128	34	102	7	0	143
8153	5252s (+0.7s)	3116	3116	256	63	186	10	0	259
8154	5253s (+0.5s)	1752	1752	128	38	129	10	0	177
8155	5254s (+0.7s)	2664	2664	128	68	165	12	0	245
8156	5254s (+0.8s)	3244	3244	256	86	170	18	0	274
8157	5255s (+0.4s)	1372	1372	128	35	105	3	0	143
8158	5255s (+0.3s)	980	980	64	30	87	5	0	122
8159	5256s (+1.0s)	4616	4616	256	94	250	20	1	365
8160	5257s (+0.9s)	4688	4688	512	85	230	13	0	328
8161	5258s (+0.7s)	2892	2892	256	50	193	6	0	249
8162	5258s (+0.3s)	716	716	64	20	69	4	0	93
8163	5259s (+0.5s)	1932	1932	128	49	116	15	1	181
8164	5259s (+0.8s)	3288	3288	256	78	183	12	0	273
8165	5260s (+0.4s)	1452	1452	128	30	118	4	0	152
8166	5261s (+0.9s)	3576	3576	256	79	214	10	0	303
8167	5261s (+0.5s)	1540	1540	128	42	116	6	0	164
8168	5262s (+0.9s)	4044	4044	256	91	218	15	0	324
8169	5263s (+0.8s)	3356	3356	256	67	194	15	0	276
8170	5264s (+0.7s)	2636	2636	256	51	174	8	0	233
8171	5264s (+0.8s)	3488	3488	256	82	196	14	0	292
8172	5265s (+0.8s)	3440	3440	256	75	197	12	0	284
8173	5266s (+0.3s)	868	868	64	30	79	4	0	113
8174	5266s (+0.5s)	1896	1896	128	46	140	6	0	192
8175	5267s (+0.5s)	1536	1536	128	36	120	7	0	163
8176	5267s (+0.8s)	3504	3504	256	73	205	17	0	295
8177	5268s (+0.3s)	840	840	64	27	79	4	0	110
8178	5268s (+0.7s)	3028	3028	256	53	185	14	0	252
8179	5270s (+1.2s)	6196	6196	512	109	306	20	0	435
8180	5270s (+0.6s)	1904	1904	128	45	144	6	0	195
8181	5271s (+0.6s)	2636	2636	256	55	155	13	0	223
8182	5271s (+0.5s)	1616	1616	128	41	121	9	0	171
8183	5272s (+0.7s)	3104	3104	256	59	184	12	0	255
8184	5273s (+0.6s)	2428	2428	256	40	158	0	7	205
8185	5273s (+0.4s)	1048	1048	64	20	98	0	9	127
8186	5274s (+0.6s)	2724	2724	256	53	155	0	12	220
8187	5274s (+0.4s)	1088	1088	64	18	99	0	8	125
8188	5275s (+0.6s)	1916	1916	128	41	151	0	6	198
8189	5275s (+0.4s)	1364	1364	128	31	107	4	0	142
8190	5276s (+0.5s)	1736	1736	128	43	127	5	0	175
8191	5276s (+0.6s)	2532	2532	256	49	156	14	0	219
8192	5277s (+1.0s)	4224	4224	256	81	249	17	0	347
8193	5278s (+0.9s)	3676	3676	256	80	211	11	0	302
8194	5279s (+0.7s)	2964	2964	256	66	187	9	0	262
8195	5280s (+1.3s)	6544	6544	512	129	320	24	0	473
8196	5281s (+0.5s)	1568	1568	128	38	120	6	0	164
8197	5281s (+0.8s)	3184	3184	256	56	199	9	1	265
8198	5282s (+0.5s)	1648	1648	128	30	134	4	1	169
8199	5282s (+0.7s)	2504	2504	128	64	157	18	0	239
Episode	Time	Reward	Score	Highest	L	U	R	D	Steps
8200	5283s (+0.4s)	1292	1292	128	36	99	4	0	139
8201	5283s (+0.4s)	1456	1456	128	40	103	9	0	152
8202	5284s (+0.9s)	3940	3940	256	74	235	15	0	324
8203	5285s (+0.5s)	1900	1900	128	57	126	10	0	193
8204	5285s (+0.3s)	920	920	64	24	95	2	0	121
8205	5286s (+0.6s)	2476	2476	128	60	158	12	0	230
8206	5286s (+0.3s)	752	752	64	16	81	4	0	101
8207	5287s (+0.6s)	1936	1936	128	40	156	6	0	202
8208	5288s (+0.9s)	3788	3788	256	69	233	11	0	313
8209	5288s (+0.9s)	3888	3888	256	61	243	8	0	312
8210	5289s (+0.5s)	1776	1776	128	40	132	8	0	180
8211	5290s (+0.8s)	3188	3188	256	66	184	15	0	265
8212	5291s (+0.8s)	3620	3620	256	85	196	12	0	293
8213	5291s (+0.7s)	2864	2864	256	65	172	10	0	247
8214	5292s (+0.3s)	896	896	64	23	74	0	10	107
8215	5292s (+0.7s)	2624	2624	256	48	175	0	8	231
8216	5293s (+0.6s)	2756	2756	256	51	176	10	0	237
8217	5294s (+0.7s)	2832	2832	256	60	180	11	0	251
8218	5294s (+0.8s)	3260	3260	256	64	199	14	0	277
8219	5295s (+0.5s)	1788	1788	128	48	125	9	0	182
8220	5296s (+0.7s)	3176	3176	256	65	189	8	0	262
8221	5296s (+0.5s)	1884	1884	128	52	118	9	0	179
8222	5297s (+1.3s)	6200	6200	512	122	309	20	0	451
8223	5298s (+0.8s)	3588	3588	256	71	196	18	0	285
8224	5299s (+0.7s)	3072	3072	256	54	189	11	0	254
8225	5300s (+0.5s)	1972	1972	128	58	124	14	0	196
8226	5300s (+0.6s)	1936	1936	128	45	151	6	0	202
8227	5301s (+0.5s)	1780	1780	128	41	135	8	0	184
8228	5301s (+0.7s)	2936	2936	256	77	150	23	0	250
8229	5302s (+0.9s)	3860	3860	256	95	212	9	0	316
8230	5303s (+0.6s)	1932	1932	128	60	128	12	1	201
8231	5304s (+1.0s)	4192	4192	256	79	249	15	0	343
8232	5304s (+0.6s)	2228	2228	256	48	138	7	0	193
8233	5305s (+0.6s)	2752	2752	256	58	170	8	0	236
8234	5306s (+0.6s)	2040	2040	128	70	120	11	0	201
8235	5307s (+0.9s)	3940	3940	256	60	253	11	0	324
8236	5307s (+0.3s)	600	600	32	20	67	3	0	90
8237	5308s (+0.9s)	3632	3632	256	85	210	15	0	310
8238	5308s (+0.4s)	1156	1156	64	39	92	5	0	136
8239	5309s (+0.9s)	4648	4648	512	89	215	18	0	322
8240	5310s (+0.5s)	1592	1592	128	46	115	4	0	165
8241	5310s (+0.8s)	3476	3476	256	80	196	17	0	293
8242	5311s (+0.5s)	1672	1672	128	30	133	7	0	170
8243	5311s (+0.3s)	804	804	64	25	71	6	0	102
8244	5312s (+0.4s)	1404	1404	128	33	111	7	0	151
8245	5312s (+0.7s)	2944	2944	256	65	162	11	0	238
8246	5313s (+0.6s)	2028	2028	128	57	136	12	0	205
8247	5313s (+0.4s)	1472	1472	128	45	98	9	0	152
8248	5314s (+0.6s)	1920	1920	128	52	140	6	0	198
8249	5315s (+0.8s)	3456	3456	256	53	225	0	13	291
8250	5315s (+0.4s)	1524	1524	128	32	121	0	5	158
8251	5316s (+0.7s)	2796	2796	256	52	181	0	9	242
8252	5316s (+0.4s)	1228	1228	64	35	94	0	10	139
8253	5317s (+0.4s)	1176	1176	64	32	100	0	9	141
8254	5317s (+0.6s)	2584	2584	256	44	179	0	4	227
8255	5318s (+0.6s)	2592	2592	256	48	163	0	12	223
8256	5319s (+0.9s)	4456	4456	256	70	244	0	32	346
8257	5320s (+0.7s)	2860	2860	256	63	187	3	0	253
8258	5320s (+0.2s)	692	692	64	27	60	3	0	90
8259	5321s (+0.8s)	3604	3604	256	82	207	14	0	303
8260	5321s (+0.4s)	1268	1268	128	25	102	2	0	129
8261	5322s (+0.6s)	1892	1892	128	50	140	6	0	196
8262	5322s (+0.5s)	2080	2080	128	52	130	10	0	192
8263	5323s (+0.6s)	2192	2192	128	58	141	8	1	208
8264	5323s (+0.4s)	1452	1452	128	37	106	5	0	148
8265	5324s (+0.7s)	2776	2776	256	60	166	11	0	237
8266	5324s (+0.5s)	1684	1684	128	37	126	8	0	171
8267	5325s (+0.4s)	1128	1128	64	41	86	8	0	135
8268	5326s (+0.9s)	3568	3568	256	65	224	11	0	300
8269	5326s (+0.3s)	688	688	64	12	76	0	3	91
8270	5327s (+0.7s)	2904	2904	256	52	185	0	15	252
8271	5328s (+0.9s)	3920	3920	256	76	230	0	15	321
8272	5329s (+1.3s)	6416	6416	512	123	311	29	0	463
8273	5330s (+0.8s)	3296	3296	256	69	193	11	2	275
8274	5330s (+0.4s)	1188	1188	128	24	96	3	0	123
8275	5330s (+0.5s)	1796	1796	128	40	136	4	0	180
8276	5332s (+1.3s)	6640	6640	512	122	307	26	0	455
8277	5332s (+0.5s)	1756	1756	128	47	121	11	0	179
8278	5333s (+0.8s)	3392	3392	256	66	201	12	0	279
8279	5334s (+0.7s)	2856	2856	256	44	196	6	1	247
8280	5334s (+0.7s)	2840	2840	256	47	185	13	0	245
8281	5335s (+0.4s)	1136	1136	64	30	92	6	0	128
8282	5335s (+0.3s)	932	932	64	32	78	7	0	117
8283	5336s (+0.6s)	2724	2724	256	38	187	5	0	230
8284	5336s (+0.5s)	1784	1784	128	42	133	6	0	181
8285	5337s (+0.8s)	3040	3040	256	75	175	14	0	264
8286	5338s (+0.7s)	2880	2880	256	52	170	14	0	236
8287	5338s (+0.4s)	1196	1196	128	27	97	3	0	127
8288	5339s (+0.4s)	1424	1424	128	35	112	4	0	151
8289	5340s (+1.0s)	4144	4144	256	80	245	17	0	342
8290	5340s (+0.5s)	1704	1704	128	39	122	5	0	166
8291	5341s (+0.6s)	2632	2632	256	56	148	13	0	217
8292	5341s (+0.5s)	1752	1752	128	36	136	6	0	178
8293	5342s (+0.7s)	2928	2928	256	64	180	14	0	258
8294	5342s (+0.5s)	1580	1580	128	37	118	8	0	163
8295	5343s (+0.6s)	2540	2540	256	53	162	7	0	222
8296	5344s (+0.9s)	3684	3684	256	79	217	15	0	311
8297	5345s (+0.8s)	3304	3304	256	65	198	14	0	277
8298	5345s (+0.7s)	3064	3064	256	56	182	0	13	251
8299	5346s (+0.4s)	1480	1480	128	22	127	0	5	154
Episode	Time	Reward	Score	Highest	L	U	R	D	Steps
8300	5346s (+0.3s)	1000	1000	64	18	92	0	6	116
8301	5347s (+0.5s)	1824	1824	128	32	152	0	7	191
8302	5347s (+0.4s)	1308	1308	128	31	96	0	10	137
8303	5348s (+0.7s)	2932	2932	256	47	200	0	13	260
8304	5349s (+0.8s)	3344	3344	256	59	206	11	0	276
8305	5349s (+0.5s)	1720	1720	128	38	125	7	0	170
8306	5350s (+1.0s)	4472	4472	256	86	263	15	0	364
8307	5351s (+0.6s)	2404	2404	256	36	160	9	0	205
8308	5352s (+1.1s)	5756	5756	512	104	283	17	0	404
8309	5353s (+1.0s)	4236	4236	256	89	240	21	0	350
8310	5353s (+0.4s)	1412	1412	128	25	120	3	0	148
8311	5354s (+0.4s)	1196	1196	64	39	101	5	0	145
8312	5354s (+0.4s)	1148	1148	64	36	87	11	0	134
8313	5355s (+0.8s)	3244	3244	256	71	193	10	0	274
8314	5356s (+0.7s)	2868	2868	256	91	150	14	0	255
8315	5356s (+0.8s)	3552	3552	256	71	220	11	0	302
8316	5357s (+0.8s)	3604	3604	256	68	210	10	1	289
8317	5358s (+0.8s)	3528	3528	256	72	204	20	0	296
8318	5359s (+0.4s)	1548	1548	128	29	115	5	0	149
8319	5359s (+0.7s)	3124	3124	256	74	169	13	0	256
8320	5360s (+1.0s)	4204	4204	256	89	247	12	0	348
8321	5361s (+0.8s)	3240	3240	256	70	188	14	0	272
8322	5362s (+0.8s)	3420	3420	256	75	204	10	0	289
8323	5363s (+1.0s)	4240	4240	256	90	241	19	0	350
8324	5364s (+1.0s)	5352	5352	512	93	260	16	1	370
8325	5364s (+0.5s)	1576	1576	128	35	117	10	0	162
8326	5365s (+0.4s)	1740	1740	128	33	122	5	1	161
8327	5365s (+0.6s)	2580	2580	256	69	139	16	0	224
8328	5366s (+0.6s)	1896	1896	128	42	148	7	0	197
8329	5366s (+0.4s)	1420	1420	128	39	115	6	1	161
8330	5367s (+0.7s)	2924	2924	256	67	175	15	0	257
8331	5368s (+0.4s)	1492	1492	128	41	110	5	0	156
8332	5369s (+1.1s)	5592	5592	512	96	285	16	0	397
8333	5370s (+0.8s)	3448	3448	256	80	190	15	1	286
8334	5370s (+0.4s)	1428	1428	128	35	110	7	0	152
8335	5370s (+0.4s)	1464	1464	128	35	113	6	0	154
8336	5372s (+1.0s)	4280	4280	256	110	231	14	0	355
8337	5372s (+0.8s)	3484	3484	256	82	187	17	0	286
8338	5373s (+0.4s)	1540	1540	128	39	107	7	0	153
8339	5374s (+1.0s)	4364	4364	256	103	240	20	1	364
8340	5374s (+0.5s)	1872	1872	128	50	127	10	0	187
8341	5375s (+0.6s)	2428	2428	256	43	149	11	0	203
8342	5375s (+0.6s)	2296	2296	256	61	128	9	0	198
8343	5376s (+0.5s)	1616	1616	128	35	128	8	0	171
8344	5377s (+0.7s)	2968	2968	256	57	183	9	0	249
8345	5378s (+0.9s)	3948	3948	256	83	225	18	0	326
8346	5378s (+0.5s)	1668	1668	128	48	113	7	1	169
8347	5379s (+0.8s)	3496	3496	256	64	213	15	1	293
8348	5379s (+0.4s)	1192	1192	128	31	90	3	0	124
8349	5380s (+0.6s)	2492	2492	256	58	148	9	0	215
8350	5380s (+0.5s)	1820	1820	128	58	100	10	0	168
8351	5381s (+0.3s)	1172	1172	128	25	86	9	0	120
8352	5381s (+0.3s)	920	920	64	25	82	5	0	112
8353	5382s (+0.7s)	2796	2796	256	46	185	0	11	242
8354	5382s (+0.5s)	1628	1628	128	35	131	0	7	173
8355	5383s (+0.4s)	1400	1400	128	29	112	0	6	147
8356	5383s (+0.6s)	2528	2528	256	52	160	0	4	216
8357	5384s (+0.9s)	4132	4132	256	71	242	0	23	336
8358	5385s (+0.7s)	2968	2968	256	81	171	11	0	263
8359	5386s (+0.7s)	3180	3180	256	56	198	10	0	264
8360	5386s (+0.6s)	2432	2432	256	52	142	11	0	205
8361	5387s (+0.8s)	3364	3364	256	63	211	9	0	283
8362	5388s (+0.4s)	1420	1420	128	40	103	11	0	154
8363	5388s (+0.7s)	2904	2904	256	55	188	9	0	252
8364	5389s (+0.8s)	3444	3444	256	80	192	20	0	292
8365	5390s (+0.7s)	2900	2900	256	56	190	8	2	256
8366	5390s (+0.4s)	1528	1528	128	47	104	10	0	161
8367	5391s (+0.8s)	3500	3500	256	72	207	14	0	293
8368	5392s (+0.8s)	3752	3752	256	74	221	10	0	305
8369	5392s (+0.6s)	1904	1904	128	37	154	0	4	195
8370	5393s (+0.5s)	1792	1792	128	32	141	0	10	183
8371	5394s (+0.9s)	3968	3968	256	68	243	0	15	326
8372	5394s (+0.4s)	1300	1300	128	17	111	5	0	133
8373	5395s (+0.5s)	1896	1896	128	45	139	8	0	192
8374	5396s (+1.0s)	4192	4192	256	112	209	21	0	342
8375	5396s (+0.4s)	1288	1288	128	25	101	4	1	131
8376	5397s (+0.7s)	2984	2984	256	49	187	10	0	246
8377	5398s (+0.7s)	3084	3084	256	55	188	7	0	250
8378	5398s (+0.3s)	1140	1140	128	44	73	3	0	120
8379	5399s (+0.8s)	3268	3268	256	80	178	14	1	273
8380	5399s (+0.7s)	2472	2472	128	57	157	15	1	230
8381	5400s (+0.7s)	2704	2704	256	65	157	13	0	235
8382	5401s (+0.8s)	3348	3348	256	61	204	0	12	277
8383	5402s (+0.7s)	3144	3144	256	52	197	0	10	259
8384	5402s (+0.7s)	3188	3188	256	52	203	0	7	262
8385	5403s (+0.5s)	1756	1756	128	40	128	0	8	176
8386	5403s (+0.6s)	1964	1964	128	52	147	0	7	206
8387	5404s (+0.4s)	1484	1484	128	37	107	0	10	154
8388	5405s (+0.7s)	2512	2512	128	61	158	12	1	232
8389	5405s (+0.3s)	684	684	64	14	75	1	0	90
8390	5405s (+0.6s)	2212	2212	128	64	149	11	0	224
8391	5406s (+0.6s)	2432	2432	256	58	136	10	0	204
8392	5407s (+0.6s)	2308	2308	128	59	151	10	0	220
8393	5407s (+0.4s)	1340	1340	64	47	100	7	0	154
8394	5408s (+0.4s)	1340	1340	128	40	99	7	0	146
8395	5408s (+0.5s)	1724	1724	128	46	116	8	1	171
8396	5409s (+0.7s)	2584	2584	128	73	161	11	0	245
8397	5409s (+0.6s)	2412	2412	256	47	152	9	0	208
8398	5410s (+0.5s)	1688	1688	128	39	126	8	1	174
8399	5410s (+0.5s)	2200	2200	256	36	138	7	0	181
Episode	Time	Reward	Score	Highest	L	U	R	D	Steps
8400	5411s (+1.1s)	4604	4604	256	109	251	21	0	381
8401	5412s (+0.9s)	3792	3792	256	97	204	17	1	319
8402	5414s (+1.3s)	6584	6584	512	119	311	26	1	457
8403	5414s (+0.5s)	2088	2088	256	43	117	9	0	169
8404	5415s (+0.7s)	2812	2812	256	54	184	8	0	246
8405	5415s (+0.6s)	2664	2664	256	44	172	10	0	226
8406	5416s (+0.3s)	792	792	64	23	78	4	1	106
8407	5416s (+0.5s)	1608	1608	128	43	118	8	0	169
8408	5417s (+0.9s)	3920	3920	256	83	225	12	0	320
8409	5418s (+0.5s)	1524	1524	128	36	117	7	0	160
8410	5419s (+0.9s)	3936	3936	256	79	227	13	0	319
8411	5419s (+0.7s)	2472	2472	128	53	165	15	0	233
8412	5420s (+0.8s)	3344	3344	256	65	205	12	0	282
8413	5421s (+0.9s)	3928	3928	256	74	232	14	1	321
8414	5421s (+0.4s)	1204	1204	128	23	105	6	0	134
8415	5422s (+0.5s)	1824	1824	128	45	130	7	1	183
8416	5423s (+0.8s)	3176	3176	256	63	191	0	10	264
8417	5423s (+0.8s)	3436	3436	256	56	215	0	15	286
8418	5424s (+0.7s)	2832	2832	256	50	194	0	7	251
8419	5425s (+0.7s)	2936	2936	256	54	178	0	14	246
8420	5425s (+0.4s)	1368	1368	128	27	111	0	4	142
8421	5426s (+0.4s)	1424	1424	128	27	114	0	4	145
8422	5426s (+0.7s)	3192	3192	256	54	199	0	9	262
8423	5427s (+0.3s)	720	720	64	22	69	0	3	94
8424	5428s (+0.9s)	3572	3572	256	72	222	0	13	307
8425	5428s (+0.5s)	1840	1840	128	32	153	0	4	189
8426	5429s (+0.5s)	1684	1684	128	36	127	6	0	169
8427	5429s (+0.3s)	664	664	32	23	66	5	0	94
8428	5430s (+1.0s)	5216	5216	512	98	253	16	1	368
8429	5430s (+0.4s)	1052	1052	64	29	91	7	0	127
8430	5431s (+0.3s)	772	772	64	27	74	3	0	104
8431	5432s (+1.0s)	5324	5324	512	76	274	16	1	367
8432	5432s (+0.4s)	1428	1428	128	29	113	5	0	147
8433	5433s (+0.6s)	2516	2516	256	53	153	8	1	215
8434	5433s (+0.4s)	1460	1460	128	32	105	6	0	143
8435	5433s (+0.3s)	864	864	64	28	79	5	0	112
8436	5434s (+0.4s)	1348	1348	128	28	108	3	0	139
8437	5435s (+0.7s)	2916	2916	256	70	173	13	0	256
8438	5435s (+0.4s)	1344	1344	128	26	108	4	0	138
8439	5435s (+0.4s)	1468	1468	128	37	105	9	0	151
8440	5436s (+0.8s)	3252	3252	256	60	200	0	15	275
8441	5437s (+0.4s)	1492	1492	128	31	115	0	5	151
8442	5437s (+0.7s)	2428	2428	128	53	167	0	10	230
8443	5438s (+0.5s)	1808	1808	128	41	134	0	12	187
8444	5438s (+0.2s)	536	536	64	14	57	3	0	74
8445	5439s (+0.8s)	3240	3240	256	67	194	12	0	273
8446	5439s (+0.5s)	1620	1620	128	46	121	5	0	172
8447	5440s (+0.2s)	416	416	32	19	47	4	0	70
8448	5440s (+0.4s)	1472	1472	128	39	111	7	0	157
8449	5440s (+0.3s)	704	704	64	15	72	3	1	91
8450	5441s (+0.9s)	3716	3716	256	79	220	13	0	312
8451	5442s (+0.4s)	1072	1072	64	31	94	6	0	131
8452	5442s (+0.4s)	1160	1160	128	29	91	7	0	127
8453	5442s (+0.4s)	1160	1160	128	34	93	2	0	129
8454	5443s (+0.4s)	1164	1164	128	30	93	7	0	130
8455	5444s (+1.4s)	6568	6568	512	117	336	19	1	473
8456	5445s (+0.9s)	3564	3564	256	51	234	0	21	306
8457	5445s (+0.5s)	1736	1736	128	51	122	0	8	181
8458	5446s (+0.7s)	2760	2760	256	43	181	0	14	238
8459	5447s (+0.5s)	1744	1744	128	32	135	0	10	177
8460	5447s (+0.5s)	1676	1676	128	27	137	0	5	169
8461	5448s (+0.7s)	2500	2500	128	40	181	0	15	236
8462	5448s (+0.5s)	1660	1660	128	40	124	0	3	167
8463	5449s (+0.9s)	3924	3924	256	64	251	0	12	327
8464	5450s (+0.5s)	1680	1680	128	36	130	6	0	172
8465	5450s (+0.7s)	3188	3188	256	73	177	15	0	265
8466	5451s (+0.6s)	1996	1996	128	43	144	14	0	201
8467	5452s (+0.6s)	1920	1920	128	56	129	13	0	198
8468	5452s (+0.9s)	3880	3880	256	79	226	9	0	314
8469	5453s (+0.6s)	2384	2384	256	44	151	0	9	204
8470	5454s (+0.9s)	3944	3944	256	70	240	0	15	325
8471	5455s (+0.7s)	3192	3192	256	61	189	0	12	262
8472	5455s (+0.5s)	1476	1476	128	27	123	0	7	157
8473	5456s (+0.8s)	3380	3380	256	59	207	0	15	281
8474	5457s (+0.8s)	3200	3200	256	50	213	5	0	268
8475	5457s (+0.7s)	2652	2652	256	66	151	13	1	231
8476	5458s (+1.0s)	4236	4236	256	85	249	16	0	350
8477	5459s (+0.7s)	2620	2620	256	54	162	14	0	230
8478	5460s (+0.5s)	1740	1740	128	39	126	10	0	175
8479	5460s (+0.9s)	4676	4676	512	80	223	17	0	320
8480	5461s (+0.5s)	1872	1872	128	34	148	8	0	190
8481	5462s (+1.2s)	6388	6388	512	115	297	19	1	432
8482	5463s (+0.4s)	1160	1160	128	24	96	3	0	123
8483	5463s (+0.8s)	3276	3276	256	66	202	13	0	281
8484	5464s (+0.7s)	3172	3172	256	61	186	10	0	257
8485	5465s (+0.6s)	2416	2416	128	58	151	11	0	220
8486	5466s (+0.9s)	3888	3888	256	111	200	16	0	327
8487	5466s (+0.6s)	2400	2400	128	65	148	10	0	223
8488	5467s (+0.4s)	1468	1468	128	33	120	2	0	155
8489	5467s (+0.3s)	768	768	64	33	62	6	0	101
8490	5468s (+0.8s)	3512	3512	256	76	202	16	0	294
8491	5468s (+0.6s)	2456	2456	256	56	144	10	0	210
8492	5469s (+0.5s)	1768	1768	128	39	125	12	0	176
8493	5470s (+0.5s)	1820	1820	128	40	135	9	0	184
8494	5470s (+0.4s)	1124	1124	128	29	89	6	0	124
8495	5470s (+0.5s)	1840	1840	128	48	127	12	1	188
8496	5471s (+0.6s)	1924	1924	128	52	138	9	0	199
8497	5472s (+0.8s)	3484	3484	256	67	211	16	0	294
8498	5472s (+0.5s)	1688	1688	128	40	126	7	0	173
8499	5473s (+0.7s)	3020	3020	256	67	172	11	0	250
Episode	Time	Reward	Score	Highest	L	U	R	D	Steps
8500	5474s (+0.8s)	3448	3448	256	81	190	17	0	288
8501	5474s (+0.4s)	1012	1012	64	27	93	8	0	128
8502	5475s (+0.6s)	2464	2464	256	52	150	10	1	213
8503	5475s (+0.3s)	1124	1124	128	25	91	0	3	119
8504	5476s (+0.5s)	1788	1788	128	49	123	0	9	181
8505	5476s (+0.5s)	1904	1904	128	44	143	0	7	194
8506	5477s (+0.6s)	2556	2556	256	43	174	0	8	225
8507	5478s (+0.9s)	4036	4036	256	63	255	0	14	332
8508	5479s (+0.7s)	2816	2816	256	59	177	0	11	247
8509	5479s (+0.7s)	3168	3168	256	46	213	0	7	266
8510	5480s (+1.0s)	3996	3996	256	74	243	0	17	334
8511	5481s (+0.4s)	1312	1312	128	22	108	0	4	134
8512	5481s (+0.6s)	2512	2512	256	47	166	0	7	220
8513	5482s (+0.6s)	2448	2448	128	36	183	0	11	230
8514	5483s (+0.7s)	2804	2804	256	43	194	0	8	245
8515	5483s (+0.7s)	2680	2680	256	48	181	0	10	239
8516	5484s (+1.1s)	5404	5404	512	81	283	0	18	382
8517	5485s (+0.2s)	612	612	64	16	61	1	5	83
8518	5485s (+0.7s)	2492	2492	128	51	159	0	24	234
8519	5487s (+1.3s)	6240	6240	512	88	333	0	26	447
8520	5487s (+0.4s)	1428	1428	128	30	111	6	0	147
8521	5488s (+0.4s)	1268	1268	128	24	105	5	0	134
8522	5488s (+0.8s)	3472	3472	256	73	199	16	0	288
8523	5489s (+0.7s)	2820	2820	256	63	166	12	0	241
8524	5490s (+0.6s)	1928	1928	128	39	155	6	0	200
8525	5490s (+0.5s)	1924	1924	128	47	126	15	0	188
8526	5491s (+0.4s)	1488	1488	128	40	109	7	0	156
8527	5491s (+0.3s)	1012	1012	128	23	77	3	0	103
8528	5491s (+0.4s)	1512	1512	128	28	119	0	5	152
8529	5492s (+0.6s)	2508	2508	256	45	163	0	10	218
8530	5493s (+0.5s)	2128	2128	256	43	124	0	11	178
8531	5493s (+0.8s)	3232	3232	256	50	208	0	14	272
8532	5494s (+0.5s)	1888	1888	128	51	131	8	0	190
8533	5494s (+0.4s)	1500	1500	128	45	109	5	0	159
8534	5495s (+1.0s)	5176	5176	512	84	267	21	0	372
8535	5496s (+0.8s)	3248	3248	256	89	173	16	0	278
8536	5496s (+0.3s)	748	748	64	23	72	5	0	100
8537	5497s (+0.9s)	3612	3612	256	68	231	6	0	305
8538	5498s (+0.4s)	1272	1272	128	27	99	3	0	129
8539	5498s (+0.7s)	2964	2964	256	77	157	14	1	249
8540	5499s (+0.6s)	2360	2360	256	41	151	10	0	202
8541	5500s (+0.5s)	1616	1616	128	43	120	9	0	172
8542	5500s (+0.6s)	1920	1920	128	50	143	5	0	198
8543	5501s (+0.5s)	1932	1932	128	28	152	0	7	187
8544	5501s (+0.5s)	1604	1604	128	35	125	0	8	168
8545	5501s (+0.2s)	516	516	64	14	50	0	6	70
8546	5502s (+0.6s)	2028	2028	128	48	139	6	1	194
8547	5502s (+0.4s)	1452	1452	128	35	111	6	0	152
8548	5503s (+0.5s)	1804	1804	128	42	134	10	0	186
8549	5504s (+0.7s)	3160	3160	256	60	195	9	1	265
8550	5505s (+1.1s)	5432	5432	512	107	253	19	0	379
8551	5505s (+0.7s)	2928	2928	256	68	163	12	0	243
8552	5506s (+0.5s)	1596	1596	128	32	124	10	0	166
8553	5507s (+0.6s)	2532	2532	256	38	160	9	0	207
8554	5507s (+0.7s)	2900	2900	256	65	162	10	0	237
8555	5508s (+0.6s)	2616	2616	256	50	159	10	0	219
8556	5508s (+0.3s)	796	796	64	29	71	7	0	107
8557	5509s (+0.7s)	2976	2976	256	59	170	12	0	241
8558	5509s (+0.3s)	728	728	64	25	63	6	1	95
8559	5510s (+0.9s)	4116	4116	256	90	232	13	0	335
8560	5511s (+1.0s)	4160	4160	256	95	222	25	0	342
8561	5511s (+0.3s)	1100	1100	128	23	88	6	0	117
8562	5512s (+0.7s)	2996	2996	256	56	188	9	0	253
8563	5513s (+0.4s)	1532	1532	128	39	111	9	0	159
8564	5513s (+0.9s)	3836	3836	256	78	220	12	0	310
8565	5514s (+1.0s)	5340	5340	512	100	246	21	0	367
8566	5515s (+0.6s)	2284	2284	128	62	137	15	0	214
8567	5516s (+1.0s)	4300	4300	256	84	252	17	0	353
8568	5516s (+0.4s)	1540	1540	128	34	112	7	1	154
8569	5517s (+0.4s)	1188	1188	64	42	84	8	0	134
8570	5517s (+0.6s)	2516	2516	256	55	155	10	0	220
8571	5518s (+0.8s)	3412	3412	256	69	198	16	0	283
8572	5519s (+1.0s)	4332	4332	256	97	240	20	0	357
8573	5520s (+0.4s)	1296	1296	128	35	101	4	0	140
8574	5520s (+0.5s)	1828	1828	128	32	148	0	5	185
8575	5521s (+0.5s)	1840	1840	128	38	144	0	8	190
8576	5521s (+0.3s)	1024	1024	128	20	88	0	3	111
8577	5522s (+0.8s)	3260	3260	256	54	211	0	8	273
8578	5523s (+0.8s)	3436	3436	256	61	213	0	15	289
8579	5523s (+0.7s)	3228	3228	256	62	189	14	0	265
8580	5524s (+0.4s)	1112	1112	64	38	93	6	0	137
8581	5524s (+0.5s)	1748	1748	128	41	140	2	0	183
8582	5525s (+0.5s)	2008	2008	128	60	119	10	1	190
8583	5526s (+0.7s)	2904	2904	256	57	188	7	0	252
8584	5526s (+0.6s)	2804	2804	256	63	154	13	0	230
8585	5527s (+0.4s)	1000	1000	64	31	92	5	0	128
8586	5527s (+0.6s)	2580	2580	256	58	145	13	0	216
8587	5528s (+0.9s)	3880	3880	256	97	213	17	0	327
8588	5529s (+0.7s)	2904	2904	256	56	175	10	1	242
8589	5529s (+0.3s)	1004	1004	64	37	77	5	0	119
8590	5530s (+0.7s)	3104	3104	256	68	177	11	0	256
8591	5530s (+0.4s)	1372	1372	128	34	102	0	7	143
8592	5531s (+0.7s)	3048	3048	256	51	191	0	14	256
8593	5531s (+0.3s)	684	684	64	20	68	0	1	89
8594	5532s (+0.3s)	744	744	64	22	73	0	3	98
8595	5532s (+0.6s)	2648	2648	256	55	157	11	0	223
8596	5533s (+0.5s)	1896	1896	128	51	140	2	0	193
8597	5534s (+0.8s)	3504	3504	256	86	198	12	0	296
8598	5535s (+0.9s)	4000	4000	256	77	233	17	0	327
8599	5535s (+0.2s)	416	416	32	11	52	3	0	66
Episode	Time	Reward	Score	Highest	L	U	R	D	Steps
8600	5536s (+1.1s)	5484	5484	512	95	273	19	0	387
8601	5537s (+0.9s)	3956	3956	256	70	236	18	0	324
8602	5538s (+0.7s)	2972	2972	256	80	155	22	1	258
8603	5538s (+0.6s)	2372	2372	256	43	146	9	0	198
8604	5539s (+0.4s)	1448	1448	128	29	114	3	0	146
8605	5539s (+0.6s)	1920	1920	128	58	128	11	1	198
8606	5539s (+0.3s)	748	748	64	32	66	3	0	101
8607	5540s (+0.7s)	2924	2924	256	51	201	0	5	257
8608	5541s (+0.5s)	1780	1780	128	37	138	0	9	184
8609	5541s (+0.8s)	3156	3156	256	45	210	0	13	268
8610	5542s (+0.4s)	1224	1224	128	38	84	0	12	134
8611	5542s (+0.5s)	2036	2036	128	47	143	0	6	196
8612	5543s (+0.7s)	3108	3108	256	39	211	7	0	257
8613	5544s (+0.4s)	1396	1396	128	39	98	8	0	145
8614	5544s (+0.6s)	1968	1968	128	55	143	7	0	205
8615	5545s (+0.5s)	1628	1628	128	43	114	6	0	163
8616	5545s (+0.8s)	3248	3248	256	62	205	8	0	275
8617	5547s (+1.1s)	5684	5684	512	103	277	24	0	404
8618	5547s (+0.9s)	3592	3592	256	72	223	12	0	307
8619	5548s (+0.8s)	3212	3212	256	66	200	5	0	271
8620	5549s (+0.6s)	2072	2072	128	69	130	10	0	209
8621	5549s (+0.6s)	2272	2272	256	42	144	10	0	196
8622	5550s (+0.5s)	1608	1608	128	43	112	3	0	158
8623	5550s (+0.5s)	1896	1896	128	41	144	7	0	192
8624	5551s (+0.7s)	2984	2984	256	70	164	12	0	246
8625	5552s (+0.4s)	1324	1324	128	32	105	9	0	146
8626	5552s (+0.6s)	2416	2416	256	45	161	2	0	208
8627	5552s (+0.3s)	708	708	64	24	70	6	0	100
8628	5553s (+0.5s)	1636	1636	128	43	114	9	0	166
8629	5553s (+0.3s)	1180	1180	128	19	102	4	0	125
8630	5554s (+0.6s)	2128	2128	128	50	155	9	0	214
8631	5555s (+0.8s)	3248	3248	256	76	181	18	0	275
8632	5555s (+0.3s)	792	792	64	29	74	4	0	107
8633	5556s (+0.8s)	3200	3200	256	61	190	17	0	268
8634	5557s (+0.9s)	4000	4000	256	77	244	8	0	329
8635	5557s (+0.5s)	1600	1600	128	44	112	11	0	167
8636	5558s (+0.4s)	1264	1264	128	37	98	4	0	139
8637	5558s (+0.4s)	1140	1140	64	38	95	4	0	137
8638	5559s (+1.0s)	4508	4508	256	93	260	15	0	368
8639	5560s (+0.6s)	1948	1948	128	51	139	10	0	200
8640	5560s (+0.6s)	2040	2040	128	45	150	10	0	205
8641	5561s (+0.4s)	1512	1512	128	33	124	4	0	161
8642	5562s (+1.0s)	5128	5128	512	101	243	14	2	360
8643	5562s (+0.5s)	1716	1716	128	56	116	4	0	176
8644	5563s (+0.6s)	2340	2340	256	51	137	10	0	198
8645	5563s (+0.8s)	3248	3248	256	62	195	11	0	268
8646	5564s (+0.7s)	2932	2932	256	61	168	14	1	244
8647	5565s (+0.5s)	1636	1636	128	28	137	0	7	172
8648	5565s (+0.5s)	2056	2056	256	33	133	0	5	171
8649	5565s (+0.3s)	1040	1040	128	25	80	0	5	110
8650	5566s (+0.6s)	2320	2320	256	42	141	0	11	194
8651	5567s (+0.5s)	1744	1744	128	40	121	0	8	169
8652	5567s (+0.6s)	2156	2156	128	52	152	6	0	210
8653	5568s (+0.6s)	2148	2148	128	61	133	14	0	208
8654	5568s (+0.7s)	3192	3192	256	60	195	11	0	266
8655	5569s (+0.7s)	3040	3040	256	65	170	10	0	245
8656	5570s (+0.4s)	1168	1168	64	42	88	9	0	139
8657	5570s (+0.4s)	1320	1320	128	37	101	7	0	145
8658	5571s (+0.6s)	1976	1976	128	58	143	6	0	207
8659	5571s (+0.8s)	3436	3436	256	78	188	0	15	281
8660	5572s (+0.3s)	836	836	64	16	90	0	4	110
8661	5572s (+0.6s)	2688	2688	256	58	158	9	0	225
8662	5573s (+0.9s)	4016	4016	256	92	230	16	0	338
8663	5574s (+0.3s)	784	784	64	21	80	3	0	104
8664	5575s (+0.9s)	4044	4044	256	81	227	21	0	329
8665	5575s (+0.8s)	3492	3492	256	57	222	13	1	293
8666	5576s (+0.5s)	2240	2240	256	47	135	4	0	186
8667	5576s (+0.5s)	2080	2080	256	43	123	9	1	176
8668	5577s (+0.5s)	1684	1684	128	38	129	6	0	173
8669	5578s (+0.5s)	1880	1880	128	53	124	12	0	189
8670	5578s (+0.4s)	1052	1052	64	30	90	6	0	126
8671	5578s (+0.3s)	972	972	64	29	87	7	0	123
8672	5579s (+0.5s)	1848	1848	128	47	127	11	0	185
8673	5579s (+0.7s)	2824	2824	256	54	174	13	0	241
8674	5580s (+0.3s)	864	864	64	27	75	0	10	112
8675	5581s (+0.8s)	3316	3316	256	47	216	0	13	276
8676	5581s (+0.7s)	2960	2960	256	56	182	0	10	248
8677	5582s (+0.2s)	408	408	32	10	52	0	4	66
8678	5582s (+0.4s)	1428	1428	128	28	114	0	5	147
8679	5583s (+0.8s)	3528	3528	256	81	192	0	19	292
8680	5584s (+0.8s)	3556	3556	256	67	214	17	0	298
8681	5584s (+0.9s)	4032	4032	256	81	231	18	0	330
8682	5585s (+0.8s)	3368	3368	256	84	189	15	0	288
8683	5586s (+0.5s)	1804	1804	128	57	112	13	0	182
8684	5587s (+0.7s)	3036	3036	256	80	161	18	0	259
8685	5587s (+0.9s)	4788	4788	512	84	222	23	0	329
8686	5588s (+1.0s)	4304	4304	256	80	264	11	0	355
8687	5589s (+0.3s)	1008	1008	128	19	88	3	0	110
8688	5589s (+0.4s)	1472	1472	128	38	108	6	1	153
8689	5590s (+0.8s)	3408	3408	256	83	181	18	0	282
8690	5591s (+0.5s)	1712	1712	128	41	126	8	0	175
8691	5591s (+0.5s)	1844	1844	128	49	125	10	0	184
8692	5592s (+0.5s)	1768	1768	128	34	138	9	0	181
8693	5592s (+0.4s)	1500	1500	128	46	100	7	0	153
8694	5593s (+0.9s)	3944	3944	256	88	218	18	1	325
8695	5594s (+0.9s)	4008	4008	256	83	223	19	0	325
8696	5595s (+0.9s)	3620	3620	256	72	215	17	0	304
8697	5595s (+0.5s)	1704	1704	128	46	118	9	0	173
8698	5596s (+0.4s)	1512	1512	128	32	125	4	0	161
8699	5596s (+0.7s)	2988	2988	256	52	179	10	0	241
Episode	Time	Reward	Score	Highest	L	U	R	D	Steps
8700	5597s (+0.7s)	2900	2900	256	58	170	10	0	238
8701	5598s (+0.5s)	1744	1744	128	50	118	8	0	176
8702	5599s (+1.3s)	6560	6560	512	124	326	26	1	477
8703	5600s (+0.6s)	2704	2704	256	54	165	9	0	228
8704	5600s (+0.9s)	3548	3548	256	62	233	6	0	301
8705	5601s (+1.0s)	5040	5040	512	92	247	15	1	355
8706	5602s (+0.7s)	3136	3136	256	67	183	13	0	263
8707	5603s (+0.5s)	1688	1688	128	34	129	6	0	169
8708	5603s (+0.7s)	2860	2860	256	56	179	12	0	247
8709	5604s (+0.6s)	2356	2356	128	53	155	8	0	216
8710	5605s (+0.8s)	3116	3116	256	77	172	17	0	266
8711	5605s (+0.5s)	1796	1796	128	49	129	6	0	184
8712	5606s (+0.5s)	1612	1612	128	33	133	4	0	170
8713	5606s (+0.5s)	2192	2192	256	40	139	8	1	188
8714	5607s (+0.4s)	1148	1148	128	36	83	5	0	124
8715	5607s (+0.7s)	2852	2852	256	55	179	10	0	244
8716	5608s (+0.5s)	1676	1676	128	38	118	10	0	166
8717	5608s (+0.4s)	1016	1016	64	44	78	3	0	125
8718	5609s (+0.5s)	1700	1700	128	31	130	8	1	170
8719	5610s (+0.7s)	3192	3192	256	53	202	11	0	266
8720	5610s (+0.7s)	2724	2724	256	66	158	10	0	234
8721	5611s (+0.3s)	884	884	64	25	86	5	0	116
8722	5611s (+0.8s)	3528	3528	256	71	214	11	0	296
8723	5612s (+0.5s)	1664	1664	128	42	119	1	9	171
8724	5612s (+0.5s)	1992	1992	128	42	137	0	11	190
8725	5613s (+0.6s)	2240	2240	128	45	158	0	12	215
8726	5614s (+0.5s)	1716	1716	128	46	115	12	1	174
8727	5614s (+0.9s)	3608	3608	256	72	215	17	0	304
8728	5615s (+0.7s)	2828	2828	256	63	168	14	0	245
8729	5616s (+0.7s)	2904	2904	256	59	187	11	0	257
8730	5617s (+0.8s)	3452	3452	256	73	193	17	1	284
8731	5617s (+0.5s)	1520	1520	128	39	114	10	0	163
8732	5618s (+1.1s)	5616	5616	512	93	293	17	0	403
8733	5619s (+0.4s)	1456	1456	128	35	113	5	0	153
8734	5619s (+0.6s)	2508	2508	256	43	160	11	0	214
8735	5620s (+0.7s)	3160	3160	256	58	187	13	0	258
8736	5621s (+0.9s)	3776	3776	256	86	214	18	0	318
8737	5621s (+0.6s)	2528	2528	256	42	163	9	0	214
8738	5622s (+0.8s)	3640	3640	256	77	209	8	0	294
8739	5623s (+0.6s)	2708	2708	256	73	140	16	0	229
8740	5624s (+0.6s)	2200	2200	128	62	149	13	0	224
8741	5624s (+0.4s)	1280	1280	128	40	89	0	7	136
8742	5624s (+0.5s)	1736	1736	128	42	126	0	6	174
8743	5625s (+0.8s)	3304	3304	256	53	212	0	12	277
8744	5626s (+1.0s)	4156	4156	256	69	252	0	21	342
8745	5627s (+0.6s)	2468	2468	256	34	159	0	11	204
8746	5628s (+1.1s)	4548	4548	256	110	253	16	0	379
8747	5629s (+0.9s)	3544	3544	256	81	209	11	0	301
8748	5629s (+0.5s)	1564	1564	128	33	126	4	0	163
8749	5630s (+0.8s)	3532	3532	256	79	204	15	1	299
8750	5631s (+0.6s)	2720	2720	256	55	161	13	0	229
8751	5631s (+0.7s)	2776	2776	256	65	164	13	0	242
8752	5633s (+1.2s)	5684	5684	512	97	279	27	1	404
8753	5633s (+0.5s)	1804	1804	128	43	128	9	0	180
8754	5634s (+0.4s)	1456	1456	128	46	95	11	1	153
8755	5634s (+0.5s)	1844	1844	128	47	134	7	1	189
8756	5635s (+0.9s)	3960	3960	256	71	236	17	0	324
8757	5636s (+1.2s)	5792	5792	512	111	284	19	0	414
8758	5637s (+0.3s)	1112	1112	128	16	101	4	0	121
8759	5637s (+0.5s)	1572	1572	128	38	119	7	0	164
8760	5638s (+1.3s)	6152	6152	512	116	295	29	0	440
8761	5639s (+0.7s)	2792	2792	256	57	173	11	0	241
8762	5640s (+0.6s)	1980	1980	128	54	136	12	0	202
8763	5640s (+0.8s)	3604	3604	256	67	210	14	0	291
8764	5641s (+0.7s)	2936	2936	256	61	187	11	1	260
8765	5642s (+0.5s)	1864	1864	128	42	138	5	0	185
8766	5642s (+0.5s)	1880	1880	128	44	144	5	0	193
8767	5643s (+0.5s)	1644	1644	128	38	132	3	0	173
8768	5643s (+0.6s)	2400	2400	256	44	141	0	14	199
8769	5644s (+0.6s)	1996	1996	128	33	161	0	7	201
8770	5644s (+0.4s)	1172	1172	64	30	102	0	8	140
8771	5645s (+0.2s)	636	636	64	17	61	1	5	84
8772	5645s (+0.5s)	1768	1768	128	35	143	0	4	182
8773	5646s (+0.9s)	3828	3828	256	67	229	0	12	308
8774	5646s (+0.4s)	1372	1372	128	37	103	0	3	143
8775	5647s (+0.5s)	1604	1604	128	37	126	5	0	168
8776	5648s (+0.8s)	3416	3416	256	68	207	14	0	289
8777	5648s (+0.3s)	948	948	64	26	81	4	0	111
8778	5649s (+0.7s)	3148	3148	256	74	175	10	0	259
8779	5649s (+0.7s)	2808	2808	256	52	187	6	0	245
8780	5650s (+0.5s)	1636	1636	128	45	107	13	0	165
8781	5651s (+1.0s)	4412	4412	256	103	236	23	0	362
8782	5652s (+0.6s)	2528	2528	256	52	158	9	1	220
8783	5652s (+0.5s)	1780	1780	128	39	137	4	0	180
8784	5653s (+0.7s)	3040	3040	256	60	172	13	0	245
8785	5654s (+1.3s)	6236	6236	512	117	304	25	0	446
8786	5655s (+0.5s)	1792	1792	128	40	136	7	0	183
8787	5655s (+0.2s)	656	656	64	22	59	5	0	86
8788	5655s (+0.5s)	1812	1812	128	43	132	6	0	181
8789	5656s (+0.5s)	1740	1740	128	48	125	8	0	181
8790	5657s (+0.7s)	2760	2760	256	58	169	6	0	233
8791	5657s (+0.4s)	1588	1588	128	40	106	8	0	154
8792	5657s (+0.4s)	1492	1492	128	45	102	9	0	156
8793	5658s (+0.5s)	1768	1768	128	59	110	12	0	181
8794	5658s (+0.5s)	1932	1932	128	57	123	10	0	190
8795	5659s (+0.6s)	2476	2476	256	38	169	5	0	212
8796	5660s (+0.7s)	2964	2964	256	59	179	9	0	247
8797	5660s (+0.6s)	2512	2512	256	51	158	11	0	220
8798	5661s (+0.7s)	2988	2988	128	81	165	20	0	266
8799	5662s (+0.7s)	3324	3324	256	72	189	16	0	277
Episode	Time	Reward	Score	Highest	L	U	R	D	Steps
8800	5662s (+0.5s)	1640	1640	128	47	108	11	0	166
8801	5663s (+0.6s)	2416	2416	256	48	144	8	1	201
8802	5663s (+0.3s)	696	696	64	23	64	4	0	91
8803	5664s (+0.4s)	1296	1296	128	29	110	2	0	141
8804	5664s (+0.8s)	3312	3312	256	70	190	10	0	270
8805	5665s (+1.0s)	5160	5160	512	87	265	16	0	368
8806	5666s (+0.5s)	1596	1596	128	40	121	5	0	166
8807	5666s (+0.3s)	812	812	64	19	86	0	5	110
8808	5666s (+0.1s)	252	252	32	10	35	0	2	47
8809	5667s (+0.4s)	1480	1480	128	33	110	10	1	154
8810	5667s (+0.4s)	1260	1260	128	28	96	7	0	131
8811	5668s (+0.6s)	2784	2784	256	70	152	16	0	238
8812	5669s (+0.9s)	3848	3848	256	79	225	17	0	321
8813	5669s (+0.5s)	1768	1768	128	31	145	6	0	182
8814	5670s (+0.5s)	1676	1676	128	45	116	10	0	171
8815	5671s (+1.0s)	4064	4064	256	78	246	14	0	338
8816	5672s (+0.9s)	3660	3660	256	84	213	15	0	312
8817	5672s (+0.3s)	1116	1116	128	26	88	4	0	118
8818	5673s (+0.7s)	2452	2452	128	60	155	15	0	230
8819	5674s (+0.8s)	3244	3244	256	60	198	15	0	273
8820	5674s (+0.7s)	2796	2796	256	54	176	12	0	242
8821	5675s (+1.0s)	4156	4156	256	80	250	18	0	348
8822	5676s (+0.4s)	1200	1200	128	28	101	4	0	133
8823	5676s (+0.2s)	680	680	64	17	70	2	0	89
8824	5677s (+0.7s)	2940	2940	256	76	162	13	0	251
8825	5677s (+0.5s)	1928	1928	128	49	139	5	0	193
8826	5678s (+0.4s)	1188	1188	128	31	93	6	0	130
8827	5678s (+0.5s)	1788	1788	128	49	116	14	0	179
8828	5678s (+0.3s)	860	860	64	17	90	4	0	111
8829	5679s (+0.5s)	1808	1808	128	47	128	12	0	187
8830	5680s (+0.8s)	3380	3380	256	49	232	0	10	291
8831	5680s (+0.4s)	1400	1400	128	38	100	0	7	145
8832	5681s (+0.4s)	1264	1264	128	28	100	0	11	139
8833	5681s (+0.8s)	3432	3432	256	59	214	0	16	289
8834	5682s (+0.2s)	348	348	32	11	43	0	4	58
8835	5682s (+0.6s)	2516	2516	256	40	173	0	4	217
8836	5683s (+0.5s)	1892	1892	128	43	144	0	5	192
8837	5683s (+0.4s)	1256	1256	128	46	83	0	6	135
8838	5684s (+1.1s)	5484	5484	512	81	290	0	11	382
8839	5685s (+0.5s)	1780	1780	128	43	129	0	9	181
8840	5685s (+0.5s)	1548	1548	128	37	125	0	4	166
8841	5686s (+0.6s)	2604	2604	256	59	156	0	10	225
8842	5686s (+0.6s)	2112	2112	128	44	160	0	9	213
8843	5687s (+0.5s)	1764	1764	128	43	124	0	9	176
8844	5688s (+0.6s)	2468	2468	256	50	145	9	0	204
8845	5688s (+0.5s)	1616	1616	128	32	133	6	0	171
8846	5689s (+0.5s)	2332	2332	256	35	151	7	0	193
8847	5690s (+1.1s)	5572	5572	512	113	262	21	0	396
8848	5690s (+0.5s)	1556	1556	128	37	117	7	0	161
8849	5691s (+0.8s)	3288	3288	256	85	179	14	0	278
8850	5691s (+0.4s)	1180	1180	64	50	87	6	0	143
8851	5692s (+0.6s)	2336	2336	256	51	135	11	0	197
8852	5692s (+0.3s)	932	932	64	32	86	6	0	124
8853	5693s (+0.7s)	2808	2808	256	52	182	0	10	244
8854	5693s (+0.4s)	1628	1628	128	36	121	0	4	161
8855	5694s (+0.6s)	2424	2424	256	35	163	0	5	203
8856	5695s (+0.6s)	2552	2552	256	53	156	6	0	215
8857	5696s (+0.9s)	4612	4612	512	61	234	13	0	308
8858	5696s (+0.6s)	2572	2572	256	60	153	10	0	223
8859	5697s (+0.7s)	2836	2836	256	56	180	5	0	241
8860	5698s (+0.7s)	2912	2912	256	76	170	12	0	258
8861	5698s (+0.5s)	1852	1852	128	51	130	9	0	190
8862	5699s (+0.3s)	952	952	64	30	77	4	0	111
8863	5699s (+0.7s)	2904	2904	256	57	184	10	1	252
8864	5700s (+0.8s)	3568	3568	256	82	202	15	0	299
8865	5701s (+0.5s)	1796	1796	128	41	134	9	0	184
8866	5701s (+0.7s)	2828	2828	256	60	170	12	1	243
8867	5702s (+0.2s)	420	420	64	9	48	3	0	60
8868	5702s (+0.5s)	1792	1792	128	46	130	7	0	183
8869	5703s (+0.9s)	4016	4016	256	90	213	21	0	324
8870	5703s (+0.4s)	1184	1184	128	20	106	0	3	129
8871	5704s (+0.6s)	2700	2700	256	43	178	0	7	228
8872	5704s (+0.3s)	1064	1064	128	17	92	0	6	115
8873	5705s (+0.2s)	372	372	32	12	48	0	3	63
8874	5705s (+0.5s)	1836	1836	128	34	143	0	5	182
8875	5706s (+0.5s)	1800	1800	128	33	145	0	7	185
8876	5706s (+0.5s)	1588	1588	128	27	127	0	5	159
8877	5707s (+0.6s)	2212	2212	128	49	148	0	11	208
8878	5707s (+0.7s)	2924	2924	256	65	180	12	0	257
8879	5708s (+0.9s)	3972	3972	256	89	218	20	0	327
8880	5709s (+0.5s)	1908	1908	128	48	140	7	0	195
8881	5710s (+0.9s)	3648	3648	256	76	212	21	1	310
8882	5711s (+1.0s)	4316	4316	256	92	244	21	0	357
8883	5711s (+0.3s)	824	824	64	30	68	8	0	106
8884	5712s (+0.5s)	1820	1820	128	49	127	9	0	185
8885	5712s (+0.7s)	2888	2888	256	70	171	13	0	254
8886	5713s (+0.5s)	2032	2032	128	54	139	8	0	201
8887	5714s (+0.6s)	2724	2724	256	44	162	12	0	218
8888	5714s (+0.4s)	944	944	64	31	90	5	0	126
8889	5715s (+0.7s)	3088	3088	256	66	174	17	0	257
8890	5715s (+0.3s)	864	864	64	28	79	5	0	112
8891	5716s (+1.5s)	7364	7364	512	137	353	28	0	518
8892	5717s (+0.5s)	1584	1584	128	44	119	4	0	167
8893	5718s (+0.7s)	2628	2628	128	60	177	15	0	252
8894	5718s (+0.4s)	1268	1268	128	27	96	5	0	128
8895	5719s (+0.7s)	2860	2860	256	60	175	11	0	246
8896	5720s (+1.0s)	4204	4204	256	97	225	19	0	341
8897	5721s (+0.7s)	3004	3004	256	77	172	11	1	261
8898	5722s (+1.0s)	4164	4164	256	77	253	13	0	343
8899	5722s (+0.7s)	2824	2824	256	60	178	11	0	249
Episode	Time	Reward	Score	Highest	L	U	R	D	Steps
8900	5723s (+0.4s)	1232	1232	128	35	88	6	0	129
8901	5723s (+0.4s)	1180	1180	128	19	103	5	0	127
8902	5724s (+0.4s)	1540	1540	128	28	131	5	0	164
8903	5724s (+0.5s)	1820	1820	128	37	142	0	5	184
8904	5725s (+0.7s)	3088	3088	256	45	194	0	14	253
8905	5725s (+0.6s)	2456	2456	256	37	167	0	3	207
8906	5726s (+0.5s)	1904	1904	128	37	148	0	9	194
8907	5727s (+0.6s)	2220	2220	128	56	143	0	11	210
8908	5728s (+1.4s)	6552	6552	512	88	363	0	25	476
8909	5729s (+0.7s)	2792	2792	256	50	176	0	16	242
8910	5730s (+0.8s)	3252	3252	256	83	173	20	0	276
8911	5730s (+0.6s)	1884	1884	128	41	146	7	0	194
8912	5731s (+0.4s)	1364	1364	128	30	108	4	0	142
8913	5731s (+0.5s)	2060	2060	256	34	130	0	9	173
8914	5732s (+1.0s)	4012	4012	256	64	255	0	18	337
8915	5733s (+0.6s)	2552	2552	256	43	168	0	4	215
8916	5733s (+0.6s)	2560	2560	256	39	174	0	9	222
8917	5734s (+0.4s)	1308	1308	128	26	114	0	3	143
8918	5734s (+0.5s)	1844	1844	128	45	132	0	8	185
8919	5735s (+0.6s)	2660	2660	256	49	168	5	3	225
8920	5735s (+0.3s)	724	724	64	18	79	0	2	99
8921	5736s (+0.9s)	4128	4128	256	100	216	24	0	340
8922	5737s (+0.6s)	1960	1960	128	52	136	9	0	197
8923	5737s (+0.6s)	2552	2552	256	47	163	0	5	215
8924	5738s (+0.9s)	3832	3832	256	64	230	0	15	309
8925	5739s (+0.7s)	2792	2792	256	51	180	0	9	240
8926	5740s (+0.6s)	2308	2308	256	41	149	0	5	195
8927	5741s (+1.0s)	4176	4176	256	80	249	0	13	342
8928	5741s (+0.4s)	1076	1076	64	27	97	0	5	129
8929	5742s (+0.5s)	1784	1784	128	44	128	0	10	182
8930	5742s (+0.4s)	1440	1440	128	43	94	11	1	149
8931	5743s (+0.7s)	3128	3128	256	68	178	16	0	262
8932	5743s (+0.6s)	2728	2728	256	59	153	18	0	230
8933	5744s (+0.8s)	3412	3412	256	71	199	13	0	283
8934	5745s (+0.6s)	2508	2508	256	46	166	6	0	218
8935	5746s (+1.0s)	4336	4336	256	103	235	20	0	358
8936	5746s (+0.4s)	1480	1480	128	40	108	6	0	154
8937	5747s (+0.6s)	1944	1944	128	55	127	15	0	197
8938	5748s (+0.7s)	3040	3040	256	62	174	10	0	246
8939	5748s (+0.7s)	2828	2828	256	64	176	10	0	250
8940	5749s (+0.6s)	2168	2168	128	61	148	12	0	221
8941	5750s (+0.7s)	3172	3172	256	68	183	10	0	261
8942	5750s (+0.3s)	752	752	64	21	75	4	0	100
8943	5750s (+0.4s)	1052	1052	64	35	85	7	0	127
8944	5751s (+0.8s)	3204	3204	256	88	175	17	0	280
8945	5752s (+0.7s)	2780	2780	256	58	165	16	0	239
8946	5753s (+0.8s)	3512	3512	256	66	215	11	0	292
8947	5753s (+0.8s)	3668	3668	256	76	199	19	0	294
8948	5754s (+0.3s)	1012	1012	64	26	92	3	0	121
8949	5754s (+0.7s)	2908	2908	256	55	186	12	0	253
8950	5755s (+0.7s)	3124	3124	256	56	191	7	0	254
8951	5755s (+0.3s)	1052	1052	128	22	86	4	0	112
8952	5756s (+0.3s)	668	668	64	23	66	3	0	92
8953	5757s (+0.8s)	3520	3520	256	74	213	12	0	299
8954	5757s (+0.4s)	1432	1432	128	21	121	6	0	148
8955	5758s (+0.8s)	3496	3496	256	70	193	17	0	280
8956	5759s (+1.1s)	5840	5840	512	108	290	20	0	418
8957	5760s (+1.3s)	6304	6304	512	118	300	29	0	447
8958	5761s (+0.5s)	1824	1824	128	40	135	9	0	184
8959	5761s (+0.6s)	2484	2484	256	44	165	5	0	214
8960	5762s (+0.6s)	2468	2468	256	46	159	8	0	213
8961	5763s (+0.6s)	2444	2444	256	49	154	5	0	208
8962	5764s (+1.2s)	6032	6032	512	93	312	21	0	426
8963	5765s (+0.9s)	3772	3772	256	80	206	14	0	300
8964	5766s (+0.8s)	3256	3256	256	65	198	14	0	277
8965	5766s (+0.6s)	1904	1904	128	48	142	5	0	195
8966	5767s (+1.1s)	5372	5372	512	95	257	22	0	374
8967	5768s (+0.5s)	1624	1624	128	33	129	8	0	170
8968	5768s (+0.4s)	1368	1368	128	42	102	9	0	153
8969	5769s (+0.9s)	3608	3608	256	80	208	17	0	305
8970	5770s (+0.5s)	1860	1860	128	38	142	9	0	189
8971	5770s (+0.5s)	1708	1708	128	37	137	4	0	178
8972	5771s (+0.9s)	3804	3804	256	90	212	15	0	317
8973	5771s (+0.3s)	812	812	64	20	74	4	0	98
8974	5772s (+0.2s)	592	592	64	26	52	4	0	82
8975	5772s (+0.8s)	3388	3388	256	75	189	14	0	278
8976	5773s (+0.6s)	2616	2616	256	68	151	10	0	229
8977	5774s (+0.8s)	3428	3428	256	71	204	13	0	288
8978	5774s (+0.3s)	784	784	64	20	79	5	0	104
8979	5775s (+0.9s)	3972	3972	256	68	250	9	0	327
8980	5776s (+0.7s)	3244	3244	256	60	201	13	0	274
8981	5776s (+0.4s)	1168	1168	64	34	98	7	0	139
8982	5777s (+0.4s)	1192	1192	128	28	96	7	0	131
8983	5777s (+0.3s)	816	816	64	29	68	8	0	105
8984	5777s (+0.6s)	1876	1876	128	61	130	8	0	199
8985	5778s (+0.5s)	2036	2036	128	61	128	7	0	196
8986	5779s (+0.6s)	2148	2148	128	51	138	12	0	201
8987	5779s (+0.7s)	2776	2776	256	52	175	10	0	237
8988	5780s (+0.4s)	1000	1000	64	34	82	8	0	124
8989	5780s (+0.3s)	732	732	64	18	74	5	0	97
8990	5780s (+0.5s)	1536	1536	128	37	116	4	0	157
8991	5781s (+0.7s)	2844	2844	256	68	161	13	1	243
8992	5782s (+0.4s)	1300	1300	128	25	106	4	0	135
8993	5782s (+0.7s)	2908	2908	256	49	182	9	0	240
8994	5783s (+0.4s)	1420	1420	128	28	107	4	0	139
8995	5783s (+0.3s)	800	800	64	14	89	5	0	108
8996	5784s (+0.9s)	3840	3840	256	84	209	21	0	314
8997	5785s (+0.9s)	3588	3588	256	64	228	13	0	305
8998	5786s (+1.4s)	6876	6876	512	140	323	25	0	488
8999	5787s (+0.7s)	3048	3048	256	59	185	12	0	256
Episode	Time	Reward	Score	Highest	L	U	R	D	Steps
9000	5788s (+0.8s)	3492	3492	256	80	190	21	0	291
9001	5789s (+1.2s)	6336	6336	512	109	309	21	0	439
9002	5790s (+0.6s)	2640	2640	256	58	154	9	0	221
9003	5790s (+0.5s)	1896	1896	128	43	131	8	0	182
9004	5791s (+0.8s)	3224	3224	256	57	198	13	1	269
9005	5791s (+0.2s)	516	516	64	14	57	3	0	74
9006	5792s (+0.5s)	1808	1808	128	38	138	5	0	181
9007	5793s (+0.7s)	3100	3100	256	67	174	14	0	255
9008	5793s (+0.6s)	2416	2416	256	45	148	10	0	203
9009	5794s (+0.4s)	1192	1192	64	36	103	6	0	145
9010	5794s (+0.6s)	2880	2880	256	65	151	11	0	227
9011	5795s (+0.7s)	2916	2916	256	63	178	14	0	255
9012	5796s (+1.1s)	5372	5372	512	82	263	22	1	368
9013	5797s (+0.5s)	1680	1680	128	38	128	6	0	172
9014	5797s (+0.8s)	3320	3320	256	78	187	12	0	277
9015	5799s (+1.5s)	7680	7680	512	148	363	27	0	538
9016	5800s (+0.5s)	2240	2240	256	45	147	3	0	195
9017	5800s (+0.3s)	936	936	64	33	78	6	0	117
9018	5801s (+0.5s)	1784	1784	128	54	115	12	0	181
9019	5801s (+0.7s)	3100	3100	256	53	191	11	0	255
9020	5802s (+0.7s)	2792	2792	256	67	163	11	0	241
9021	5803s (+0.6s)	2048	2048	128	51	137	15	0	203
9022	5803s (+0.9s)	4716	4716	512	67	248	13	0	328
9023	5804s (+0.8s)	3160	3160	256	69	186	10	1	266
9024	5805s (+0.4s)	1168	1168	128	27	100	2	0	129
9025	5806s (+1.0s)	4124	4124	256	90	245	13	0	348
9026	5806s (+0.4s)	1424	1424	128	33	108	4	0	145
9027	5807s (+0.7s)	2788	2788	256	66	160	14	0	240
9028	5808s (+0.8s)	3396	3396	256	64	206	15	0	285
9029	5808s (+0.3s)	916	916	64	25	84	4	0	113
9030	5809s (+0.7s)	2792	2792	256	63	169	9	0	241
9031	5809s (+0.4s)	1300	1300	128	37	98	6	0	141
9032	5810s (+0.8s)	3276	3276	256	80	181	14	0	275
9033	5810s (+0.5s)	1708	1708	128	53	109	7	1	170
9034	5811s (+0.9s)	4096	4096	256	89	225	18	0	332
9035	5812s (+0.4s)	1496	1496	128	34	115	8	0	157
9036	5812s (+0.6s)	1976	1976	128	45	140	13	0	198
9037	5813s (+0.8s)	3452	3452	256	70	206	11	0	287
9038	5814s (+0.7s)	2764	2764	256	49	176	10	0	235
9039	5814s (+0.5s)	1692	1692	128	43	126	5	0	174
9040	5815s (+0.9s)	3956	3956	256	70	237	16	0	323
9041	5816s (+0.7s)	2740	2740	256	67	153	13	0	233
9042	5817s (+0.8s)	3408	3408	256	70	200	12	1	283
9043	5818s (+0.9s)	4100	4100	256	87	231	15	0	333
9044	5818s (+0.5s)	1824	1824	128	35	147	3	0	185
9045	5819s (+0.4s)	1520	1520	128	36	108	6	0	150
9046	5819s (+0.5s)	1812	1812	128	48	128	0	8	184
9047	5820s (+0.7s)	3024	3024	256	46	189	0	16	251
9048	5820s (+0.7s)	2556	2556	128	77	161	7	0	245
9049	5821s (+0.5s)	1872	1872	128	46	139	6	0	191
9050	5822s (+1.1s)	5516	5516	512	127	251	16	1	395
9051	5823s (+0.8s)	3200	3200	256	61	198	9	0	268
9052	5823s (+0.6s)	1976	1976	128	55	139	11	0	205
9053	5824s (+0.5s)	1544	1544	128	47	102	11	0	160
9054	5825s (+0.7s)	2840	2840	256	66	158	18	0	242
9055	5825s (+0.6s)	1948	1948	128	54	144	6	1	205
9056	5826s (+0.7s)	2656	2656	256	53	166	8	1	228
9057	5827s (+0.8s)	3392	3392	256	78	197	14	0	289
9058	5827s (+0.5s)	1560	1560	128	39	117	7	1	164
9059	5828s (+0.6s)	2540	2540	256	64	151	6	0	221
9060	5828s (+0.5s)	1816	1816	128	43	136	9	0	188
9061	5829s (+0.6s)	2020	2020	128	44	152	9	0	205
9062	5830s (+0.7s)	2972	2972	256	59	179	12	0	250
9063	5831s (+1.1s)	4484	4484	256	103	245	19	0	367
9064	5831s (+0.7s)	2744	2744	256	62	171	8	0	241
9065	5832s (+0.7s)	2780	2780	256	61	172	10	0	243
9066	5833s (+1.0s)	4220	4220	256	81	252	12	0	345
9067	5834s (+0.8s)	3256	3256	256	77	178	17	0	272
9068	5835s (+0.9s)	3816	3816	256	97	206	17	0	320
9069	5835s (+0.6s)	2500	2500	256	43	164	10	0	217
9070	5836s (+0.6s)	1944	1944	128	48	147	9	0	204
9071	5837s (+0.7s)	3148	3148	256	66	177	16	0	259
9072	5837s (+0.3s)	1044	1044	128	23	83	3	0	109
9073	5838s (+0.7s)	2904	2904	256	61	182	10	0	253
9074	5838s (+0.6s)	2556	2556	256	48	156	14	1	219
9075	5839s (+0.5s)	1612	1612	128	29	132	0	9	170
9076	5839s (+0.3s)	880	880	64	26	83	0	6	115
9077	5840s (+0.6s)	2632	2632	256	43	184	0	5	232
9078	5840s (+0.6s)	1960	1960	128	40	144	0	9	193
9079	5841s (+0.9s)	3952	3952	256	68	240	0	14	322
9080	5842s (+0.6s)	2612	2612	256	41	178	0	9	228
9081	5842s (+0.3s)	968	968	64	26	81	5	0	112
9082	5843s (+0.8s)	3264	3264	256	61	199	12	0	272
9083	5844s (+0.4s)	1444	1444	128	34	104	0	2	140
9084	5844s (+0.5s)	1888	1888	128	44	139	0	7	190
9085	5845s (+0.6s)	2312	2312	256	44	149	0	9	202
9086	5845s (+0.7s)	3140	3140	256	56	189	0	13	258
9087	5846s (+0.6s)	2508	2508	256	41	171	0	8	220
9088	5847s (+0.5s)	1676	1676	128	38	123	0	7	168
9089	5847s (+0.3s)	768	768	64	25	71	0	4	100
9090	5848s (+1.3s)	6388	6388	512	129	298	24	0	451
9091	5849s (+0.4s)	1488	1488	128	37	113	5	0	155
9092	5849s (+0.7s)	2932	2932	256	64	182	12	1	259
9093	5850s (+0.8s)	3528	3528	256	82	203	11	0	296
9094	5851s (+0.8s)	3432	3432	256	53	219	11	0	283
9095	5852s (+0.8s)	3212	3212	256	53	205	8	0	266
9096	5852s (+0.5s)	1952	1952	128	49	138	8	0	195
9097	5853s (+0.6s)	2496	2496	256	58	147	11	0	216
9098	5854s (+0.6s)	2604	2604	256	50	167	9	0	226
9099	5854s (+0.6s)	2568	2568	256	57	151	11	0	219
Episode	Time	Reward	Score	Highest	L	U	R	D	Steps
9100	5855s (+0.6s)	2556	2556	256	52	164	3	0	219
9101	5855s (+0.6s)	2476	2476	256	49	149	6	0	204
9102	5856s (+0.7s)	2780	2780	256	50	180	8	0	238
9103	5857s (+0.5s)	1776	1776	128	35	135	10	0	180
9104	5857s (+0.8s)	3452	3452	256	59	202	11	0	272
9105	5858s (+0.4s)	980	980	64	29	90	5	0	124
9106	5858s (+0.4s)	1328	1328	64	36	103	8	0	147
9107	5859s (+1.1s)	5560	5560	512	98	278	12	0	388
9108	5860s (+0.5s)	1672	1672	128	37	123	10	0	170
9109	5861s (+1.3s)	6404	6404	512	118	319	23	0	460
9110	5862s (+0.7s)	2876	2876	256	74	166	11	0	251
9111	5862s (+0.4s)	1140	1140	64	31	100	5	1	137
9112	5863s (+1.1s)	5756	5756	512	97	275	23	0	395
9113	5864s (+0.6s)	2516	2516	256	61	147	12	0	220
9114	5865s (+1.1s)	4516	4516	256	98	247	26	0	371
9115	5865s (+0.3s)	856	856	64	24	78	8	0	110
9116	5866s (+0.4s)	1016	1016	64	29	90	5	1	125
9117	5866s (+0.4s)	1484	1484	128	37	108	9	0	154
9118	5867s (+1.0s)	5080	5080	512	88	242	20	0	350
9119	5868s (+0.5s)	1708	1708	128	50	114	5	0	169
9120	5868s (+0.4s)	1024	1024	64	27	92	6	0	125
9121	5870s (+1.4s)	6872	6872	512	137	324	20	0	481
9122	5870s (+0.4s)	1340	1340	128	35	100	6	0	141
9123	5871s (+0.8s)	3540	3540	256	71	218	10	0	299
9124	5871s (+0.4s)	1480	1480	128	32	114	8	0	154
9125	5872s (+0.4s)	1488	1488	128	38	112	5	0	155
9126	5872s (+0.4s)	1476	1476	128	38	103	11	0	152
9127	5873s (+0.8s)	3296	3296	256	76	182	18	0	276
9128	5873s (+0.6s)	1848	1848	128	50	134	8	0	192
9129	5874s (+0.8s)	3432	3432	256	69	199	14	0	282
9130	5875s (+0.8s)	3292	3292	256	66	198	11	0	275
9131	5876s (+1.0s)	4088	4088	256	78	245	14	0	337
9132	5877s (+0.8s)	3232	3232	256	74	188	13	0	275
9133	5877s (+0.5s)	1872	1872	128	66	109	13	0	188
9134	5878s (+0.4s)	1380	1380	128	41	100	4	0	145
9135	5878s (+0.5s)	2136	2136	256	38	136	6	1	181
9136	5879s (+0.6s)	2528	2528	256	45	158	10	0	213
9137	5880s (+0.5s)	1840	1840	128	47	133	10	0	190
9138	5880s (+0.5s)	1796	1796	128	61	116	11	0	188
9139	5881s (+0.5s)	1560	1560	128	37	127	5	0	169
9140	5882s (+1.4s)	6836	6836	512	134	336	25	0	495
9141	5883s (+0.7s)	3220	3220	256	63	182	17	0	262
9142	5883s (+0.3s)	884	884	64	32	76	8	0	116
9143	5884s (+1.0s)	4192	4192	256	73	248	18	0	339
9144	5885s (+0.8s)	3348	3348	256	67	203	12	1	283
9145	5886s (+1.0s)	4284	4284	256	91	243	15	0	349
9146	5886s (+0.4s)	1480	1480	128	36	112	6	0	154
9147	5887s (+0.8s)	3228	3228	256	64	196	0	9	269
9148	5888s (+0.3s)	836	836	64	24	77	0	8	109
9149	5888s (+0.9s)	3520	3520	256	69	214	0	16	299
9150	5889s (+0.5s)	1756	1756	128	35	135	6	0	176
9151	5890s (+1.0s)	4328	4328	256	97	240	19	0	356
9152	5891s (+0.7s)	2872	2872	256	64	173	12	0	249
9153	5891s (+0.7s)	2940	2940	256	62	190	9	0	261
9154	5892s (+0.7s)	2608	2608	256	54	160	13	0	227
9155	5893s (+1.3s)	6500	6500	512	116	309	22	1	448
9156	5894s (+0.3s)	764	764	64	21	74	0	5	100
9157	5894s (+0.3s)	716	716	64	25	65	3	0	93
9158	5895s (+0.7s)	2820	2820	256	72	162	9	1	244
9159	5896s (+0.9s)	4640	4640	512	81	220	19	0	320
9160	5896s (+0.9s)	3624	3624	256	78	219	10	0	307
9161	5897s (+0.3s)	908	908	64	31	71	6	0	108
9162	5898s (+0.9s)	3544	3544	256	61	225	13	1	300
9163	5898s (+0.5s)	1864	1864	128	43	133	11	0	187
9164	5899s (+0.8s)	3064	3064	256	54	202	10	0	266
9165	5900s (+1.0s)	5068	5068	512	97	238	13	0	348
9166	5900s (+0.4s)	1476	1476	128	45	97	10	0	152
9167	5901s (+0.3s)	892	892	64	34	75	4	1	114
9168	5901s (+0.7s)	3160	3160	256	63	183	13	0	259
9169	5902s (+0.3s)	876	876	64	28	82	4	1	115
9170	5902s (+0.3s)	772	772	64	26	70	5	0	101
9171	5903s (+0.7s)	2900	2900	256	58	186	7	0	251
9172	5903s (+0.5s)	1672	1672	128	44	114	11	0	169
9173	5904s (+0.6s)	2712	2712	256	58	165	8	1	232
9174	5905s (+0.8s)	3232	3232	256	68	195	8	0	271
9175	5905s (+0.6s)	2732	2732	256	60	157	14	0	231
9176	5906s (+0.6s)	2584	2584	256	48	158	10	0	216
9177	5907s (+0.5s)	1688	1688	128	43	117	0	14	174
9178	5907s (+0.8s)	3344	3344	256	59	198	0	15	272
9179	5908s (+0.9s)	3860	3860	256	86	210	0	17	313
9180	5909s (+0.6s)	2412	2412	256	46	153	0	8	207
9181	5910s (+0.7s)	2776	2776	256	71	154	13	0	238
9182	5910s (+0.4s)	1460	1460	128	48	98	6	0	152
9183	5911s (+0.6s)	2228	2228	128	50	147	9	0	206
9184	5911s (+0.5s)	1572	1572	128	39	121	7	0	167
9185	5912s (+1.0s)	4808	4808	512	81	248	12	0	341
9186	5913s (+0.7s)	3120	3120	256	65	184	11	0	260
9187	5913s (+0.7s)	2912	2912	256	61	170	14	0	245
9188	5914s (+0.9s)	4680	4680	512	80	219	20	1	320
9189	5915s (+0.8s)	3156	3156	256	77	177	10	0	264
9190	5916s (+0.8s)	3328	3328	256	68	201	10	0	279
9191	5917s (+0.7s)	2568	2568	128	71	158	13	0	242
9192	5917s (+0.6s)	2156	2156	128	50	152	9	0	211
9193	5918s (+0.4s)	1156	1156	128	27	96	2	0	125
9194	5918s (+0.8s)	3208	3208	256	82	175	12	1	270
9195	5919s (+0.5s)	1736	1736	128	38	131	5	0	174
9196	5919s (+0.6s)	2212	2212	128	50	160	13	0	223
9197	5920s (+0.5s)	1856	1856	128	48	127	12	0	187
9198	5921s (+0.5s)	1812	1812	128	52	120	12	0	184
9199	5921s (+0.5s)	1832	1832	128	40	133	0	6	179
Episode	Time	Reward	Score	Highest	L	U	R	D	Steps
9200	5922s (+0.8s)	3636	3636	256	52	229	0	11	292
9201	5923s (+1.0s)	4044	4044	256	62	261	0	17	340
9202	5923s (+0.5s)	1756	1756	128	42	126	0	8	176
9203	5924s (+0.3s)	688	688	64	15	74	0	2	91
9204	5924s (+0.8s)	3136	3136	256	53	193	0	18	264
9205	5925s (+0.5s)	2184	2184	256	35	137	0	6	178
9206	5925s (+0.5s)	1840	1840	128	33	149	0	8	190
9207	5926s (+0.2s)	536	536	64	11	59	0	4	74
9208	5926s (+0.8s)	3600	3600	256	57	219	0	12	288
9209	5927s (+0.2s)	528	528	64	20	47	0	4	71
9210	5927s (+0.6s)	2512	2512	128	74	148	13	0	235
9211	5928s (+0.6s)	2092	2092	128	57	135	15	0	207
9212	5929s (+0.7s)	3028	3028	256	66	174	8	0	248
9213	5930s (+1.0s)	4312	4312	256	95	245	16	0	356
9214	5930s (+0.4s)	1432	1432	128	34	112	7	0	153
9215	5931s (+0.6s)	2608	2608	256	50	169	8	0	227
9216	5931s (+0.5s)	1840	1840	128	48	127	9	0	184
9217	5932s (+1.0s)	4140	4140	256	97	222	18	0	337
9218	5933s (+1.1s)	5604	5604	512	92	274	23	0	389
9219	5934s (+0.8s)	3352	3352	256	72	201	11	0	284
9220	5935s (+0.8s)	3308	3308	256	74	185	15	0	274
9221	5936s (+0.7s)	2784	2784	256	55	174	8	2	239
9222	5937s (+1.0s)	4288	4288	256	93	243	21	0	357
9223	5937s (+0.3s)	1144	1144	128	29	85	8	0	122
9224	5938s (+0.8s)	3296	3296	256	80	177	14	0	271
9225	5938s (+0.5s)	1944	1944	128	49	132	12	0	193
9226	5939s (+0.6s)	2016	2016	128	56	143	10	0	209
9227	5940s (+0.5s)	2340	2340	256	50	132	12	1	195
9228	5940s (+0.9s)	3636	3636	256	89	206	12	0	307
9229	5941s (+1.1s)	5420	5420	512	84	271	19	0	374
9230	5942s (+0.6s)	1916	1916	128	39	150	8	0	197
9231	5943s (+0.7s)	2620	2620	128	73	163	12	0	248
9232	5943s (+0.4s)	1176	1176	64	42	91	8	0	141
9233	5944s (+0.6s)	2560	2560	256	57	140	13	1	211
9234	5945s (+0.9s)	3860	3860	256	86	219	19	0	324
9235	5945s (+0.3s)	1148	1148	128	29	80	4	1	114
9236	5945s (+0.4s)	980	980	64	24	96	4	0	124
9237	5946s (+0.7s)	3188	3188	256	64	188	12	0	264
9238	5947s (+0.9s)	3544	3544	256	82	209	14	0	305
9239	5948s (+0.9s)	3680	3680	256	74	215	14	0	303
9240	5948s (+0.5s)	1664	1664	128	51	111	6	0	168
9241	5949s (+0.8s)	3480	3480	256	64	210	14	1	289
9242	5950s (+0.9s)	3480	3480	256	92	186	17	0	295
9243	5951s (+0.8s)	3304	3304	256	55	211	11	0	277
9244	5951s (+0.5s)	1680	1680	128	26	139	2	0	167
9245	5952s (+0.5s)	1524	1524	128	40	113	11	0	164
9246	5952s (+0.3s)	700	700	64	24	68	2	0	94
9247	5953s (+0.4s)	1472	1472	128	29	121	6	1	157
9248	5954s (+1.0s)	4168	4168	256	86	243	15	0	344
9249	5954s (+0.5s)	1624	1624	128	41	124	8	0	173
9250	5955s (+0.6s)	2440	2440	256	44	155	5	0	204
9251	5955s (+0.7s)	2836	2836	256	49	177	11	1	238
9252	5956s (+0.7s)	2760	2760	256	51	184	5	0	240
9253	5957s (+0.6s)	2848	2848	256	49	175	8	1	233
9254	5957s (+0.7s)	2772	2772	256	51	179	11	0	241
9255	5958s (+0.4s)	1244	1244	128	26	108	4	0	138
9256	5958s (+0.5s)	1676	1676	128	30	129	4	0	163
9257	5959s (+0.7s)	2616	2616	256	56	164	9	0	229
9258	5960s (+0.9s)	3864	3864	256	91	204	21	1	317
9259	5961s (+0.7s)	3128	3128	256	50	199	8	0	257
9260	5961s (+0.5s)	1640	1640	128	43	114	9	0	166
9261	5962s (+1.0s)	5244	5244	512	82	272	16	0	370
9262	5962s (+0.3s)	624	624	64	20	63	3	0	86
9263	5963s (+0.5s)	1636	1636	128	43	126	6	0	175
9264	5963s (+0.2s)	592	592	32	26	56	6	0	88
9265	5964s (+1.3s)	6196	6196	512	122	294	25	0	441
9266	5965s (+0.7s)	3092	3092	256	53	186	0	12	251
9267	5966s (+0.5s)	1616	1616	128	39	127	0	5	171
9268	5967s (+0.9s)	3960	3960	256	63	248	0	13	324
9269	5967s (+0.6s)	2300	2300	128	52	151	15	1	219
9270	5968s (+0.8s)	2924	2924	256	76	168	13	0	257
9271	5969s (+1.0s)	4828	4828	512	85	236	18	0	339
9272	5969s (+0.3s)	860	860	64	28	78	5	0	111
9273	5970s (+0.6s)	2460	2460	256	46	156	8	0	210
9274	5970s (+0.5s)	1888	1888	128	38	145	7	0	190
9275	5971s (+0.3s)	960	960	64	42	70	8	0	120
9276	5971s (+0.6s)	2616	2616	256	49	169	11	0	229
9277	5972s (+0.9s)	3656	3656	256	75	207	15	0	297
9278	5973s (+0.5s)	1780	1780	128	47	127	10	0	184
9279	5973s (+0.3s)	892	892	64	28	82	4	0	114
9280	5974s (+0.6s)	2500	2500	128	56	158	7	0	221
9281	5974s (+0.4s)	932	932	64	28	89	0	6	123
9282	5975s (+0.8s)	3460	3460	256	52	218	0	14	284
9283	5976s (+1.0s)	4272	4272	256	81	252	0	20	353
9284	5977s (+0.5s)	1792	1792	128	36	133	0	14	183
9285	5977s (+0.2s)	556	556	64	14	58	0	3	75
9286	5978s (+0.9s)	3752	3752	256	66	229	0	14	309
9287	5978s (+0.5s)	1536	1536	128	30	128	0	4	162
9288	5979s (+0.8s)	3180	3180	256	55	198	0	11	264
9289	5979s (+0.3s)	916	916	64	29	85	0	6	120
9290	5980s (+0.9s)	3552	3552	256	59	223	0	20	302
9291	5981s (+1.0s)	4360	4360	256	63	284	0	13	360
9292	5981s (+0.3s)	740	740	64	20	76	2	0	98
9293	5982s (+0.6s)	2112	2112	128	57	138	6	0	201
9294	5983s (+0.7s)	2804	2804	256	46	196	6	0	248
9295	5984s (+1.1s)	5328	5328	512	98	254	16	0	368
9296	5984s (+0.5s)	1804	1804	128	47	129	10	0	186
9297	5985s (+0.8s)	3200	3200	256	67	184	16	0	267
9298	5985s (+0.4s)	1456	1456	128	32	114	6	0	152
9299	5986s (+0.5s)	1624	1624	128	44	118	10	0	172
Episode	Time	Reward	Score	Highest	L	U	R	D	Steps
9300	5987s (+0.6s)	1944	1944	128	52	139	8	0	199
9301	5987s (+0.5s)	1716	1716	128	45	122	3	0	170
9302	5987s (+0.4s)	1476	1476	128	33	111	8	0	152
9303	5988s (+0.8s)	3380	3380	256	85	186	19	1	291
9304	5989s (+0.4s)	1376	1376	128	28	114	3	0	145
9305	5989s (+0.7s)	3168	3168	256	61	187	9	0	257
9306	5990s (+0.9s)	3720	3720	256	86	212	18	1	317
9307	5991s (+0.4s)	1480	1480	128	36	110	7	0	153
9308	5992s (+1.0s)	4128	4128	256	79	258	12	0	349
9309	5993s (+0.8s)	3300	3300	256	73	200	9	0	282
9310	5993s (+0.5s)	1896	1896	128	40	134	9	0	183
9311	5994s (+0.5s)	1816	1816	128	25	159	0	5	189
9312	5994s (+0.5s)	1776	1776	128	37	134	0	8	179
9313	5995s (+0.7s)	2840	2840	256	47	184	0	10	241
9314	5995s (+0.5s)	2168	2168	256	32	153	0	2	187
9315	5996s (+0.7s)	2880	2880	256	63	166	14	0	243
9316	5997s (+0.4s)	1224	1224	128	36	91	7	0	134
9317	5998s (+1.0s)	4380	4380	256	102	251	16	0	369
9318	5998s (+0.5s)	1824	1824	128	54	124	12	0	190
9319	5999s (+0.7s)	2796	2796	256	53	184	5	0	242
9320	6000s (+0.9s)	3756	3756	256	90	201	19	0	310
9321	6000s (+0.6s)	1956	1956	128	46	149	7	0	202
9322	6001s (+0.6s)	2516	2516	256	53	158	9	0	220
9323	6002s (+0.8s)	3432	3432	256	69	199	14	0	282
9324	6002s (+0.5s)	1776	1776	128	43	129	11	0	183
9325	6003s (+0.4s)	1460	1460	128	29	117	0	7	153
9326	6003s (+0.4s)	1332	1332	128	24	106	0	5	135
9327	6004s (+0.9s)	3756	3756	256	55	239	0	13	307
9328	6004s (+0.4s)	1192	1192	128	26	98	0	7	131
9329	6005s (+0.5s)	1812	1812	128	44	138	0	6	188
9330	6006s (+0.6s)	2476	2476	256	53	143	15	0	211
9331	6006s (+0.4s)	1456	1456	128	30	116	6	0	152
9332	6007s (+0.5s)	1728	1728	128	44	126	7	1	178
9333	6007s (+0.4s)	1148	1148	128	23	100	2	0	125
9334	6008s (+0.6s)	2536	2536	256	49	159	6	0	214
9335	6008s (+0.8s)	3612	3612	256	81	197	17	0	295
9336	6009s (+0.6s)	2432	2432	256	44	151	11	0	206
9337	6010s (+0.8s)	3624	3624	256	61	219	12	0	292
9338	6010s (+0.7s)	2768	2768	256	52	167	16	0	235
9339	6011s (+0.8s)	3524	3524	256	70	211	12	0	293
9340	6012s (+0.7s)	2820	2820	256	58	157	12	0	227
9341	6012s (+0.2s)	432	432	32	16	50	4	0	70
9342	6012s (+0.2s)	544	544	32	14	64	3	0	81
9343	6013s (+0.5s)	1596	1596	128	41	121	4	0	166
9344	6014s (+0.9s)	4768	4768	512	79	238	17	0	334
9345	6014s (+0.6s)	2432	2432	128	62	149	13	0	224
9346	6015s (+0.5s)	1496	1496	128	40	108	9	1	158
9347	6016s (+0.8s)	3200	3200	256	71	183	13	0	267
9348	6016s (+0.5s)	1628	1628	128	29	130	0	6	165
9349	6017s (+0.9s)	3500	3500	256	63	226	0	11	300
9350	6018s (+0.6s)	2688	2688	256	51	167	0	10	228
9351	6018s (+0.7s)	2792	2792	256	44	187	0	10	241
9352	6019s (+0.5s)	1632	1632	128	52	113	10	0	175
9353	6019s (+0.5s)	2016	2016	128	58	124	10	0	192
9354	6020s (+0.9s)	4112	4112	256	85	230	16	0	331
9355	6022s (+1.3s)	6472	6472	512	129	305	27	0	461
9356	6022s (+0.4s)	1232	1232	128	33	94	5	0	132
9357	6023s (+0.9s)	3492	3492	256	68	224	7	0	299
9358	6024s (+0.6s)	2796	2796	256	52	163	14	0	229
9359	6024s (+0.9s)	3588	3588	256	94	192	14	0	300
9360	6025s (+0.7s)	2816	2816	256	68	167	12	0	247
9361	6026s (+1.1s)	5368	5368	512	96	255	22	1	374
9362	6027s (+0.9s)	3448	3448	256	64	213	16	0	293
9363	6028s (+0.9s)	3568	3568	256	82	203	13	1	299
9364	6029s (+0.8s)	3504	3504	256	88	183	17	1	289
9365	6029s (+0.6s)	1940	1940	128	47	152	4	0	203
9366	6030s (+0.5s)	1496	1496	128	36	116	5	0	157
9367	6031s (+1.0s)	4224	4224	256	81	247	19	0	347
9368	6031s (+0.5s)	1640	1640	128	36	136	4	0	176
9369	6032s (+0.5s)	1912	1912	128	43	134	13	0	190
9370	6033s (+0.6s)	2404	2404	256	57	133	11	1	202
9371	6033s (+0.7s)	2932	2932	256	67	179	13	0	259
9372	6034s (+0.7s)	2852	2852	256	49	187	8	0	244
9373	6035s (+0.7s)	2988	2988	256	65	183	14	0	262
9374	6036s (+0.9s)	3632	3632	256	94	195	21	0	310
9375	6036s (+0.7s)	2764	2764	256	53	174	10	1	238
9376	6037s (+1.1s)	4640	4640	256	101	264	20	0	385
9377	6038s (+0.8s)	3252	3252	256	62	202	12	0	276
9378	6039s (+0.8s)	3380	3380	256	75	192	17	0	284
9379	6040s (+0.8s)	3532	3532	256	77	195	19	0	291
9380	6041s (+0.9s)	3580	3580	256	74	213	15	0	302
9381	6041s (+0.8s)	3188	3188	256	58	196	10	1	265
9382	6043s (+1.1s)	5632	5632	512	124	261	21	0	406
9383	6043s (+0.5s)	1792	1792	128	55	117	10	1	183
9384	6044s (+0.6s)	2560	2560	256	50	170	6	0	226
9385	6044s (+0.5s)	1616	1616	128	41	119	5	0	165
9386	6045s (+0.5s)	1636	1636	128	37	134	5	0	176
9387	6046s (+0.8s)	3028	3028	256	61	193	12	1	267
9388	6046s (+0.4s)	1484	1484	128	46	101	8	0	155
9389	6046s (+0.5s)	1516	1516	128	50	101	7	0	158
9390	6047s (+0.4s)	1268	1268	128	18	108	0	3	129
9391	6047s (+0.5s)	1636	1636	128	34	120	0	8	162
9392	6048s (+0.3s)	676	676	64	27	57	6	0	90
9393	6049s (+1.3s)	6752	6752	512	131	299	31	1	462
9394	6050s (+0.8s)	3488	3488	256	76	204	11	0	291
9395	6050s (+0.7s)	2936	2936	256	57	168	10	0	235
9396	6051s (+0.8s)	3304	3304	256	63	198	12	0	273
9397	6052s (+0.5s)	1780	1780	128	41	135	8	0	184
9398	6053s (+1.3s)	6216	6216	512	117	296	27	0	440
9399	6054s (+0.9s)	3648	3648	256	98	196	16	0	310
Episode	Time	Reward	Score	Highest	L	U	R	D	Steps
9400	6055s (+0.9s)	3556	3556	256	86	201	16	0	303
9401	6056s (+1.0s)	4024	4024	256	83	235	17	0	335
9402	6056s (+0.4s)	1412	1412	128	39	101	12	1	153
9403	6057s (+0.4s)	1620	1620	128	39	115	8	0	162
9404	6058s (+0.8s)	3396	3396	256	84	196	10	0	290
9405	6058s (+0.6s)	1912	1912	128	54	132	10	0	196
9406	6059s (+0.4s)	1448	1448	128	32	115	3	0	150
9407	6059s (+0.4s)	1428	1428	128	36	103	9	0	148
9408	6059s (+0.4s)	1484	1484	128	33	116	6	0	155
9409	6060s (+0.6s)	2388	2388	256	49	143	7	0	199
9410	6061s (+0.5s)	1840	1840	128	44	141	5	0	190
9411	6061s (+0.6s)	2356	2356	256	50	132	11	0	193
9412	6062s (+0.5s)	1720	1720	128	42	124	8	0	174
9413	6062s (+0.8s)	3152	3152	256	51	199	12	0	262
9414	6063s (+0.7s)	3164	3164	256	65	182	13	1	261
9415	6064s (+1.0s)	4248	4248	256	83	248	21	0	352
9416	6065s (+0.4s)	1488	1488	128	35	113	8	0	156
9417	6065s (+0.5s)	1624	1624	128	46	119	8	0	173
9418	6066s (+0.5s)	1824	1824	128	44	135	8	0	187
9419	6066s (+0.5s)	2160	2160	256	49	121	9	0	179
9420	6067s (+0.5s)	1808	1808	128	39	138	10	0	187
9421	6067s (+0.5s)	1764	1764	128	45	127	9	0	181
9422	6067s (+0.3s)	1004	1004	128	19	84	4	0	107
9423	6068s (+0.6s)	2576	2576	256	45	167	0	8	220
9424	6069s (+0.6s)	2368	2368	128	49	158	0	13	220
9425	6069s (+0.6s)	2228	2228	128	49	157	0	7	213
9426	6070s (+0.7s)	2880	2880	256	44	202	0	7	253
9427	6071s (+0.7s)	3212	3212	256	55	198	0	11	264
9428	6072s (+0.8s)	3612	3612	256	76	199	16	0	291
9429	6072s (+0.7s)	2780	2780	256	57	175	9	1	242
9430	6073s (+0.9s)	3908	3908	256	76	226	15	0	317
9431	6074s (+0.4s)	1092	1092	64	36	89	7	0	132
9432	6075s (+1.1s)	4608	4608	256	111	251	20	0	382
9433	6076s (+0.7s)	3152	3152	256	52	197	10	0	259
9434	6076s (+0.2s)	392	392	32	13	56	1	0	70
9435	6076s (+0.7s)	2920	2920	256	55	192	9	0	256
9436	6077s (+0.8s)	3224	3224	256	74	183	10	1	268
9437	6078s (+0.5s)	1788	1788	128	50	123	9	0	182
9438	6078s (+0.3s)	728	728	64	19	73	3	0	95
9439	6079s (+0.7s)	2772	2772	256	61	163	11	1	236
9440	6079s (+0.5s)	1796	1796	128	36	142	6	0	184
9441	6080s (+0.3s)	936	936	64	41	66	5	1	113
9442	6080s (+0.5s)	1748	1748	128	43	132	8	0	183
9443	6081s (+1.0s)	4264	4264	256	103	232	21	0	356
9444	6082s (+0.5s)	1496	1496	128	39	111	7	0	157
9445	6082s (+0.8s)	3192	3192	256	55	204	8	0	267
9446	6083s (+0.4s)	1568	1568	128	31	120	3	0	154
9447	6083s (+0.2s)	584	584	64	17	60	3	0	80
9448	6084s (+0.5s)	2328	2328	256	43	139	13	0	195
9449	6084s (+0.6s)	1988	1988	128	48	141	11	0	200
9450	6085s (+0.7s)	3136	3136	256	52	199	7	0	258
9451	6085s (+0.4s)	1428	1428	128	42	99	5	0	146
9452	6086s (+0.8s)	3244	3244	256	60	205	10	0	275
9453	6087s (+0.6s)	2296	2296	256	41	146	0	11	198
9454	6087s (+0.5s)	1720	1720	128	33	133	0	5	171
9455	6088s (+0.6s)	2616	2616	256	46	169	0	8	223
9456	6088s (+0.5s)	2268	2268	256	31	151	0	9	191
9457	6089s (+0.2s)	612	612	64	14	64	0	6	84
9458	6089s (+0.4s)	1128	1128	128	25	94	0	4	123
9459	6090s (+0.7s)	2712	2712	256	54	159	13	1	227
9460	6090s (+0.8s)	3180	3180	256	57	191	15	0	263
9461	6091s (+0.5s)	1584	1584	128	36	123	8	0	167
9462	6092s (+0.6s)	2588	2588	256	45	167	5	0	217
9463	6092s (+0.6s)	1916	1916	128	42	148	7	0	197
9464	6093s (+0.5s)	1912	1912	128	37	133	10	1	181
9465	6093s (+0.4s)	1124	1124	64	28	99	5	1	133
9466	6093s (+0.5s)	1720	1720	128	44	120	10	0	174
9467	6095s (+1.1s)	5344	5344	512	83	267	18	0	368
9468	6095s (+0.5s)	1788	1788	128	52	120	11	0	183
9469	6096s (+0.8s)	3216	3216	256	74	178	16	2	270
9470	6096s (+0.5s)	1764	1764	128	48	125	8	0	181
9471	6097s (+0.6s)	2532	2532	256	61	153	6	0	220
9472	6098s (+0.7s)	2460	2460	128	69	150	12	0	231
9473	6099s (+0.9s)	3608	3608	256	91	196	19	0	306
9474	6099s (+0.6s)	2624	2624	256	42	171	0	8	221
9475	6100s (+0.5s)	1504	1504	128	24	128	0	8	160
9476	6100s (+0.8s)	3248	3248	256	52	211	0	13	276
9477	6101s (+0.8s)	3320	3320	256	77	191	13	0	281
9478	6102s (+0.7s)	3160	3160	256	66	182	11	1	260
9479	6102s (+0.2s)	632	632	64	30	55	2	0	87
9480	6103s (+0.5s)	1516	1516	128	40	111	7	0	158
9481	6103s (+0.7s)	2760	2760	128	62	181	14	0	257
9482	6104s (+0.9s)	4028	4028	256	82	229	18	0	329
9483	6105s (+0.8s)	3316	3316	256	61	202	12	1	276
9484	6105s (+0.2s)	628	628	64	24	57	5	0	86
9485	6106s (+0.5s)	1632	1632	128	28	137	0	0	165
9486	6106s (+0.5s)	1600	1600	128	34	116	8	0	158
9487	6107s (+0.5s)	1636	1636	128	47	109	9	0	165
9488	6107s (+0.5s)	1824	1824	128	46	138	6	0	190
9489	6108s (+1.1s)	5488	5488	512	95	276	15	0	386
9490	6109s (+0.7s)	2716	2716	256	67	156	15	0	238
9491	6110s (+0.5s)	1836	1836	128	46	130	7	0	183
9492	6111s (+0.8s)	3556	3556	256	79	213	11	0	303
9493	6111s (+0.7s)	3192	3192	256	70	177	15	0	262
9494	6112s (+0.8s)	3360	3360	256	61	211	14	0	286
9495	6113s (+0.6s)	2608	2608	256	49	166	11	1	227
9496	6113s (+0.4s)	1172	1172	128	21	98	6	1	126
9497	6114s (+0.3s)	860	860	64	24	82	5	0	111
9498	6114s (+0.6s)	1908	1908	128	45	144	6	0	195
9499	6115s (+0.5s)	1792	1792	128	45	131	7	0	183
Episode	Time	Reward	Score	Highest	L	U	R	D	Steps
9500	6116s (+1.2s)	5972	5972	512	87	307	0	25	419
9501	6116s (+0.6s)	2688	2688	256	41	178	0	7	226
9502	6117s (+0.9s)	3780	3780	256	58	240	0	13	311
9503	6118s (+0.8s)	3612	3612	256	53	237	0	10	300
9504	6119s (+0.7s)	2456	2456	128	44	176	0	13	233
9505	6120s (+0.9s)	3724	3724	256	61	236	0	15	312
9506	6120s (+0.4s)	1296	1296	128	32	87	0	11	130
9507	6120s (+0.2s)	408	408	32	17	46	0	5	68
9508	6121s (+0.5s)	1600	1600	128	29	131	0	8	168
9509	6122s (+1.2s)	6240	6240	512	110	297	20	0	427
9510	6123s (+0.7s)	3048	3048	256	57	184	16	0	257
9511	6124s (+0.9s)	3544	3544	256	72	214	12	0	298
9512	6125s (+0.8s)	3320	3320	256	78	187	16	0	281
9513	6125s (+0.5s)	2196	2196	256	43	138	8	0	189
9514	6126s (+0.8s)	3444	3444	256	76	200	16	0	292
9515	6127s (+0.4s)	1504	1504	128	37	117	5	0	159
9516	6127s (+0.6s)	1880	1880	128	55	127	11	0	193
9517	6128s (+0.8s)	3480	3480	256	65	213	15	0	293
9518	6128s (+0.5s)	1540	1540	128	45	109	10	0	164
9519	6129s (+0.5s)	1780	1780	128	46	127	7	0	180
9520	6129s (+0.6s)	1928	1928	128	50	141	9	0	200
9521	6130s (+0.5s)	1836	1836	128	46	137	10	0	193
9522	6130s (+0.4s)	1160	1160	64	29	104	5	0	138
9523	6131s (+1.0s)	4096	4096	256	97	227	17	0	341
9524	6133s (+1.1s)	5488	5488	512	116	252	23	0	391
9525	6133s (+0.4s)	1092	1092	64	44	75	7	0	126
9526	6134s (+1.0s)	4288	4288	256	98	247	12	0	357
9527	6134s (+0.4s)	1416	1416	128	34	109	6	0	149
9528	6135s (+1.0s)	4188	4188	256	100	231	13	0	344
9529	6136s (+0.9s)	4124	4124	256	91	233	13	0	337
9530	6137s (+0.8s)	3356	3356	256	69	208	8	0	285
9531	6137s (+0.3s)	712	712	64	21	72	2	0	95
9532	6138s (+0.4s)	1304	1304	128	33	99	10	0	142
9533	6138s (+0.6s)	2356	2356	256	43	149	6	0	198
9534	6139s (+0.7s)	2904	2904	256	53	182	6	0	241
9535	6140s (+0.8s)	3504	3504	256	74	209	12	0	295
9536	6140s (+0.4s)	1400	1400	64	42	105	10	0	157
9537	6141s (+0.4s)	1476	1476	128	34	115	4	0	153
9538	6142s (+1.0s)	4296	4296	256	93	246	21	0	360
9539	6142s (+0.5s)	1804	1804	128	41	139	0	6	186
9540	6143s (+0.6s)	1908	1908	128	46	139	0	10	195
9541	6144s (+0.9s)	3564	3564	256	84	205	13	0	302
9542	6145s (+0.8s)	3568	3568	256	85	196	14	0	295
9543	6145s (+0.4s)	1468	1468	128	45	98	12	0	155
9544	6146s (+1.0s)	4224	4224	256	109	221	21	0	351
9545	6147s (+0.5s)	1912	1912	128	40	134	9	0	183
9546	6147s (+0.6s)	1896	1896	128	50	135	12	0	197
9547	6148s (+1.0s)	4224	4224	256	82	250	19	0	351
9548	6149s (+0.3s)	868	868	64	29	69	5	0	103
9549	6149s (+0.4s)	1452	1452	128	35	110	7	0	152
9550	6149s (+0.3s)	916	916	64	27	79	0	4	110
9551	6150s (+0.8s)	3532	3532	256	58	213	0	13	284
9552	6151s (+0.6s)	2348	2348	128	53	148	0	13	214
9553	6151s (+0.3s)	828	828	64	22	80	0	6	108
9554	6152s (+0.5s)	1572	1572	128	36	117	11	0	164
9555	6153s (+0.9s)	3992	3992	256	75	241	16	0	332
9556	6153s (+0.4s)	1276	1276	128	37	89	9	0	135
9557	6153s (+0.3s)	1064	1064	128	28	82	5	0	115
9558	6154s (+0.8s)	3408	3408	256	73	197	17	0	287
9559	6155s (+0.5s)	2320	2320	256	47	134	14	0	195
9560	6156s (+0.9s)	4132	4132	256	87	219	23	0	329
9561	6156s (+0.5s)	1600	1600	128	41	120	6	0	167
9562	6157s (+0.6s)	2660	2660	256	56	155	14	0	225
9563	6157s (+0.7s)	3224	3224	256	56	202	11	0	269
9564	6158s (+0.6s)	2044	2044	128	48	148	7	0	203
9565	6159s (+0.5s)	1684	1684	128	37	130	5	0	172
9566	6159s (+0.6s)	2584	2584	256	47	164	6	0	217
9567	6160s (+0.6s)	2348	2348	256	50	144	6	0	200
9568	6160s (+0.7s)	2876	2876	256	52	182	11	0	245
9569	6161s (+0.5s)	1808	1808	128	43	135	8	0	186
9570	6162s (+0.5s)	1964	1964	128	53	126	12	0	191
9571	6162s (+0.4s)	1184	1184	128	26	105	2	0	133
9572	6163s (+0.7s)	2680	2680	256	63	167	9	0	239
9573	6163s (+0.5s)	1624	1624	128	48	115	9	0	172
9574	6164s (+0.6s)	2468	2468	128	70	143	14	1	228
9575	6164s (+0.5s)	1780	1780	128	47	125	8	0	180
9576	6165s (+0.6s)	2540	2540	256	45	158	10	0	213
9577	6166s (+1.0s)	4064	4064	256	75	248	16	0	339
9578	6167s (+0.9s)	3664	3664	256	84	221	13	0	318
9579	6168s (+0.8s)	3416	3416	256	86	178	12	2	278
9580	6168s (+0.5s)	1816	1816	128	44	133	11	0	188
9581	6169s (+0.4s)	1348	1348	128	28	104	0	6	138
9582	6169s (+0.5s)	1820	1820	128	48	127	11	0	186
9583	6170s (+0.5s)	1692	1692	128	42	127	5	0	174
9584	6170s (+0.5s)	1860	1860	128	34	152	0	7	193
9585	6171s (+0.6s)	2496	2496	256	48	157	0	7	212
9586	6171s (+0.7s)	3140	3140	256	67	179	8	0	254
9587	6172s (+0.8s)	3356	3356	256	67	199	11	0	277
9588	6173s (+0.8s)	3412	3412	256	87	194	14	0	295
9589	6174s (+1.1s)	5572	5572	512	94	285	17	0	396
9590	6175s (+0.7s)	2928	2928	256	72	157	18	1	248
9591	6176s (+1.2s)	5748	5748	512	98	291	19	0	408
9592	6177s (+0.4s)	1192	1192	64	33	107	5	0	145
9593	6177s (+0.5s)	1736	1736	128	29	142	4	0	175
9594	6177s (+0.4s)	1308	1308	128	20	109	0	5	134
9595	6178s (+0.5s)	1732	1732	128	37	130	0	7	174
9596	6179s (+0.8s)	3120	3120	256	49	202	0	9	260
9597	6179s (+0.5s)	1592	1592	128	34	128	0	3	165
9598	6180s (+0.6s)	2208	2208	128	60	151	10	0	221
9599	6180s (+0.6s)	1948	1948	128	50	143	8	0	201
Episode	Time	Reward	Score	Highest	L	U	R	D	Steps
9600	6181s (+0.6s)	2528	2528	256	54	152	13	0	219
9601	6182s (+0.7s)	2768	2768	256	61	170	9	0	240
9602	6183s (+1.1s)	5352	5352	512	103	256	21	0	380
9603	6184s (+1.3s)	6616	6616	512	140	290	24	3	457
9604	6185s (+0.5s)	1788	1788	128	40	135	6	0	181
9605	6185s (+0.3s)	1128	1128	128	23	93	4	0	120
9606	6186s (+0.7s)	3144	3144	256	77	161	17	0	255
9607	6186s (+0.3s)	1024	1024	64	27	89	8	0	124
9608	6187s (+0.6s)	2116	2116	128	58	137	13	0	208
9609	6188s (+1.0s)	4192	4192	256	87	243	13	0	343
9610	6188s (+0.6s)	1924	1924	128	59	129	11	0	199
9611	6189s (+0.6s)	2544	2544	256	61	156	6	0	223
9612	6190s (+1.0s)	4176	4176	256	78	249	12	0	339
9613	6191s (+0.7s)	2776	2776	256	65	165	10	0	240
9614	6191s (+0.6s)	1880	1880	128	41	142	10	0	193
9615	6192s (+0.7s)	3192	3192	256	71	177	12	0	260
9616	6192s (+0.6s)	2332	2332	256	41	153	9	0	203
9617	6193s (+0.9s)	3912	3912	256	107	206	18	1	332
9618	6194s (+0.7s)	3132	3132	256	62	186	14	0	262
9619	6194s (+0.3s)	888	888	64	35	72	6	0	113
9620	6195s (+0.7s)	3016	3016	256	56	176	12	0	244
9621	6196s (+1.0s)	4040	4040	256	82	235	15	0	332
9622	6197s (+0.4s)	1452	1452	128	34	110	8	0	152
9623	6197s (+0.8s)	3188	3188	256	73	176	15	0	264
9624	6198s (+0.6s)	2256	2256	128	61	148	9	0	218
9625	6199s (+0.7s)	2908	2908	256	58	189	5	0	252
9626	6199s (+0.5s)	1716	1716	128	40	128	8	0	176
9627	6200s (+0.7s)	2628	2628	256	45	177	0	6	228
9628	6200s (+0.4s)	1176	1176	128	29	92	0	5	126
9629	6201s (+0.4s)	1312	1312	128	38	99	7	0	144
9630	6201s (+0.5s)	1812	1812	128	53	120	11	1	185
9631	6202s (+1.0s)	4320	4320	256	93	249	16	0	358
9632	6202s (+0.3s)	812	812	64	29	77	4	0	110
9633	6203s (+0.7s)	3048	3048	256	76	170	15	0	261
9634	6204s (+0.9s)	4020	4020	256	79	241	15	0	335
9635	6205s (+0.5s)	1800	1800	128	36	141	6	1	184
9636	6205s (+0.6s)	2560	2560	256	57	160	9	1	227
9637	6206s (+0.7s)	3096	3096	256	58	188	11	1	258
9638	6207s (+0.5s)	1796	1796	128	32	146	0	7	185
9639	6207s (+0.7s)	2784	2784	256	59	161	14	0	234
9640	6208s (+0.4s)	1472	1472	128	41	104	11	0	156
9641	6208s (+0.3s)	756	756	64	25	67	5	0	97
9642	6208s (+0.5s)	1656	1656	128	38	121	5	0	164
9643	6209s (+0.4s)	1500	1500	128	33	123	3	0	159
9644	6209s (+0.4s)	1200	1200	128	23	105	4	0	132
9645	6210s (+0.8s)	3016	3016	256	60	198	11	0	269
9646	6211s (+0.5s)	1652	1652	128	49	115	9	0	173
9647	6211s (+0.6s)	2696	2696	256	51	163	12	0	226
9648	6212s (+0.5s)	1780	1780	128	51	120	12	0	183
9649	6212s (+0.5s)	1900	1900	128	50	130	17	0	197
9650	6213s (+0.7s)	3124	3124	256	66	179	16	0	261
9651	6214s (+0.5s)	1664	1664	128	55	100	13	0	168
9652	6214s (+0.6s)	2096	2096	128	62	127	15	0	204
9653	6214s (+0.2s)	604	604	64	18	63	0	0	81
9654	6215s (+0.5s)	1628	1628	128	34	133	0	7	174
9655	6216s (+1.0s)	4276	4276	256	61	284	0	14	359
9656	6216s (+0.5s)	1592	1592	128	29	131	0	6	166
9657	6217s (+0.7s)	2792	2792	256	50	179	0	12	241
9658	6218s (+0.7s)	2780	2780	256	52	175	0	12	239
9659	6219s (+1.1s)	5484	5484	512	75	292	0	18	385
9660	6220s (+0.8s)	3456	3456	256	49	236	0	9	294
9661	6220s (+0.4s)	1204	1204	128	27	95	0	3	125
9662	6221s (+0.6s)	1916	1916	128	34	157	0	6	197
9663	6221s (+0.7s)	2924	2924	256	60	175	8	0	243
9664	6222s (+0.9s)	3820	3820	256	79	209	18	0	306
9665	6223s (+0.5s)	1552	1552	128	38	114	9	0	161
9666	6223s (+0.6s)	2612	2612	256	59	160	9	0	228
9667	6224s (+0.3s)	672	672	64	21	67	4	0	92
9668	6224s (+0.3s)	1076	1076	128	25	90	3	0	118
9669	6225s (+0.5s)	1568	1568	128	42	120	8	0	170
9670	6225s (+0.6s)	1912	1912	128	42	145	9	0	196
9671	6226s (+0.5s)	1580	1580	128	36	121	5	0	162
9672	6226s (+0.5s)	1748	1748	128	35	121	0	7	163
9673	6227s (+0.5s)	1712	1712	128	32	138	0	5	175
9674	6227s (+0.5s)	1752	1752	128	29	141	0	8	178
9675	6228s (+1.2s)	6200	6200	512	94	318	0	24	436
9676	6229s (+0.4s)	1048	1048	64	21	97	0	8	126
9677	6229s (+0.4s)	1380	1380	128	34	107	0	6	147
9678	6230s (+0.7s)	2944	2944	256	76	145	17	1	239
9679	6230s (+0.6s)	2400	2400	128	64	154	8	0	226
9680	6231s (+0.4s)	1176	1176	64	38	91	9	0	138
9681	6231s (+0.4s)	1184	1184	128	26	99	4	0	129
9682	6232s (+0.7s)	3216	3216	256	63	183	20	0	266
9683	6232s (+0.4s)	1360	1360	128	22	120	3	0	145
9684	6233s (+0.7s)	2920	2920	256	72	174	10	0	256
9685	6234s (+1.0s)	5164	5164	512	85	268	16	0	369
9686	6235s (+0.4s)	1408	1408	128	33	106	9	0	148
9687	6235s (+0.7s)	3004	3004	256	71	175	16	0	262
9688	6236s (+0.4s)	1356	1356	128	34	98	7	0	139
9689	6237s (+0.9s)	3600	3600	256	89	197	17	0	303
9690	6237s (+0.4s)	1340	1340	128	27	106	5	0	138
9691	6237s (+0.4s)	1356	1356	128	34	110	6	0	150
9692	6238s (+0.3s)	732	732	64	28	65	3	0	96
9693	6238s (+0.7s)	2472	2472	128	71	139	19	0	229
9694	6239s (+0.5s)	1768	1768	128	33	141	0	5	179
9695	6239s (+0.5s)	1548	1548	128	27	125	0	6	158
9696	6240s (+0.5s)	1740	1740	128	33	133	0	9	175
9697	6241s (+0.8s)	3160	3160	256	51	206	0	9	266
9698	6241s (+0.8s)	3420	3420	256	57	214	0	15	286
9699	6242s (+0.5s)	1744	1744	128	37	131	8	0	176
Episode	Time	Reward	Score	Highest	L	U	R	D	Steps
9700	6242s (+0.4s)	1492	1492	128	38	109	0	10	157
9701	6243s (+0.4s)	1056	1056	64	33	91	4	0	128
9702	6244s (+0.8s)	3424	3424	256	72	195	19	1	287
9703	6244s (+0.5s)	1536	1536	128	37	118	7	1	163
9704	6245s (+0.6s)	2088	2088	128	64	127	13	0	204
9705	6245s (+0.4s)	1428	1428	128	32	115	5	0	152
9706	6246s (+0.7s)	3188	3188	256	51	196	0	13	260
9707	6246s (+0.5s)	1592	1592	128	41	117	0	8	166
9708	6247s (+0.5s)	2012	2012	128	50	130	11	0	191
9709	6247s (+0.4s)	1080	1080	64	38	89	6	0	133
9710	6248s (+0.9s)	3936	3936	256	85	221	17	0	323
9711	6249s (+0.6s)	2752	2752	256	44	183	0	9	236
9712	6250s (+0.7s)	3340	3340	256	77	187	0	11	275
9713	6250s (+0.8s)	3708	3708	256	53	230	0	13	296
9714	6251s (+0.5s)	1744	1744	128	33	139	0	5	177
9715	6252s (+0.6s)	2576	2576	256	42	168	0	10	220
9716	6252s (+0.3s)	652	652	64	16	69	4	0	89
9717	6253s (+0.7s)	2820	2820	256	48	190	10	0	248
9718	6253s (+0.3s)	1028	1028	64	24	92	6	0	122
9719	6253s (+0.4s)	1496	1496	128	42	109	7	0	158
9720	6254s (+0.5s)	1876	1876	128	43	141	0	7	191
9721	6255s (+0.6s)	2476	2476	256	47	156	0	12	215
9722	6255s (+0.8s)	3232	3232	256	51	213	0	7	271
9723	6256s (+0.5s)	1796	1796	128	43	129	0	12	184
9724	6256s (+0.5s)	1804	1804	128	32	146	0	8	186
9725	6257s (+0.6s)	2440	2440	256	50	135	0	12	197
9726	6257s (+0.5s)	1528	1528	128	36	115	0	10	161
9727	6258s (+0.3s)	1076	1076	128	23	90	0	5	118
9728	6259s (+1.0s)	5244	5244	512	78	264	0	18	360
9729	6259s (+0.6s)	2380	2380	256	55	142	10	0	207
9730	6260s (+0.5s)	1828	1828	128	49	136	3	0	188
9731	6260s (+0.4s)	1484	1484	128	27	124	4	0	155
9732	6261s (+0.6s)	1916	1916	128	41	151	5	0	197
9733	6261s (+0.4s)	1160	1160	64	36	94	6	1	137
9734	6262s (+0.7s)	2508	2508	128	75	146	16	1	238
9735	6262s (+0.4s)	1472	1472	128	36	111	6	0	153
9736	6263s (+0.7s)	2868	2868	256	53	173	8	0	234
9737	6264s (+0.5s)	1600	1600	128	40	118	9	0	167
9738	6264s (+0.7s)	3076	3076	256	63	177	12	1	253
9739	6265s (+0.4s)	1460	1460	128	27	115	0	11	153
9740	6266s (+0.9s)	3620	3620	256	68	227	13	0	308
9741	6266s (+0.6s)	2188	2188	128	57	136	13	1	207
9742	6267s (+0.8s)	3668	3668	256	79	210	15	0	304
9743	6268s (+0.9s)	3960	3960	256	79	225	16	1	321
9744	6268s (+0.4s)	1044	1044	64	26	96	3	0	125
9745	6269s (+0.6s)	2392	2392	256	53	141	9	0	203
9746	6270s (+0.8s)	3644	3644	256	87	197	10	0	294
9747	6270s (+0.6s)	2060	2060	128	54	138	14	0	206
9748	6271s (+0.4s)	1448	1448	128	32	116	2	0	150
9749	6271s (+0.5s)	1712	1712	128	52	117	6	0	175
9750	6272s (+0.8s)	3208	3208	256	69	186	11	0	266
9751	6273s (+0.4s)	1344	1344	128	43	86	8	0	137
9752	6273s (+0.9s)	3936	3936	256	73	230	20	0	323
9753	6274s (+0.8s)	3236	3236	256	78	182	10	1	271
9754	6275s (+0.4s)	1484	1484	128	44	107	5	0	156
9755	6275s (+0.7s)	3236	3236	256	64	198	11	0	273
9756	6277s (+1.2s)	6032	6032	512	105	294	21	0	420
9757	6277s (+0.6s)	2684	2684	256	50	163	12	0	225
9758	6278s (+0.8s)	3228	3228	256	61	200	9	0	270
9759	6279s (+0.5s)	1604	1604	128	49	108	7	0	164
9760	6279s (+0.4s)	1284	1284	128	43	96	5	0	144
9761	6280s (+0.5s)	1832	1832	128	57	125	6	0	188
9762	6280s (+0.7s)	2976	2976	256	63	174	13	0	250
9763	6281s (+0.8s)	3512	3512	256	69	195	15	1	280
9764	6282s (+0.8s)	3280	3280	256	69	199	9	1	278
9765	6282s (+0.5s)	1856	1856	128	47	134	7	0	188
9766	6283s (+0.6s)	2716	2716	256	65	152	10	0	227
9767	6284s (+0.5s)	1856	1856	128	56	117	10	0	183
9768	6285s (+1.0s)	4252	4252	256	116	221	16	0	353
9769	6285s (+0.7s)	3032	3032	256	52	176	16	1	245
9770	6286s (+0.5s)	1812	1812	128	44	133	5	0	182
9771	6287s (+0.9s)	3620	3620	256	85	203	18	1	307
9772	6288s (+1.0s)	4128	4128	256	83	237	19	0	339
9773	6288s (+0.5s)	1600	1600	128	44	116	7	0	167
9774	6289s (+1.4s)	6792	6792	512	131	339	26	0	496
9775	6290s (+0.5s)	1748	1748	128	44	125	7	1	177
9776	6291s (+0.9s)	3632	3632	256	69	227	15	0	311
9777	6292s (+0.7s)	3180	3180	256	55	196	13	0	264
9778	6292s (+0.6s)	2616	2616	256	49	170	10	0	229
9779	6293s (+0.4s)	1396	1396	128	30	113	6	0	149
9780	6293s (+0.6s)	2568	2568	256	52	171	5	0	228
9781	6294s (+0.9s)	3952	3952	256	58	250	0	16	324
9782	6295s (+0.4s)	1456	1456	128	30	108	0	10	148
9783	6295s (+0.3s)	896	896	64	25	78	6	1	110
9784	6296s (+1.3s)	6108	6108	512	108	310	22	0	440
9785	6297s (+0.9s)	4700	4700	512	76	231	16	0	323
9786	6298s (+0.8s)	3460	3460	256	60	211	17	1	289
9787	6299s (+0.6s)	2216	2216	128	49	157	4	0	210
9788	6300s (+0.9s)	4740	4740	512	71	243	13	1	328
9789	6300s (+0.8s)	3424	3424	256	65	202	14	0	281
9790	6301s (+0.5s)	1716	1716	128	43	127	6	0	176
9791	6302s (+1.1s)	5776	5776	512	90	291	19	1	401
9792	6303s (+0.5s)	1580	1580	128	34	121	8	0	163
9793	6303s (+0.6s)	2384	2384	256	62	131	11	0	204
9794	6304s (+0.5s)	1792	1792	128	46	128	9	0	183
9795	6305s (+0.7s)	2996	2996	256	61	177	10	0	248
9796	6305s (+0.7s)	3256	3256	256	80	181	11	0	272
9797	6306s (+0.4s)	1460	1460	128	32	120	2	0	154
9798	6306s (+0.5s)	1492	1492	128	41	112	5	0	158
9799	6307s (+0.9s)	3696	3696	256	77	224	13	0	314
Episode	Time	Reward	Score	Highest	L	U	R	D	Steps
9800	6308s (+0.9s)	4032	4032	256	97	210	20	0	327
9801	6309s (+0.5s)	1588	1588	128	39	122	4	0	165
9802	6309s (+0.3s)	792	792	64	32	71	3	0	106
9803	6310s (+1.1s)	5428	5428	512	90	276	18	0	384
9804	6311s (+0.6s)	2488	2488	256	49	155	9	0	213
9805	6311s (+0.5s)	1568	1568	128	34	124	6	0	164
9806	6311s (+0.4s)	1000	1000	64	25	99	5	0	129
9807	6312s (+0.6s)	2624	2624	256	55	170	5	1	231
9808	6313s (+0.4s)	1584	1584	128	35	114	6	0	155
9809	6313s (+0.8s)	3488	3488	256	67	210	14	0	291
9810	6314s (+0.6s)	2560	2560	256	51	159	10	0	220
9811	6315s (+0.5s)	1536	1536	128	37	120	5	1	163
9812	6316s (+1.1s)	4604	4604	256	107	257	17	0	381
9813	6316s (+0.5s)	1500	1500	128	32	122	4	0	158
9814	6317s (+0.6s)	2076	2076	128	50	135	8	0	193
9815	6317s (+0.7s)	2636	2636	256	55	174	5	0	234
9816	6318s (+0.8s)	3464	3464	256	84	187	18	0	289
9817	6319s (+0.5s)	1708	1708	128	34	134	0	7	175
9818	6319s (+0.6s)	2512	2512	256	44	166	6	0	216
9819	6320s (+0.4s)	1152	1152	64	30	101	4	0	135
9820	6320s (+0.5s)	1640	1640	128	46	116	11	0	173
9821	6321s (+0.7s)	2672	2672	256	60	158	13	0	231
9822	6322s (+0.8s)	3400	3400	256	64	206	14	1	285
9823	6322s (+0.8s)	3288	3288	256	66	193	13	1	273
9824	6323s (+0.8s)	3368	3368	256	68	195	14	0	277
9825	6324s (+0.7s)	2848	2848	256	72	156	15	0	243
9826	6324s (+0.6s)	1968	1968	128	44	159	2	0	205
9827	6325s (+0.4s)	1548	1548	128	31	119	0	6	156
9828	6326s (+0.9s)	4008	4008	256	64	243	0	17	324
9829	6327s (+0.9s)	3900	3900	256	71	236	0	18	325
9830	6328s (+0.9s)	3852	3852	256	73	223	0	18	314
9831	6328s (+0.6s)	2552	2552	256	54	152	0	9	215
9832	6329s (+0.6s)	2216	2216	128	62	152	10	0	224
9833	6329s (+0.5s)	1924	1924	128	42	140	6	0	188
9834	6330s (+0.4s)	1408	1408	128	30	110	5	0	145
9835	6330s (+0.5s)	1808	1808	128	45	131	11	0	187
9836	6331s (+0.4s)	1376	1376	128	34	106	3	0	143
9837	6331s (+0.3s)	1028	1028	128	22	87	2	0	111
9838	6332s (+0.8s)	3228	3228	256	59	199	12	0	270
9839	6333s (+0.8s)	3412	3412	256	56	209	12	0	277
9840	6334s (+0.9s)	4036	4036	256	113	199	19	0	331
9841	6334s (+0.4s)	1280	1280	128	31	101	5	0	137
9842	6335s (+0.5s)	1908	1908	128	36	152	7	0	195
9843	6335s (+0.5s)	1876	1876	128	51	131	10	0	192
9844	6336s (+0.4s)	1380	1380	128	28	109	8	0	145
9845	6336s (+0.4s)	1052	1052	64	34	86	6	0	126
9846	6337s (+0.8s)	3272	3272	256	67	194	13	0	274
9847	6337s (+0.5s)	1820	1820	128	39	133	7	0	179
9848	6338s (+0.4s)	1488	1488	128	40	113	5	0	158
9849	6338s (+0.6s)	2592	2592	256	43	163	0	11	217
9850	6339s (+0.9s)	4008	4008	256	68	250	0	14	332
9851	6340s (+0.5s)	1592	1592	128	30	125	0	10	165
9852	6341s (+1.2s)	5808	5808	512	86	313	0	19	418
9853	6341s (+0.3s)	1136	1136	128	20	96	0	5	121
9854	6342s (+0.5s)	1616	1616	128	48	113	10	0	171
9855	6343s (+0.8s)	3312	3312	256	79	177	19	1	276
9856	6343s (+0.9s)	3672	3672	256	88	205	12	0	305
9857	6344s (+0.7s)	2700	2700	256	56	168	10	0	234
9858	6345s (+0.7s)	2868	2868	256	56	185	8	0	249
9859	6345s (+0.6s)	2624	2624	256	53	156	12	0	221
9860	6346s (+0.5s)	1676	1676	128	39	123	9	0	171
9861	6346s (+0.5s)	1828	1828	128	50	121	10	0	181
9862	6347s (+0.9s)	3584	3584	256	74	217	11	0	302
9863	6348s (+0.4s)	1412	1412	128	30	107	9	0	146
9864	6348s (+0.4s)	1480	1480	128	34	118	0	2	154
9865	6349s (+0.5s)	1632	1632	128	36	128	0	11	175
9866	6349s (+0.6s)	2640	2640	256	42	173	0	10	225
9867	6350s (+0.5s)	1840	1840	128	47	135	0	8	190
9868	6350s (+0.4s)	1452	1452	128	23	115	0	10	148
9869	6351s (+0.4s)	1356	1356	128	37	95	8	0	140
9870	6351s (+0.7s)	3020	3020	256	56	178	12	1	247
9871	6352s (+0.5s)	1908	1908	128	39	154	2	0	195
9872	6352s (+0.5s)	1540	1540	128	36	116	9	0	161
9873	6353s (+0.9s)	3768	3768	256	83	219	15	0	317
9874	6354s (+0.9s)	3868	3868	256	81	220	12	0	313
9875	6355s (+0.8s)	3128	3128	256	57	192	12	1	262
9876	6356s (+0.8s)	3484	3484	256	84	201	10	0	295
9877	6356s (+0.6s)	2460	2460	256	60	139	12	0	211
9878	6357s (+0.4s)	1384	1384	128	34	104	1	7	146
9879	6357s (+0.4s)	1488	1488	128	30	118	0	8	156
9880	6358s (+0.3s)	1120	1120	128	28	86	5	0	119
9881	6358s (+0.3s)	840	840	64	26	76	4	0	106
9882	6359s (+0.7s)	3004	3004	256	73	169	9	0	251
9883	6360s (+0.8s)	3424	3424	256	73	200	14	0	287
9884	6360s (+0.8s)	3012	3012	256	78	176	12	1	267
9885	6361s (+0.7s)	2920	2920	256	51	197	8	0	256
9886	6362s (+0.7s)	3012	3012	256	64	174	14	1	253
9887	6362s (+0.7s)	2720	2720	256	50	168	14	0	232
9888	6363s (+0.5s)	1796	1796	128	44	135	6	0	185
9889	6363s (+0.3s)	756	756	64	18	76	4	0	98
9890	6364s (+0.8s)	2988	2988	256	71	185	11	1	268
9891	6365s (+0.8s)	3284	3284	256	56	209	0	13	278
9892	6366s (+0.8s)	3364	3364	256	47	227	0	13	287
9893	6366s (+0.4s)	1416	1416	128	37	105	7	0	149
9894	6367s (+1.0s)	4148	4148	256	83	240	16	0	339
9895	6368s (+0.9s)	3556	3556	256	73	216	13	1	303
9896	6368s (+0.5s)	1592	1592	128	38	119	9	0	166
9897	6369s (+0.3s)	680	680	64	15	71	0	5	91
9898	6369s (+0.4s)	1504	1504	128	36	116	7	0	159
9899	6370s (+0.6s)	2544	2544	256	59	156	7	0	222
Episode	Time	Reward	Score	Highest	L	U	R	D	Steps
9900	6371s (+0.9s)	3584	3584	256	90	201	14	0	305
9901	6371s (+0.3s)	772	772	64	17	85	3	0	105
9902	6371s (+0.5s)	1748	1748	128	39	132	4	0	175
9903	6373s (+1.5s)	7252	7252	512	109	372	0	26	507
9904	6373s (+0.4s)	1384	1384	128	32	105	0	9	146
9905	6374s (+0.5s)	1792	1792	128	42	135	6	0	183
9906	6375s (+0.9s)	3652	3652	256	87	208	16	0	311
9907	6376s (+0.7s)	3348	3348	256	69	197	8	0	274
9908	6376s (+0.7s)	3152	3152	256	66	182	14	0	262
9909	6377s (+0.5s)	1680	1680	128	46	132	4	0	182
9910	6377s (+0.6s)	2380	2380	256	39	150	14	0	203
9911	6378s (+0.3s)	1120	1120	128	23	99	2	0	124
9912	6378s (+0.5s)	1612	1612	128	41	123	6	0	170
9913	6379s (+0.7s)	2776	2776	256	61	166	11	0	238
9914	6379s (+0.5s)	1624	1624	128	44	108	12	0	164
9915	6380s (+0.4s)	1272	1272	64	29	104	9	0	142
9916	6381s (+0.9s)	3588	3588	256	93	198	12	1	304
9917	6381s (+0.6s)	2324	2324	128	57	153	14	0	224
9918	6382s (+0.9s)	4852	4852	512	99	212	20	0	331
9919	6383s (+0.7s)	2476	2476	128	77	141	13	0	231
9920	6384s (+0.6s)	1904	1904	128	41	145	8	0	194
9921	6384s (+0.4s)	1232	1232	128	30	101	5	0	136
9922	6385s (+0.7s)	2728	2728	256	76	145	9	0	230
9923	6385s (+0.6s)	1904	1904	128	45	142	7	0	194
9924	6386s (+0.6s)	2244	2244	128	60	152	12	0	224
9925	6386s (+0.6s)	2516	2516	256	39	172	4	0	215
9926	6387s (+0.9s)	3988	3988	256	82	239	15	0	336
9927	6388s (+0.5s)	1584	1584	128	37	117	9	0	163
9928	6389s (+0.8s)	3548	3548	256	76	204	14	1	295
9929	6389s (+0.5s)	1660	1660	128	31	133	3	0	167
9930	6390s (+0.5s)	1780	1780	128	47	125	7	0	179
9931	6390s (+0.7s)	3056	3056	256	65	182	12	0	259
9932	6391s (+0.9s)	4180	4180	256	83	241	15	0	339
9933	6392s (+1.0s)	4356	4356	256	90	255	17	1	363
9934	6393s (+0.9s)	3608	3608	256	71	214	16	0	301
9935	6394s (+0.4s)	1348	1348	128	34	107	7	0	148
9936	6395s (+0.8s)	3428	3428	256	61	216	10	0	287
9937	6395s (+0.4s)	1324	1324	128	23	104	2	1	130
9938	6396s (+0.6s)	2724	2724	256	60	162	8	0	230
9939	6396s (+0.5s)	1932	1932	128	47	134	7	0	188
9940	6397s (+0.6s)	1908	1908	128	49	141	5	0	195
9941	6398s (+0.9s)	3784	3784	256	77	223	12	0	312
9942	6398s (+0.5s)	1532	1532	128	33	122	6	0	161
9943	6398s (+0.5s)	1736	1736	128	39	128	7	0	174
9944	6399s (+0.7s)	2908	2908	256	49	197	7	0	253
9945	6400s (+0.6s)	2708	2708	256	57	164	9	0	230
9946	6401s (+0.9s)	3920	3920	256	81	227	16	0	324
9947	6401s (+0.4s)	1472	1472	128	29	115	5	0	149
9948	6401s (+0.3s)	748	748	64	21	76	3	0	100
9949	6402s (+0.5s)	2200	2200	256	44	123	16	0	183
9950	6403s (+0.7s)	2808	2808	256	57	177	11	0	245
9951	6403s (+0.4s)	1360	1360	128	47	100	4	0	151
9952	6404s (+0.6s)	2184	2184	128	41	157	7	0	205
9953	6405s (+0.9s)	3528	3528	256	82	202	17	0	301
9954	6406s (+0.9s)	4196	4196	256	88	240	15	0	343
9955	6406s (+0.6s)	2148	2148	128	53	151	12	0	216
9956	6407s (+0.6s)	2476	2476	256	38	159	0	7	204
9957	6407s (+0.8s)	3432	3432	256	55	209	0	20	284
9958	6408s (+0.6s)	2360	2360	256	34	154	1	7	196
9959	6409s (+0.7s)	2492	2492	128	66	151	17	0	234
9960	6409s (+0.3s)	980	980	128	22	80	2	0	104
9961	6410s (+0.6s)	2344	2344	256	40	149	6	0	195
9962	6410s (+0.4s)	1388	1388	128	36	105	6	0	147
9963	6411s (+0.7s)	2680	2680	256	67	153	10	0	230
9964	6411s (+0.5s)	1512	1512	64	50	106	9	0	165
9965	6411s (+0.3s)	708	708	64	19	73	3	0	95
9966	6412s (+0.6s)	2464	2464	256	53	149	10	0	212
9967	6413s (+0.6s)	2392	2392	256	39	155	9	0	203
9968	6413s (+0.5s)	1656	1656	128	36	123	7	0	166
9969	6414s (+0.8s)	3432	3432	256	67	212	10	0	289
9970	6415s (+0.7s)	3128	3128	256	73	172	11	1	257
9971	6415s (+0.7s)	2892	2892	256	59	171	7	0	237
9972	6416s (+0.6s)	2184	2184	128	57	146	14	0	217
9973	6417s (+0.5s)	2192	2192	256	37	145	0	6	188
9974	6417s (+0.4s)	1404	1404	128	32	106	0	9	147
9975	6417s (+0.3s)	1120	1120	128	23	91	0	5	119
9976	6418s (+0.6s)	2516	2516	256	40	172	0	8	220
9977	6419s (+0.9s)	3868	3868	256	55	248	0	8	311
9978	6420s (+0.9s)	4028	4028	256	93	223	15	0	331
9979	6421s (+0.8s)	3676	3676	256	80	208	14	0	302
9980	6421s (+0.8s)	3436	3436	256	62	211	16	2	291
9981	6422s (+0.6s)	2668	2668	256	44	174	9	1	228
9982	6423s (+0.5s)	1920	1920	128	38	151	9	0	198
9983	6423s (+0.6s)	2520	2520	256	52	150	12	0	214
9984	6424s (+0.5s)	1784	1784	128	43	131	7	0	181
9985	6424s (+0.6s)	2480	2480	256	66	142	5	0	213
9986	6425s (+0.7s)	2848	2848	256	51	173	0	9	233
9987	6426s (+0.9s)	3608	3608	256	82	205	18	0	305
9988	6427s (+0.6s)	2512	2512	256	46	160	0	10	216
9989	6427s (+0.5s)	1736	1736	128	54	111	9	0	174
9990	6428s (+0.6s)	2552	2552	256	45	164	0	10	219
9991	6428s (+0.5s)	1784	1784	128	37	135	0	9	181
9992	6429s (+0.8s)	3276	3276	256	73	191	12	1	277
9993	6429s (+0.2s)	616	616	64	28	55	4	0	87
9994	6430s (+0.4s)	1444	1444	128	40	105	6	0	151
9995	6430s (+0.5s)	1780	1780	128	40	132	7	1	180
9996	6431s (+0.5s)	1692	1692	128	45	121	5	0	171
9997	6431s (+0.5s)	1780	1780	128	45	122	12	1	180
9998	6432s (+0.7s)	3236	3236	256	59	200	13	0	272
9999	6432s (+0.5s)	2064	2064	128	39	145	0	9	193
Episode	Time	Reward	Score	Highest	L	U	R	D	Steps
10000	6433s (+0.6s)	2792	2792	256	40	178	0	10	228
10001	6434s (+0.4s)	1068	1068	64	23	94	0	10	127
10002	6434s (+0.5s)	2320	2320	256	40	140	0	10	190
10003	6435s (+0.5s)	1668	1668	128	33	124	0	12	169
10004	6435s (+0.3s)	704	704	64	15	78	1	0	94
10005	6436s (+1.0s)	4364	4364	256	98	246	17	0	361
10006	6436s (+0.5s)	1772	1772	128	47	120	11	0	178
10007	6437s (+0.5s)	1868	1868	128	43	141	6	0	190
10008	6437s (+0.4s)	1184	1184	64	27	96	8	2	133
10009	6438s (+0.5s)	1604	1604	128	40	122	6	0	168
10010	6438s (+0.5s)	1776	1776	128	42	134	8	0	184
10011	6439s (+1.1s)	4908	4908	256	100	249	25	0	374
10012	6440s (+1.0s)	4348	4348	256	96	248	21	0	365
10013	6441s (+0.8s)	3424	3424	256	72	201	14	0	287
10014	6442s (+0.3s)	924	924	64	20	89	3	0	112
10015	6443s (+1.3s)	6408	6408	512	136	289	30	1	456
10016	6444s (+1.0s)	4476	4476	256	92	251	22	0	365
10017	6445s (+0.5s)	1840	1840	128	47	132	11	0	190
10018	6445s (+0.4s)	1308	1308	64	46	93	8	0	147
10019	6445s (+0.3s)	968	968	64	43	68	7	1	119
10020	6447s (+1.4s)	6528	6528	512	127	324	20	0	471
10021	6448s (+0.8s)	3348	3348	256	57	217	10	0	284
10022	6449s (+1.1s)	5508	5508	512	68	307	0	18	393
10023	6450s (+0.8s)	3348	3348	256	67	203	0	13	283
10024	6450s (+0.5s)	1776	1776	128	29	145	0	9	183
10025	6451s (+0.6s)	2644	2644	256	49	166	0	10	225
10026	6452s (+1.0s)	4300	4300	256	96	236	21	0	353
10027	6452s (+0.7s)	2560	2560	128	71	152	14	2	239
10028	6453s (+0.9s)	3644	3644	256	81	217	15	0	313
10029	6454s (+1.0s)	4840	4840	512	83	239	22	0	344
10030	6455s (+0.5s)	1608	1608	128	43	119	7	0	169
10031	6456s (+0.8s)	3272	3272	256	80	183	17	0	280
10032	6456s (+0.7s)	2968	2968	256	57	180	12	0	249
10033	6457s (+0.6s)	1912	1912	128	48	139	9	0	196
10034	6457s (+0.4s)	1212	1212	64	37	107	6	0	150
10035	6458s (+0.4s)	1032	1032	64	24	97	5	0	126
10036	6458s (+0.7s)	2952	2952	256	64	164	13	2	243
10037	6459s (+0.5s)	1820	1820	128	39	145	5	0	189
10038	6460s (+0.7s)	2840	2840	256	48	178	11	0	237
10039	6460s (+0.9s)	3540	3540	256	58	233	0	9	300
10040	6461s (+0.8s)	3348	3348	256	62	211	0	10	283
10041	6462s (+0.4s)	1608	1608	128	36	114	0	9	159
10042	6462s (+0.5s)	1840	1840	128	37	123	0	10	170
10043	6462s (+0.3s)	1116	1116	128	25	92	0	4	121
10044	6463s (+0.7s)	2976	2976	256	45	203	0	7	255
10045	6463s (+0.3s)	964	964	128	17	81	2	0	100
10046	6464s (+0.4s)	1484	1484	128	39	111	6	0	156
10047	6464s (+0.5s)	1620	1620	128	37	130	5	0	172
10048	6465s (+0.9s)	3528	3528	256	82	204	14	1	301
10049	6466s (+0.9s)	4196	4196	256	90	231	18	1	340
10050	6467s (+0.4s)	1476	1476	128	39	107	6	0	152
10051	6467s (+0.6s)	2568	2568	256	49	154	0	13	216
10052	6468s (+0.4s)	1216	1216	64	36	106	0	4	146
10053	6468s (+0.7s)	2880	2880	256	54	182	0	12	248
10054	6469s (+0.8s)	3248	3248	256	50	210	0	15	275
10055	6470s (+0.8s)	3248	3248	256	52	214	0	10	276
10056	6471s (+0.5s)	1720	1720	128	40	124	0	12	176
10057	6471s (+0.7s)	2768	2768	256	49	177	0	10	236
10058	6472s (+0.9s)	3908	3908	256	56	247	0	13	316
10059	6473s (+0.5s)	1512	1512	128	26	128	0	7	161
10060	6473s (+0.8s)	3400	3400	256	64	202	0	20	286
10061	6474s (+0.9s)	3604	3604	256	59	237	0	15	311
10062	6475s (+0.6s)	2332	2332	256	43	139	0	14	196
10063	6476s (+0.8s)	3372	3372	256	81	194	14	0	289
10064	6476s (+0.4s)	1200	1200	64	42	89	6	0	137
10065	6477s (+0.5s)	1612	1612	128	43	123	5	0	171
10066	6477s (+0.8s)	3580	3580	256	84	203	17	0	304
10067	6478s (+0.9s)	3908	3908	256	81	221	15	0	317
10068	6479s (+0.6s)	2208	2208	256	46	141	6	0	193
10069	6480s (+0.9s)	3680	3680	256	80	218	12	0	310
10070	6480s (+0.8s)	3564	3564	256	79	200	15	0	294
10071	6481s (+0.4s)	1572	1572	128	31	119	5	0	155
10072	6482s (+1.1s)	5420	5420	512	110	250	22	1	383
10073	6483s (+0.6s)	2352	2352	256	39	151	7	0	197
10074	6483s (+0.8s)	3220	3220	256	63	208	12	1	284
10075	6484s (+0.9s)	3904	3904	256	81	224	15	0	320
10076	6485s (+0.6s)	1960	1960	128	41	147	9	0	197
10077	6486s (+0.8s)	3420	3420	256	69	216	11	0	296
10078	6487s (+0.9s)	3644	3644	256	68	228	13	0	309
10079	6487s (+0.9s)	3768	3768	256	102	196	18	0	316
10080	6488s (+0.8s)	3272	3272	256	57	199	11	0	267
10081	6489s (+0.9s)	4020	4020	256	76	237	19	0	332
10082	6490s (+0.8s)	3260	3260	256	80	173	19	0	272
10083	6491s (+0.6s)	1916	1916	128	43	145	6	0	194
10084	6491s (+0.5s)	1568	1568	128	43	115	12	0	170
10085	6491s (+0.3s)	964	964	64	38	76	7	1	122
10086	6492s (+0.4s)	1224	1224	64	33	103	4	0	140
10087	6492s (+0.5s)	1780	1780	128	38	135	7	0	180
10088	6493s (+0.6s)	2612	2612	256	61	153	14	0	228
10089	6493s (+0.3s)	708	708	64	22	66	0	7	95
10090	6494s (+0.8s)	3268	3268	256	55	199	0	12	266
10091	6495s (+0.6s)	2548	2548	256	50	158	0	6	214
10092	6495s (+0.5s)	1812	1812	128	38	137	0	12	187
10093	6496s (+1.0s)	5360	5360	512	94	257	0	21	372
10094	6497s (+0.8s)	3456	3456	256	61	219	0	10	290
10095	6498s (+0.8s)	3552	3552	256	69	220	13	0	302
10096	6498s (+0.5s)	1884	1884	128	44	142	7	0	193
10097	6499s (+0.7s)	2856	2856	256	66	168	11	0	245
10098	6500s (+0.8s)	3428	3428	256	92	181	14	1	288
10099	6501s (+1.0s)	5164	5164	512	90	249	15	0	354
Episode	Time	Reward	Score	Highest	L	U	R	D	Steps
10100	6502s (+0.6s)	2508	2508	256	63	141	10	0	214
10101	6502s (+0.6s)	2004	2004	128	50	158	6	0	214
10102	6503s (+0.7s)	3156	3156	256	61	182	11	3	257
10103	6504s (+0.8s)	3476	3476	256	85	196	14	0	295
10104	6504s (+0.4s)	1444	1444	128	33	118	5	0	156
10105	6505s (+0.6s)	2276	2276	128	59	148	10	0	217
10106	6506s (+1.0s)	4220	4220	256	93	232	21	0	346
10107	6506s (+0.5s)	1824	1824	128	51	126	13	0	190
10108	6507s (+0.5s)	1884	1884	128	48	137	9	0	194
10109	6508s (+0.9s)	3772	3772	256	114	173	23	0	310
10110	6508s (+0.3s)	1128	1128	128	33	84	3	0	120
10111	6508s (+0.3s)	1140	1140	128	28	89	6	0	123
10112	6510s (+1.2s)	5812	5812	512	114	286	18	1	419
10113	6511s (+1.0s)	5096	5096	512	105	231	21	0	357
10114	6511s (+0.7s)	2872	2872	256	49	179	7	0	235
10115	6512s (+0.4s)	1128	1128	128	25	92	0	6	123
10116	6513s (+0.8s)	3352	3352	256	56	212	0	16	284
10117	6513s (+0.6s)	2296	2296	256	58	135	0	7	200
10118	6514s (+0.5s)	1800	1800	128	40	138	8	0	186
10119	6515s (+0.9s)	3860	3860	256	91	210	15	0	316
10120	6515s (+0.9s)	3692	3692	256	84	211	14	0	309
10121	6516s (+0.7s)	2596	2596	128	65	165	14	0	244
10122	6517s (+0.4s)	1544	1544	128	35	116	6	0	157
10123	6517s (+0.5s)	2312	2312	256	47	139	7	0	193
10124	6518s (+0.5s)	2192	2192	256	53	127	9	0	189
10125	6519s (+0.8s)	3504	3504	256	77	195	19	0	291
10126	6519s (+0.6s)	2732	2732	256	47	173	12	0	232
10127	6519s (+0.2s)	476	476	32	24	51	1	0	76
10128	6520s (+0.9s)	4008	4008	256	99	197	28	0	324
10129	6521s (+0.5s)	1632	1632	128	40	115	10	0	165
10130	6522s (+0.9s)	3836	3836	256	83	214	16	1	314
10131	6522s (+0.6s)	2124	2124	128	44	151	0	7	202
10132	6523s (+0.4s)	992	992	64	31	87	0	5	123
10133	6523s (+0.2s)	596	596	64	18	58	0	4	80
10134	6523s (+0.5s)	1920	1920	128	49	141	8	0	198
10135	6524s (+0.5s)	1812	1812	128	56	123	8	0	187
10136	6525s (+0.6s)	2696	2696	256	57	164	7	0	228
10137	6525s (+0.5s)	2264	2264	256	42	142	11	0	195
10138	6526s (+0.7s)	2892	2892	256	71	167	16	0	254
10139	6526s (+0.4s)	1056	1056	64	34	90	4	0	128
10140	6527s (+0.5s)	1620	1620	128	34	131	0	7	172
10141	6528s (+0.8s)	3476	3476	256	66	216	0	13	295
10142	6528s (+0.5s)	1696	1696	128	33	140	0	3	176
10143	6528s (+0.3s)	1120	1120	128	24	90	0	5	119
10144	6529s (+0.8s)	3484	3484	256	74	206	11	0	291
10145	6530s (+0.5s)	1568	1568	128	26	132	5	0	163
10146	6530s (+0.6s)	2056	2056	128	58	132	10	2	202
10147	6531s (+0.9s)	3956	3956	256	75	228	17	1	321
10148	6532s (+0.8s)	3248	3248	256	73	189	8	0	270
10149	6533s (+0.7s)	2516	2516	128	72	154	11	0	237
10150	6533s (+0.5s)	1728	1728	128	36	137	6	0	179
10151	6534s (+0.5s)	1840	1840	128	47	126	10	0	183
10152	6534s (+0.5s)	1592	1592	128	48	109	8	0	165
10153	6535s (+0.6s)	2536	2536	256	51	160	10	0	221
10154	6536s (+1.0s)	4428	4428	256	95	247	23	0	365
10155	6537s (+0.8s)	3348	3348	256	79	192	12	0	283
10156	6537s (+0.5s)	1668	1668	128	46	114	8	0	168
10157	6538s (+0.6s)	2436	2436	256	50	149	7	1	207
10158	6538s (+0.5s)	1504	1504	128	33	122	4	0	159
10159	6538s (+0.3s)	600	600	32	17	70	3	0	90
10160	6539s (+0.5s)	1584	1584	128	40	124	5	0	169
10161	6540s (+0.6s)	2500	2500	256	49	161	5	1	216
10162	6541s (+0.9s)	4004	4004	256	98	214	16	0	328
10163	6542s (+1.2s)	6156	6156	512	129	280	24	2	435
10164	6543s (+0.8s)	3360	3360	256	68	199	19	0	286
10165	6543s (+0.7s)	2800	2800	128	74	177	11	0	262
10166	6544s (+0.2s)	648	648	64	19	61	5	1	86
10167	6544s (+0.7s)	2940	2940	256	66	183	12	0	261
10168	6545s (+0.6s)	2028	2028	128	48	137	9	0	194
10169	6546s (+0.6s)	2580	2580	256	49	171	5	0	225
10170	6546s (+0.5s)	1636	1636	128	42	111	8	0	161
10171	6547s (+0.8s)	3520	3520	256	76	206	17	0	299
10172	6548s (+0.6s)	2112	2112	128	58	145	12	0	215
10173	6548s (+0.8s)	3232	3232	256	66	192	14	0	272
10174	6549s (+0.7s)	3100	3100	256	79	162	13	1	255
10175	6550s (+1.0s)	5456	5456	512	87	268	19	1	375
10176	6551s (+0.8s)	2976	2976	256	76	178	11	0	265
10177	6551s (+0.4s)	1220	1220	128	27	99	6	1	133
10178	6552s (+1.1s)	4436	4436	256	90	256	21	0	367
10179	6553s (+0.6s)	2308	2308	128	57	154	9	0	220
10180	6553s (+0.5s)	1640	1640	128	37	127	6	0	170
10181	6554s (+0.4s)	1316	1316	128	30	104	1	6	141
10182	6554s (+0.5s)	2164	2164	256	44	127	0	12	183
10183	6555s (+0.7s)	2928	2928	256	53	193	0	12	258
10184	6556s (+0.6s)	1972	1972	128	55	131	0	11	197
10185	6556s (+0.4s)	1356	1356	128	36	99	0	6	141
10186	6557s (+0.7s)	2784	2784	256	51	177	0	11	239
10187	6557s (+0.4s)	1264	1264	128	26	103	0	7	136
10188	6558s (+0.4s)	1324	1324	128	28	102	0	4	134
10189	6558s (+0.8s)	3472	3472	256	70	208	0	10	288
10190	6559s (+0.6s)	2036	2036	128	49	141	14	0	204
10191	6560s (+0.7s)	2796	2796	256	51	181	10	0	242
10192	6561s (+1.0s)	4240	4240	256	83	245	22	0	350
10193	6561s (+0.8s)	3448	3448	256	58	227	8	0	293
10194	6562s (+0.8s)	3540	3540	256	65	221	12	1	299
10195	6563s (+0.4s)	1440	1440	128	24	124	1	0	149
10196	6563s (+0.5s)	1872	1872	128	57	121	13	0	191
10197	6564s (+0.6s)	2440	2440	256	48	149	9	0	206
10198	6564s (+0.3s)	972	972	64	32	80	4	0	116
10199	6565s (+0.5s)	1740	1740	128	48	127	6	0	181
Episode	Time	Reward	Score	Highest	L	U	R	D	Steps
10200	6565s (+0.3s)	608	608	32	18	68	5	1	92
10201	6566s (+0.7s)	2736	2736	256	45	174	0	13	232
10202	6566s (+0.4s)	1140	1140	64	30	95	0	7	132
10203	6567s (+0.6s)	2280	2280	128	45	154	0	11	210
10204	6567s (+0.4s)	1420	1420	128	25	117	0	2	144
10205	6568s (+0.7s)	3124	3124	256	58	199	0	4	261
10206	6569s (+0.8s)	3496	3496	256	84	186	18	0	288
10207	6569s (+0.7s)	3172	3172	256	55	191	15	0	261
10208	6571s (+1.3s)	5992	5992	512	128	282	26	0	436
10209	6572s (+1.1s)	5568	5568	512	123	243	25	0	391
10210	6572s (+0.5s)	1664	1664	128	33	134	3	0	170
10211	6573s (+0.6s)	1952	1952	128	48	149	9	0	206
10212	6573s (+0.5s)	1712	1712	128	38	132	6	0	176
10213	6574s (+0.9s)	3952	3952	256	95	213	14	0	322
10214	6575s (+0.5s)	1560	1560	128	56	105	7	0	168
10215	6575s (+0.4s)	1292	1292	128	30	104	5	0	139
10216	6576s (+0.6s)	1876	1876	128	57	125	9	0	191
10217	6576s (+0.6s)	1828	1828	128	51	132	8	0	191
10218	6577s (+0.8s)	3408	3408	256	68	204	11	0	283
10219	6578s (+0.6s)	1916	1916	128	54	134	9	0	197
10220	6578s (+0.5s)	1776	1776	128	45	130	4	0	179
10221	6579s (+0.5s)	1780	1780	128	36	138	6	0	180
10222	6579s (+0.5s)	1560	1560	128	41	119	8	0	168
10223	6580s (+0.5s)	1760	1760	128	27	141	0	8	176
10224	6580s (+0.7s)	3124	3124	256	65	186	0	10	261
10225	6581s (+0.4s)	1160	1160	64	28	105	0	4	137
10226	6581s (+0.5s)	1848	1848	128	35	150	0	7	192
10227	6582s (+0.4s)	1204	1204	128	31	93	0	6	130
10228	6582s (+0.6s)	2512	2512	256	37	173	0	8	218
10229	6583s (+0.4s)	1260	1260	128	22	100	0	5	127
10230	6583s (+0.3s)	880	880	64	26	84	5	0	115
10231	6584s (+0.9s)	3564	3564	256	79	200	19	0	298
10232	6584s (+0.4s)	1316	1316	64	35	105	7	1	148
10233	6585s (+0.9s)	4096	4096	256	60	254	0	18	332
10234	6586s (+0.8s)	3496	3496	256	64	209	10	0	283
10235	6587s (+0.7s)	2912	2912	256	62	181	11	0	254
10236	6588s (+0.8s)	3352	3352	256	69	192	13	0	274
10237	6588s (+0.9s)	3640	3640	256	74	218	16	0	308
10238	6589s (+0.7s)	3192	3192	256	57	190	15	0	262
10239	6590s (+0.6s)	2000	2000	128	51	146	9	0	206
10240	6590s (+0.5s)	1568	1568	128	37	123	4	0	164
10241	6591s (+0.6s)	2052	2052	128	57	135	8	0	200
10242	6591s (+0.5s)	1836	1836	128	45	127	9	1	182
10243	6592s (+0.4s)	1344	1344	128	43	95	9	0	147
10244	6592s (+0.6s)	2308	2308	256	52	137	12	0	201
10245	6593s (+0.3s)	732	732	64	21	69	6	0	96
10246	6594s (+0.9s)	4144	4144	256	58	269	0	11	338
10247	6594s (+0.3s)	1104	1104	128	20	92	0	6	118
10248	6595s (+0.7s)	2772	2772	256	52	179	0	5	236
10249	6595s (+0.5s)	1752	1752	128	30	139	0	6	175
10250	6596s (+0.6s)	2524	2524	256	51	159	0	9	219
10251	6596s (+0.4s)	1256	1256	64	28	112	0	5	145
10252	6597s (+0.6s)	2712	2712	256	46	179	0	8	233
10253	6597s (+0.3s)	1008	1008	128	26	75	0	6	107
10254	6597s (+0.4s)	1136	1136	64	32	96	0	5	133
10255	6598s (+0.6s)	2596	2596	256	45	167	0	9	221
10256	6599s (+0.8s)	3536	3536	256	60	222	0	16	298
10257	6600s (+0.7s)	2508	2508	128	74	164	11	0	249
10258	6601s (+0.9s)	3620	3620	256	67	227	10	0	304
10259	6601s (+0.6s)	2352	2352	256	49	139	10	0	198
10260	6602s (+0.9s)	3844	3844	256	83	208	20	1	312
10261	6603s (+0.8s)	3228	3228	256	66	198	9	0	273
10262	6603s (+0.5s)	1896	1896	128	52	133	12	0	197
10263	6604s (+1.0s)	4352	4352	256	108	230	24	0	362
10264	6605s (+0.6s)	2448	2448	256	64	137	8	0	209
10265	6606s (+1.1s)	5732	5732	512	98	271	17	0	386
10266	6607s (+0.7s)	2584	2584	128	69	163	13	0	245
10267	6607s (+0.7s)	2780	2780	256	70	157	11	0	238
10268	6608s (+0.4s)	1400	1400	128	30	116	4	0	150
10269	6609s (+0.8s)	3268	3268	256	70	194	11	0	275
10270	6609s (+0.3s)	1024	1024	64	28	82	5	0	115
10271	6610s (+0.7s)	2764	2764	256	66	162	11	0	239
10272	6610s (+0.5s)	1716	1716	128	57	109	7	0	173
10273	6611s (+0.4s)	1172	1172	64	34	103	3	0	140
10274	6611s (+0.7s)	2596	2596	128	62	170	12	0	244
10275	6612s (+0.4s)	1384	1384	128	33	108	6	0	147
10276	6612s (+0.5s)	1756	1756	128	31	142	0	6	179
10277	6613s (+0.7s)	2824	2824	256	49	181	0	19	249
10278	6613s (+0.3s)	780	780	64	28	68	0	7	103
10279	6614s (+0.8s)	3508	3508	256	64	214	13	0	291
10280	6615s (+0.7s)	2900	2900	256	73	174	9	0	256
10281	6616s (+0.7s)	2860	2860	256	56	177	8	1	242
10282	6617s (+1.1s)	5268	5268	512	81	270	18	0	369
10283	6618s (+1.0s)	4224	4224	256	91	236	19	0	346
10284	6618s (+0.8s)	3312	3312	256	86	182	11	0	279
10285	6619s (+0.7s)	3076	3076	256	61	194	8	1	264
10286	6620s (+0.8s)	3320	3320	256	81	183	16	1	281
10287	6621s (+0.7s)	3120	3120	256	72	176	11	0	259
10288	6621s (+0.4s)	1472	1472	128	36	109	7	0	152
10289	6622s (+0.9s)	4756	4756	512	82	221	18	1	322
10290	6623s (+1.0s)	5372	5372	512	101	250	23	0	374
10291	6624s (+0.5s)	1808	1808	128	49	127	11	0	187
10292	6624s (+0.3s)	876	876	64	27	79	7	1	114
10293	6625s (+0.7s)	3068	3068	256	60	179	12	0	251
10294	6625s (+0.5s)	1660	1660	128	34	130	4	0	168
10295	6626s (+0.5s)	1656	1656	128	47	117	8	0	172
10296	6626s (+0.4s)	1224	1224	128	31	97	6	0	134
10297	6627s (+0.7s)	2804	2804	256	68	166	11	0	245
10298	6628s (+0.9s)	3648	3648	256	90	201	16	0	307
10299	6628s (+0.5s)	1544	1544	128	25	135	5	0	165
Episode	Time	Reward	Score	Highest	L	U	R	D	Steps
10300	6629s (+0.7s)	2780	2780	256	63	167	12	0	242
10301	6629s (+0.7s)	2804	2804	256	59	171	14	0	244
10302	6630s (+0.4s)	1228	1228	128	28	93	8	0	129
10303	6631s (+0.9s)	3860	3860	256	82	221	15	0	318
10304	6631s (+0.6s)	2448	2448	256	49	149	11	0	209
10305	6632s (+0.4s)	1388	1388	128	27	109	5	0	141
10306	6632s (+0.6s)	2784	2784	256	53	163	8	1	225
10307	6633s (+0.9s)	3744	3744	256	69	223	11	0	303
10308	6634s (+0.5s)	1592	1592	128	36	124	6	0	166
10309	6634s (+0.3s)	848	848	64	18	87	3	0	108
10310	6635s (+0.5s)	1664	1664	128	48	110	11	0	169
10311	6635s (+0.4s)	1048	1048	64	26	96	4	0	126
10312	6635s (+0.5s)	1460	1460	128	44	113	6	0	163
10313	6636s (+0.4s)	1200	1200	64	49	85	8	0	142
10314	6637s (+0.7s)	2928	2928	256	60	189	9	0	258
10315	6637s (+0.9s)	3988	3988	256	76	235	11	0	322
10316	6638s (+0.4s)	1432	1432	128	43	94	5	0	142
10317	6638s (+0.3s)	876	876	64	34	78	2	0	114
10318	6639s (+0.7s)	3212	3212	256	57	193	15	2	267
10319	6640s (+0.7s)	2864	2864	256	70	165	12	0	247
10320	6640s (+0.7s)	3048	3048	256	64	183	10	0	257
10321	6641s (+0.3s)	1164	1164	128	25	90	4	0	119
10322	6642s (+0.9s)	3548	3548	256	80	203	19	0	302
10323	6642s (+0.5s)	1828	1828	128	50	132	5	0	187
10324	6642s (+0.3s)	780	780	64	25	70	8	0	103
10325	6643s (+0.4s)	1252	1252	128	24	104	6	0	134
10326	6643s (+0.4s)	1488	1488	128	34	109	13	0	156
10327	6644s (+0.6s)	2420	2420	128	60	156	12	0	228
10328	6645s (+0.8s)	3220	3220	256	65	189	15	0	269
10329	6645s (+0.8s)	3184	3184	256	71	179	14	0	264
10330	6646s (+0.7s)	3112	3112	256	69	177	13	0	259
10331	6647s (+0.4s)	1532	1532	128	36	110	9	0	155
10332	6648s (+1.0s)	5036	5036	512	88	249	21	0	358
10333	6648s (+0.5s)	1800	1800	128	45	132	8	0	185
10334	6649s (+0.7s)	2988	2988	256	54	179	9	1	243
10335	6649s (+0.5s)	1608	1608	128	53	107	9	0	169
10336	6650s (+0.7s)	2388	2388	128	57	162	12	1	232
10337	6651s (+0.8s)	3252	3252	256	73	187	16	0	276
10338	6651s (+0.4s)	1312	1312	128	42	95	7	0	144
10339	6652s (+0.9s)	3632	3632	256	74	216	16	0	306
10340	6653s (+0.7s)	3152	3152	256	69	180	11	0	260
10341	6653s (+0.3s)	824	824	64	25	77	4	0	106
10342	6654s (+0.6s)	2048	2048	128	45	147	5	1	198
10343	6654s (+0.7s)	2708	2708	256	50	170	0	13	233
10344	6655s (+0.5s)	1548	1548	128	42	109	0	9	160
10345	6656s (+0.7s)	3140	3140	256	58	194	0	9	261
10346	6656s (+0.8s)	3496	3496	256	59	222	0	11	292
10347	6657s (+0.2s)	648	648	64	10	75	0	1	86
10348	6657s (+0.8s)	3220	3220	256	56	206	0	7	269
10349	6658s (+0.3s)	1132	1132	128	24	93	0	4	121
10350	6659s (+0.8s)	3336	3336	256	70	199	12	0	281
10351	6659s (+0.4s)	1468	1468	128	37	107	8	0	152
10352	6660s (+0.6s)	2292	2292	128	53	147	13	1	214
10353	6660s (+0.5s)	1668	1668	128	50	120	9	0	179
10354	6661s (+0.9s)	3704	3704	256	80	217	15	0	312
10355	6661s (+0.4s)	1384	1384	128	38	101	5	1	145
10356	6662s (+0.6s)	1920	1920	128	39	154	5	0	198
10357	6663s (+0.6s)	2448	2448	256	79	116	14	0	209
10358	6663s (+0.7s)	2932	2932	256	68	177	8	0	253
10359	6664s (+0.7s)	2772	2772	256	53	175	13	0	241
10360	6665s (+0.5s)	1788	1788	128	44	131	7	0	182
10361	6665s (+0.8s)	3436	3436	256	61	213	16	0	290
10362	6666s (+0.5s)	1780	1780	128	42	130	8	0	180
10363	6667s (+0.6s)	2248	2248	128	63	130	17	0	210
10364	6668s (+1.0s)	4176	4176	256	90	226	23	0	339
10365	6668s (+0.8s)	3340	3340	256	51	212	0	9	272
10366	6669s (+0.8s)	3460	3460	256	72	198	0	16	286
10367	6670s (+0.7s)	2920	2920	256	51	192	0	13	256
10368	6671s (+1.0s)	4240	4240	256	67	260	0	23	350
10369	6672s (+0.8s)	3412	3412	256	75	192	13	0	280
10370	6672s (+0.7s)	2896	2896	256	56	187	7	0	250
10371	6673s (+0.6s)	2072	2072	128	52	145	12	0	209
10372	6674s (+0.6s)	2488	2488	256	44	163	7	0	214
10373	6674s (+0.8s)	3460	3460	256	80	198	17	0	295
10374	6675s (+0.6s)	2112	2112	128	58	133	9	0	200
10375	6675s (+0.4s)	1488	1488	128	40	106	9	1	156
10376	6677s (+1.2s)	5684	5684	512	131	261	22	0	414
10377	6677s (+0.8s)	3212	3212	256	69	185	16	1	271
10378	6678s (+0.6s)	2544	2544	256	48	153	11	1	213
10379	6679s (+0.5s)	2172	2172	256	34	142	8	0	184
10380	6679s (+0.6s)	2252	2252	128	60	153	9	0	222
10381	6680s (+0.4s)	1428	1428	128	38	103	6	0	147
10382	6680s (+0.8s)	3216	3216	256	58	200	10	0	268
10383	6681s (+0.3s)	1020	1020	128	26	79	4	0	109
10384	6681s (+0.3s)	668	668	64	23	63	5	0	91
10385	6681s (+0.5s)	1620	1620	128	46	119	7	0	172
10386	6682s (+0.6s)	1908	1908	128	44	149	7	0	200
10387	6683s (+0.5s)	1828	1828	128	53	128	6	0	187
10388	6683s (+0.5s)	1832	1832	128	50	134	5	0	189
10389	6684s (+0.5s)	2076	2076	256	34	133	9	0	176
10390	6684s (+0.6s)	2464	2464	256	44	160	8	0	212
10391	6685s (+0.6s)	2320	2320	128	63	147	13	0	223
10392	6686s (+0.9s)	3888	3888	256	74	219	18	0	311
10393	6686s (+0.3s)	940	940	64	24	84	7	0	115
10394	6687s (+0.6s)	2412	2412	128	46	164	0	16	226
10395	6688s (+0.7s)	3228	3228	256	54	198	0	14	266
10396	6688s (+0.5s)	1700	1700	128	31	129	0	7	167
10397	6689s (+0.5s)	1892	1892	128	41	148	0	2	191
10398	6689s (+0.5s)	1784	1784	128	37	131	1	5	174
10399	6690s (+0.5s)	1692	1692	128	36	130	9	0	175
Episode	Time	Reward	Score	Highest	L	U	R	D	Steps
10400	6690s (+0.9s)	3620	3620	256	82	207	14	0	303
10401	6691s (+0.3s)	872	872	64	27	78	5	0	110
10402	6691s (+0.6s)	2688	2688	256	47	156	8	0	211
10403	6692s (+0.3s)	848	848	64	20	84	5	0	109
10404	6692s (+0.5s)	1804	1804	128	47	133	6	0	186
10405	6693s (+0.5s)	1876	1876	128	45	143	4	0	192
10406	6694s (+0.9s)	4068	4068	256	99	219	18	1	337
10407	6694s (+0.4s)	1472	1472	128	37	113	2	0	152
10408	6695s (+0.8s)	3852	3852	256	61	232	12	0	305
10409	6696s (+0.7s)	2780	2780	256	50	184	5	0	239
10410	6696s (+0.4s)	1184	1184	128	38	86	5	0	129
10411	6697s (+0.4s)	1396	1396	128	28	113	8	0	149
10412	6697s (+0.3s)	788	788	64	26	75	4	0	105
10413	6697s (+0.4s)	1448	1448	128	47	94	10	0	151
10414	6698s (+0.5s)	1864	1864	128	46	136	7	1	190
10415	6698s (+0.4s)	1240	1240	128	28	105	4	0	137
10416	6699s (+1.0s)	4256	4256	256	102	225	21	0	348
10417	6700s (+0.8s)	3380	3380	256	51	222	0	13	286
10418	6700s (+0.4s)	1168	1168	128	23	99	0	3	125
10419	6701s (+0.3s)	992	992	64	17	94	0	7	118
10420	6701s (+0.5s)	1804	1804	128	30	131	0	11	172
10421	6702s (+0.4s)	1496	1496	128	37	114	6	1	158
10422	6702s (+0.4s)	1396	1396	128	29	109	7	0	145
10423	6702s (+0.3s)	864	864	64	27	79	6	0	112
10424	6703s (+0.8s)	3420	3420	256	71	201	14	0	286
10425	6704s (+0.6s)	2600	2600	256	60	157	7	1	225
10426	6705s (+0.7s)	2700	2700	256	55	171	7	0	233
10427	6706s (+1.0s)	4308	4308	256	99	237	19	0	355
10428	6706s (+0.8s)	3488	3488	256	70	204	20	1	295
10429	6707s (+0.6s)	2500	2500	256	52	155	8	1	216
10430	6708s (+0.7s)	2856	2856	256	62	169	15	0	246
10431	6708s (+0.4s)	1224	1224	64	44	96	8	0	148
10432	6708s (+0.3s)	720	720	64	16	78	0	0	94
10433	6709s (+0.2s)	672	672	64	16	68	3	0	87
10434	6709s (+0.5s)	2292	2292	256	44	140	9	0	193
10435	6710s (+0.5s)	1844	1844	128	49	128	8	0	185
10436	6711s (+1.2s)	5612	5612	512	89	294	0	18	401
10437	6712s (+0.8s)	3264	3264	256	72	195	0	11	278
10438	6712s (+0.3s)	760	760	64	18	79	0	6	103
10439	6713s (+0.7s)	2844	2844	256	54	185	0	11	250
10440	6713s (+0.7s)	2912	2912	256	48	201	0	6	255
10441	6714s (+0.4s)	1068	1068	64	39	83	6	0	128
10442	6714s (+0.6s)	1968	1968	128	51	139	9	0	199
10443	6715s (+0.8s)	3380	3380	256	60	222	9	0	291
10444	6716s (+0.8s)	3504	3504	256	63	214	11	0	288
10445	6717s (+0.5s)	1776	1776	128	37	138	8	0	183
10446	6717s (+0.8s)	3368	3368	256	72	203	13	0	288
10447	6718s (+0.6s)	2468	2468	256	48	155	9	0	212
10448	6718s (+0.5s)	1616	1616	128	51	104	6	0	161
10449	6719s (+0.8s)	3348	3348	256	70	205	8	0	283
10450	6720s (+0.8s)	3440	3440	256	73	202	16	0	291
10451	6721s (+0.8s)	3468	3468	256	65	221	7	0	293
10452	6721s (+0.5s)	1740	1740	128	34	136	6	0	176
10453	6722s (+0.5s)	1884	1884	128	43	132	11	0	186
10454	6723s (+0.9s)	3728	3728	256	82	208	19	0	309
10455	6723s (+0.3s)	1156	1156	128	25	94	7	0	126
10456	6724s (+0.5s)	1728	1728	128	48	119	12	0	179
10457	6724s (+0.7s)	2928	2928	256	70	164	10	0	244
10458	6725s (+0.8s)	3228	3228	256	60	195	15	0	270
10459	6726s (+0.8s)	3492	3492	256	99	178	15	0	292
10460	6727s (+0.8s)	3152	3152	256	81	180	13	0	274
10461	6727s (+0.4s)	1408	1408	128	22	117	4	0	143
10462	6728s (+0.7s)	3060	3060	256	56	193	11	0	260
10463	6728s (+0.5s)	1712	1712	128	37	131	10	0	178
10464	6729s (+0.8s)	3196	3196	256	67	184	16	0	267
10465	6730s (+0.5s)	1772	1772	128	36	138	0	8	182
10466	6730s (+0.5s)	1772	1772	128	39	131	0	10	180
10467	6731s (+0.5s)	1812	1812	128	32	149	0	7	188
10468	6732s (+1.0s)	5036	5036	512	104	222	18	0	344
10469	6733s (+1.1s)	5388	5388	512	102	255	23	0	380
10470	6733s (+0.5s)	1816	1816	128	43	135	10	0	188
10471	6734s (+0.7s)	3104	3104	256	58	186	11	0	255
10472	6735s (+1.1s)	5420	5420	512	101	257	18	0	376
10473	6736s (+0.5s)	1768	1768	128	50	126	5	0	181
10474	6736s (+0.5s)	2048	2048	256	31	130	6	0	167
10475	6737s (+0.7s)	2908	2908	256	51	196	6	0	253
10476	6737s (+0.5s)	1656	1656	128	41	116	11	0	168
10477	6738s (+0.8s)	3188	3188	256	79	172	14	0	265
10478	6739s (+0.8s)	3240	3240	256	56	206	11	0	273
10479	6740s (+0.8s)	3744	3744	256	85	209	17	0	311
10480	6741s (+0.7s)	2532	2532	128	69	155	12	0	236
10481	6741s (+0.5s)	1604	1604	128	41	116	10	0	167
10482	6743s (+1.5s)	7604	7604	512	148	359	27	0	534
10483	6743s (+0.5s)	1756	1756	128	43	129	7	0	179
10484	6744s (+0.6s)	2436	2436	256	41	157	7	0	205
10485	6744s (+0.5s)	1804	1804	128	43	137	6	0	186
10486	6745s (+0.6s)	2520	2520	128	51	168	11	1	231
10487	6746s (+0.8s)	3448	3448	256	76	194	16	0	286
10488	6746s (+0.2s)	620	620	64	22	56	6	1	85
10489	6747s (+0.5s)	1864	1864	128	39	138	11	1	189
10490	6747s (+0.5s)	1676	1676	128	38	124	9	0	171
10491	6748s (+0.7s)	2848	2848	256	64	168	12	0	244
10492	6749s (+0.9s)	4052	4052	256	72	236	14	0	322
10493	6749s (+0.3s)	920	920	128	21	74	4	1	100
10494	6750s (+0.5s)	1608	1608	128	43	109	11	0	163
10495	6750s (+0.4s)	1156	1156	128	21	95	0	7	123
10496	6750s (+0.3s)	844	844	64	32	67	0	8	107
10497	6751s (+0.9s)	3808	3808	256	78	225	0	15	318
10498	6752s (+0.8s)	3236	3236	256	52	206	0	13	271
10499	6753s (+0.6s)	2172	2172	128	47	146	15	0	208
Episode	Time	Reward	Score	Highest	L	U	R	D	Steps
10500	6753s (+0.7s)	2812	2812	256	66	164	9	0	239
10501	6754s (+0.5s)	2056	2056	256	42	124	7	0	173
10502	6754s (+0.5s)	1496	1496	64	41	108	12	1	162
10503	6755s (+0.7s)	2784	2784	256	60	165	9	1	235
10504	6755s (+0.5s)	1608	1608	128	37	121	11	0	169
10505	6756s (+0.4s)	1324	1324	128	27	104	2	0	133
10506	6756s (+0.7s)	2720	2720	256	52	174	7	0	233
10507	6757s (+0.8s)	3540	3540	256	74	217	10	0	301
10508	6758s (+0.3s)	740	740	64	21	73	4	0	98
10509	6758s (+0.5s)	1816	1816	128	42	139	7	0	188
10510	6759s (+0.5s)	1488	1488	128	31	114	0	11	156
10511	6759s (+0.7s)	2752	2752	256	52	174	0	7	233
10512	6760s (+0.4s)	1484	1484	128	25	126	0	5	156
10513	6760s (+0.8s)	3240	3240	256	57	195	0	15	267
10514	6761s (+0.5s)	1920	1920	128	31	146	0	7	184
10515	6762s (+0.7s)	2680	2680	256	50	172	9	0	231
10516	6762s (+0.7s)	2816	2816	256	56	181	10	0	247
10517	6763s (+0.9s)	4112	4112	256	86	232	17	0	335
10518	6764s (+0.4s)	1552	1552	128	39	110	7	0	156
10519	6765s (+1.1s)	5396	5396	512	96	260	24	0	380
10520	6766s (+1.3s)	6804	6804	512	152	289	26	1	468
10521	6767s (+0.8s)	3504	3504	256	83	195	17	0	295
10522	6767s (+0.5s)	1760	1760	128	54	114	9	0	177
10523	6768s (+0.5s)	1868	1868	128	59	121	10	0	190
10524	6769s (+0.7s)	2748	2748	256	76	148	11	0	235
10525	6769s (+0.6s)	2188	2188	128	64	143	10	0	217
10526	6770s (+0.6s)	1932	1932	128	51	139	11	0	201
10527	6771s (+0.6s)	2656	2656	256	54	164	7	0	225
10528	6771s (+0.5s)	1820	1820	128	50	128	12	0	190
10529	6772s (+0.7s)	2488	2488	128	58	165	9	1	233
10530	6772s (+0.3s)	920	920	64	27	76	7	0	110
10531	6773s (+0.8s)	3424	3424	256	68	199	13	0	280
10532	6773s (+0.6s)	1924	1924	128	42	149	8	0	199
10533	6774s (+0.7s)	2748	2748	256	46	179	9	1	235
10534	6775s (+0.5s)	1588	1588	128	38	119	8	0	165
10535	6775s (+0.4s)	1376	1376	128	31	107	0	6	144
10536	6776s (+0.5s)	1688	1688	128	42	119	0	8	169
10537	6776s (+0.9s)	3964	3964	256	61	247	0	18	326
10538	6777s (+0.3s)	972	972	64	26	83	0	8	117
10539	6777s (+0.6s)	2476	2476	256	44	161	0	17	222
10540	6778s (+0.4s)	1524	1524	128	29	122	0	8	159
10541	6779s (+0.7s)	2960	2960	256	39	213	0	9	261
10542	6779s (+0.3s)	976	976	128	14	85	4	0	103
10543	6780s (+0.8s)	3640	3640	256	72	209	13	0	294
10544	6780s (+0.6s)	1988	1988	128	51	138	13	1	203
10545	6781s (+0.8s)	3612	3612	256	67	212	12	0	291
10546	6782s (+0.8s)	3528	3528	256	77	207	14	0	298
10547	6783s (+0.6s)	2532	2532	256	60	151	9	0	220
10548	6783s (+0.7s)	3096	3096	256	73	163	17	1	254
10549	6784s (+0.8s)	3376	3376	256	84	184	22	0	290
10550	6784s (+0.3s)	792	792	64	20	78	5	0	103
10551	6785s (+0.7s)	3064	3064	256	70	181	10	0	261
10552	6786s (+0.8s)	3400	3400	256	68	198	14	0	280
10553	6787s (+0.6s)	2248	2248	128	60	149	16	0	225
10554	6787s (+0.5s)	1700	1700	128	46	117	13	0	176
10555	6788s (+1.2s)	5976	5976	512	117	291	20	0	428
10556	6789s (+0.7s)	2912	2912	256	61	180	13	0	254
10557	6790s (+0.6s)	2652	2652	256	60	153	9	1	223
10558	6790s (+0.6s)	2336	2336	256	47	145	11	0	203
10559	6791s (+0.8s)	3472	3472	256	83	186	18	0	287
10560	6792s (+0.5s)	1616	1616	128	53	101	7	0	161
10561	6792s (+0.4s)	1164	1164	128	30	93	4	0	127
10562	6792s (+0.5s)	1820	1820	128	49	122	12	0	183
10563	6793s (+0.6s)	2440	2440	256	45	153	9	0	207
10564	6794s (+0.7s)	2920	2920	256	67	176	13	0	256
10565	6795s (+0.8s)	3352	3352	256	82	179	14	0	275
10566	6796s (+1.0s)	4332	4332	256	81	265	15	0	361
10567	6797s (+1.3s)	6680	6680	512	134	311	24	1	470
10568	6797s (+0.4s)	1424	1424	128	30	115	6	0	151
10569	6798s (+0.7s)	3228	3228	256	68	186	16	0	270
10570	6799s (+0.9s)	3816	3816	256	83	216	16	0	315
10571	6799s (+0.3s)	952	952	64	31	81	6	0	118
10572	6800s (+0.7s)	3060	3060	256	50	196	5	0	251
10573	6801s (+0.5s)	1796	1796	128	39	135	10	0	184
10574	6801s (+0.8s)	3380	3380	256	69	193	13	2	277
10575	6802s (+0.5s)	1680	1680	128	28	136	3	0	167
10576	6803s (+0.7s)	2544	2544	128	67	163	12	0	242
10577	6803s (+0.7s)	2844	2844	256	53	180	9	0	242
10578	6804s (+0.5s)	2168	2168	256	46	124	7	0	177
10579	6804s (+0.3s)	1128	1128	128	23	91	5	0	119
10580	6805s (+0.5s)	1784	1784	128	36	138	7	0	181
10581	6805s (+0.8s)	3272	3272	256	79	186	11	0	276
10582	6806s (+0.6s)	2704	2704	256	68	144	14	0	226
10583	6807s (+0.8s)	3224	3224	256	64	195	10	0	269
10584	6807s (+0.4s)	1504	1504	128	42	105	8	0	155
10585	6808s (+0.6s)	2432	2432	256	35	161	9	0	205
10586	6808s (+0.4s)	1280	1280	64	50	89	8	0	147
10587	6809s (+0.4s)	1376	1376	128	46	92	7	0	145
10588	6809s (+0.6s)	2628	2628	256	60	155	7	0	222
10589	6810s (+0.8s)	3532	3532	256	90	182	18	1	291
10590	6811s (+0.4s)	1416	1416	128	27	116	6	0	149
10591	6811s (+0.4s)	1072	1072	64	34	91	6	0	131
10592	6811s (+0.5s)	1496	1496	128	29	123	6	0	158
10593	6812s (+0.8s)	3356	3356	256	62	212	11	0	285
10594	6813s (+0.7s)	2896	2896	256	52	180	0	9	241
10595	6813s (+0.3s)	1088	1088	128	27	85	0	6	118
10596	6814s (+0.8s)	3460	3460	256	72	209	14	0	295
10597	6815s (+0.6s)	2240	2240	128	65	134	16	0	215
10598	6815s (+0.4s)	1300	1300	128	22	105	4	0	131
10599	6816s (+0.7s)	3120	3120	256	57	184	12	0	253
Episode	Time	Reward	Score	Highest	L	U	R	D	Steps
10600	6817s (+0.7s)	2800	2800	256	65	167	10	0	242
10601	6817s (+0.7s)	2940	2940	256	68	182	11	0	261
10602	6818s (+0.5s)	1728	1728	128	42	125	6	0	173
10603	6819s (+0.8s)	3208	3208	256	58	198	14	0	270
10604	6819s (+0.7s)	2900	2900	256	54	182	7	0	243
10605	6820s (+0.6s)	2080	2080	128	65	134	11	0	210
10606	6820s (+0.4s)	1136	1136	128	33	88	6	0	127
10607	6821s (+0.7s)	2928	2928	256	75	171	12	0	258
10608	6822s (+0.6s)	1868	1868	128	47	145	5	0	197
10609	6822s (+0.3s)	1036	1036	64	40	77	6	0	123
10610	6822s (+0.4s)	1336	1336	128	33	97	6	0	136
10611	6823s (+0.6s)	2596	2596	256	54	157	12	1	224
10612	6823s (+0.3s)	708	708	64	25	71	4	0	100
10613	6824s (+0.8s)	3496	3496	256	63	220	10	0	293
10614	6825s (+0.5s)	1584	1584	128	31	128	6	0	165
10615	6825s (+0.4s)	1492	1492	128	28	123	5	0	156
10616	6826s (+0.5s)	1792	1792	128	51	122	10	0	183
10617	6826s (+0.8s)	3012	3012	256	50	207	0	10	267
10618	6827s (+0.4s)	1540	1540	128	41	112	0	5	158
10619	6827s (+0.4s)	1000	1000	64	27	92	0	5	124
10620	6828s (+0.5s)	1508	1508	128	37	116	0	7	160
10621	6828s (+0.5s)	1808	1808	128	32	148	0	7	187
10622	6829s (+0.3s)	1148	1148	64	19	99	0	8	126
10623	6829s (+0.7s)	2588	2588	128	58	173	14	1	246
10624	6830s (+0.7s)	3108	3108	256	49	197	11	0	257
10625	6830s (+0.5s)	1456	1456	128	45	106	7	0	158
10626	6831s (+0.9s)	3708	3708	256	73	229	15	0	317
10627	6832s (+0.5s)	1644	1644	128	44	119	5	0	168
10628	6833s (+0.8s)	3552	3552	256	82	201	14	0	297
10629	6833s (+0.5s)	1796	1796	128	53	126	5	0	184
10630	6834s (+0.9s)	3984	3984	256	70	240	14	1	325
10631	6835s (+0.7s)	3032	3032	256	65	187	10	0	262
10632	6835s (+0.5s)	1836	1836	128	50	122	13	1	186
10633	6836s (+0.5s)	2200	2200	256	39	140	8	0	187
10634	6836s (+0.5s)	1508	1508	128	34	120	0	6	160
10635	6837s (+0.5s)	1728	1728	128	35	127	8	1	171
10636	6837s (+0.6s)	2360	2360	256	40	154	6	0	200
10637	6838s (+0.8s)	2844	2844	128	70	180	16	0	266
10638	6839s (+0.6s)	2192	2192	128	62	140	17	0	219
10639	6840s (+0.8s)	3308	3308	256	85	185	9	0	279
10640	6840s (+0.5s)	1712	1712	128	33	134	0	6	173
10641	6841s (+0.9s)	4052	4052	256	66	251	0	17	334
10642	6842s (+0.5s)	1844	1844	128	49	122	5	8	184
10643	6842s (+0.6s)	2716	2716	256	38	174	0	10	222
10644	6843s (+0.7s)	3224	3224	256	46	213	0	11	270
10645	6843s (+0.4s)	1464	1464	128	31	115	1	4	151
10646	6844s (+0.6s)	1900	1900	128	48	139	0	7	194
10647	6845s (+0.5s)	1768	1768	128	37	134	0	6	177
10648	6845s (+0.8s)	3284	3284	256	61	201	0	12	274
10649	6846s (+0.5s)	1440	1440	128	36	114	9	0	159
10650	6846s (+0.4s)	1148	1148	128	32	90	4	0	126
10651	6847s (+0.9s)	3820	3820	256	77	216	17	1	311
10652	6848s (+0.8s)	3416	3416	256	74	204	7	0	285
10653	6849s (+1.4s)	7028	7028	512	128	328	26	1	483
10654	6850s (+0.5s)	1756	1756	128	39	130	9	0	178
10655	6851s (+0.6s)	2424	2424	256	46	156	8	0	210
10656	6851s (+0.4s)	1464	1464	128	46	92	12	0	150
10657	6852s (+0.8s)	3380	3380	256	66	213	12	0	291
10658	6853s (+0.8s)	3468	3468	256	60	221	11	1	293
10659	6853s (+0.7s)	2912	2912	256	69	170	16	0	255
10660	6854s (+0.5s)	1544	1544	128	43	112	10	0	165
10661	6854s (+0.5s)	1708	1708	128	30	129	9	0	168
10662	6855s (+0.5s)	1800	1800	128	50	122	12	0	184
10663	6856s (+0.8s)	3636	3636	256	70	215	10	1	296
10664	6857s (+0.9s)	3876	3876	256	89	223	12	1	325
10665	6857s (+0.8s)	3200	3200	256	53	201	13	1	268
10666	6858s (+1.0s)	5312	5312	512	91	249	18	0	358
10667	6859s (+0.4s)	1356	1356	128	30	102	7	1	140
10668	6860s (+1.0s)	4232	4232	256	97	235	17	0	349
10669	6860s (+0.4s)	1080	1080	64	36	84	7	0	127
10670	6861s (+0.5s)	1804	1804	128	45	133	7	0	185
10671	6861s (+0.7s)	2836	2836	256	70	160	15	0	245
10672	6862s (+1.0s)	4476	4476	256	98	226	22	0	346
10673	6863s (+0.4s)	1036	1036	64	33	89	2	0	124
10674	6863s (+0.3s)	652	652	64	18	71	3	0	92
10675	6863s (+0.3s)	620	620	64	20	63	2	0	85
10676	6864s (+0.5s)	1792	1792	128	54	117	11	0	182
10677	6865s (+0.9s)	3796	3796	256	68	229	8	0	305
10678	6865s (+0.3s)	700	700	64	29	59	4	0	92
10679	6866s (+0.5s)	1656	1656	128	47	122	7	0	176
10680	6866s (+0.6s)	2460	2460	256	41	158	12	0	211
10681	6867s (+0.9s)	3872	3872	256	95	191	21	0	307
10682	6868s (+0.6s)	2400	2400	128	72	138	13	0	223
10683	6868s (+0.5s)	1804	1804	128	40	142	3	0	185
10684	6869s (+0.3s)	852	852	64	30	72	7	0	109
10685	6869s (+0.5s)	1800	1800	128	40	135	9	0	184
10686	6870s (+0.6s)	2728	2728	256	68	147	14	0	229
10687	6870s (+0.5s)	1752	1752	128	34	138	8	0	180
10688	6871s (+0.6s)	1944	1944	128	45	151	8	0	204
10689	6872s (+0.7s)	3152	3152	256	69	176	15	0	260
10690	6872s (+0.6s)	2112	2112	128	42	150	7	1	200
10691	6873s (+0.5s)	1508	1508	128	33	121	6	0	160
10692	6873s (+0.5s)	1852	1852	128	49	131	10	0	190
10693	6874s (+0.6s)	2504	2504	256	45	154	12	0	211
10694	6874s (+0.6s)	2592	2592	256	57	161	10	0	228
10695	6875s (+1.0s)	4328	4328	256	84	258	19	0	361
10696	6876s (+0.6s)	2328	2328	256	56	133	6	0	195
10697	6876s (+0.4s)	1296	1296	128	35	102	3	0	140
10698	6877s (+0.6s)	2524	2524	256	52	161	6	0	219
10699	6878s (+0.6s)	2332	2332	128	65	137	10	0	212
Episode	Time	Reward	Score	Highest	L	U	R	D	Steps
10700	6878s (+0.6s)	2376	2376	256	38	157	6	0	201
10701	6879s (+0.5s)	1736	1736	128	44	121	8	0	173
10702	6879s (+0.5s)	1664	1664	128	45	117	7	0	169
10703	6880s (+0.8s)	3180	3180	256	74	180	9	0	263
10704	6880s (+0.4s)	1492	1492	128	33	117	0	8	158
10705	6881s (+0.6s)	2276	2276	256	45	143	0	9	197
10706	6881s (+0.5s)	1636	1636	128	35	122	0	8	165
10707	6882s (+0.3s)	1012	1012	64	21	94	0	7	122
10708	6882s (+0.4s)	1500	1500	128	39	112	0	7	158
10709	6883s (+0.6s)	2480	2480	256	50	149	12	1	212
10710	6884s (+0.6s)	2616	2616	256	51	169	8	0	228
10711	6884s (+0.4s)	1036	1036	64	29	93	4	1	127
10712	6885s (+1.1s)	5816	5816	512	117	263	19	0	399
10713	6886s (+0.7s)	2356	2356	128	59	156	13	0	228
10714	6887s (+0.8s)	3464	3464	256	55	225	10	0	290
10715	6887s (+0.8s)	3392	3392	256	73	191	16	0	280
10716	6888s (+0.6s)	1900	1900	128	53	135	10	0	198
10717	6889s (+0.7s)	2800	2800	256	56	174	12	0	242
10718	6889s (+0.5s)	1624	1624	128	32	127	4	0	163
10719	6889s (+0.3s)	1016	1016	64	25	93	4	0	122
10720	6890s (+0.5s)	1632	1632	128	46	113	5	0	164
10721	6891s (+0.7s)	2976	2976	256	59	177	14	0	250
10722	6891s (+0.5s)	1588	1588	128	37	123	4	0	164
10723	6892s (+1.0s)	4172	4172	256	82	247	0	16	345
10724	6893s (+0.5s)	1592	1592	128	44	113	0	8	165
10725	6893s (+0.6s)	2544	2544	256	56	154	0	9	219
10726	6894s (+0.8s)	3508	3508	256	73	205	0	17	295
10727	6894s (+0.4s)	1320	1320	128	23	111	0	4	138
10728	6895s (+0.8s)	3408	3408	256	70	202	0	15	287
10729	6896s (+0.8s)	3364	3364	256	66	187	0	25	278
10730	6897s (+0.8s)	3212	3212	256	52	205	0	10	267
10731	6897s (+0.3s)	872	872	64	22	86	0	6	114
10732	6898s (+0.8s)	3040	3040	256	57	203	0	10	270
10733	6899s (+0.7s)	3108	3108	256	55	182	0	14	251
10734	6899s (+0.3s)	724	724	64	21	70	0	4	95
10735	6899s (+0.3s)	784	784	64	23	75	0	6	104
10736	6900s (+0.4s)	1328	1328	128	30	114	0	3	147
10737	6900s (+0.8s)	3424	3424	256	78	195	14	0	287
10738	6901s (+0.5s)	1656	1656	128	41	116	9	0	166
10739	6902s (+1.0s)	4216	4216	256	94	232	18	0	344
10740	6903s (+0.8s)	3532	3532	256	63	224	11	0	298
10741	6903s (+0.5s)	2060	2060	128	49	129	14	0	192
10742	6904s (+0.5s)	1736	1736	128	40	130	5	0	175
10743	6904s (+0.4s)	1340	1340	128	35	102	9	0	146
10744	6905s (+0.6s)	2304	2304	128	55	156	7	1	219
10745	6906s (+0.8s)	2900	2900	128	87	165	20	0	272
10746	6907s (+0.8s)	3496	3496	256	69	210	15	0	294
10747	6907s (+0.4s)	1408	1408	128	37	107	7	0	151
10748	6908s (+0.7s)	3072	3072	256	50	194	10	0	254
10749	6908s (+0.6s)	2252	2252	128	67	133	16	2	218
10750	6909s (+0.4s)	1324	1324	128	35	100	7	0	142
10751	6909s (+0.3s)	1112	1112	128	18	92	6	0	116
10752	6910s (+0.6s)	1920	1920	128	53	137	8	0	198
10753	6910s (+0.3s)	912	912	64	31	72	7	0	110
10754	6911s (+0.6s)	2144	2144	128	58	139	17	0	214
10755	6911s (+0.3s)	1092	1092	128	25	88	5	0	118
10756	6911s (+0.5s)	1604	1604	128	43	117	8	0	168
10757	6912s (+0.4s)	1024	1024	64	24	95	0	5	124
10758	6912s (+0.3s)	568	568	32	17	65	0	4	86
10759	6912s (+0.3s)	1060	1060	128	25	85	0	4	114
10760	6913s (+0.9s)	3556	3556	256	68	222	0	13	303
10761	6914s (+0.5s)	1736	1736	128	33	119	0	8	160
10762	6914s (+0.3s)	1040	1040	64	21	96	0	4	121
10763	6915s (+0.5s)	1836	1836	128	41	132	0	10	183
10764	6915s (+0.8s)	3376	3376	256	72	202	9	0	283
10765	6916s (+1.1s)	4548	4548	256	107	255	16	0	378
10766	6917s (+0.5s)	1492	1492	128	38	113	5	1	157
10767	6918s (+0.8s)	3208	3208	256	65	185	15	0	265
10768	6919s (+0.9s)	3544	3544	256	65	219	16	0	300
10769	6919s (+0.5s)	1504	1504	128	32	122	6	0	160
10770	6920s (+0.7s)	3092	3092	256	57	186	11	0	254
10771	6920s (+0.5s)	2040	2040	256	36	128	8	0	172
10772	6921s (+0.5s)	1820	1820	128	46	134	9	0	189
10773	6921s (+0.7s)	2940	2940	256	58	179	11	0	248
10774	6922s (+0.6s)	2344	2344	128	58	151	15	0	224
10775	6923s (+0.5s)	1656	1656	128	38	119	9	0	166
10776	6923s (+0.6s)	2428	2428	256	42	154	8	0	204
10777	6924s (+0.9s)	3728	3728	256	78	214	22	0	314
10778	6925s (+0.9s)	3736	3736	256	83	204	21	1	309
10779	6926s (+0.9s)	3992	3992	256	97	212	16	1	326
10780	6926s (+0.6s)	1948	1948	128	53	138	9	0	200
10781	6927s (+0.5s)	2256	2256	256	35	150	5	0	190
10782	6928s (+1.0s)	4860	4860	512	81	257	11	0	349
10783	6928s (+0.4s)	1052	1052	64	28	94	5	0	127
10784	6929s (+0.7s)	3228	3228	256	91	162	17	0	270
10785	6930s (+0.4s)	1192	1192	128	26	100	5	0	131
10786	6930s (+0.6s)	2496	2496	256	54	151	11	0	216
10787	6931s (+0.8s)	3412	3412	256	72	206	11	0	289
10788	6932s (+0.6s)	2228	2228	256	36	148	8	0	192
10789	6932s (+0.8s)	3396	3396	256	79	201	10	0	290
10790	6933s (+0.5s)	1716	1716	128	43	120	11	2	176
10791	6934s (+1.1s)	4516	4516	256	106	250	19	0	375
10792	6934s (+0.5s)	1892	1892	128	54	126	8	0	188
10793	6935s (+0.3s)	1136	1136	128	27	86	9	0	122
10794	6936s (+0.9s)	3744	3744	256	76	224	11	0	311
10795	6936s (+0.4s)	1084	1084	64	34	89	5	0	128
10796	6937s (+0.5s)	1604	1604	128	35	129	4	0	168
10797	6937s (+0.5s)	1780	1780	128	39	135	6	0	180
10798	6938s (+0.7s)	2764	2764	256	55	169	11	0	235
10799	6939s (+0.9s)	3900	3900	256	80	221	12	0	313
Episode	Time	Reward	Score	Highest	L	U	R	D	Steps
10800	6939s (+0.4s)	1336	1336	128	31	103	5	0	139
10801	6940s (+0.8s)	3512	3512	256	79	204	9	0	292
10802	6941s (+0.7s)	2916	2916	256	58	178	6	0	242
10803	6942s (+1.0s)	5212	5212	512	92	245	18	1	356
10804	6942s (+0.6s)	2108	2108	128	52	138	9	1	200
10805	6943s (+1.2s)	5652	5652	512	81	318	12	0	411
10806	6944s (+0.4s)	1416	1416	128	32	104	7	0	143
10807	6945s (+1.0s)	4484	4484	256	103	247	17	0	367
10808	6945s (+0.6s)	1996	1996	128	57	148	7	0	212
10809	6946s (+0.5s)	1860	1860	128	52	125	11	0	188
10810	6947s (+0.8s)	3280	3280	256	74	187	15	0	276
10811	6947s (+0.5s)	1528	1528	128	36	118	7	0	161
10812	6948s (+0.5s)	1524	1524	128	44	103	11	0	158
10813	6948s (+0.5s)	1624	1624	128	42	115	6	0	163
10814	6949s (+0.8s)	3388	3388	256	66	202	15	0	283
10815	6949s (+0.2s)	568	568	64	19	56	3	0	78
10816	6950s (+0.7s)	2744	2744	256	51	170	13	0	234
10817	6950s (+0.3s)	600	600	32	26	57	6	1	90
10818	6951s (+0.8s)	3496	3496	256	71	204	17	1	293
10819	6951s (+0.4s)	1540	1540	128	42	108	8	1	159
10820	6952s (+0.9s)	3616	3616	256	62	226	15	0	303
10821	6953s (+0.8s)	3356	3356	256	65	195	15	1	276
10822	6954s (+0.8s)	3404	3404	256	76	192	13	1	282
10823	6954s (+0.4s)	1384	1384	128	37	97	11	1	146
10824	6955s (+0.4s)	1196	1196	128	30	94	8	0	132
10825	6955s (+0.5s)	2212	2212	256	51	123	0	12	186
10826	6956s (+0.4s)	1152	1152	128	34	82	0	6	122
10827	6956s (+0.5s)	1832	1832	128	34	148	0	4	186
10828	6957s (+0.9s)	3608	3608	256	62	219	0	20	301
10829	6958s (+1.1s)	5504	5504	512	81	289	0	21	391
10830	6959s (+0.8s)	3292	3292	256	62	202	0	11	275
10831	6960s (+0.8s)	3252	3252	256	53	210	0	12	275
10832	6961s (+0.8s)	3360	3360	256	53	209	0	13	275
10833	6961s (+0.7s)	3088	3088	256	66	177	0	9	252
10834	6962s (+0.5s)	1880	1880	128	37	147	0	6	190
10835	6962s (+0.5s)	1716	1716	128	40	124	0	6	170
10836	6963s (+0.8s)	3512	3512	256	62	219	0	15	296
10837	6964s (+1.1s)	5184	5184	512	103	252	18	1	374
10838	6965s (+0.5s)	2184	2184	256	43	134	9	0	186
10839	6965s (+0.5s)	1736	1736	128	31	138	5	0	174
10840	6966s (+0.4s)	1604	1604	128	36	117	4	1	158
10841	6966s (+0.6s)	2500	2500	256	48	160	8	0	216
10842	6967s (+0.8s)	3512	3512	256	75	208	14	0	297
10843	6968s (+0.6s)	2420	2420	256	41	151	10	0	202
10844	6968s (+0.6s)	2652	2652	256	59	157	12	0	228
10845	6969s (+0.4s)	1500	1500	128	32	121	6	0	159
10846	6970s (+0.7s)	2760	2760	256	62	166	9	0	237
10847	6970s (+0.4s)	1320	1320	64	35	105	8	0	148
10848	6970s (+0.3s)	1076	1076	128	20	92	2	0	114
10849	6971s (+0.9s)	4764	4764	512	75	242	13	0	330
10850	6972s (+0.6s)	2096	2096	128	55	145	10	0	210
10851	6973s (+0.7s)	2448	2448	128	63	141	24	0	228
10852	6974s (+1.1s)	4588	4588	256	89	277	18	0	384
10853	6974s (+0.8s)	3440	3440	256	75	200	16	0	291
10854	6975s (+0.8s)	3216	3216	256	64	195	12	0	271
10855	6976s (+1.1s)	5388	5388	512	83	281	13	1	378
10856	6977s (+1.1s)	5612	5612	512	93	287	21	0	401
10857	6979s (+1.1s)	5416	5416	512	102	256	21	0	379
10858	6980s (+1.0s)	4340	4340	256	81	264	18	0	363
10859	6980s (+0.8s)	3244	3244	256	69	191	14	0	274
10860	6981s (+0.5s)	1916	1916	128	51	137	9	0	197
10861	6981s (+0.4s)	1220	1220	64	36	95	6	0	137
10862	6982s (+0.5s)	1836	1836	128	59	123	8	0	190
10863	6982s (+0.4s)	1540	1540	128	39	112	8	0	159
10864	6983s (+0.5s)	1536	1536	128	53	102	7	1	163
10865	6983s (+0.2s)	504	504	32	17	60	4	0	81
10866	6983s (+0.4s)	1480	1480	128	40	108	5	0	153
10867	6984s (+0.5s)	1772	1772	128	44	123	13	0	180
10868	6985s (+0.8s)	3248	3248	256	64	191	15	0	270
10869	6985s (+0.5s)	1596	1596	128	36	127	0	5	168
10870	6986s (+0.5s)	1596	1596	128	37	126	0	4	167
10871	6987s (+1.0s)	4140	4140	256	84	237	0	17	338
10872	6987s (+0.6s)	2220	2220	128	39	166	0	9	214
10873	6988s (+0.6s)	2384	2384	256	40	158	1	5	204
10874	6988s (+0.4s)	1324	1324	128	29	101	0	7	137
10875	6989s (+0.4s)	1372	1372	128	28	110	0	6	144
10876	6989s (+0.5s)	1624	1624	128	32	126	0	5	163
10877	6990s (+0.8s)	3576	3576	256	74	211	13	0	298
10878	6991s (+0.7s)	2888	2888	256	64	176	9	0	249
10879	6992s (+0.8s)	3500	3500	256	80	202	12	0	294
10880	6993s (+0.9s)	3936	3936	256	75	231	13	0	319
10881	6993s (+0.5s)	1688	1688	128	47	135	2	0	184
10882	6994s (+0.5s)	1844	1844	128	41	145	5	0	191
10883	6994s (+0.6s)	1920	1920	128	51	141	6	0	198
10884	6995s (+0.6s)	2052	2052	128	73	124	13	0	210
10885	6996s (+1.0s)	5208	5208	512	85	253	17	0	355
10886	6996s (+0.3s)	948	948	64	27	81	6	0	114
10887	6997s (+0.5s)	1596	1596	128	47	121	5	0	173
10888	6997s (+0.8s)	3592	3592	256	86	199	17	0	302
10889	6998s (+0.4s)	1424	1424	128	41	107	4	0	152
10890	6998s (+0.4s)	1484	1484	128	45	102	8	0	155
10891	6999s (+0.8s)	3420	3420	256	64	206	15	0	285
10892	7000s (+0.6s)	1928	1928	128	54	133	13	0	200
10893	7000s (+0.7s)	2684	2684	256	61	157	12	1	231
10894	7001s (+0.8s)	3440	3440	256	62	216	13	0	291
10895	7002s (+0.7s)	3092	3092	256	61	179	16	0	256
10896	7002s (+0.4s)	1408	1408	128	25	116	5	0	146
10897	7003s (+0.6s)	2320	2320	256	41	145	8	0	194
10898	7003s (+0.3s)	780	780	64	21	69	7	0	97
10899	7004s (+0.5s)	1696	1696	128	48	120	7	0	175
Episode	Time	Reward	Score	Highest	L	U	R	D	Steps
10900	7004s (+0.6s)	2560	2560	256	55	153	9	0	217
10901	7005s (+0.4s)	1180	1180	128	25	98	6	0	129
10902	7005s (+0.4s)	1420	1420	128	39	97	9	0	145
10903	7006s (+0.4s)	1248	1248	128	26	108	1	0	135
10904	7006s (+0.1s)	180	180	16	5	35	2	0	42
10905	7007s (+1.0s)	4252	4252	256	96	230	27	0	353
10906	7007s (+0.6s)	2472	2472	256	60	147	7	0	214
10907	7008s (+0.5s)	1820	1820	128	41	141	7	0	189
10908	7009s (+0.8s)	3276	3276	256	79	190	16	0	285
10909	7009s (+0.3s)	844	844	64	29	81	4	0	114
10910	7010s (+0.5s)	1800	1800	128	50	124	10	1	185
10911	7011s (+0.9s)	3920	3920	256	103	205	13	0	321
10912	7012s (+1.0s)	4292	4292	256	91	240	20	0	351
10913	7012s (+0.4s)	1208	1208	128	25	94	0	5	124
10914	7013s (+0.8s)	3500	3500	256	58	224	0	12	294
10915	7014s (+1.2s)	6072	6072	512	85	317	0	23	425
10916	7015s (+1.4s)	7196	7196	512	92	380	0	26	498
10917	7016s (+0.8s)	3412	3412	256	67	208	0	10	285
10918	7017s (+0.8s)	3624	3624	256	53	225	0	15	293
10919	7018s (+0.8s)	3292	3292	256	66	201	0	14	281
10920	7018s (+0.5s)	1748	1748	128	39	134	0	4	177
10921	7019s (+0.7s)	2744	2744	256	51	170	0	9	230
10922	7019s (+0.4s)	1292	1292	128	29	97	0	4	130
10923	7020s (+0.6s)	2232	2232	128	44	153	0	16	213
10924	7020s (+0.3s)	700	700	64	25	62	0	5	92
10925	7021s (+0.4s)	1172	1172	128	20	102	0	6	128
10926	7021s (+0.6s)	2412	2412	256	39	155	7	0	201
10927	7022s (+0.5s)	1656	1656	128	49	110	8	0	167
10928	7022s (+0.6s)	2528	2528	256	47	155	11	0	213
10929	7023s (+0.3s)	908	908	64	26	77	6	0	109
10930	7024s (+0.8s)	3264	3264	256	99	167	14	0	280
10931	7024s (+0.3s)	1056	1056	128	33	74	7	0	114
10932	7024s (+0.4s)	1272	1272	128	24	103	8	0	135
10933	7025s (+0.9s)	3660	3660	256	77	206	19	0	302
10934	7026s (+0.9s)	4100	4100	256	80	236	16	0	332
10935	7027s (+0.5s)	1788	1788	128	48	128	6	0	182
10936	7027s (+0.5s)	2172	2172	256	38	136	10	0	184
10937	7028s (+0.4s)	1324	1324	128	33	103	3	0	139
10938	7028s (+0.5s)	1868	1868	128	44	134	12	0	190
10939	7029s (+0.8s)	3568	3568	256	72	213	14	0	299
10940	7030s (+1.0s)	5108	5108	512	87	263	16	1	367
10941	7031s (+1.0s)	4328	4328	256	110	223	24	0	357
10942	7031s (+0.5s)	1800	1800	128	41	139	5	0	185
10943	7032s (+0.5s)	1892	1892	128	47	134	11	0	192
10944	7033s (+0.7s)	2932	2932	256	60	190	9	0	259
10945	7033s (+0.5s)	1676	1676	128	38	125	7	0	170
10946	7034s (+1.0s)	5304	5304	512	95	251	21	0	367
10947	7035s (+0.8s)	3156	3156	256	63	183	15	0	261
10948	7035s (+0.2s)	484	484	64	16	52	4	0	72
10949	7036s (+0.7s)	3132	3132	256	66	185	12	0	263
10950	7036s (+0.5s)	1768	1768	128	40	132	9	0	181
10951	7037s (+1.0s)	4492	4492	256	99	252	15	0	366
10952	7038s (+0.8s)	3292	3292	256	70	192	12	0	274
10953	7039s (+1.1s)	5624	5624	512	106	266	20	1	393
10954	7040s (+0.6s)	2512	2512	256	47	164	8	0	219
10955	7041s (+0.7s)	2756	2756	256	80	147	10	0	237
10956	7041s (+0.5s)	1680	1680	128	55	117	9	0	181
10957	7042s (+0.5s)	1788	1788	128	34	141	7	0	182
10958	7042s (+0.5s)	2276	2276	256	42	148	3	0	193
10959	7043s (+0.9s)	3956	3956	256	78	231	14	0	323
10960	7044s (+0.5s)	1676	1676	128	48	113	9	1	171
10961	7044s (+0.6s)	2496	2496	256	44	169	5	0	218
10962	7045s (+0.4s)	1268	1268	128	29	102	6	0	137
10963	7046s (+0.8s)	3472	3472	256	79	197	11	1	288
10964	7046s (+0.6s)	2536	2536	256	56	151	11	0	218
10965	7047s (+0.5s)	1600	1600	128	37	117	9	1	164
10966	7047s (+0.5s)	1908	1908	128	48	133	12	0	193
10967	7048s (+0.8s)	3260	3260	256	73	187	13	0	273
10968	7048s (+0.3s)	864	864	64	31	73	8	0	112
10969	7049s (+0.7s)	2788	2788	256	45	177	0	12	234
10970	7050s (+0.5s)	1800	1800	128	38	139	0	8	185
10971	7050s (+0.5s)	1816	1816	128	33	144	0	6	183
10972	7051s (+0.8s)	3196	3196	256	56	199	0	12	267
10973	7052s (+0.9s)	3844	3844	256	62	238	0	13	313
10974	7053s (+0.8s)	3344	3344	256	54	212	0	16	282
10975	7053s (+0.6s)	2088	2088	128	56	140	13	0	209
10976	7054s (+0.6s)	2284	2284	128	53	150	11	0	214
10977	7054s (+0.5s)	1648	1648	128	39	119	6	0	164
10978	7055s (+0.7s)	2768	2768	256	49	178	7	1	235
10979	7055s (+0.5s)	2224	2224	256	32	138	6	0	176
10980	7056s (+0.7s)	2968	2968	256	58	177	12	0	247
10981	7057s (+0.6s)	1960	1960	128	49	136	13	0	198
10982	7058s (+0.8s)	3228	3228	256	66	191	14	0	271
10983	7058s (+0.5s)	1676	1676	128	20	143	1	1	165
10984	7059s (+1.0s)	4156	4156	256	116	195	24	0	335
10985	7060s (+0.8s)	3208	3208	256	59	196	11	0	266
10986	7061s (+0.8s)	3276	3276	256	46	226	0	10	282
10987	7061s (+0.7s)	2808	2808	256	51	179	0	11	241
10988	7062s (+0.5s)	1772	1772	128	39	130	0	9	178
10989	7062s (+0.8s)	3224	3224	256	60	197	11	0	268
10990	7063s (+0.6s)	2548	2548	256	55	153	9	0	217
10991	7064s (+0.5s)	1836	1836	128	47	128	4	0	179
10992	7064s (+0.8s)	3228	3228	256	73	181	16	0	270
10993	7065s (+0.6s)	2596	2596	256	52	162	10	0	224
10994	7066s (+0.7s)	2636	2636	256	53	172	9	0	234
10995	7067s (+0.9s)	3912	3912	256	79	224	14	0	317
10996	7067s (+0.5s)	1512	1512	128	41	112	8	0	161
10997	7068s (+0.5s)	1596	1596	128	39	119	8	0	166
10998	7069s (+1.1s)	5484	5484	512	100	260	25	0	385
10999	7070s (+0.9s)	3576	3576	256	94	191	15	0	300
Episode	Time	Reward	Score	Highest	L	U	R	D	Steps
11000	7070s (+0.6s)	1888	1888	128	54	129	12	0	195
11001	7071s (+0.6s)	1952	1952	128	56	131	12	0	199
11002	7071s (+0.4s)	1520	1520	128	29	124	3	0	156
11003	7072s (+0.9s)	3892	3892	256	98	214	16	0	328
11004	7073s (+0.6s)	2576	2576	256	53	161	10	0	224
11005	7073s (+0.5s)	1680	1680	128	37	127	8	0	172
11006	7074s (+0.8s)	3336	3336	256	71	197	8	0	276
11007	7075s (+0.7s)	3172	3172	256	78	173	11	0	262
11008	7075s (+0.3s)	792	792	64	15	85	0	3	103
11009	7076s (+0.7s)	3108	3108	256	61	182	0	14	257
11010	7076s (+0.6s)	2260	2260	128	43	166	0	6	215
11011	7077s (+0.4s)	1428	1428	128	31	109	0	7	147
11012	7078s (+0.8s)	3648	3648	256	55	228	0	12	295
11013	7079s (+0.8s)	3428	3428	256	72	200	0	16	288
11014	7079s (+0.3s)	840	840	64	18	87	0	2	107
11015	7079s (+0.6s)	2608	2608	256	48	166	0	7	221
11016	7080s (+0.2s)	508	508	64	13	59	0	2	74
11017	7081s (+1.0s)	5104	5104	512	66	272	0	18	356
11018	7082s (+0.9s)	3804	3804	256	71	219	17	0	307
11019	7083s (+1.0s)	4064	4064	256	84	238	16	0	338
11020	7083s (+0.6s)	2388	2388	256	39	151	8	0	198
11021	7084s (+0.3s)	1084	1084	128	21	86	3	0	110
11022	7084s (+0.6s)	2668	2668	256	43	173	10	0	226
11023	7085s (+0.7s)	2716	2716	256	50	172	9	1	232
11024	7086s (+0.8s)	3320	3320	256	76	183	18	1	278
11025	7086s (+0.4s)	1344	1344	128	43	99	5	0	147
11026	7087s (+0.8s)	3236	3236	256	66	193	13	0	272
11027	7087s (+0.6s)	2544	2544	256	43	166	9	0	218
11028	7088s (+0.4s)	1152	1152	64	36	94	5	0	135
11029	7088s (+0.6s)	1912	1912	128	49	136	11	0	196
11030	7089s (+0.7s)	2592	2592	128	66	164	13	0	243
11031	7090s (+0.8s)	3612	3612	256	78	203	14	0	295
11032	7091s (+0.8s)	3508	3508	256	85	190	20	0	295
11033	7091s (+0.6s)	2384	2384	256	37	161	6	0	204
11034	7092s (+0.5s)	1712	1712	128	46	120	7	0	173
11035	7093s (+0.7s)	3108	3108	256	53	190	14	0	257
11036	7093s (+0.6s)	2252	2252	256	53	131	9	0	193
11037	7094s (+0.5s)	2196	2196	256	36	148	5	0	189
11038	7095s (+0.7s)	3124	3124	256	65	180	13	0	258
11039	7095s (+0.8s)	3576	3576	256	89	188	19	1	297
11040	7096s (+0.6s)	2460	2460	256	45	155	10	1	211
11041	7097s (+0.8s)	3348	3348	256	70	200	13	0	283
11042	7098s (+0.8s)	3216	3216	256	73	181	13	0	267
11043	7098s (+0.5s)	1628	1628	128	36	120	9	0	165
11044	7099s (+0.6s)	2008	2008	128	51	140	9	0	200
11045	7100s (+0.8s)	3524	3524	256	70	207	18	0	295
11046	7100s (+0.5s)	1600	1600	128	44	114	9	0	167
11047	7101s (+0.7s)	2828	2828	128	73	173	16	0	262
11048	7101s (+0.6s)	1924	1924	128	49	142	8	0	199
11049	7102s (+0.5s)	1888	1888	128	45	138	7	0	190
11050	7103s (+0.8s)	3504	3504	256	69	196	15	1	281
11051	7103s (+0.5s)	1876	1876	128	52	132	8	0	192
11052	7104s (+0.3s)	748	748	64	15	78	3	0	96
11053	7104s (+0.5s)	1712	1712	128	45	118	12	1	176
11054	7105s (+0.7s)	2956	2956	256	72	169	16	1	258
11055	7105s (+0.4s)	1312	1312	64	38	104	6	0	148
11056	7106s (+0.4s)	1184	1184	64	33	106	0	5	144
11057	7106s (+0.5s)	1824	1824	128	28	153	0	9	190
11058	7106s (+0.3s)	928	928	64	24	86	0	3	113
11059	7107s (+0.5s)	1912	1912	128	35	138	0	9	182
11060	7107s (+0.2s)	568	568	64	17	54	0	6	77
11061	7108s (+0.9s)	3956	3956	256	68	242	0	13	323
11062	7109s (+0.6s)	2488	2488	256	50	151	12	0	213
11063	7110s (+1.0s)	4260	4260	256	90	246	13	1	350
11064	7111s (+0.8s)	3276	3276	256	69	187	18	0	274
11065	7111s (+0.5s)	1700	1700	128	37	127	8	0	172
11066	7112s (+0.6s)	2444	2444	256	42	155	11	0	208
11067	7112s (+0.8s)	2900	2900	128	89	167	16	0	272
11068	7113s (+0.5s)	1608	1608	128	40	121	8	0	169
11069	7113s (+0.5s)	1640	1640	128	52	107	10	0	169
11070	7114s (+0.9s)	3832	3832	256	91	219	13	1	324
11071	7115s (+0.5s)	1708	1708	128	38	122	11	0	171
11072	7116s (+1.2s)	6028	6028	512	98	308	19	0	425
11073	7117s (+0.7s)	2492	2492	128	64	155	14	0	233
11074	7118s (+0.7s)	2772	2772	256	42	194	6	0	242
11075	7119s (+1.1s)	5472	5472	512	102	264	16	1	383
11076	7120s (+0.9s)	3996	3996	256	89	228	16	0	333
11077	7120s (+0.7s)	2488	2488	128	63	155	15	0	233
11078	7121s (+0.8s)	3552	3552	256	71	211	13	0	295
11079	7122s (+0.5s)	1816	1816	128	47	131	5	1	184
11080	7122s (+0.5s)	1804	1804	128	38	141	7	0	186
11081	7122s (+0.4s)	1136	1136	128	23	91	8	0	122
11082	7123s (+0.7s)	2796	2796	256	75	152	15	0	242
11083	7124s (+1.0s)	4336	4336	256	101	233	25	0	359
11084	7124s (+0.2s)	512	512	64	21	50	3	0	74
11085	7125s (+0.6s)	1952	1952	128	46	148	5	0	199
11086	7126s (+1.0s)	4324	4324	256	103	232	20	0	355
11087	7126s (+0.3s)	972	972	64	25	90	2	0	117
11088	7127s (+0.5s)	1584	1584	128	30	125	5	0	160
11089	7127s (+0.5s)	1600	1600	128	35	128	4	0	167
11090	7128s (+0.8s)	3216	3216	256	50	208	10	0	268
11091	7129s (+0.8s)	3388	3388	256	74	193	16	0	283
11092	7129s (+0.5s)	1720	1720	128	48	121	7	0	176
11093	7130s (+0.6s)	2156	2156	128	63	139	12	0	214
11094	7130s (+0.4s)	1332	1332	128	31	97	9	1	138
11095	7131s (+0.7s)	2452	2452	128	63	155	12	0	230
11096	7132s (+0.6s)	2092	2092	128	55	146	8	0	209
11097	7132s (+0.6s)	2176	2176	128	60	148	11	0	219
11098	7133s (+0.8s)	3536	3536	256	73	206	18	1	298
11099	7134s (+1.0s)	5064	5064	512	88	250	23	1	362
Episode	Time	Reward	Score	Highest	L	U	R	D	Steps
11100	7135s (+0.5s)	1748	1748	128	44	121	11	1	177
11101	7135s (+0.7s)	2928	2928	256	59	190	8	1	258
11102	7136s (+0.6s)	2388	2388	256	48	151	7	0	206
11103	7137s (+0.7s)	2916	2916	256	45	181	14	1	241
11104	7137s (+0.8s)	3268	3268	256	62	200	0	13	275
11105	7138s (+0.9s)	3540	3540	256	55	233	0	11	299
11106	7139s (+1.0s)	4148	4148	256	73	244	0	22	339
11107	7140s (+0.5s)	1820	1820	128	35	142	0	6	183
11108	7141s (+0.9s)	4012	4012	256	66	249	0	18	333
11109	7142s (+1.0s)	4228	4228	256	91	238	18	0	347
11110	7143s (+0.7s)	2796	2796	256	53	179	9	1	242
11111	7143s (+0.4s)	1004	1004	64	27	99	4	0	130
11112	7143s (+0.4s)	1248	1248	128	27	106	7	0	140
11113	7144s (+0.6s)	2360	2360	256	44	147	8	0	199
11114	7144s (+0.5s)	1672	1672	128	33	131	0	7	171
11115	7145s (+0.4s)	1432	1432	128	25	116	0	3	144
11116	7145s (+0.5s)	1600	1600	128	41	121	0	6	168
11117	7146s (+0.8s)	3560	3560	256	59	220	0	14	293
11118	7147s (+0.7s)	2640	2640	256	57	163	0	10	230
11119	7148s (+0.8s)	3224	3224	256	58	202	0	14	274
11120	7149s (+1.2s)	5708	5708	512	101	290	19	0	410
11121	7150s (+0.9s)	3552	3552	256	83	201	18	0	302
11122	7150s (+0.7s)	2980	2980	256	59	182	10	1	252
11123	7151s (+0.4s)	1408	1408	128	37	101	10	0	148
11124	7151s (+0.5s)	1608	1608	128	41	120	8	0	169
11125	7152s (+0.7s)	2932	2932	256	52	179	4	0	235
11126	7153s (+0.9s)	3560	3560	256	65	224	15	0	304
11127	7153s (+0.6s)	2364	2364	256	42	144	13	0	199
11128	7154s (+0.5s)	1600	1600	128	40	121	6	0	167
11129	7154s (+0.4s)	1496	1496	128	39	102	10	0	151
11130	7155s (+0.4s)	1484	1484	128	28	121	5	1	155
11131	7156s (+0.8s)	3520	3520	256	73	208	18	0	299
11132	7156s (+0.5s)	1516	1516	128	54	96	8	0	158
11133	7157s (+0.7s)	2680	2680	256	62	162	0	7	231
11134	7157s (+0.4s)	1408	1408	128	27	111	0	8	146
11135	7158s (+0.8s)	3420	3420	256	63	200	0	19	282
11136	7159s (+1.1s)	5556	5556	512	74	301	0	17	392
11137	7159s (+0.4s)	1180	1180	64	30	103	0	8	141
11138	7160s (+0.8s)	3284	3284	256	68	190	0	11	269
11139	7161s (+1.0s)	3984	3984	256	58	265	0	11	334
11140	7162s (+0.4s)	1232	1232	64	38	93	0	9	140
11141	7162s (+0.3s)	836	836	64	27	73	0	6	106
11142	7163s (+0.6s)	2372	2372	128	50	156	0	16	222
11143	7163s (+0.3s)	1036	1036	64	29	86	0	8	123
11144	7164s (+0.6s)	2388	2388	256	48	152	0	9	209
11145	7164s (+0.8s)	3284	3284	256	67	196	0	16	279
11146	7165s (+0.9s)	4008	4008	256	90	221	20	0	331
11147	7166s (+0.4s)	1444	1444	128	41	105	5	0	151
11148	7166s (+0.5s)	1672	1672	128	42	120	8	0	170
11149	7167s (+0.7s)	2804	2804	256	67	164	10	0	241
11150	7167s (+0.5s)	1772	1772	128	40	123	15	0	178
11151	7168s (+0.5s)	1752	1752	128	50	127	8	0	185
11152	7169s (+0.6s)	2360	2360	128	48	155	9	0	212
11153	7169s (+0.4s)	1508	1508	128	46	106	8	0	160
11154	7170s (+0.5s)	1568	1568	128	27	132	5	0	164
11155	7170s (+0.8s)	3224	3224	256	68	196	5	0	269
11156	7171s (+0.4s)	1116	1116	64	24	112	1	0	137
11157	7172s (+0.8s)	3500	3500	256	79	201	14	0	294
11158	7172s (+0.4s)	1452	1452	64	44	105	8	1	158
11159	7173s (+0.8s)	3404	3404	256	81	191	14	0	286
11160	7173s (+0.5s)	1532	1532	128	40	111	10	0	161
11161	7174s (+0.8s)	3532	3532	256	74	210	13	0	297
11162	7175s (+1.1s)	4608	4608	256	94	269	19	0	382
11163	7176s (+0.6s)	1892	1892	128	42	142	7	0	191
11164	7176s (+0.6s)	1900	1900	128	46	134	11	0	191
11165	7177s (+0.5s)	1560	1560	128	48	102	10	1	161
11166	7177s (+0.6s)	2484	2484	128	61	159	11	1	232
11167	7179s (+1.1s)	5568	5568	512	116	255	20	1	392
11168	7179s (+0.8s)	3312	3312	256	66	196	13	1	276
11169	7180s (+0.7s)	3176	3176	256	58	197	13	0	268
11170	7180s (+0.4s)	1060	1060	64	24	102	3	0	129
11171	7181s (+0.7s)	2916	2916	256	54	190	11	0	255
11172	7182s (+0.8s)	3484	3484	256	71	203	16	0	290
11173	7183s (+0.8s)	3516	3516	256	74	200	18	1	293
11174	7184s (+0.6s)	2532	2532	256	49	162	9	0	220
11175	7184s (+0.7s)	2908	2908	256	61	183	9	0	253
11176	7185s (+0.6s)	2424	2424	256	46	154	10	0	210
11177	7185s (+0.4s)	1416	1416	128	30	111	5	0	146
11178	7186s (+0.4s)	1192	1192	128	38	88	5	0	131
11179	7187s (+1.0s)	4140	4140	256	91	230	17	0	338
11180	7188s (+1.0s)	4340	4340	256	98	242	23	0	363
11181	7188s (+0.5s)	1804	1804	128	51	128	7	0	186
11182	7189s (+0.4s)	1352	1352	128	32	101	6	0	139
11183	7189s (+0.8s)	3324	3324	256	82	190	10	0	282
11184	7190s (+0.8s)	3648	3648	256	56	221	0	19	296
11185	7191s (+0.8s)	3304	3304	256	55	211	0	11	277
11186	7191s (+0.4s)	1148	1148	128	24	96	0	2	122
11187	7192s (+0.4s)	1464	1464	128	36	109	5	0	150
11188	7192s (+0.5s)	1784	1784	128	48	125	8	0	181
11189	7193s (+0.4s)	1612	1612	128	33	118	9	0	160
11190	7193s (+0.6s)	2440	2440	256	50	149	9	0	208
11191	7194s (+0.4s)	1256	1256	128	38	89	4	0	131
11192	7194s (+0.2s)	676	676	64	13	72	0	3	88
11193	7195s (+0.4s)	1512	1512	128	24	122	0	5	151
11194	7195s (+0.8s)	3380	3380	256	65	211	0	16	292
11195	7196s (+1.0s)	4180	4180	256	77	249	15	0	341
11196	7197s (+0.7s)	2616	2616	256	53	169	7	0	229
11197	7198s (+1.0s)	5004	5004	512	82	246	16	2	346
11198	7199s (+0.9s)	3596	3596	256	90	191	21	0	302
11199	7200s (+0.9s)	3996	3996	256	79	225	19	0	323
Episode	Time	Reward	Score	Highest	L	U	R	D	Steps
11200	7200s (+0.6s)	1948	1948	128	55	139	6	0	200
11201	7202s (+1.2s)	6044	6044	512	107	306	17	0	430
11202	7202s (+0.8s)	3240	3240	256	74	179	19	1	273
11203	7203s (+0.7s)	3120	3120	256	67	185	8	0	260
11204	7204s (+0.7s)	2844	2844	256	64	178	7	0	249
11205	7204s (+0.6s)	1996	1996	128	46	144	11	0	201
11206	7205s (+0.8s)	3328	3328	256	49	215	14	0	278
11207	7206s (+0.7s)	2676	2676	256	62	156	11	0	229
11208	7206s (+0.3s)	736	736	64	35	63	5	0	103
11209	7207s (+0.7s)	2920	2920	256	72	176	8	0	256
11210	7207s (+0.5s)	1636	1636	128	52	103	11	0	166
11211	7208s (+0.4s)	1516	1516	128	47	101	9	1	158
11212	7209s (+0.8s)	3264	3264	256	87	175	13	0	275
11213	7210s (+0.8s)	3500	3500	256	91	185	15	0	291
11214	7210s (+0.6s)	2468	2468	256	37	171	2	0	210
11215	7211s (+0.4s)	1424	1424	128	29	121	5	0	155
11216	7211s (+0.6s)	2184	2184	128	52	148	6	0	206
11217	7212s (+0.7s)	2736	2736	256	48	173	11	0	232
11218	7213s (+0.8s)	3352	3352	256	72	201	12	0	285
11219	7213s (+0.5s)	1780	1780	128	38	131	11	0	180
11220	7214s (+0.6s)	1880	1880	128	50	132	11	0	193
11221	7215s (+0.9s)	3800	3800	256	74	230	12	0	316
11222	7215s (+0.4s)	1528	1528	128	37	111	6	0	154
11223	7217s (+1.4s)	6752	6752	512	130	327	26	0	483
11224	7217s (+0.4s)	1356	1356	128	42	88	9	1	140
11225	7217s (+0.5s)	2212	2212	256	59	123	7	0	189
11226	7219s (+1.0s)	4284	4284	256	109	229	18	0	356
11227	7219s (+0.5s)	1792	1792	128	42	134	7	0	183
11228	7220s (+0.5s)	1796	1796	128	52	120	12	0	184
11229	7220s (+0.5s)	1900	1900	128	52	128	10	0	190
11230	7220s (+0.2s)	584	584	64	19	59	5	0	83
11231	7221s (+0.5s)	1788	1788	128	48	125	9	0	182
11232	7221s (+0.4s)	1412	1412	128	25	118	0	3	146
11233	7222s (+0.8s)	3292	3292	256	60	207	0	13	280
11234	7223s (+0.4s)	1064	1064	64	26	99	0	6	131
11235	7223s (+0.4s)	1424	1424	128	25	116	0	4	145
11236	7223s (+0.5s)	1628	1628	128	40	124	0	6	170
11237	7224s (+0.7s)	2652	2652	256	45	180	0	12	237
11238	7225s (+0.5s)	1640	1640	128	35	124	1	4	164
11239	7225s (+0.8s)	3440	3440	256	68	209	0	14	291
11240	7226s (+0.2s)	528	528	64	18	54	0	0	72
11241	7226s (+0.8s)	3652	3652	256	73	215	12	1	301
11242	7227s (+0.9s)	4204	4204	256	79	253	13	0	345
11243	7228s (+0.5s)	1536	1536	128	36	109	11	0	156
11244	7228s (+0.5s)	2004	2004	256	27	129	8	0	164
11245	7229s (+0.6s)	1960	1960	128	50	149	4	0	203
11246	7229s (+0.5s)	1796	1796	128	39	137	7	0	183
11247	7230s (+0.9s)	3980	3980	256	72	232	18	1	323
11248	7231s (+0.7s)	2788	2788	256	61	166	10	0	237
11249	7232s (+0.6s)	2508	2508	256	61	148	9	0	218
11250	7232s (+0.7s)	2668	2668	256	62	162	12	1	237
11251	7233s (+0.4s)	1468	1468	128	45	103	7	0	155
11252	7233s (+0.6s)	2044	2044	128	45	148	9	0	202
11253	7235s (+1.6s)	8268	8268	512	156	367	34	0	557
11254	7236s (+0.6s)	2324	2324	256	54	138	12	1	205
11255	7236s (+0.8s)	3420	3420	256	72	195	13	0	280
11256	7237s (+0.9s)	3780	3780	256	76	224	11	0	311
11257	7239s (+1.3s)	6328	6328	512	120	306	30	0	456
11258	7239s (+0.7s)	3100	3100	256	69	183	7	0	259
11259	7240s (+1.1s)	4484	4484	256	97	251	20	0	368
11260	7241s (+0.3s)	692	692	64	24	68	5	0	97
11261	7241s (+0.6s)	1932	1932	128	47	147	7	0	201
11262	7242s (+1.2s)	6104	6104	512	136	279	24	0	439
11263	7243s (+0.5s)	1800	1800	128	43	136	6	1	186
11264	7244s (+1.3s)	6420	6420	512	113	313	27	0	453
11265	7245s (+0.4s)	1312	1312	128	29	111	4	0	144
11266	7245s (+0.7s)	2700	2700	256	54	165	15	1	235
11267	7246s (+0.6s)	1900	1900	128	38	151	4	0	193
11268	7247s (+0.8s)	3236	3236	256	71	175	19	0	265
11269	7247s (+0.5s)	1568	1568	128	33	123	9	0	165
11270	7248s (+0.8s)	3160	3160	256	62	198	10	0	270
11271	7248s (+0.3s)	872	872	64	31	77	6	0	114
11272	7249s (+0.4s)	1496	1496	128	41	105	7	0	153
11273	7249s (+0.5s)	1740	1740	128	37	134	5	0	176
11274	7250s (+0.8s)	3308	3308	256	67	204	12	1	284
11275	7251s (+0.4s)	1240	1240	128	41	93	3	0	137
11276	7252s (+1.0s)	5356	5356	512	86	270	15	0	371
11277	7252s (+0.3s)	928	928	64	27	78	0	7	112
11278	7252s (+0.6s)	2452	2452	256	49	146	0	11	206
11279	7254s (+1.2s)	6376	6376	512	100	314	0	20	434
11280	7255s (+1.0s)	4796	4796	512	84	239	14	1	338
11281	7255s (+0.5s)	1508	1508	128	52	100	9	0	161
11282	7257s (+1.3s)	6664	6664	512	112	328	25	0	465
11283	7257s (+0.8s)	3440	3440	256	73	205	12	0	290
11284	7258s (+0.7s)	2876	2876	256	44	196	6	0	246
11285	7259s (+0.8s)	3344	3344	256	56	217	10	0	283
11286	7259s (+0.5s)	1828	1828	128	41	134	10	0	185
11287	7260s (+0.9s)	3892	3892	256	103	194	16	0	313
11288	7261s (+0.8s)	3448	3448	256	63	208	15	0	286
11289	7262s (+0.8s)	3336	3336	256	58	205	13	1	277
11290	7263s (+0.6s)	2276	2276	128	70	143	6	0	219
11291	7263s (+0.4s)	1372	1372	64	38	107	6	0	151
11292	7264s (+0.5s)	1592	1592	128	43	124	5	0	172
11293	7264s (+0.8s)	3616	3616	256	72	209	11	1	293
11294	7265s (+0.4s)	1328	1328	128	34	99	4	0	137
11295	7265s (+0.4s)	1496	1496	128	55	98	5	0	158
11296	7265s (+0.3s)	780	780	64	22	75	6	0	103
11297	7266s (+0.8s)	3496	3496	256	90	193	13	1	297
11298	7267s (+0.9s)	3988	3988	256	73	233	0	25	331
11299	7268s (+0.6s)	2492	2492	256	46	156	0	15	217
Episode	Time	Reward	Score	Highest	L	U	R	D	Steps
11300	7268s (+0.4s)	1484	1484	128	33	114	0	8	155
11301	7269s (+0.5s)	1828	1828	128	37	143	0	7	187
11302	7269s (+0.2s)	556	556	64	15	64	0	1	80
11303	7270s (+0.6s)	2648	2648	256	46	168	0	12	226
11304	7271s (+0.9s)	3968	3968	256	67	249	0	11	327
11305	7271s (+0.8s)	3396	3396	256	59	212	0	9	280
11306	7272s (+0.5s)	2136	2136	256	40	130	0	10	180
11307	7272s (+0.4s)	1528	1528	128	27	120	0	5	152
11308	7273s (+1.0s)	4076	4076	256	77	246	15	0	338
11309	7274s (+0.5s)	1828	1828	128	43	141	8	0	192
11310	7275s (+0.6s)	2272	2272	256	57	128	11	0	196
11311	7275s (+0.8s)	3432	3432	256	74	197	18	0	289
11312	7276s (+0.8s)	3552	3552	256	71	217	14	0	302
11313	7277s (+0.7s)	3016	3016	256	70	171	17	0	258
11314	7278s (+1.5s)	7636	7636	512	151	352	26	0	529
11315	7279s (+0.6s)	2052	2052	128	55	145	11	0	211
11316	7280s (+0.7s)	3148	3148	256	73	185	8	0	266
11317	7280s (+0.4s)	1300	1300	128	40	90	5	0	135
11318	7281s (+0.6s)	2372	2372	128	57	159	10	0	226
11319	7282s (+0.8s)	3512	3512	256	80	197	16	0	293
11320	7283s (+0.7s)	2540	2540	128	59	166	14	0	239
11321	7283s (+0.6s)	2800	2800	256	44	170	9	0	223
11322	7284s (+0.9s)	3908	3908	256	103	208	19	0	330
11323	7285s (+0.5s)	1780	1780	128	45	127	8	0	180
11324	7285s (+0.6s)	2364	2364	256	49	143	7	0	199
11325	7286s (+0.5s)	1584	1584	128	40	115	10	0	165
11326	7286s (+0.3s)	804	804	64	28	73	6	1	108
11327	7287s (+0.6s)	2396	2396	256	36	157	7	2	202
11328	7287s (+0.4s)	1512	1512	128	39	108	9	1	157
11329	7288s (+0.6s)	2392	2392	256	48	151	7	0	206
11330	7289s (+0.9s)	4060	4060	256	81	238	14	0	333
11331	7290s (+0.9s)	4032	4032	256	87	225	18	0	330
11332	7290s (+0.8s)	3516	3516	256	76	204	12	0	292
11333	7291s (+0.7s)	2736	2736	128	86	147	18	0	251
11334	7292s (+0.5s)	1688	1688	128	25	143	1	0	169
11335	7292s (+0.8s)	3440	3440	256	71	204	15	1	291
11336	7293s (+0.9s)	3692	3692	256	83	210	20	0	313
11337	7294s (+1.0s)	4208	4208	256	93	233	17	0	343
11338	7295s (+1.0s)	5180	5180	512	80	259	20	0	359
11339	7296s (+0.8s)	3440	3440	256	84	181	15	0	280
11340	7297s (+0.7s)	3084	3084	256	72	168	16	0	256
11341	7297s (+0.6s)	2028	2028	128	49	136	9	0	194
11342	7298s (+0.9s)	3852	3852	256	69	228	10	0	307
11343	7299s (+0.7s)	3168	3168	256	59	188	13	0	260
11344	7300s (+0.7s)	2276	2276	128	68	144	16	0	228
11345	7300s (+0.4s)	1400	1400	128	23	119	8	0	150
11346	7301s (+0.4s)	1476	1476	128	29	114	9	0	152
11347	7302s (+1.0s)	5064	5064	512	88	251	21	1	361
11348	7303s (+1.0s)	4320	4320	256	95	246	18	0	359
11349	7304s (+0.8s)	3200	3200	256	74	178	16	0	268
11350	7304s (+0.9s)	3636	3636	256	85	204	23	0	312
11351	7305s (+0.7s)	2752	2752	256	67	158	8	0	233
11352	7305s (+0.4s)	1360	1360	64	45	94	7	0	146
11353	7306s (+0.2s)	480	480	32	11	60	3	0	74
11354	7306s (+0.4s)	1236	1236	128	35	94	7	0	136
11355	7307s (+0.5s)	1620	1620	128	48	116	8	0	172
11356	7308s (+1.0s)	3980	3980	256	84	231	14	0	329
11357	7308s (+0.6s)	1948	1948	128	38	163	4	0	205
11358	7309s (+1.1s)	5700	5700	512	93	287	16	0	396
11359	7310s (+1.0s)	4264	4264	256	102	234	15	0	351
11360	7311s (+0.4s)	1176	1176	128	40	78	9	0	127
11361	7311s (+0.8s)	3204	3204	256	55	209	7	0	271
11362	7312s (+0.5s)	1464	1464	64	47	102	10	0	159
11363	7313s (+0.7s)	2616	2616	256	59	160	10	0	229
11364	7313s (+0.8s)	3536	3536	256	74	211	11	0	296
11365	7314s (+1.0s)	4052	4052	256	88	235	19	0	342
11366	7315s (+0.3s)	876	876	64	29	75	10	0	114
11367	7315s (+0.5s)	1624	1624	128	36	128	0	9	173
11368	7316s (+0.5s)	1684	1684	128	34	133	0	5	172
11369	7316s (+0.2s)	428	428	32	9	57	0	3	69
11370	7317s (+0.9s)	3704	3704	256	102	194	17	0	313
11371	7317s (+0.6s)	2440	2440	256	45	160	8	0	213
11372	7318s (+0.5s)	1840	1840	128	41	145	4	0	190
11373	7318s (+0.3s)	896	896	64	26	91	2	0	119
11374	7320s (+1.3s)	6924	6924	512	140	296	30	0	466
11375	7321s (+0.9s)	4180	4180	256	92	233	15	0	340
11376	7321s (+0.4s)	1432	1432	128	35	107	5	0	147
11377	7322s (+0.6s)	1916	1916	128	40	151	6	0	197
11378	7323s (+0.7s)	2788	2788	256	49	184	7	0	240
11379	7323s (+0.5s)	1812	1812	128	58	116	7	0	181
11380	7324s (+0.5s)	2020	2020	128	51	132	9	0	192
11381	7324s (+0.6s)	2468	2468	256	45	155	8	0	208
11382	7325s (+0.4s)	1212	1212	128	26	104	2	0	132
11383	7325s (+0.8s)	3380	3380	256	84	184	13	0	281
11384	7326s (+0.5s)	1728	1728	128	42	120	9	0	171
11385	7327s (+0.8s)	3348	3348	256	68	201	14	0	283
11386	7327s (+0.6s)	1960	1960	128	46	135	11	0	192
11387	7328s (+0.7s)	3068	3068	256	64	175	13	0	252
11388	7329s (+1.1s)	5552	5552	512	99	277	14	0	390
11389	7330s (+0.6s)	1948	1948	128	42	143	10	0	195
11390	7330s (+0.4s)	1176	1176	128	34	87	6	0	127
11391	7331s (+0.8s)	3232	3232	256	77	180	14	0	271
11392	7332s (+0.8s)	3564	3564	256	73	216	10	0	299
11393	7332s (+0.7s)	3080	3080	256	57	187	10	0	254
11394	7333s (+0.5s)	1792	1792	128	44	128	11	0	183
11395	7334s (+0.7s)	2736	2736	256	70	149	12	1	232
11396	7334s (+0.8s)	3420	3420	256	70	208	8	0	286
11397	7335s (+0.4s)	1184	1184	64	35	104	4	0	143
11398	7335s (+0.6s)	2408	2408	256	43	154	6	0	203
11399	7336s (+0.7s)	2804	2804	256	54	176	10	0	240
Episode	Time	Reward	Score	Highest	L	U	R	D	Steps
11400	7337s (+0.7s)	2640	2640	256	58	159	8	0	225
11401	7337s (+0.6s)	2168	2168	128	42	152	8	0	202
11402	7338s (+0.8s)	3456	3456	256	76	200	12	0	288
11403	7339s (+0.6s)	2328	2328	128	61	147	13	0	221
11404	7340s (+0.7s)	2920	2920	256	50	197	9	0	256
11405	7340s (+0.7s)	2892	2892	256	51	190	9	0	250
11406	7341s (+0.9s)	3716	3716	256	87	216	13	0	316
11407	7342s (+0.6s)	2152	2152	128	62	123	17	0	202
11408	7343s (+0.8s)	3448	3448	256	72	204	12	0	288
11409	7343s (+0.6s)	2116	2116	128	41	149	10	1	201
11410	7344s (+0.5s)	1556	1556	128	46	118	3	0	167
11411	7344s (+0.6s)	2544	2544	256	45	167	4	0	216
11412	7345s (+0.4s)	1280	1280	128	40	96	7	0	143
11413	7345s (+0.5s)	1844	1844	128	52	121	11	0	184
11414	7346s (+0.3s)	832	832	64	18	86	1	0	105
11415	7346s (+0.3s)	816	816	64	19	88	4	0	111
11416	7346s (+0.5s)	1752	1752	128	37	138	4	0	179
11417	7347s (+0.6s)	2296	2296	128	51	152	11	0	214
11418	7348s (+0.9s)	3724	3724	256	97	199	17	0	313
11419	7349s (+0.5s)	2312	2312	256	49	135	9	0	193
11420	7349s (+0.6s)	2676	2676	256	50	165	0	14	229
11421	7350s (+0.7s)	3080	3080	256	50	192	0	8	250
11422	7350s (+0.4s)	1440	1440	128	28	116	0	5	149
11423	7351s (+0.4s)	1192	1192	64	33	104	0	8	145
11424	7351s (+0.7s)	2820	2820	256	54	181	0	13	248
11425	7352s (+0.9s)	4640	4640	512	75	231	14	0	320
11426	7353s (+1.0s)	4312	4312	256	92	239	25	0	356
11427	7354s (+0.7s)	2648	2648	256	56	170	6	0	232
11428	7354s (+0.4s)	1404	1404	128	37	106	8	0	151
11429	7355s (+0.5s)	1880	1880	128	49	139	5	0	193
11430	7355s (+0.5s)	1684	1684	128	35	130	2	0	167
11431	7356s (+0.9s)	4212	4212	256	85	237	21	0	343
11432	7357s (+0.4s)	1152	1152	64	34	93	9	0	136
11433	7358s (+0.8s)	3244	3244	256	74	186	14	0	274
11434	7358s (+0.7s)	2472	2472	128	54	163	15	1	233
11435	7359s (+0.6s)	2584	2584	256	52	166	7	0	225
11436	7360s (+0.8s)	3480	3480	256	68	207	15	0	290
11437	7360s (+0.5s)	1676	1676	128	47	114	10	0	171
11438	7361s (+0.4s)	1036	1036	64	20	100	4	0	124
11439	7361s (+0.8s)	3312	3312	256	74	195	10	0	279
11440	7362s (+1.0s)	5332	5332	512	103	252	11	1	367
11441	7363s (+1.0s)	4252	4252	256	83	253	17	0	353
11442	7364s (+0.6s)	2524	2524	256	58	148	9	0	215
11443	7365s (+0.8s)	3460	3460	256	84	197	11	0	292
11444	7366s (+0.7s)	3204	3204	256	64	191	11	0	266
11445	7366s (+0.6s)	2596	2596	256	42	167	0	9	218
11446	7367s (+0.5s)	1788	1788	128	43	130	0	9	182
11447	7367s (+0.5s)	1672	1672	128	46	129	0	5	180
11448	7368s (+0.9s)	3492	3492	256	50	230	0	11	291
11449	7369s (+0.5s)	1872	1872	128	34	147	0	7	188
11450	7369s (+0.6s)	1984	1984	128	60	140	9	0	209
11451	7370s (+0.5s)	1708	1708	128	50	118	10	0	178
11452	7370s (+0.5s)	1664	1664	128	37	125	7	0	169
11453	7371s (+0.9s)	3620	3620	256	72	221	14	0	307
11454	7372s (+1.0s)	5316	5316	512	115	225	25	1	366
11455	7373s (+0.7s)	2848	2848	256	61	170	12	0	243
11456	7373s (+0.4s)	1320	1320	128	33	96	6	0	135
11457	7374s (+0.6s)	2464	2464	256	55	146	9	2	212
11458	7375s (+0.8s)	3588	3588	256	73	204	13	0	290
11459	7375s (+0.3s)	980	980	64	18	93	4	0	115
11460	7376s (+0.8s)	3444	3444	256	82	197	12	0	291
11461	7377s (+0.8s)	3212	3212	256	70	190	11	0	271
11462	7378s (+1.0s)	4256	4256	256	85	251	15	0	351
11463	7379s (+0.8s)	3392	3392	256	66	197	16	0	279
11464	7379s (+0.7s)	2820	2820	256	46	192	9	0	247
11465	7380s (+0.7s)	2876	2876	256	61	175	13	1	250
11466	7381s (+0.4s)	1464	1464	128	40	108	6	0	154
11467	7381s (+0.5s)	1712	1712	128	31	137	6	0	174
11468	7382s (+0.5s)	1716	1716	128	43	123	10	0	176
11469	7382s (+0.7s)	2824	2824	256	62	178	9	0	249
11470	7383s (+1.1s)	5496	5496	512	81	288	12	1	382
11471	7384s (+0.5s)	1652	1652	128	37	130	9	1	177
11472	7384s (+0.6s)	2232	2232	256	48	138	8	0	194
11473	7385s (+0.7s)	2924	2924	256	53	175	14	0	242
11474	7386s (+0.6s)	2076	2076	128	50	147	13	0	210
11475	7386s (+0.5s)	1512	1512	128	42	104	11	0	157
11476	7387s (+1.0s)	4328	4328	256	96	245	19	0	360
11477	7388s (+0.4s)	1012	1012	64	37	89	6	0	132
11478	7388s (+0.9s)	3556	3556	256	72	222	9	0	303
11479	7389s (+0.7s)	2788	2788	256	52	180	8	0	240
11480	7390s (+0.9s)	4128	4128	256	76	244	18	0	338
11481	7391s (+0.7s)	2768	2768	256	62	165	8	0	235
11482	7391s (+0.7s)	2904	2904	256	63	168	12	0	243
11483	7392s (+0.5s)	1616	1616	128	52	110	9	0	171
11484	7392s (+0.4s)	1292	1292	64	43	96	4	0	143
11485	7393s (+0.9s)	4076	4076	256	87	237	13	0	337
11486	7394s (+0.7s)	2676	2676	256	58	177	5	0	240
11487	7395s (+0.7s)	2800	2800	256	66	161	16	0	243
11488	7395s (+0.5s)	1572	1572	128	43	109	8	0	160
11489	7395s (+0.3s)	792	792	64	31	70	5	0	106
11490	7396s (+0.9s)	3912	3912	256	90	220	12	0	322
11491	7397s (+0.7s)	3116	3116	256	60	186	11	1	258
11492	7398s (+0.5s)	1744	1744	128	41	127	9	0	177
11493	7398s (+0.3s)	736	736	64	26	66	5	0	97
11494	7398s (+0.4s)	1328	1328	128	28	105	9	1	143
11495	7399s (+1.0s)	4408	4408	256	94	247	18	1	360
11496	7400s (+0.8s)	3256	3256	256	68	189	8	0	265
11497	7401s (+1.0s)	5160	5160	512	80	261	13	0	354
11498	7402s (+0.7s)	2988	2988	256	58	173	12	0	243
11499	7403s (+1.1s)	4580	4580	256	102	247	21	0	370
Episode	Time	Reward	Score	Highest	L	U	R	D	Steps
11500	7403s (+0.4s)	1184	1184	128	25	91	7	0	123
11501	7404s (+1.1s)	5812	5812	512	112	284	21	2	419
11502	7405s (+0.7s)	2444	2444	128	66	149	14	0	229
11503	7406s (+0.5s)	1732	1732	128	47	122	8	0	177
11504	7406s (+0.8s)	3508	3508	256	71	206	9	0	286
11505	7407s (+0.4s)	1288	1288	128	31	104	4	0	139
11506	7408s (+0.6s)	2676	2676	256	59	160	9	1	229
11507	7408s (+0.5s)	1676	1676	128	41	122	8	0	171
11508	7409s (+0.8s)	3528	3528	256	71	213	13	0	297
11509	7410s (+0.7s)	3108	3108	256	62	182	13	0	257
11510	7411s (+1.3s)	6528	6528	512	127	314	25	0	466
11511	7411s (+0.5s)	1764	1764	128	37	139	5	0	181
11512	7412s (+0.5s)	1596	1596	128	43	115	8	0	166
11513	7413s (+0.9s)	3936	3936	256	78	232	13	0	323
11514	7414s (+0.9s)	3600	3600	256	85	199	17	1	302
11515	7414s (+0.4s)	1372	1372	128	33	100	10	0	143
11516	7415s (+0.8s)	3196	3196	256	75	172	16	0	263
11517	7415s (+0.5s)	1644	1644	128	34	129	4	0	167
11518	7416s (+1.1s)	4504	4504	256	92	260	20	0	372
11519	7417s (+0.4s)	1480	1480	128	38	108	8	0	154
11520	7417s (+0.5s)	1620	1620	128	46	117	9	0	172
11521	7418s (+0.7s)	3172	3172	256	80	170	11	0	261
11522	7419s (+0.6s)	2136	2136	128	51	140	14	0	205
11523	7419s (+0.4s)	1356	1356	128	42	91	7	0	140
11524	7420s (+0.5s)	1920	1920	128	52	138	8	0	198
11525	7420s (+0.4s)	1404	1404	128	31	108	7	0	146
11526	7420s (+0.3s)	752	752	64	15	75	0	8	98
11527	7421s (+0.3s)	972	972	64	26	91	0	3	120
11528	7422s (+0.8s)	3296	3296	256	50	209	0	17	276
11529	7422s (+0.8s)	3264	3264	256	60	201	0	13	274
11530	7423s (+0.8s)	3408	3408	256	57	216	0	11	284
11531	7424s (+0.5s)	1788	1788	128	35	139	0	8	182
11532	7424s (+0.4s)	1180	1180	128	28	95	4	0	127
11533	7424s (+0.4s)	1352	1352	128	47	93	7	1	148
11534	7425s (+0.5s)	2388	2388	256	59	127	10	0	196
11535	7426s (+0.6s)	1912	1912	128	52	135	9	0	196
11536	7426s (+0.4s)	1336	1336	128	27	107	4	1	139
11537	7427s (+0.5s)	1880	1880	128	37	147	9	0	193
11538	7427s (+0.6s)	2344	2344	128	60	161	7	0	228
11539	7428s (+0.6s)	2524	2524	256	48	157	8	0	213
11540	7429s (+1.5s)	7512	7512	512	139	360	28	1	528
11541	7430s (+0.8s)	3376	3376	256	60	220	10	0	290
11542	7431s (+0.9s)	3748	3748	256	72	227	13	0	312
11543	7432s (+0.5s)	1228	1228	64	43	97	9	0	149
11544	7432s (+0.5s)	1792	1792	128	39	130	8	0	177
11545	7433s (+0.6s)	2460	2460	256	58	141	9	0	208
11546	7434s (+0.9s)	3544	3544	256	75	210	15	0	300
11547	7434s (+0.6s)	2652	2652	256	48	162	13	0	223
11548	7435s (+0.5s)	1812	1812	128	48	129	10	0	187
11549	7436s (+0.8s)	3556	3556	256	99	182	15	1	297
11550	7436s (+0.5s)	1616	1616	128	41	123	7	0	171
11551	7437s (+0.6s)	2656	2656	256	62	152	9	0	223
11552	7437s (+0.5s)	1892	1892	128	52	134	5	0	191
11553	7438s (+0.8s)	3192	3192	256	71	179	12	1	263
11554	7439s (+0.5s)	1724	1724	128	49	118	11	0	178
11555	7439s (+0.7s)	3176	3176	256	56	196	10	0	262
11556	7440s (+0.3s)	1060	1060	64	32	89	7	0	128
11557	7440s (+0.6s)	1968	1968	128	62	127	10	0	199
11558	7441s (+0.8s)	3408	3408	256	89	190	19	0	298
11559	7442s (+0.8s)	3376	3376	256	77	198	15	0	290
11560	7443s (+0.9s)	3684	3684	256	75	227	14	0	316
11561	7444s (+0.6s)	2680	2680	256	65	150	15	0	230
11562	7444s (+0.6s)	2168	2168	128	58	146	13	0	217
11563	7445s (+0.6s)	2504	2504	256	44	165	9	0	218
11564	7445s (+0.5s)	1524	1524	128	34	122	8	0	164
11565	7446s (+0.3s)	860	860	64	33	71	7	0	111
11566	7447s (+1.2s)	5700	5700	512	100	291	16	1	408
11567	7448s (+0.7s)	3092	3092	256	69	168	15	0	252
11568	7448s (+0.5s)	1876	1876	128	57	120	15	0	192
11569	7449s (+0.8s)	3368	3368	256	70	207	11	0	288
11570	7450s (+0.8s)	3560	3560	256	82	207	15	0	304
11571	7450s (+0.4s)	980	980	64	28	88	8	0	124
11572	7451s (+0.5s)	1552	1552	128	46	99	12	0	157
11573	7451s (+0.8s)	3440	3440	256	77	194	12	0	283
11574	7452s (+0.5s)	1764	1764	128	49	120	10	0	179
11575	7452s (+0.5s)	1880	1880	128	48	135	0	5	188
11576	7453s (+0.6s)	2448	2448	256	31	171	0	6	208
11577	7454s (+0.6s)	2416	2416	256	41	154	0	10	205
11578	7454s (+0.3s)	1064	1064	128	28	80	0	7	115
11579	7454s (+0.5s)	1544	1544	128	33	121	0	11	165
11580	7455s (+0.5s)	1528	1528	128	34	120	0	8	162
11581	7455s (+0.4s)	1052	1052	64	30	88	0	10	128
11582	7455s (+0.2s)	448	448	32	8	62	0	3	73
11583	7456s (+0.4s)	1120	1120	64	26	93	0	9	128
11584	7457s (+0.9s)	3776	3776	256	72	222	0	17	311
11585	7458s (+1.3s)	6536	6536	512	134	302	24	1	461
11586	7459s (+0.6s)	1932	1932	128	44	147	10	0	201
11587	7459s (+0.4s)	1332	1332	128	29	104	4	0	137
11588	7460s (+1.0s)	4312	4312	256	101	233	19	0	353
11589	7461s (+0.7s)	3096	3096	256	53	189	12	0	254
11590	7461s (+0.5s)	1868	1868	128	44	136	7	0	187
11591	7462s (+0.3s)	960	960	64	29	78	6	0	113
11592	7463s (+1.0s)	4248	4248	256	85	242	16	1	344
11593	7463s (+0.7s)	2752	2752	256	70	152	14	0	236
11594	7464s (+1.0s)	3952	3952	256	78	242	18	0	338
11595	7465s (+0.3s)	1124	1124	128	35	80	4	0	119
11596	7465s (+0.4s)	1436	1436	128	30	116	7	0	153
11597	7465s (+0.4s)	1168	1168	128	32	90	6	0	128
11598	7466s (+0.3s)	852	852	64	29	77	3	0	109
11599	7466s (+0.5s)	1740	1740	128	38	130	4	0	172
Episode	Time	Reward	Score	Highest	L	U	R	D	Steps
11600	7467s (+0.8s)	3024	3024	128	79	177	18	1	275
11601	7468s (+0.6s)	2528	2528	256	62	133	15	2	212
11602	7468s (+0.4s)	1280	1280	128	35	102	4	0	141
11603	7469s (+0.6s)	1912	1912	128	46	145	5	0	196
11604	7469s (+0.4s)	1456	1456	128	40	108	4	0	152
11605	7469s (+0.2s)	620	620	64	12	71	2	0	85
11606	7470s (+0.7s)	3052	3052	256	63	178	12	2	255
11607	7471s (+0.5s)	1692	1692	128	42	119	13	0	174
11608	7471s (+0.6s)	2392	2392	128	58	154	13	0	225
11609	7473s (+1.5s)	7612	7612	512	120	395	22	0	537
11610	7473s (+0.5s)	1696	1696	128	41	127	7	0	175
11611	7474s (+0.5s)	1728	1728	128	47	123	2	0	172
11612	7474s (+0.4s)	1456	1456	128	41	102	10	0	153
11613	7476s (+1.2s)	5912	5912	512	90	303	21	0	414
11614	7476s (+0.7s)	2884	2884	256	61	172	13	0	246
11615	7477s (+0.8s)	3220	3220	256	47	208	0	14	269
11616	7478s (+0.6s)	2460	2460	256	32	167	0	8	207
11617	7478s (+0.3s)	668	668	64	15	73	0	2	90
11618	7478s (+0.3s)	964	964	64	21	88	0	8	117
11619	7479s (+0.7s)	2920	2920	256	53	184	6	0	243
11620	7480s (+0.9s)	3940	3940	256	95	217	12	0	324
11621	7481s (+0.6s)	2444	2444	256	45	155	7	0	207
11622	7481s (+0.9s)	3556	3556	256	79	207	16	0	302
11623	7482s (+0.3s)	1008	1008	64	30	80	8	0	118
11624	7483s (+1.0s)	4252	4252	256	96	237	20	0	353
11625	7483s (+0.3s)	988	988	64	34	77	6	0	117
11626	7484s (+0.5s)	1500	1500	128	44	109	7	0	160
11627	7484s (+0.7s)	2964	2964	256	63	188	10	1	262
11628	7485s (+0.4s)	1116	1116	64	33	86	8	0	127
11629	7485s (+0.8s)	3348	3348	256	82	183	18	0	283
11630	7486s (+0.6s)	1924	1924	128	56	129	11	0	196
11631	7487s (+0.6s)	2500	2500	256	49	154	13	0	216
11632	7487s (+0.5s)	1740	1740	128	33	139	4	0	176
11633	7488s (+0.4s)	1588	1588	128	43	111	7	0	161
11634	7489s (+0.9s)	4100	4100	256	78	245	9	0	332
11635	7489s (+0.7s)	3008	3008	256	61	171	14	1	247
11636	7490s (+0.5s)	1916	1916	128	45	125	12	1	183
11637	7491s (+0.8s)	3572	3572	256	79	203	18	0	300
11638	7491s (+0.7s)	3032	3032	256	62	175	11	0	248
11639	7492s (+0.4s)	1336	1336	128	34	98	6	0	138
11640	7492s (+0.4s)	1416	1416	128	32	106	6	0	144
11641	7493s (+0.7s)	3108	3108	256	61	183	12	1	257
11642	7493s (+0.5s)	1788	1788	128	46	128	8	0	182
11643	7494s (+0.9s)	3612	3612	256	78	212	15	0	305
11644	7495s (+0.5s)	1692	1692	128	42	124	5	0	171
11645	7495s (+0.4s)	1456	1456	128	42	104	6	0	152
11646	7496s (+0.9s)	3532	3532	256	71	214	16	0	301
11647	7497s (+1.0s)	4360	4360	256	92	254	18	0	364
11648	7498s (+0.7s)	2924	2924	256	63	179	16	0	258
11649	7499s (+0.8s)	3524	3524	256	72	211	12	0	295
11650	7499s (+0.6s)	2136	2136	128	61	121	17	0	199
11651	7500s (+0.4s)	1456	1456	128	40	108	4	0	152
11652	7500s (+0.4s)	1476	1476	128	39	106	9	0	154
11653	7501s (+0.4s)	1460	1460	128	41	104	8	0	153
11654	7501s (+0.6s)	2436	2436	256	45	149	12	0	206
11655	7502s (+0.6s)	1924	1924	128	52	137	10	0	199
11656	7503s (+1.0s)	4232	4232	256	98	236	19	0	353
11657	7503s (+0.5s)	1488	1488	128	30	120	6	0	156
11658	7504s (+0.3s)	872	872	64	32	72	9	0	113
11659	7504s (+0.6s)	2436	2436	256	58	140	7	0	205
11660	7505s (+0.4s)	1104	1104	64	28	100	7	1	136
11661	7505s (+0.8s)	3200	3200	256	73	182	13	0	268
11662	7506s (+0.7s)	2712	2712	128	69	159	12	1	241
11663	7507s (+0.6s)	2120	2120	128	43	148	0	11	202
11664	7507s (+0.7s)	3208	3208	256	51	200	0	14	265
11665	7508s (+0.4s)	1456	1456	128	23	125	0	5	153
11666	7509s (+0.6s)	2732	2732	256	46	179	0	7	232
11667	7509s (+0.4s)	1560	1560	128	33	121	0	9	163
11668	7510s (+0.9s)	3952	3952	256	76	231	15	0	322
11669	7510s (+0.6s)	1960	1960	128	54	138	9	0	201
11670	7511s (+1.0s)	4292	4292	256	100	235	16	0	351
11671	7512s (+0.5s)	1856	1856	128	56	119	12	0	187
11672	7512s (+0.4s)	1352	1352	128	37	108	3	0	148
11673	7513s (+0.7s)	2912	2912	256	63	174	12	0	249
11674	7514s (+0.7s)	2840	2840	256	54	173	6	0	233
11675	7515s (+1.1s)	4572	4572	256	104	268	12	0	384
11676	7516s (+0.6s)	2680	2680	256	50	170	10	0	230
11677	7516s (+0.7s)	2900	2900	256	61	173	17	0	251
11678	7517s (+0.6s)	1968	1968	128	52	147	6	0	205
11679	7517s (+0.4s)	1508	1508	128	40	108	8	0	156
11680	7518s (+1.0s)	4440	4440	256	100	246	22	0	368
11681	7519s (+0.3s)	708	708	64	26	64	4	0	94
11682	7519s (+0.5s)	1668	1668	128	31	135	3	0	169
11683	7520s (+0.5s)	1592	1592	128	39	121	10	0	170
11684	7520s (+0.2s)	628	628	64	16	66	1	0	83
11685	7520s (+0.4s)	1488	1488	128	32	116	7	0	155
11686	7521s (+0.5s)	1612	1612	128	34	129	0	6	169
11687	7521s (+0.3s)	1048	1048	128	14	94	0	5	113
11688	7522s (+1.0s)	4140	4140	256	70	247	0	20	337
11689	7523s (+0.5s)	1848	1848	128	40	146	0	6	192
11690	7524s (+0.8s)	3360	3360	256	56	216	0	14	286
11691	7524s (+0.4s)	1092	1092	64	25	101	0	7	133
11692	7524s (+0.5s)	1788	1788	128	37	137	0	8	182
11693	7525s (+0.5s)	1692	1692	128	33	133	0	2	168
11694	7526s (+1.0s)	5084	5084	512	89	259	17	0	365
11695	7526s (+0.5s)	1668	1668	128	41	118	10	0	169
11696	7527s (+0.5s)	2176	2176	256	47	131	7	0	185
11697	7527s (+0.5s)	1764	1764	128	26	131	8	1	166
11698	7528s (+0.9s)	3772	3772	256	82	209	13	0	304
11699	7529s (+0.8s)	3344	3344	256	62	204	17	0	283
Episode	Time	Reward	Score	Highest	L	U	R	D	Steps
11700	7530s (+0.5s)	2324	2324	256	43	147	6	0	196
11701	7531s (+1.1s)	4612	4612	256	111	254	17	0	382
11702	7531s (+0.5s)	2020	2020	128	43	133	9	1	186
11703	7532s (+0.3s)	892	892	64	26	81	4	0	111
11704	7532s (+0.6s)	2456	2456	256	46	156	9	1	212
11705	7533s (+0.8s)	3464	3464	256	78	197	17	0	292
11706	7534s (+0.6s)	2468	2468	256	55	147	7	0	209
11707	7534s (+0.7s)	2784	2784	256	74	154	11	0	239
11708	7535s (+0.4s)	1148	1148	64	32	97	5	0	134
11709	7536s (+0.8s)	3212	3212	256	68	194	9	0	271
11710	7537s (+1.1s)	5352	5352	512	93	274	13	0	380
11711	7538s (+1.2s)	5752	5752	512	116	272	21	0	409
11712	7539s (+1.0s)	4988	4988	512	96	236	21	0	353
11713	7540s (+0.8s)	3580	3580	256	87	192	18	1	298
11714	7540s (+0.6s)	2808	2808	256	43	183	4	0	230
11715	7541s (+0.7s)	2768	2768	256	50	178	7	0	235
11716	7541s (+0.5s)	1600	1600	128	44	115	8	0	167
11717	7542s (+0.7s)	2896	2896	256	51	190	9	0	250
11718	7542s (+0.2s)	524	524	64	22	49	5	1	77
11719	7543s (+0.5s)	1648	1648	128	52	111	11	0	174
11720	7543s (+0.4s)	1472	1472	128	34	109	9	0	152
11721	7544s (+0.4s)	1072	1072	64	25	100	3	0	128
11722	7545s (+1.0s)	4324	4324	256	102	232	26	0	360
11723	7545s (+0.6s)	2104	2104	128	58	138	16	0	212
11724	7546s (+0.8s)	3360	3360	256	71	191	14	0	276
11725	7547s (+1.0s)	5132	5132	512	95	246	24	0	365
11726	7548s (+0.9s)	4036	4036	256	80	232	19	0	331
11727	7548s (+0.4s)	1268	1268	128	32	94	4	0	130
11728	7549s (+0.5s)	1596	1596	128	43	111	8	0	162
11729	7549s (+0.3s)	1136	1136	128	29	86	6	0	121
11730	7550s (+0.9s)	3756	3756	256	64	234	15	1	314
11731	7551s (+0.7s)	2916	2916	256	56	188	11	0	255
11732	7552s (+1.1s)	5440	5440	512	93	264	22	0	379
11733	7553s (+0.6s)	1972	1972	128	55	147	4	0	206
11734	7553s (+0.4s)	1156	1156	64	25	107	5	0	137
11735	7553s (+0.4s)	1180	1180	64	38	96	7	0	141
11736	7554s (+0.6s)	2020	2020	128	52	142	6	1	201
11737	7555s (+0.7s)	3132	3132	256	62	189	11	1	263
11738	7556s (+0.8s)	3312	3312	256	79	191	9	0	279
11739	7556s (+0.8s)	3428	3428	256	60	209	12	0	281
11740	7557s (+0.4s)	1532	1532	128	37	112	3	0	152
11741	7558s (+1.0s)	4292	4292	256	97	240	19	0	356
11742	7558s (+0.6s)	1864	1864	128	53	133	9	0	195
11743	7559s (+0.4s)	1188	1188	128	26	92	6	0	124
11744	7559s (+0.4s)	1936	1936	256	30	123	6	0	159
11745	7560s (+0.8s)	3244	3244	256	85	174	13	0	272
11746	7561s (+0.6s)	2520	2520	256	48	162	11	0	221
11747	7561s (+0.7s)	2912	2912	256	60	178	16	0	254
11748	7562s (+0.6s)	2496	2496	256	50	157	8	0	215
11749	7563s (+0.6s)	1940	1940	128	38	155	0	10	203
11750	7563s (+0.9s)	3816	3816	256	64	230	0	16	310
11751	7564s (+0.6s)	1936	1936	128	39	153	0	5	197
11752	7565s (+0.6s)	2424	2424	256	48	151	0	4	203
11753	7565s (+0.6s)	2704	2704	256	49	172	0	4	225
11754	7566s (+0.4s)	1392	1392	128	25	109	0	9	143
11755	7566s (+0.6s)	2240	2240	128	37	164	0	13	214
11756	7567s (+0.6s)	1908	1908	128	53	137	5	0	195
11757	7567s (+0.4s)	1552	1552	128	32	118	7	1	158
11758	7568s (+0.5s)	1684	1684	128	39	125	5	0	169
11759	7569s (+0.8s)	3116	3116	256	72	188	9	0	269
11760	7569s (+0.3s)	988	988	128	26	76	5	1	108
11761	7569s (+0.4s)	1472	1472	128	27	119	5	0	151
11762	7570s (+0.4s)	1352	1352	128	26	111	3	0	140
11763	7570s (+0.7s)	3188	3188	256	65	185	15	0	265
11764	7571s (+0.7s)	3044	3044	256	62	174	10	0	246
11765	7572s (+1.0s)	4312	4312	256	88	244	21	0	353
11766	7573s (+0.6s)	1860	1860	128	47	139	9	0	195
11767	7573s (+0.3s)	924	924	64	31	77	4	0	112
11768	7574s (+0.9s)	3920	3920	256	79	221	15	0	315
11769	7575s (+0.8s)	3376	3376	256	62	201	16	0	279
11770	7575s (+0.6s)	2236	2236	128	58	150	16	0	224
11771	7576s (+0.4s)	1204	1204	128	34	86	7	0	127
11772	7576s (+0.5s)	1796	1796	128	42	135	8	0	185
11773	7577s (+0.4s)	1476	1476	128	37	110	7	0	154
11774	7577s (+0.2s)	528	528	64	12	59	1	0	72
11775	7578s (+0.6s)	2340	2340	256	27	164	0	7	198
11776	7578s (+0.8s)	3336	3336	256	50	218	0	12	280
11777	7579s (+0.8s)	3240	3240	256	63	200	0	11	274
11778	7580s (+0.8s)	3352	3352	256	65	206	0	13	284
11779	7580s (+0.1s)	176	176	16	9	28	0	3	40
11780	7580s (+0.1s)	272	272	32	6	42	0	4	52
11781	7581s (+0.7s)	3120	3120	256	73	170	17	0	260
11782	7582s (+1.3s)	6668	6668	512	118	326	27	0	471
11783	7583s (+0.9s)	3600	3600	256	93	194	20	0	307
11784	7584s (+0.5s)	1856	1856	128	48	132	8	0	188
11785	7584s (+0.4s)	1024	1024	64	30	85	8	0	123
11786	7585s (+0.7s)	2772	2772	256	55	179	6	0	240
11787	7585s (+0.4s)	1536	1536	128	42	112	6	0	160
11788	7586s (+0.5s)	1652	1652	128	42	120	6	1	169
11789	7586s (+0.4s)	1436	1436	128	35	109	4	0	148
11790	7587s (+0.9s)	3936	3936	256	107	203	12	1	323
11791	7588s (+0.6s)	2480	2480	256	58	144	10	0	212
11792	7588s (+0.4s)	1148	1148	128	29	87	7	1	124
11793	7589s (+0.6s)	2500	2500	128	56	150	10	1	217
11794	7590s (+1.0s)	4272	4272	256	104	239	15	0	358
11795	7590s (+0.5s)	1684	1684	128	45	120	8	0	173
11796	7591s (+0.9s)	3680	3680	256	78	223	13	0	314
11797	7592s (+0.6s)	2212	2212	128	54	152	17	0	223
11798	7592s (+0.8s)	3252	3252	256	58	204	14	0	276
11799	7593s (+0.6s)	2500	2500	256	58	147	11	0	216
Episode	Time	Reward	Score	Highest	L	U	R	D	Steps
11800	7594s (+0.8s)	3448	3448	256	77	193	12	0	282
11801	7595s (+0.8s)	3412	3412	256	68	196	13	0	277
11802	7595s (+0.6s)	2132	2132	128	59	140	10	0	209
11803	7596s (+0.8s)	3328	3328	256	83	190	9	0	282
11804	7597s (+0.8s)	3500	3500	256	59	222	12	0	293
11805	7597s (+0.6s)	2432	2432	256	41	158	5	1	205
11806	7598s (+0.6s)	2504	2504	256	48	153	10	0	211
11807	7599s (+0.5s)	1572	1572	128	44	109	7	1	161
11808	7599s (+0.5s)	1800	1800	128	45	131	9	0	185
11809	7600s (+0.5s)	1608	1608	128	32	131	6	1	170
11810	7600s (+0.7s)	2880	2880	256	52	172	12	0	236
11811	7601s (+0.8s)	3460	3460	256	73	194	17	0	284
11812	7602s (+1.1s)	5532	5532	512	95	277	15	0	387
11813	7603s (+0.7s)	3052	3052	256	56	182	10	0	248
11814	7603s (+0.5s)	1672	1672	128	39	126	5	0	170
11815	7604s (+0.8s)	3336	3336	256	69	194	11	0	274
11816	7605s (+0.9s)	3560	3560	256	72	218	14	0	304
11817	7605s (+0.3s)	804	804	64	25	77	6	0	108
11818	7606s (+0.4s)	1160	1160	64	30	88	8	0	126
11819	7606s (+0.7s)	3184	3184	256	79	176	13	0	268
11820	7607s (+1.1s)	4528	4528	256	94	260	20	0	374
11821	7608s (+0.7s)	2820	2820	128	74	174	8	0	256
11822	7609s (+0.9s)	3988	3988	256	87	218	19	0	324
11823	7610s (+0.8s)	3256	3256	256	69	196	11	0	276
11824	7610s (+0.5s)	1644	1644	128	40	130	3	0	173
11825	7611s (+0.7s)	2580	2580	128	65	168	15	0	248
11826	7612s (+0.4s)	1476	1476	128	37	115	6	0	158
11827	7612s (+0.7s)	2900	2900	256	61	179	15	0	255
11828	7613s (+0.4s)	1436	1436	128	33	116	5	0	154
11829	7613s (+0.5s)	1804	1804	128	35	146	5	0	186
11830	7614s (+0.7s)	2624	2624	128	72	156	18	0	246
11831	7615s (+0.5s)	1708	1708	128	44	128	10	0	182
11832	7615s (+0.6s)	1904	1904	128	42	145	7	0	194
11833	7616s (+0.4s)	1172	1172	128	23	99	4	0	126
11834	7616s (+0.7s)	2800	2800	256	47	187	0	9	243
11835	7617s (+0.8s)	3260	3260	256	61	206	0	11	278
11836	7618s (+0.9s)	3788	3788	256	67	227	0	16	310
11837	7618s (+0.4s)	1068	1068	64	24	97	0	10	131
11838	7619s (+0.9s)	3720	3720	256	66	220	0	16	302
11839	7620s (+0.6s)	2756	2756	256	46	169	0	8	223
11840	7620s (+0.4s)	1416	1416	128	33	105	7	0	145
11841	7621s (+0.4s)	1496	1496	128	23	130	1	0	154
11842	7621s (+0.4s)	1448	1448	128	36	109	6	0	151
11843	7622s (+0.7s)	2708	2708	256	45	171	0	12	228
11844	7622s (+0.7s)	2556	2556	128	62	162	14	0	238
11845	7623s (+0.8s)	3444	3444	256	80	191	14	0	285
11846	7624s (+0.5s)	1676	1676	128	42	125	4	0	171
11847	7624s (+0.4s)	1348	1348	128	30	105	6	0	141
11848	7625s (+0.4s)	1312	1312	128	42	94	8	0	144
11849	7625s (+0.6s)	2300	2300	256	44	146	9	0	199
11850	7626s (+1.0s)	4324	4324	256	91	247	21	0	359
11851	7627s (+0.9s)	4108	4108	256	102	224	18	0	344
11852	7628s (+0.5s)	1796	1796	128	37	139	8	0	184
11853	7628s (+0.4s)	1288	1288	128	28	102	0	8	138
11854	7628s (+0.5s)	1628	1628	128	38	125	0	7	170
11855	7629s (+0.5s)	1940	1940	128	37	146	9	0	192
11856	7630s (+0.7s)	3216	3216	256	68	182	11	0	261
11857	7630s (+0.4s)	1336	1336	128	36	102	7	0	145
11858	7631s (+0.5s)	1548	1548	128	42	114	10	0	166
11859	7631s (+0.5s)	1828	1828	128	45	138	4	0	187
11860	7632s (+0.5s)	1828	1828	128	43	140	0	8	191
11861	7633s (+0.8s)	3404	3404	256	56	216	0	14	286
11862	7633s (+0.8s)	3368	3368	256	77	196	15	0	288
11863	7634s (+0.4s)	1536	1536	128	34	115	8	0	157
11864	7635s (+0.9s)	3860	3860	256	84	219	17	0	320
11865	7635s (+0.5s)	1680	1680	128	25	137	4	0	166
11866	7636s (+0.3s)	864	864	64	29	80	3	0	112
11867	7636s (+0.7s)	2864	2864	256	69	170	7	0	246
11868	7637s (+0.6s)	1948	1948	128	59	134	7	0	200
11869	7637s (+0.5s)	1692	1692	128	37	131	6	1	175
11870	7638s (+0.5s)	1908	1908	128	51	126	13	0	190
11871	7639s (+0.8s)	3332	3332	256	78	193	13	0	284
11872	7639s (+0.6s)	1936	1936	128	51	143	8	0	202
11873	7640s (+0.6s)	2816	2816	256	48	173	0	11	232
11874	7640s (+0.4s)	1544	1544	128	37	113	5	0	155
11875	7642s (+1.3s)	6364	6364	512	127	296	29	0	452
11876	7642s (+0.3s)	1008	1008	64	30	82	6	0	118
11877	7642s (+0.4s)	1404	1404	128	40	100	7	0	147
11878	7643s (+0.4s)	1548	1548	128	29	121	5	0	155
11879	7644s (+0.7s)	2912	2912	256	46	198	10	0	254
11880	7644s (+0.4s)	1136	1136	64	42	89	5	0	136
11881	7644s (+0.4s)	1512	1512	128	36	113	8	0	157
11882	7646s (+1.2s)	6300	6300	512	124	306	19	0	449
11883	7646s (+0.5s)	1756	1756	128	53	118	8	0	179
11884	7647s (+0.7s)	2924	2924	256	64	180	13	0	257
11885	7648s (+0.5s)	1780	1780	128	31	146	3	0	180
11886	7648s (+0.5s)	1788	1788	128	57	112	11	0	180
11887	7649s (+0.6s)	2544	2544	256	45	158	0	10	213
11888	7649s (+0.5s)	1936	1936	128	48	125	0	8	181
11889	7650s (+0.4s)	1488	1488	128	30	120	0	6	156
11890	7650s (+0.5s)	1708	1708	128	31	132	0	9	172
11891	7651s (+0.5s)	1764	1764	128	38	139	4	0	181
11892	7652s (+0.9s)	4036	4036	256	66	250	15	0	331
11893	7652s (+0.5s)	2196	2196	256	41	139	6	0	186
11894	7652s (+0.4s)	1128	1128	128	22	100	5	0	127
11895	7653s (+1.1s)	4516	4516	256	100	254	21	0	375
11896	7654s (+0.5s)	1740	1740	128	46	120	9	0	175
11897	7655s (+0.8s)	3108	3108	256	69	180	14	1	264
11898	7655s (+0.3s)	1136	1136	128	36	77	9	0	122
11899	7655s (+0.3s)	904	904	64	36	74	7	0	117
Episode	Time	Reward	Score	Highest	L	U	R	D	Steps
11900	7656s (+0.5s)	1540	1540	128	30	134	3	0	167
11901	7657s (+0.6s)	2464	2464	256	50	150	12	0	212
11902	7657s (+0.8s)	3508	3508	256	73	209	14	0	296
11903	7658s (+0.6s)	2748	2748	256	61	162	12	0	235
11904	7659s (+0.7s)	2824	2824	256	60	177	6	0	243
11905	7659s (+0.6s)	2132	2132	128	55	140	13	1	209
11906	7660s (+0.5s)	1612	1612	128	40	118	6	0	164
11907	7661s (+0.7s)	2880	2880	256	52	174	10	0	236
11908	7661s (+0.8s)	3172	3172	256	68	189	18	1	276
11909	7662s (+0.7s)	2744	2744	256	53	172	0	10	235
11910	7663s (+0.6s)	1836	1836	128	37	148	0	9	194
11911	7663s (+0.8s)	3552	3552	256	56	211	0	14	281
11912	7664s (+0.3s)	1172	1172	128	25	100	0	1	126
11913	7665s (+1.1s)	4636	4636	256	120	242	23	0	385
11914	7666s (+0.8s)	3284	3284	256	66	206	7	0	279
11915	7667s (+0.9s)	3552	3552	256	87	204	11	0	302
11916	7667s (+0.7s)	3068	3068	256	57	183	11	0	251
11917	7668s (+0.6s)	1964	1964	128	50	147	7	0	204
11918	7668s (+0.4s)	1252	1252	128	30	101	3	0	134
11919	7669s (+0.7s)	3068	3068	256	67	172	11	2	252
11920	7669s (+0.4s)	1388	1388	128	35	95	8	2	140
11921	7670s (+0.8s)	3604	3604	256	62	216	15	0	293
11922	7671s (+0.6s)	1912	1912	128	45	147	4	0	196
11923	7671s (+0.6s)	2456	2456	256	51	151	8	0	210
11924	7672s (+0.4s)	1440	1440	128	41	100	8	0	149
11925	7672s (+0.4s)	1188	1188	64	40	96	8	0	144
11926	7673s (+0.6s)	2504	2504	256	56	157	5	0	218
11927	7674s (+0.7s)	3164	3164	256	73	176	14	1	264
11928	7674s (+0.6s)	1904	1904	128	50	137	7	0	194
11929	7675s (+0.7s)	3240	3240	256	78	186	9	0	273
11930	7675s (+0.6s)	1916	1916	128	49	143	5	0	197
11931	7676s (+1.0s)	4168	4168	256	99	224	21	0	344
11932	7677s (+1.0s)	5396	5396	512	90	258	22	0	370
11933	7679s (+1.1s)	5336	5336	512	84	272	15	0	371
11934	7680s (+1.3s)	6308	6308	512	123	307	21	0	451
11935	7681s (+0.8s)	3344	3344	256	54	212	16	0	282
11936	7681s (+0.7s)	2692	2692	256	47	180	9	0	236
11937	7682s (+0.4s)	1548	1548	128	35	116	4	0	155
11938	7682s (+0.5s)	1688	1688	128	38	124	6	0	168
11939	7683s (+0.4s)	1132	1132	64	27	99	5	0	131
11940	7683s (+0.5s)	1608	1608	128	39	125	5	0	169
11941	7684s (+0.8s)	3260	3260	256	68	186	13	0	267
11942	7684s (+0.5s)	1744	1744	128	44	120	11	0	175
11943	7685s (+1.0s)	4200	4200	256	81	248	11	0	340
11944	7686s (+0.3s)	880	880	64	26	76	4	0	106
11945	7686s (+0.4s)	1392	1392	64	41	106	8	1	156
11946	7687s (+0.7s)	2912	2912	256	67	178	9	0	254
11947	7687s (+0.6s)	1920	1920	128	35	156	7	0	198
11948	7688s (+0.6s)	2492	2492	256	44	160	11	0	215
11949	7689s (+0.8s)	3604	3604	256	89	196	19	0	304
11950	7689s (+0.5s)	1516	1516	128	40	114	8	0	162
11951	7690s (+0.3s)	752	752	64	22	73	6	0	101
11952	7690s (+0.8s)	3456	3456	256	60	210	18	0	288
11953	7691s (+0.4s)	1400	1400	128	28	110	6	0	144
11954	7692s (+1.0s)	4260	4260	256	84	249	14	1	348
11955	7692s (+0.4s)	1340	1340	128	31	98	7	0	136
11956	7693s (+0.7s)	2872	2872	256	64	172	8	0	244
11957	7694s (+0.9s)	4000	4000	256	55	261	0	18	334
11958	7695s (+0.6s)	2540	2540	256	43	171	0	8	222
11959	7695s (+0.7s)	3296	3296	256	53	209	0	14	276
11960	7696s (+0.8s)	3280	3280	256	53	217	0	8	278
11961	7697s (+0.5s)	1592	1592	128	27	133	0	6	166
11962	7697s (+0.5s)	1496	1496	128	39	109	0	9	157
11963	7698s (+0.9s)	3692	3692	256	59	231	0	16	306
11964	7698s (+0.4s)	1340	1340	128	27	110	0	3	140
11965	7699s (+0.5s)	1764	1764	128	29	141	0	11	181
11966	7699s (+0.6s)	2420	2420	256	48	145	8	0	201
11967	7700s (+0.7s)	2860	2860	256	52	172	8	0	232
11968	7701s (+0.5s)	1688	1688	128	43	122	7	0	172
11969	7701s (+0.9s)	3916	3916	256	85	218	17	0	320
11970	7702s (+0.4s)	1456	1456	128	30	116	3	0	149
11971	7702s (+0.5s)	1596	1596	128	39	121	6	0	166
11972	7703s (+0.5s)	1896	1896	128	52	118	9	0	179
11973	7703s (+0.4s)	1340	1340	128	38	91	7	0	136
11974	7704s (+0.6s)	2376	2376	128	47	162	12	0	221
11975	7704s (+0.5s)	1752	1752	128	32	142	5	0	179
11976	7705s (+0.8s)	3572	3572	256	80	213	14	0	307
11977	7706s (+0.6s)	2448	2448	256	41	156	8	0	205
11978	7706s (+0.5s)	1800	1800	128	41	139	6	0	186
11979	7707s (+0.7s)	3060	3060	256	50	190	10	1	251
11980	7708s (+0.5s)	1840	1840	128	40	134	10	0	184
11981	7708s (+0.9s)	3668	3668	256	69	220	15	0	304
11982	7710s (+1.2s)	6060	6060	512	134	269	30	0	433
11983	7711s (+0.9s)	4768	4768	512	82	224	16	0	322
11984	7711s (+0.7s)	3220	3220	256	76	184	8	0	268
11985	7712s (+0.4s)	1340	1340	128	38	101	6	0	145
11986	7712s (+0.4s)	1128	1128	128	30	89	5	0	124
11987	7713s (+0.7s)	2760	2760	256	52	175	12	0	239
11988	7713s (+0.3s)	1000	1000	128	13	89	3	0	105
11989	7714s (+1.4s)	6608	6608	512	116	339	23	0	478
11990	7715s (+0.8s)	3116	3116	256	78	181	11	0	270
11991	7716s (+0.6s)	2660	2660	256	52	165	9	0	226
11992	7717s (+0.9s)	3660	3660	256	92	213	7	0	312
11993	7717s (+0.4s)	1336	1336	128	28	100	7	1	136
11994	7718s (+0.6s)	2140	2140	128	59	142	13	0	214
11995	7719s (+0.7s)	2800	2800	256	61	176	6	0	243
11996	7719s (+0.8s)	3376	3376	256	82	175	18	0	275
11997	7720s (+0.5s)	1604	1604	128	37	126	5	0	168
11998	7720s (+0.3s)	1212	1212	128	27	92	6	0	125
11999	7720s (+0.3s)	928	928	128	21	73	5	0	99
Episode	Time	Reward	Score	Highest	L	U	R	D	Steps
12000	7721s (+0.7s)	3068	3068	256	63	179	10	0	252
12001	7722s (+0.6s)	2456	2456	256	57	142	11	0	210
12002	7722s (+0.7s)	2860	2860	256	65	166	16	0	247
12003	7723s (+0.9s)	4064	4064	256	89	226	19	0	334
12004	7724s (+0.6s)	2344	2344	256	43	148	8	0	199
12005	7725s (+0.6s)	2060	2060	128	50	142	10	0	202
12006	7725s (+0.8s)	3412	3412	256	66	208	10	0	284
12007	7726s (+0.7s)	3060	3060	256	61	185	9	0	255
12008	7727s (+0.4s)	1380	1380	64	35	111	8	0	154
12009	7727s (+0.8s)	3492	3492	256	66	213	14	0	293
12010	7728s (+0.4s)	1592	1592	128	29	124	3	0	156
12011	7728s (+0.4s)	1484	1484	128	37	110	8	0	155
12012	7729s (+0.9s)	4052	4052	256	72	236	17	0	325
12013	7730s (+0.5s)	2288	2288	256	42	139	9	0	190
12014	7730s (+0.2s)	536	536	64	14	56	3	0	73
12015	7731s (+0.5s)	1780	1780	128	48	122	8	0	178
12016	7731s (+0.6s)	2132	2132	128	44	147	9	1	201
12017	7732s (+0.4s)	1476	1476	128	34	114	5	0	153
12018	7732s (+0.6s)	2576	2576	256	60	152	12	0	224
12019	7733s (+0.5s)	1688	1688	128	43	121	9	1	174
12020	7733s (+0.8s)	3460	3460	256	81	190	13	0	284
12021	7734s (+0.8s)	3232	3232	256	69	191	11	0	271
12022	7735s (+0.6s)	2484	2484	256	35	170	8	1	214
12023	7735s (+0.4s)	1592	1592	128	47	107	5	0	159
12024	7736s (+0.5s)	1896	1896	128	49	124	16	0	189
12025	7736s (+0.5s)	1532	1532	128	39	120	3	0	162
12026	7737s (+0.7s)	3084	3084	256	67	174	14	0	255
12027	7738s (+0.6s)	2532	2532	256	57	150	12	0	219
12028	7738s (+0.5s)	1808	1808	128	42	131	7	0	180
12029	7739s (+0.6s)	1920	1920	128	43	146	9	0	198
12030	7740s (+0.9s)	3992	3992	256	67	248	0	18	333
12031	7740s (+0.7s)	3220	3220	256	71	185	0	12	268
12032	7741s (+0.4s)	1192	1192	128	21	103	0	7	131
12033	7742s (+0.7s)	2640	2640	256	39	187	0	5	231
12034	7742s (+0.2s)	644	644	64	12	71	0	5	88
12035	7742s (+0.4s)	1524	1524	128	30	120	0	2	152
12036	7743s (+0.8s)	3284	3284	256	50	208	0	16	274
12037	7743s (+0.4s)	1536	1536	128	31	119	0	12	162
12038	7744s (+0.8s)	3188	3188	256	55	198	0	13	266
12039	7745s (+0.7s)	2540	2540	128	57	166	0	15	238
12040	7746s (+0.8s)	3208	3208	256	63	189	0	12	264
12041	7746s (+0.7s)	3092	3092	256	62	189	0	11	262
12042	7747s (+0.4s)	1116	1116	64	29	95	0	7	131
12043	7747s (+0.5s)	1660	1660	128	30	136	0	5	171
12044	7748s (+0.8s)	3232	3232	256	54	203	0	14	271
12045	7749s (+0.8s)	3248	3248	256	65	196	0	13	274
12046	7749s (+0.5s)	1760	1760	128	38	131	10	0	179
12047	7750s (+0.7s)	2976	2976	256	73	184	8	0	265
12048	7750s (+0.3s)	808	808	64	19	86	4	0	109
12049	7752s (+1.1s)	5776	5776	512	103	279	21	0	403
12050	7752s (+0.7s)	2948	2948	256	39	195	7	0	241
12051	7753s (+0.4s)	1408	1408	128	27	115	7	0	149
12052	7753s (+0.6s)	2680	2680	256	50	168	12	0	230
12053	7754s (+0.3s)	1000	1000	64	26	87	5	0	118
12054	7754s (+0.7s)	2840	2840	256	72	160	13	0	245
12055	7755s (+0.5s)	2240	2240	256	29	156	5	0	190
12056	7756s (+1.3s)	6552	6552	512	141	295	26	0	462
12057	7757s (+0.9s)	3744	3744	256	79	216	15	1	311
12058	7758s (+0.5s)	1960	1960	128	39	145	0	10	194
12059	7759s (+1.0s)	4324	4324	256	97	242	21	0	360
12060	7759s (+0.4s)	1272	1272	128	42	90	6	0	138
12061	7760s (+0.5s)	1756	1756	128	39	131	5	0	175
12062	7760s (+0.6s)	2076	2076	128	50	136	9	1	196
12063	7761s (+0.6s)	2532	2532	256	63	148	13	0	224
12064	7762s (+1.0s)	4440	4440	256	122	224	17	0	363
12065	7762s (+0.4s)	1144	1144	128	35	86	2	0	123
12066	7763s (+0.5s)	1500	1500	128	32	117	9	0	158
12067	7764s (+1.0s)	4248	4248	256	89	245	18	0	352
12068	7764s (+0.5s)	1828	1828	128	48	130	9	0	187
12069	7765s (+0.5s)	1632	1632	128	43	112	10	0	165
12070	7765s (+0.4s)	1348	1348	128	27	100	6	0	133
12071	7766s (+0.5s)	1628	1628	128	30	127	0	7	164
12072	7766s (+0.6s)	2372	2372	256	53	141	0	9	203
12073	7767s (+0.7s)	3212	3212	256	57	196	0	13	266
12074	7767s (+0.4s)	1292	1292	128	24	103	0	3	130
12075	7768s (+0.5s)	1800	1800	128	39	138	0	8	185
12076	7768s (+0.3s)	1008	1008	128	20	83	0	6	109
12077	7769s (+0.6s)	1932	1932	128	31	158	0	12	201
12078	7769s (+0.7s)	2732	2732	128	55	181	0	14	250
12079	7770s (+0.4s)	1388	1388	128	46	94	7	0	147
12080	7770s (+0.4s)	1120	1120	64	38	88	7	0	133
12081	7771s (+0.3s)	724	724	64	20	71	6	1	98
12082	7771s (+0.7s)	2644	2644	128	70	170	15	0	255
12083	7772s (+0.6s)	2276	2276	128	58	158	10	0	226
12084	7773s (+0.8s)	3332	3332	256	69	201	9	0	279
12085	7773s (+0.5s)	1776	1776	128	39	133	8	0	180
12086	7774s (+0.3s)	1032	1032	128	21	83	5	0	109
12087	7775s (+1.2s)	5768	5768	512	109	286	18	0	413
12088	7775s (+0.4s)	1176	1176	64	34	97	7	0	138
12089	7776s (+0.6s)	1892	1892	128	43	140	9	1	193
12090	7776s (+0.4s)	1444	1444	128	36	110	4	0	150
12091	7777s (+0.5s)	1412	1412	64	42	102	13	0	157
12092	7777s (+0.5s)	1636	1636	128	24	136	0	6	166
12093	7778s (+0.5s)	1736	1736	128	41	127	12	0	180
12094	7778s (+0.5s)	1780	1780	128	46	124	10	0	180
12095	7779s (+0.6s)	1912	1912	128	43	144	9	0	196
12096	7779s (+0.7s)	2892	2892	256	52	188	9	0	249
12097	7780s (+0.5s)	1584	1584	128	36	118	0	10	164
12098	7780s (+0.5s)	1776	1776	128	36	136	0	7	179
12099	7781s (+0.6s)	2504	2504	256	52	149	12	0	213
Episode	Time	Reward	Score	Highest	L	U	R	D	Steps
12100	7782s (+0.8s)	3504	3504	256	76	209	10	0	295
12101	7783s (+0.9s)	3832	3832	256	88	205	16	0	309
12102	7783s (+0.6s)	1968	1968	128	61	119	14	1	195
12103	7784s (+0.3s)	1024	1024	64	24	94	4	0	122
12104	7784s (+0.6s)	2704	2704	256	61	152	8	0	221
12105	7785s (+0.5s)	1544	1544	128	40	115	10	0	165
12106	7785s (+0.5s)	1840	1840	128	36	138	8	1	183
12107	7786s (+0.9s)	3792	3792	256	104	188	20	0	312
12108	7787s (+0.8s)	2988	2988	256	88	172	8	0	268
12109	7788s (+0.7s)	2748	2748	256	64	165	12	0	241
12110	7788s (+0.7s)	2616	2616	256	58	156	15	0	229
12111	7789s (+0.3s)	568	568	32	26	57	4	0	87
12112	7789s (+0.8s)	3396	3396	256	62	197	21	0	280
12113	7790s (+0.8s)	3340	3340	256	59	211	11	0	281
12114	7791s (+0.4s)	1316	1316	128	36	92	7	0	135
12115	7791s (+0.4s)	1428	1428	128	49	99	7	1	156
12116	7792s (+0.7s)	2772	2772	256	57	168	11	0	236
12117	7792s (+0.5s)	1652	1652	128	44	113	12	0	169
12118	7793s (+0.4s)	1368	1368	128	27	110	6	0	143
12119	7793s (+0.4s)	1336	1336	128	33	104	7	0	144
12120	7794s (+0.5s)	1780	1780	128	47	126	7	0	180
12121	7795s (+0.9s)	3592	3592	256	65	223	12	1	301
12122	7795s (+0.8s)	3208	3208	256	62	192	11	0	265
12123	7796s (+0.8s)	3344	3344	256	74	184	14	0	272
12124	7796s (+0.4s)	1488	1488	128	39	103	8	0	150
12125	7797s (+0.5s)	1780	1780	128	44	127	8	0	179
12126	7797s (+0.5s)	1764	1764	128	35	137	0	9	181
12127	7798s (+0.7s)	3052	3052	256	41	202	0	15	258
12128	7799s (+0.4s)	1172	1172	128	40	83	7	0	130
12129	7799s (+0.6s)	2616	2616	256	64	149	13	0	226
12130	7800s (+0.8s)	3204	3204	256	58	198	13	1	270
12131	7801s (+0.6s)	2360	2360	256	38	154	7	0	199
12132	7801s (+0.6s)	1940	1940	128	45	151	7	0	203
12133	7802s (+0.8s)	3500	3500	256	73	205	15	1	294
12134	7803s (+0.8s)	3676	3676	256	82	201	19	0	302
12135	7803s (+0.4s)	1388	1388	128	27	109	5	0	141
12136	7804s (+0.7s)	2680	2680	256	60	159	10	0	229
12137	7804s (+0.5s)	1500	1500	128	34	122	3	0	159
12138	7805s (+0.5s)	1600	1600	128	40	119	8	0	167
12139	7806s (+0.7s)	2668	2668	256	48	169	13	0	230
12140	7806s (+0.4s)	1208	1208	64	37	104	3	0	144
12141	7807s (+0.5s)	1844	1844	128	43	125	9	0	177
12142	7807s (+0.7s)	3068	3068	256	66	182	14	0	262
12143	7808s (+0.7s)	2852	2852	256	62	167	16	0	245
12144	7809s (+0.9s)	3972	3972	256	83	231	13	0	327
12145	7810s (+0.7s)	3216	3216	256	58	192	14	0	264
12146	7810s (+0.6s)	1908	1908	128	47	142	6	0	195
12147	7811s (+0.3s)	820	820	64	26	74	6	0	106
12148	7812s (+1.0s)	4296	4296	256	109	227	14	0	350
12149	7813s (+1.0s)	4292	4292	256	70	256	0	22	348
12150	7813s (+0.3s)	988	988	64	32	81	0	4	117
12151	7814s (+0.9s)	4044	4044	256	87	231	15	0	333
12152	7815s (+0.8s)	4444	4444	512	57	224	11	0	292
12153	7815s (+0.5s)	1608	1608	128	39	124	6	0	169
12154	7815s (+0.4s)	1328	1328	128	43	85	5	0	133
12155	7816s (+0.8s)	3320	3320	256	60	204	13	0	277
12156	7817s (+0.5s)	1644	1644	128	43	124	6	0	173
12157	7817s (+0.4s)	1504	1504	128	49	103	8	0	160
12158	7818s (+0.5s)	1516	1516	128	37	118	7	0	162
12159	7818s (+0.8s)	3492	3492	256	78	203	11	0	292
12160	7819s (+0.9s)	3816	3816	256	66	231	12	0	309
12161	7820s (+0.4s)	1336	1336	128	38	94	7	0	139
12162	7820s (+0.6s)	2744	2744	256	56	161	13	0	230
12163	7821s (+0.7s)	3000	3000	256	68	179	9	0	256
12164	7822s (+0.7s)	3184	3184	256	59	190	14	0	263
12165	7822s (+0.4s)	1512	1512	128	38	106	11	0	155
12166	7823s (+0.8s)	3196	3196	256	65	196	6	0	267
12167	7824s (+0.7s)	2864	2864	256	46	182	11	0	239
12168	7824s (+0.7s)	2488	2488	128	60	159	13	1	233
12169	7825s (+0.3s)	872	872	64	33	75	6	0	114
12170	7826s (+0.7s)	2648	2648	128	80	143	17	1	241
12171	7826s (+0.5s)	1736	1736	128	44	128	8	0	180
12172	7827s (+0.7s)	2872	2872	256	72	163	14	0	249
12173	7828s (+1.0s)	4228	4228	256	81	247	19	0	347
12174	7829s (+1.1s)	5408	5408	512	101	259	17	0	377
12175	7829s (+0.5s)	1600	1600	128	54	105	9	0	168
12176	7830s (+0.5s)	1780	1780	128	42	132	7	0	181
12177	7830s (+0.4s)	1480	1480	128	33	116	5	0	154
12178	7831s (+0.7s)	2748	2748	256	51	173	10	0	234
12179	7831s (+0.5s)	2144	2144	256	32	141	8	1	182
12180	7832s (+0.4s)	972	972	64	31	94	4	0	129
12181	7833s (+0.9s)	3636	3636	256	90	207	15	0	312
12182	7833s (+0.7s)	3096	3096	256	61	186	12	0	259
12183	7834s (+0.3s)	720	720	64	24	67	2	0	93
12184	7835s (+0.9s)	3908	3908	256	94	212	17	0	323
12185	7836s (+1.0s)	4604	4604	256	96	271	13	1	381
12186	7837s (+0.9s)	3468	3468	256	70	211	10	0	291
12187	7837s (+0.5s)	1732	1732	128	42	133	4	0	179
12188	7838s (+0.6s)	2092	2092	128	53	139	13	1	206
12189	7839s (+1.2s)	6204	6204	512	109	283	25	0	417
12190	7840s (+1.0s)	4604	4604	256	96	244	20	1	361
12191	7841s (+0.9s)	3832	3832	256	64	228	0	17	309
12192	7841s (+0.4s)	1360	1360	128	26	108	0	7	141
12193	7842s (+0.8s)	3468	3468	256	78	191	17	0	286
12194	7843s (+0.5s)	1788	1788	128	44	133	9	0	186
12195	7843s (+0.4s)	1380	1380	128	42	100	7	0	149
12196	7844s (+0.5s)	1836	1836	128	38	140	6	1	185
12197	7844s (+0.6s)	1920	1920	128	44	144	10	0	198
12198	7845s (+0.5s)	1556	1556	128	34	126	7	0	167
12199	7845s (+0.5s)	1800	1800	128	38	140	0	6	184
Episode	Time	Reward	Score	Highest	L	U	R	D	Steps
12200	7846s (+0.6s)	1920	1920	128	36	154	0	9	199
12201	7846s (+0.4s)	1288	1288	128	20	108	0	5	133
12202	7847s (+0.9s)	4040	4040	256	70	253	0	9	332
12203	7848s (+0.8s)	3472	3472	256	74	212	13	0	299
12204	7849s (+0.7s)	3128	3128	256	66	187	8	0	261
12205	7849s (+0.5s)	2284	2284	256	35	150	5	0	190
12206	7850s (+0.6s)	2636	2636	256	56	156	13	0	225
12207	7850s (+0.2s)	532	532	64	25	50	3	0	78
12208	7850s (+0.3s)	1196	1196	128	25	94	4	0	123
12209	7851s (+0.9s)	3716	3716	256	70	223	16	0	309
12210	7852s (+0.5s)	1776	1776	128	42	135	7	0	184
12211	7852s (+0.5s)	1788	1788	128	53	122	6	0	181
12212	7853s (+1.1s)	5772	5772	512	116	270	23	0	409
12213	7854s (+0.7s)	2876	2876	256	71	177	9	0	257
12214	7854s (+0.3s)	780	780	64	21	76	6	0	103
12215	7855s (+0.7s)	2940	2940	256	57	196	8	0	261
12216	7856s (+0.5s)	2184	2184	256	38	141	7	0	186
12217	7857s (+1.1s)	5036	5036	256	96	274	15	1	386
12218	7858s (+0.7s)	2868	2868	256	53	170	10	1	234
12219	7858s (+0.6s)	2504	2504	256	42	166	9	0	217
12220	7859s (+0.4s)	1360	1360	128	35	102	5	0	142
12221	7859s (+0.9s)	3828	3828	256	80	212	16	0	308
12222	7860s (+0.7s)	2852	2852	256	53	180	11	0	244
12223	7861s (+0.5s)	1676	1676	128	43	118	11	0	172
12224	7861s (+0.6s)	2140	2140	128	51	148	15	0	214
12225	7862s (+0.8s)	3376	3376	256	73	187	15	1	276
12226	7863s (+0.9s)	4744	4744	512	78	241	13	0	332
12227	7863s (+0.3s)	780	780	64	27	73	3	0	103
12228	7865s (+1.3s)	6208	6208	512	118	306	19	0	443
12229	7865s (+0.6s)	2468	2468	256	49	155	9	1	214
12230	7866s (+0.3s)	900	900	64	27	86	3	0	116
12231	7866s (+0.8s)	3364	3364	256	61	205	11	0	277
12232	7867s (+0.8s)	3336	3336	256	74	196	10	1	281
12233	7868s (+1.0s)	4424	4424	256	101	244	19	0	364
12234	7869s (+0.5s)	1624	1624	128	40	123	10	0	173
12235	7870s (+0.9s)	3992	3992	256	90	222	20	0	332
12236	7870s (+0.7s)	2672	2672	256	58	157	13	0	228
12237	7871s (+0.3s)	912	912	64	38	77	4	0	119
12238	7871s (+0.6s)	2116	2116	128	58	128	14	0	200
12239	7872s (+0.6s)	2600	2600	256	55	161	9	0	225
12240	7872s (+0.6s)	2368	2368	256	54	138	9	0	201
12241	7873s (+0.5s)	1876	1876	128	50	128	13	0	191
12242	7874s (+0.7s)	2616	2616	256	60	157	12	0	229
12243	7874s (+0.5s)	1864	1864	128	45	134	9	0	188
12244	7875s (+0.5s)	1584	1584	128	35	130	5	0	170
12245	7875s (+0.3s)	812	812	64	26	74	3	0	103
12246	7876s (+1.4s)	7064	7064	512	150	319	23	0	492
12247	7877s (+0.5s)	1788	1788	128	37	139	6	0	182
12248	7877s (+0.5s)	1780	1780	128	47	132	5	0	184
12249	7878s (+0.6s)	1904	1904	128	50	138	6	0	194
12250	7879s (+0.9s)	3988	3988	256	84	234	13	0	331
12251	7879s (+0.4s)	1496	1496	128	24	119	6	0	149
12252	7880s (+0.4s)	1456	1456	128	40	102	8	0	150
12253	7881s (+1.0s)	4200	4200	256	94	229	18	0	341
12254	7881s (+0.4s)	1540	1540	128	37	112	8	0	157
12255	7882s (+0.4s)	1464	1464	128	36	105	6	0	147
12256	7882s (+0.7s)	3208	3208	256	70	179	16	0	265
12257	7883s (+0.4s)	1520	1520	128	36	120	7	0	163
12258	7884s (+0.8s)	3260	3260	256	88	172	11	1	272
12259	7884s (+0.7s)	3004	3004	256	62	177	13	0	252
12260	7885s (+0.7s)	2928	2928	256	67	169	18	0	254
12261	7886s (+1.1s)	5644	5644	512	104	270	21	0	395
12262	7887s (+0.9s)	3956	3956	256	70	240	14	0	324
12263	7888s (+0.9s)	3680	3680	256	90	211	16	0	317
12264	7889s (+0.5s)	1528	1528	128	29	130	6	0	165
12265	7890s (+0.9s)	5000	5000	512	84	236	11	0	331
12266	7890s (+0.8s)	3508	3508	256	75	200	16	0	291
12267	7891s (+0.4s)	1324	1324	64	42	100	7	1	150
12268	7892s (+0.8s)	3344	3344	256	80	187	16	0	283
12269	7892s (+0.6s)	2612	2612	256	52	169	7	0	228
12270	7893s (+0.5s)	1764	1764	128	36	130	4	0	170
12271	7893s (+0.3s)	876	876	64	29	79	6	0	114
12272	7894s (+0.5s)	2360	2360	256	45	139	8	0	192
12273	7894s (+0.3s)	1124	1124	128	23	90	6	0	119
12274	7895s (+0.5s)	1920	1920	128	54	133	10	1	198
12275	7895s (+0.3s)	988	988	128	22	81	2	0	105
12276	7895s (+0.5s)	2316	2316	256	59	119	14	0	192
12277	7896s (+0.7s)	2924	2924	256	63	185	9	0	257
12278	7897s (+1.1s)	4656	4656	256	132	237	25	0	394
12279	7898s (+0.5s)	1768	1768	128	45	128	5	0	178
12280	7898s (+0.7s)	2864	2864	256	53	176	0	19	248
12281	7899s (+0.3s)	836	836	64	19	80	0	2	101
12282	7899s (+0.6s)	2404	2404	256	40	158	0	4	202
12283	7900s (+0.9s)	3952	3952	256	78	230	15	0	323
12284	7901s (+0.4s)	1444	1444	128	46	98	6	0	150
12285	7901s (+0.3s)	1120	1120	128	18	99	2	0	119
12286	7901s (+0.3s)	904	904	64	30	72	5	1	108
12287	7902s (+0.6s)	2260	2260	128	50	148	0	11	209
12288	7902s (+0.5s)	1712	1712	128	39	132	6	0	177
12289	7903s (+0.3s)	888	888	64	29	75	9	0	113
12290	7903s (+0.7s)	2652	2652	256	44	173	9	0	226
12291	7904s (+1.0s)	5088	5088	512	104	232	24	0	360
12292	7905s (+0.6s)	2236	2236	128	39	161	6	2	208
12293	7906s (+0.5s)	1972	1972	128	51	134	6	1	192
12294	7906s (+0.6s)	2132	2132	128	64	129	15	0	208
12295	7907s (+0.5s)	1616	1616	128	40	123	7	0	170
12296	7907s (+0.5s)	1864	1864	128	28	158	0	4	190
12297	7908s (+0.8s)	3316	3316	256	64	201	0	12	277
12298	7909s (+0.7s)	2896	2896	256	56	185	0	10	251
12299	7910s (+0.8s)	3424	3424	256	58	213	0	16	287
Episode	Time	Reward	Score	Highest	L	U	R	D	Steps
12300	7910s (+0.5s)	1792	1792	128	41	135	0	8	184
12301	7911s (+0.4s)	1404	1404	128	29	105	0	10	144
12302	7911s (+0.6s)	2508	2508	256	46	154	0	9	209
12303	7912s (+0.9s)	3620	3620	256	77	215	19	0	311
12304	7912s (+0.2s)	576	576	64	14	65	2	0	81
12305	7913s (+0.7s)	3292	3292	256	60	202	9	0	271
12306	7914s (+0.6s)	2604	2604	256	57	159	10	0	226
12307	7915s (+1.0s)	4380	4380	256	93	252	19	0	364
12308	7915s (+0.4s)	1180	1180	128	27	96	5	0	128
12309	7916s (+0.6s)	2152	2152	128	57	146	7	0	210
12310	7917s (+0.8s)	4548	4548	512	69	223	10	0	302
12311	7917s (+0.5s)	1896	1896	128	50	136	6	0	192
12312	7918s (+0.4s)	1500	1500	128	26	125	6	1	158
12313	7918s (+0.4s)	1476	1476	128	34	113	5	0	152
12314	7919s (+0.5s)	1568	1568	64	52	100	12	0	164
12315	7919s (+0.9s)	3916	3916	256	87	215	17	0	319
12316	7920s (+0.5s)	2316	2316	256	39	146	8	0	193
12317	7921s (+0.7s)	2980	2980	256	63	180	16	1	260
12318	7922s (+0.8s)	3356	3356	256	61	211	13	0	285
12319	7923s (+1.0s)	4768	4768	512	72	247	15	1	335
12320	7923s (+0.4s)	1528	1528	128	31	125	4	0	160
12321	7923s (+0.3s)	716	716	64	22	68	6	0	96
12322	7924s (+0.5s)	1920	1920	128	57	116	11	0	184
12323	7925s (+0.7s)	2612	2612	128	69	163	16	1	249
12324	7925s (+0.5s)	1576	1576	128	42	111	12	1	166
12325	7926s (+0.6s)	2364	2364	128	45	165	9	1	220
12326	7927s (+0.9s)	3860	3860	256	79	222	15	0	316
12327	7927s (+0.7s)	3188	3188	256	71	179	15	0	265
12328	7928s (+0.7s)	2660	2660	128	64	171	9	0	244
12329	7928s (+0.5s)	1704	1704	128	48	119	6	0	173
12330	7929s (+0.3s)	808	808	64	27	70	6	0	103
12331	7929s (+0.4s)	1416	1416	128	29	115	6	0	150
12332	7930s (+0.5s)	1912	1912	128	54	135	7	0	196
12333	7930s (+0.3s)	904	904	64	32	82	3	0	117
12334	7931s (+0.5s)	2056	2056	256	25	142	6	0	173
12335	7931s (+0.6s)	2404	2404	256	35	161	0	12	208
12336	7932s (+0.6s)	2744	2744	256	54	166	0	11	231
12337	7932s (+0.6s)	1888	1888	128	41	149	0	5	195
12338	7933s (+0.4s)	1384	1384	128	29	103	0	8	140
12339	7933s (+0.3s)	788	788	64	18	77	0	4	99
12340	7934s (+0.9s)	3552	3552	256	72	218	12	0	302
12341	7935s (+0.9s)	3892	3892	256	79	235	14	0	328
12342	7936s (+1.0s)	4040	4040	256	80	249	10	0	339
12343	7936s (+0.3s)	1084	1084	128	23	95	2	0	120
12344	7937s (+0.3s)	904	904	64	25	79	3	0	107
12345	7937s (+0.6s)	2196	2196	128	45	150	9	0	204
12346	7938s (+0.8s)	3232	3232	256	66	195	10	0	271
12347	7939s (+0.7s)	2752	2752	128	72	171	12	0	255
12348	7939s (+0.4s)	1200	1200	64	42	87	7	0	136
12349	7939s (+0.3s)	904	904	64	30	80	7	0	117
12350	7940s (+0.5s)	1640	1640	128	37	133	6	0	176
12351	7941s (+1.1s)	4640	4640	256	105	263	21	1	390
12352	7942s (+0.7s)	2904	2904	256	61	178	13	0	252
12353	7943s (+0.8s)	3300	3300	256	60	202	0	11	273
12354	7944s (+1.0s)	5048	5048	512	97	243	0	16	356
12355	7944s (+0.6s)	2484	2484	256	54	155	0	5	214
12356	7945s (+0.5s)	1772	1772	128	34	138	0	8	180
12357	7945s (+0.3s)	1140	1140	128	25	93	0	6	124
12358	7946s (+0.6s)	2640	2640	256	55	158	0	12	225
12359	7946s (+0.4s)	1420	1420	128	30	110	0	4	144
12360	7947s (+0.5s)	2248	2248	256	45	130	0	12	187
12361	7947s (+0.7s)	2724	2724	256	49	174	0	8	231
12362	7948s (+0.7s)	2844	2844	256	56	182	0	11	249
12363	7948s (+0.4s)	1208	1208	128	35	85	8	0	128
12364	7949s (+0.9s)	3988	3988	256	81	224	20	0	325
12365	7950s (+0.6s)	2088	2088	128	68	125	15	0	208
12366	7950s (+0.5s)	1832	1832	128	53	120	8	1	182
12367	7951s (+0.3s)	864	864	64	27	80	4	0	111
12368	7952s (+0.8s)	3648	3648	256	76	206	13	0	295
12369	7952s (+0.7s)	2688	2688	256	61	154	16	0	231
12370	7953s (+0.8s)	3524	3524	256	80	198	17	0	295
12371	7954s (+0.8s)	3600	3600	256	68	211	20	3	302
12372	7955s (+0.6s)	2476	2476	256	58	148	10	0	216
12373	7955s (+0.7s)	2736	2736	256	56	170	6	1	233
12374	7956s (+0.6s)	2716	2716	256	57	166	6	0	229
12375	7957s (+0.8s)	3340	3340	256	69	195	14	0	278
12376	7957s (+0.7s)	2652	2652	256	56	173	9	0	238
12377	7958s (+0.6s)	1888	1888	128	38	148	9	0	195
12378	7959s (+0.8s)	3556	3556	256	93	185	18	0	296
12379	7960s (+0.9s)	3548	3548	256	71	218	12	0	301
12380	7960s (+0.2s)	604	604	64	12	65	0	4	81
12381	7960s (+0.2s)	572	572	64	14	64	0	0	78
12382	7961s (+0.8s)	3508	3508	256	74	207	11	0	292
12383	7962s (+0.8s)	3496	3496	256	70	204	18	0	292
12384	7963s (+0.9s)	3956	3956	256	92	208	13	1	314
12385	7964s (+1.2s)	5748	5748	512	124	263	20	1	408
12386	7964s (+0.5s)	1768	1768	128	34	136	8	0	178
12387	7965s (+0.5s)	1832	1832	128	44	136	8	0	188
12388	7966s (+0.8s)	3348	3348	256	77	190	16	0	283
12389	7967s (+0.8s)	3420	3420	256	72	199	14	0	285
12390	7967s (+0.5s)	1820	1820	128	44	136	5	0	185
12391	7968s (+0.4s)	1244	1244	64	38	95	10	0	143
12392	7968s (+0.6s)	2536	2536	256	63	143	9	0	215
12393	7969s (+0.7s)	3172	3172	256	56	195	10	0	261
12394	7969s (+0.5s)	1700	1700	128	41	122	7	0	170
12395	7970s (+0.4s)	1332	1332	128	29	109	1	0	139
12396	7970s (+0.5s)	1612	1612	128	29	136	5	0	170
12397	7971s (+0.6s)	2604	2604	256	57	158	10	1	226
12398	7972s (+0.9s)	3780	3780	256	106	197	17	0	320
12399	7972s (+0.4s)	1484	1484	128	37	110	8	0	155
Episode	Time	Reward	Score	Highest	L	U	R	D	Steps
12400	7973s (+0.4s)	1148	1148	64	31	102	2	0	135
12401	7974s (+1.0s)	4940	4940	512	84	240	18	0	342
12402	7974s (+0.4s)	1188	1188	64	35	103	6	0	144
12403	7975s (+0.8s)	3252	3252	256	81	184	11	0	276
12404	7976s (+0.9s)	3980	3980	256	82	231	16	0	329
12405	7976s (+0.7s)	2864	2864	256	61	176	10	0	247
12406	7977s (+0.5s)	1832	1832	128	49	126	7	0	182
12407	7977s (+0.4s)	1132	1132	64	49	80	5	0	134
12408	7978s (+0.7s)	2884	2884	256	53	175	9	0	237
12409	7979s (+0.6s)	2788	2788	256	53	163	8	0	224
12410	7980s (+0.8s)	3328	3328	256	64	197	17	0	278
12411	7980s (+0.5s)	1668	1668	128	41	124	5	0	170
12412	7981s (+1.0s)	4260	4260	256	85	255	15	0	355
12413	7982s (+0.7s)	2808	2808	256	72	162	11	0	245
12414	7982s (+0.5s)	1760	1760	128	39	124	12	1	176
12415	7983s (+1.0s)	4228	4228	256	95	230	21	1	347
12416	7984s (+0.3s)	760	760	64	18	82	2	0	102
12417	7985s (+1.0s)	4300	4300	256	82	257	14	0	353
12418	7985s (+0.6s)	2416	2416	256	55	145	8	0	208
12419	7986s (+0.6s)	2652	2652	256	55	151	16	0	222
12420	7987s (+1.0s)	4380	4380	256	107	239	19	0	365
12421	7988s (+0.6s)	2596	2596	256	54	160	10	0	224
12422	7988s (+0.6s)	1888	1888	128	43	140	8	1	192
12423	7989s (+0.8s)	3368	3368	256	69	212	7	0	288
12424	7990s (+0.8s)	3552	3552	256	85	200	11	0	296
12425	7991s (+0.8s)	3624	3624	256	49	234	0	12	295
12426	7991s (+0.8s)	3520	3520	256	57	224	0	14	295
12427	7992s (+0.7s)	3180	3180	256	51	200	0	8	259
12428	7993s (+0.6s)	2336	2336	256	51	136	9	0	196
12429	7993s (+0.6s)	2616	2616	256	39	171	8	0	218
12430	7994s (+0.7s)	2580	2580	128	76	151	13	0	240
12431	7994s (+0.4s)	1156	1156	64	39	81	6	0	126
12432	7995s (+0.8s)	3384	3384	256	75	193	9	0	277
12433	7996s (+0.7s)	2796	2796	256	55	180	6	0	241
12434	7996s (+0.4s)	1268	1268	128	21	108	1	0	130
12435	7997s (+0.8s)	3408	3408	256	70	198	15	0	283
12436	7998s (+0.5s)	1636	1636	128	41	126	5	0	172
12437	7998s (+0.6s)	1944	1944	128	49	144	7	0	200
12438	7999s (+1.2s)	5820	5820	512	117	276	21	0	414
12439	8000s (+0.5s)	1640	1640	128	47	119	6	0	172
12440	8000s (+0.4s)	1116	1116	64	28	98	0	6	132
12441	8001s (+0.8s)	3236	3236	256	61	201	0	10	272
12442	8002s (+0.8s)	3416	3416	256	53	216	0	16	285
12443	8003s (+0.7s)	2616	2616	256	74	141	13	0	228
12444	8003s (+0.5s)	1716	1716	128	36	120	13	0	169
12445	8004s (+0.7s)	3172	3172	256	57	191	10	0	258
12446	8004s (+0.7s)	2796	2796	256	52	177	13	0	242
12447	8005s (+0.9s)	3732	3732	256	82	213	15	0	310
12448	8006s (+0.8s)	3368	3368	256	99	172	17	0	288
12449	8007s (+0.7s)	2804	2804	256	65	161	12	0	238
12450	8007s (+0.5s)	1620	1620	128	51	101	9	0	161
12451	8008s (+0.9s)	4016	4016	256	98	208	22	0	328
12452	8009s (+0.5s)	1548	1548	128	43	114	9	0	166
12453	8010s (+0.9s)	3916	3916	256	79	231	14	0	324
12454	8010s (+0.5s)	1764	1764	128	47	128	6	0	181
12455	8011s (+0.4s)	1288	1288	64	41	94	7	0	142
12456	8011s (+0.7s)	2888	2888	128	76	181	15	0	272
12457	8012s (+1.0s)	4164	4164	256	80	246	17	0	343
12458	8013s (+0.5s)	2028	2028	128	42	139	8	0	189
12459	8013s (+0.3s)	860	860	64	28	77	6	0	111
12460	8014s (+0.5s)	1644	1644	128	38	125	4	0	167
12461	8014s (+0.7s)	2956	2956	256	79	163	16	0	258
12462	8016s (+1.2s)	6300	6300	512	107	302	21	0	430
12463	8016s (+0.4s)	972	972	64	26	92	4	0	122
12464	8017s (+0.7s)	2560	2560	128	62	170	7	0	239
12465	8018s (+0.8s)	3528	3528	256	62	219	15	0	296
12466	8018s (+0.9s)	3580	3580	256	75	223	11	0	309
12467	8019s (+0.5s)	1792	1792	128	45	128	9	0	182
12468	8020s (+1.0s)	4344	4344	256	104	243	17	0	364
12469	8021s (+0.7s)	3100	3100	256	60	185	11	0	256
12470	8022s (+0.8s)	3212	3212	256	62	193	12	0	267
12471	8022s (+0.7s)	2476	2476	128	68	150	12	0	230
12472	8022s (+0.3s)	688	688	64	23	63	4	0	90
12473	8023s (+0.4s)	1548	1548	128	40	107	9	0	156
12474	8024s (+0.8s)	3348	3348	256	66	198	12	1	277
12475	8024s (+0.7s)	3156	3156	256	63	191	8	0	262
12476	8025s (+0.9s)	4356	4356	256	83	226	23	1	333
12477	8026s (+0.7s)	2564	2564	256	48	170	9	0	227
12478	8027s (+0.8s)	3352	3352	256	89	174	16	0	279
12479	8027s (+0.5s)	1572	1572	128	45	109	0	8	162
12480	8028s (+0.8s)	3072	3072	256	57	191	0	14	262
12481	8029s (+0.7s)	2984	2984	256	47	195	0	9	251
12482	8030s (+0.7s)	2932	2932	256	49	189	0	8	246
12483	8030s (+0.3s)	692	692	64	22	72	0	2	96
12484	8030s (+0.5s)	1916	1916	128	38	138	0	8	184
12485	8031s (+0.6s)	2444	2444	256	45	157	0	6	208
12486	8031s (+0.3s)	1020	1020	128	18	88	0	3	109
12487	8032s (+0.7s)	3140	3140	256	59	187	0	14	260
12488	8033s (+0.6s)	2444	2444	256	44	159	0	5	208
12489	8033s (+0.6s)	2300	2300	128	48	160	0	10	218
12490	8033s (+0.1s)	176	176	16	9	32	0	0	41
12491	8034s (+0.8s)	3276	3276	256	60	209	0	7	276
12492	8035s (+0.4s)	1388	1388	128	32	112	0	3	147
12493	8035s (+0.8s)	3244	3244	256	53	212	0	8	273
12494	8036s (+0.8s)	3404	3404	256	68	199	0	16	283
12495	8037s (+0.5s)	1740	1740	128	39	130	0	13	182
12496	8037s (+0.6s)	1892	1892	128	38	143	0	10	191
12497	8038s (+0.6s)	2140	2140	128	43	148	0	11	202
12498	8039s (+0.9s)	3824	3824	256	55	244	0	10	309
12499	8039s (+0.4s)	1332	1332	128	24	107	0	4	135
Episode	Time	Reward	Score	Highest	L	U	R	D	Steps
12500	8040s (+0.6s)	2328	2328	256	41	146	8	0	195
12501	8041s (+1.0s)	4260	4260	256	93	236	20	0	349
12502	8042s (+0.7s)	3064	3064	256	68	165	10	1	244
12503	8042s (+0.5s)	1780	1780	128	36	135	10	0	181
12504	8043s (+0.7s)	2676	2676	256	58	155	16	0	229
12505	8043s (+0.3s)	744	744	64	24	72	2	0	98
12506	8044s (+0.8s)	3404	3404	256	54	214	13	1	282
12507	8044s (+0.5s)	1720	1720	128	41	125	11	0	177
12508	8045s (+0.7s)	3144	3144	256	57	193	12	0	262
12509	8046s (+1.0s)	4316	4316	256	90	257	17	0	364
12510	8047s (+0.6s)	2120	2120	128	50	136	8	1	195
12511	8048s (+0.8s)	3540	3540	256	66	212	14	0	292
12512	8048s (+0.5s)	1828	1828	128	46	135	11	0	192
12513	8049s (+0.5s)	1472	1472	128	34	118	5	0	157
12514	8049s (+0.4s)	1348	1348	128	24	110	4	0	138
12515	8049s (+0.4s)	1512	1512	128	34	110	8	0	152
12516	8050s (+0.8s)	3224	3224	256	54	207	8	0	269
12517	8051s (+0.5s)	1500	1500	128	44	110	5	0	159
12518	8052s (+1.0s)	4516	4516	256	102	252	20	1	375
12519	8052s (+0.4s)	1272	1272	128	27	96	6	0	129
12520	8052s (+0.2s)	476	476	32	20	51	4	0	75
12521	8053s (+0.5s)	1768	1768	128	45	127	9	0	181
12522	8053s (+0.5s)	1648	1648	128	35	125	8	0	168
12523	8054s (+0.4s)	1432	1432	128	26	116	5	0	147
12524	8055s (+0.7s)	3092	3092	256	65	176	11	0	252
12525	8055s (+0.4s)	1160	1160	128	38	81	7	0	126
12526	8056s (+1.3s)	6716	6716	512	119	321	23	0	463
12527	8057s (+0.5s)	1792	1792	128	41	131	11	0	183
12528	8057s (+0.7s)	2836	2836	256	62	163	16	0	241
12529	8058s (+0.4s)	1276	1276	64	39	99	6	0	144
12530	8058s (+0.3s)	848	848	64	29	72	7	0	108
12531	8059s (+0.4s)	1532	1532	128	27	121	3	0	151
12532	8060s (+1.0s)	4204	4204	256	81	246	17	2	346
12533	8060s (+0.2s)	500	500	64	16	51	4	0	71
12534	8060s (+0.3s)	848	848	64	30	68	6	0	104
12535	8060s (+0.3s)	664	664	32	15	74	4	1	94
12536	8061s (+0.4s)	1364	1364	128	40	96	7	0	143
12537	8061s (+0.3s)	976	976	64	23	84	6	0	113
12538	8062s (+1.3s)	6588	6588	512	144	298	28	0	470
12539	8063s (+0.4s)	988	988	64	37	80	9	0	126
12540	8064s (+0.7s)	3004	3004	256	63	175	9	0	247
12541	8064s (+0.7s)	3144	3144	256	55	195	11	0	261
12542	8065s (+0.4s)	1152	1152	64	27	109	0	1	137
12543	8066s (+0.9s)	3908	3908	256	66	246	0	15	327
12544	8066s (+0.4s)	1312	1312	128	22	110	0	3	135
12545	8067s (+0.5s)	1604	1604	128	34	131	0	3	168
12546	8067s (+0.6s)	2368	2368	256	41	156	0	4	201
12547	8068s (+0.8s)	3216	3216	256	63	191	0	9	263
12548	8068s (+0.5s)	1604	1604	128	40	118	0	10	168
12549	8069s (+0.6s)	2124	2124	128	41	151	0	10	202
12550	8070s (+0.8s)	3212	3212	256	55	198	0	17	270
12551	8070s (+0.6s)	2600	2600	256	40	175	0	12	227
12552	8071s (+0.4s)	1444	1444	128	36	111	0	3	150
12553	8072s (+0.7s)	2968	2968	256	66	174	1	13	254
12554	8072s (+0.4s)	1180	1180	128	28	95	0	2	125
12555	8072s (+0.4s)	1148	1148	128	30	89	0	6	125
12556	8073s (+0.4s)	1440	1440	128	34	105	0	8	147
12557	8073s (+0.5s)	1800	1800	128	43	136	6	0	185
12558	8074s (+0.5s)	1764	1764	128	48	121	12	0	181
12559	8075s (+1.0s)	4356	4356	256	112	229	23	0	364
12560	8075s (+0.5s)	1692	1692	128	34	128	5	1	168
12561	8076s (+0.7s)	2800	2800	256	58	177	8	0	243
12562	8076s (+0.5s)	1516	1516	128	29	125	6	0	160
12563	8077s (+0.7s)	2448	2448	128	57	152	19	0	228
12564	8078s (+0.6s)	2140	2140	128	49	157	8	0	214
12565	8078s (+0.4s)	1492	1492	128	36	110	10	0	156
12566	8079s (+0.4s)	1404	1404	128	34	105	8	0	147
12567	8079s (+0.5s)	1712	1712	128	50	113	8	2	173
12568	8080s (+0.8s)	3540	3540	256	78	198	16	1	293
12569	8080s (+0.5s)	1628	1628	128	40	130	4	0	174
12570	8081s (+0.9s)	4084	4084	256	81	235	12	0	328
12571	8082s (+0.5s)	1780	1780	128	45	124	12	0	181
12572	8082s (+0.6s)	1912	1912	128	46	145	5	0	196
12573	8083s (+0.6s)	2132	2132	128	55	145	12	0	212
12574	8083s (+0.4s)	1272	1272	128	24	101	6	0	131
12575	8084s (+0.8s)	3440	3440	256	67	208	17	0	292
12576	8085s (+0.7s)	3072	3072	256	72	169	12	0	253
12577	8086s (+0.5s)	1796	1796	128	38	141	5	0	184
12578	8086s (+0.7s)	2956	2956	256	64	184	12	0	260
12579	8087s (+0.6s)	2324	2324	128	59	156	13	0	228
12580	8088s (+1.3s)	6312	6312	512	112	314	27	0	453
12581	8089s (+0.7s)	3120	3120	256	72	175	12	1	260
12582	8090s (+0.5s)	1736	1736	128	47	115	9	0	171
12583	8090s (+0.4s)	1420	1420	128	36	112	6	0	154
12584	8091s (+1.0s)	4220	4220	256	96	234	15	0	345
12585	8091s (+0.5s)	1692	1692	128	41	122	11	1	175
12586	8092s (+0.6s)	1976	1976	128	52	144	11	0	207
12587	8093s (+0.8s)	3376	3376	256	83	183	14	0	280
12588	8094s (+0.9s)	3876	3876	256	91	222	14	1	328
12589	8094s (+0.5s)	1580	1580	128	35	124	7	0	166
12590	8095s (+0.5s)	1836	1836	128	41	141	7	0	189
12591	8096s (+0.7s)	2976	2976	256	75	170	10	0	255
12592	8097s (+1.1s)	4588	4588	256	89	266	18	0	373
12593	8097s (+0.6s)	2088	2088	128	44	160	8	0	212
12594	8098s (+0.4s)	1188	1188	128	36	88	6	0	130
12595	8098s (+0.5s)	1772	1772	128	54	119	9	0	182
12596	8099s (+0.7s)	3204	3204	256	79	173	13	0	265
12597	8100s (+0.8s)	3568	3568	256	69	204	12	0	285
12598	8100s (+0.7s)	2924	2924	256	59	187	11	0	257
12599	8101s (+0.6s)	2456	2456	256	48	149	9	0	206
Episode	Time	Reward	Score	Highest	L	U	R	D	Steps
12600	8102s (+0.7s)	3112	3112	256	74	171	14	0	259
12601	8102s (+0.6s)	2568	2568	256	53	157	12	0	222
12602	8103s (+0.7s)	2912	2912	256	62	176	16	0	254
12603	8104s (+0.6s)	2636	2636	256	48	160	11	0	219
12604	8104s (+0.7s)	2908	2908	256	62	184	7	0	253
12605	8106s (+1.3s)	6580	6580	512	127	319	28	1	475
12606	8107s (+0.8s)	3196	3196	256	53	205	9	0	267
12607	8107s (+0.6s)	2256	2256	128	65	132	16	0	213
12608	8108s (+0.6s)	2232	2232	128	55	145	13	0	213
12609	8108s (+0.4s)	1480	1480	128	45	102	8	0	155
12610	8109s (+0.6s)	2060	2060	128	56	139	11	0	206
12611	8109s (+0.5s)	1604	1604	128	41	118	9	0	168
12612	8110s (+0.7s)	2924	2924	256	57	188	12	0	257
12613	8111s (+1.0s)	4312	4312	256	94	234	23	1	352
12614	8112s (+1.1s)	5536	5536	512	107	264	23	0	394
12615	8113s (+0.5s)	1552	1552	128	36	115	9	0	160
12616	8113s (+0.7s)	2568	2568	128	51	176	11	0	238
12617	8114s (+0.5s)	1792	1792	128	43	134	5	0	182
12618	8114s (+0.5s)	1704	1704	128	35	137	9	0	181
12619	8115s (+0.8s)	3388	3388	256	78	190	14	0	282
12620	8116s (+0.7s)	2516	2516	128	70	152	13	0	235
12621	8116s (+0.3s)	1064	1064	128	20	83	5	0	108
12622	8117s (+1.0s)	4168	4168	256	81	247	16	0	344
12623	8118s (+0.8s)	3276	3276	256	63	201	0	14	278
12624	8118s (+0.2s)	352	352	32	11	44	0	4	59
12625	8119s (+0.5s)	1776	1776	128	48	123	8	0	179
12626	8120s (+0.8s)	3404	3404	256	70	198	12	2	282
12627	8120s (+0.5s)	1668	1668	128	42	117	9	0	168
12628	8121s (+0.9s)	3696	3696	256	91	203	17	0	311
12629	8121s (+0.6s)	2204	2204	128	46	153	12	0	211
12630	8122s (+1.0s)	3936	3936	256	91	221	23	0	335
12631	8123s (+0.5s)	1512	1512	128	44	111	6	0	161
12632	8124s (+0.7s)	2856	2856	256	60	175	14	0	249
12633	8124s (+0.8s)	3072	3072	256	56	196	11	0	263
12634	8125s (+0.4s)	1256	1256	64	33	99	7	0	139
12635	8126s (+0.7s)	3188	3188	256	61	189	10	1	261
12636	8126s (+0.7s)	3048	3048	256	65	181	11	0	257
12637	8127s (+0.7s)	2880	2880	256	64	177	10	0	251
12638	8127s (+0.3s)	784	784	64	24	74	6	0	104
12639	8128s (+0.7s)	2680	2680	256	68	150	12	0	230
12640	8128s (+0.5s)	1612	1612	128	40	125	5	0	170
12641	8129s (+0.6s)	2484	2484	256	47	158	7	0	212
12642	8130s (+0.8s)	2996	2996	256	68	180	16	0	264
12643	8131s (+0.7s)	2832	2832	256	64	172	8	2	246
12644	8131s (+0.8s)	3544	3544	256	72	214	14	0	300
12645	8132s (+0.4s)	1476	1476	128	37	111	5	0	153
12646	8132s (+0.3s)	748	748	64	25	69	6	0	100
12647	8132s (+0.3s)	904	904	64	32	79	5	1	117
12648	8133s (+0.6s)	2316	2316	128	57	149	12	0	218
12649	8134s (+0.5s)	1636	1636	128	42	114	0	9	165
12650	8134s (+0.3s)	1000	1000	64	20	93	6	0	119
12651	8135s (+1.0s)	4252	4252	256	90	250	13	0	353
12652	8135s (+0.5s)	1768	1768	128	48	127	6	0	181
12653	8136s (+0.4s)	1524	1524	128	38	115	4	0	157
12654	8136s (+0.5s)	1724	1724	128	55	105	11	0	171
12655	8137s (+0.6s)	2780	2780	256	53	163	0	8	224
12656	8138s (+0.8s)	3520	3520	256	63	219	0	13	295
12657	8139s (+0.7s)	2688	2688	256	40	182	0	9	231
12658	8139s (+0.6s)	2204	2204	128	41	154	0	13	208
12659	8140s (+0.5s)	1660	1660	128	36	124	0	8	168
12660	8140s (+0.5s)	2056	2056	128	49	141	0	10	200
12661	8141s (+0.8s)	3448	3448	256	73	207	13	0	293
12662	8141s (+0.4s)	1308	1308	128	31	98	4	0	133
12663	8142s (+0.7s)	2816	2816	256	55	183	8	0	246
12664	8143s (+0.9s)	3636	3636	256	71	217	19	0	307
12665	8144s (+0.7s)	2876	2876	256	64	158	12	1	235
12666	8144s (+0.7s)	2936	2936	256	58	177	7	0	242
12667	8145s (+0.5s)	1736	1736	128	39	136	6	0	181
12668	8145s (+0.3s)	896	896	128	19	75	2	0	96
12669	8146s (+0.6s)	2544	2544	256	48	152	12	0	212
12670	8147s (+0.9s)	3584	3584	256	78	208	13	0	299
12671	8147s (+0.4s)	1412	1412	128	37	103	8	1	149
12672	8148s (+1.1s)	4504	4504	256	100	252	20	0	372
12673	8149s (+0.9s)	3552	3552	256	62	223	10	0	295
12674	8149s (+0.2s)	652	652	64	20	64	2	0	86
12675	8150s (+0.8s)	3296	3296	256	72	190	13	0	275
12676	8151s (+1.0s)	5284	5284	512	91	264	13	0	368
12677	8152s (+0.9s)	3828	3828	256	77	222	10	0	309
12678	8153s (+0.9s)	3936	3936	256	81	223	13	1	318
12679	8153s (+0.6s)	1884	1884	128	54	130	10	0	194
12680	8154s (+0.7s)	2952	2952	256	62	185	10	0	257
12681	8155s (+0.8s)	3160	3160	256	59	195	10	0	264
12682	8156s (+0.7s)	2580	2580	128	66	160	18	0	244
12683	8156s (+0.7s)	3244	3244	256	63	198	11	1	273
12684	8157s (+0.5s)	1632	1632	128	39	132	4	0	175
12685	8158s (+0.9s)	3532	3532	256	73	216	9	0	298
12686	8158s (+0.3s)	1004	1004	128	18	84	4	0	106
12687	8159s (+0.7s)	2656	2656	256	52	173	9	0	234
12688	8159s (+0.5s)	1780	1780	128	52	120	9	0	181
12689	8160s (+0.6s)	2096	2096	128	53	135	15	0	203
12690	8160s (+0.4s)	1424	1424	128	54	93	4	0	151
12691	8161s (+0.6s)	1976	1976	128	58	131	12	0	201
12692	8161s (+0.5s)	1740	1740	128	40	122	8	1	171
12693	8162s (+0.5s)	1708	1708	128	39	130	2	0	171
12694	8163s (+0.8s)	3380	3380	256	67	199	15	0	281
12695	8163s (+0.7s)	2928	2928	256	57	191	10	0	258
12696	8164s (+0.7s)	2800	2800	256	53	181	8	0	242
12697	8164s (+0.4s)	996	996	64	30	87	7	0	124
12698	8165s (+0.8s)	3288	3288	256	52	211	0	11	274
12699	8166s (+1.0s)	4236	4236	256	72	268	0	16	356
Episode	Time	Reward	Score	Highest	L	U	R	D	Steps
12700	8167s (+0.2s)	320	320	32	12	43	0	3	58
12701	8168s (+1.0s)	4236	4236	256	77	259	0	10	346
12702	8168s (+0.7s)	3024	3024	256	53	186	0	6	245
12703	8169s (+0.6s)	2480	2480	256	45	160	0	11	216
12704	8170s (+0.9s)	3700	3700	256	74	224	0	10	308
12705	8170s (+0.5s)	1800	1800	128	36	142	0	7	185
12706	8171s (+0.6s)	2692	2692	256	41	176	1	9	227
12707	8172s (+0.7s)	2520	2520	128	54	171	0	11	236
12708	8172s (+0.5s)	1552	1552	128	28	125	0	7	160
12709	8173s (+0.5s)	1836	1836	128	41	135	0	6	182
12710	8173s (+0.2s)	540	540	64	14	60	0	0	74
12711	8173s (+0.4s)	1548	1548	128	31	123	5	0	159
12712	8174s (+1.0s)	4180	4180	256	91	243	13	0	347
12713	8175s (+0.7s)	2564	2564	128	60	171	9	0	240
12714	8176s (+1.0s)	4976	4976	512	90	239	21	0	350
12715	8177s (+0.7s)	2776	2776	256	55	177	10	0	242
12716	8177s (+0.8s)	3568	3568	256	72	204	17	0	293
12717	8178s (+0.6s)	2712	2712	256	50	163	14	0	227
12718	8179s (+0.6s)	2672	2672	256	57	161	9	2	229
12719	8179s (+0.5s)	1788	1788	128	39	135	8	0	182
12720	8180s (+0.3s)	716	716	64	23	65	3	1	92
12721	8180s (+0.4s)	1460	1460	128	33	116	4	0	153
12722	8181s (+1.0s)	4220	4220	256	84	253	13	0	350
12723	8181s (+0.4s)	1376	1376	128	45	99	10	0	154
12724	8182s (+0.5s)	1784	1784	128	40	134	0	7	181
12725	8183s (+0.6s)	2572	2572	256	41	164	8	0	213
12726	8183s (+0.4s)	1532	1532	128	27	123	0	6	156
12727	8184s (+0.8s)	3520	3520	256	53	225	0	16	294
12728	8184s (+0.5s)	1612	1612	128	39	121	9	0	169
12729	8185s (+0.4s)	1280	1280	128	38	93	7	0	138
12730	8185s (+0.4s)	1436	1436	128	25	119	5	0	149
12731	8186s (+0.9s)	4004	4004	256	63	251	0	18	332
12732	8187s (+0.6s)	2620	2620	256	51	172	0	7	230
12733	8188s (+0.9s)	3684	3684	256	68	226	0	15	309
12734	8188s (+0.7s)	2820	2820	256	39	198	0	11	248
12735	8189s (+0.5s)	1424	1424	64	45	106	9	0	160
12736	8190s (+0.6s)	2216	2216	128	61	144	5	0	210
12737	8190s (+0.6s)	1912	1912	128	54	130	12	0	196
12738	8191s (+0.8s)	3208	3208	256	75	174	17	0	266
12739	8191s (+0.5s)	1504	1504	128	38	112	10	0	160
12740	8192s (+0.7s)	2908	2908	256	44	191	5	0	240
12741	8193s (+0.5s)	1792	1792	128	49	126	8	0	183
12742	8193s (+0.9s)	3800	3800	256	68	236	12	0	316
12743	8194s (+0.4s)	1500	1500	128	36	115	7	0	158
12744	8195s (+0.7s)	3048	3048	256	62	183	11	1	257
12745	8195s (+0.6s)	1896	1896	128	42	144	7	0	193
12746	8196s (+0.5s)	1760	1760	128	51	120	9	0	180
12747	8196s (+0.4s)	1136	1136	64	33	94	8	1	136
12748	8197s (+0.4s)	1524	1524	128	40	109	8	0	157
12749	8197s (+0.5s)	1808	1808	128	47	132	7	1	187
12750	8198s (+0.4s)	1440	1440	128	40	103	5	0	148
12751	8199s (+1.0s)	4356	4356	256	97	252	14	0	363
12752	8199s (+0.5s)	1596	1596	128	39	117	9	1	166
12753	8200s (+0.9s)	3684	3684	256	89	205	14	1	309
12754	8200s (+0.5s)	1640	1640	128	34	130	2	0	166
12755	8201s (+1.0s)	4212	4212	256	96	229	19	0	344
12756	8202s (+0.6s)	2540	2540	256	45	164	6	0	215
12757	8203s (+0.7s)	3028	3028	256	74	168	10	1	253
12758	8203s (+0.5s)	1556	1556	64	53	105	14	0	172
12759	8205s (+1.4s)	7124	7124	512	129	329	24	0	482
12760	8205s (+0.8s)	3140	3140	256	55	193	0	13	261
12761	8206s (+1.0s)	5028	5028	512	64	274	0	16	354
12762	8207s (+0.3s)	880	880	64	13	92	0	1	106
12763	8207s (+0.5s)	2212	2212	256	35	144	0	8	187
12764	8207s (+0.2s)	292	292	32	12	40	0	4	56
12765	8208s (+0.7s)	2508	2508	128	54	173	0	11	238
12766	8209s (+0.9s)	3540	3540	256	64	225	0	10	299
12767	8210s (+0.6s)	1920	1920	128	51	137	10	0	198
12768	8210s (+0.4s)	1236	1236	128	27	106	4	0	137
12769	8210s (+0.5s)	1520	1520	128	33	118	7	0	158
12770	8211s (+0.6s)	2200	2200	128	64	136	10	0	210
12771	8211s (+0.5s)	1496	1496	128	32	119	7	0	158
12772	8212s (+0.5s)	1736	1736	128	41	115	9	0	165
12773	8213s (+0.6s)	2420	2420	256	46	150	9	0	205
12774	8213s (+0.6s)	2512	2512	256	45	167	0	8	220
12775	8214s (+0.4s)	1348	1348	128	23	111	0	5	139
12776	8215s (+1.0s)	4036	4036	256	65	259	0	14	338
12777	8215s (+0.6s)	2228	2228	128	40	161	0	11	212
12778	8216s (+0.4s)	1444	1444	128	34	104	0	9	147
12779	8216s (+0.4s)	1384	1384	64	43	106	6	0	155
12780	8217s (+0.5s)	1680	1680	128	43	135	4	0	182
12781	8218s (+0.9s)	3980	3980	256	86	229	14	0	329
12782	8218s (+0.7s)	3048	3048	256	59	178	0	9	246
12783	8219s (+0.6s)	2568	2568	256	51	158	0	9	218
12784	8220s (+0.9s)	4056	4056	256	100	189	19	0	308
12785	8220s (+0.4s)	1084	1084	64	36	92	3	0	131
12786	8221s (+0.4s)	1440	1440	128	23	118	5	0	146
12787	8221s (+0.8s)	3304	3304	256	66	204	7	0	277
12788	8222s (+0.9s)	3968	3968	256	90	219	17	0	326
12789	8223s (+0.5s)	1680	1680	128	36	131	5	0	172
12790	8224s (+0.7s)	3088	3088	256	60	180	12	0	252
12791	8224s (+0.9s)	3536	3536	256	95	193	15	0	303
12792	8225s (+0.3s)	892	892	64	33	69	10	0	112
12793	8225s (+0.5s)	1556	1556	128	44	115	8	0	167
12794	8226s (+0.8s)	3220	3220	256	70	183	16	0	269
12795	8227s (+0.6s)	2216	2216	128	43	155	0	12	210
12796	8227s (+0.5s)	1800	1800	128	37	140	0	9	186
12797	8228s (+0.7s)	2520	2520	128	53	177	0	11	241
12798	8228s (+0.3s)	1144	1144	128	24	98	1	0	123
12799	8229s (+0.6s)	2508	2508	256	45	163	10	0	218
Episode	Time	Reward	Score	Highest	L	U	R	D	Steps
12800	8229s (+0.6s)	1940	1940	128	60	135	8	0	203
12801	8230s (+0.4s)	1488	1488	128	49	100	7	0	156
12802	8230s (+0.4s)	1140	1140	64	31	100	5	0	136
12803	8231s (+0.5s)	1604	1604	128	42	116	10	0	168
12804	8231s (+0.6s)	2500	2500	256	50	156	7	0	213
12805	8232s (+0.5s)	1612	1612	128	37	128	5	0	170
12806	8233s (+0.8s)	3364	3364	256	75	201	11	0	287
12807	8233s (+0.8s)	3224	3224	256	77	178	14	0	269
12808	8234s (+0.8s)	3356	3356	256	80	190	15	0	285
12809	8235s (+0.6s)	2664	2664	256	53	158	14	0	225
12810	8236s (+0.8s)	3248	3248	256	71	189	15	0	275
12811	8236s (+0.5s)	1908	1908	128	43	126	7	0	176
12812	8237s (+0.5s)	1512	1512	128	44	108	6	0	158
12813	8237s (+0.3s)	716	716	64	28	61	7	0	96
12814	8238s (+0.6s)	2668	2668	256	58	161	9	0	228
12815	8238s (+0.5s)	1892	1892	128	54	129	9	0	192
12816	8239s (+0.7s)	3100	3100	256	68	172	15	0	255
12817	8239s (+0.5s)	1764	1764	128	43	129	8	1	181
12818	8240s (+0.5s)	2348	2348	256	48	140	11	0	199
12819	8241s (+0.6s)	2500	2500	256	40	170	7	0	217
12820	8241s (+0.6s)	1992	1992	128	48	140	8	0	196
12821	8242s (+0.7s)	3084	3084	256	67	181	7	0	255
12822	8242s (+0.4s)	1344	1344	128	29	106	0	6	141
12823	8243s (+1.0s)	4152	4152	256	77	240	0	23	340
12824	8244s (+0.7s)	3048	3048	256	61	173	12	0	246
12825	8245s (+0.8s)	3224	3224	256	58	198	14	0	270
12826	8245s (+0.4s)	1152	1152	128	37	79	6	0	122
12827	8246s (+0.4s)	1136	1136	64	38	89	4	1	132
12828	8246s (+0.6s)	2512	2512	256	51	154	10	0	215
12829	8247s (+0.8s)	3268	3268	256	70	197	13	0	280
12830	8248s (+1.0s)	4384	4384	256	91	262	12	0	365
12831	8249s (+0.6s)	2084	2084	128	53	126	18	0	197
12832	8249s (+0.6s)	2300	2300	128	69	148	12	0	229
12833	8250s (+1.2s)	5892	5892	512	95	300	14	0	409
12834	8251s (+0.9s)	3788	3788	256	80	214	16	0	310
12835	8252s (+0.3s)	808	808	64	22	84	3	0	109
12836	8252s (+0.3s)	956	956	64	24	89	6	0	119
12837	8253s (+0.6s)	1936	1936	128	41	147	11	0	199
12838	8253s (+0.9s)	3580	3580	256	65	232	12	0	309
12839	8254s (+0.5s)	1800	1800	128	38	140	7	0	185
12840	8255s (+0.7s)	2800	2800	256	58	174	11	0	243
12841	8256s (+0.8s)	3580	3580	256	76	212	10	0	298
12842	8256s (+0.5s)	1860	1860	128	43	140	5	0	188
12843	8257s (+0.5s)	1828	1828	128	44	132	8	0	184
12844	8257s (+0.6s)	2248	2248	128	54	146	9	1	210
12845	8258s (+0.3s)	1148	1148	128	21	95	3	1	120
12846	8258s (+0.7s)	2788	2788	256	41	185	7	0	233
12847	8259s (+0.8s)	3396	3396	256	61	203	16	0	280
12848	8260s (+0.6s)	2464	2464	256	51	147	11	0	209
12849	8260s (+0.2s)	616	616	64	15	69	3	0	87
12850	8261s (+0.6s)	2196	2196	128	52	142	14	1	209
12851	8261s (+0.9s)	3532	3532	256	68	219	14	0	301
12852	8262s (+0.5s)	1608	1608	128	33	117	9	0	159
12853	8262s (+0.6s)	1912	1912	128	50	133	14	0	197
12854	8263s (+0.9s)	3820	3820	256	90	210	21	0	321
12855	8264s (+0.7s)	2760	2760	256	55	169	13	0	237
12856	8264s (+0.3s)	1072	1072	64	23	94	4	0	121
12857	8266s (+1.1s)	4608	4608	256	104	263	15	0	382
12858	8267s (+1.1s)	5496	5496	512	72	290	0	23	385
12859	8267s (+0.4s)	1492	1492	128	20	130	1	5	156
12860	8267s (+0.4s)	1332	1332	128	30	99	0	6	135
12861	8268s (+0.8s)	3264	3264	256	51	211	0	11	273
12862	8269s (+1.0s)	3992	3992	256	62	261	0	9	332
12863	8270s (+0.5s)	1800	1800	128	37	123	0	10	170
12864	8270s (+0.5s)	1588	1588	128	35	123	0	7	165
12865	8270s (+0.2s)	644	644	64	19	62	1	3	85
12866	8272s (+1.1s)	5440	5440	512	81	285	0	14	380
12867	8272s (+0.6s)	2260	2260	128	40	170	0	9	219
12868	8273s (+0.5s)	1708	1708	128	33	134	0	6	173
12869	8273s (+0.7s)	2812	2812	256	49	186	0	11	246
12870	8274s (+1.1s)	6060	6060	512	84	301	0	15	400
12871	8275s (+0.8s)	3500	3500	256	68	214	0	9	291
12872	8276s (+0.6s)	2212	2212	256	38	146	0	5	189
12873	8277s (+0.9s)	3524	3524	256	54	230	0	16	300
12874	8277s (+0.4s)	1092	1092	64	21	103	0	4	128
12875	8278s (+0.8s)	3252	3252	256	66	196	0	11	273
12876	8279s (+0.7s)	2796	2796	256	42	191	0	9	242
12877	8279s (+0.4s)	1296	1296	128	30	103	7	0	140
12878	8279s (+0.3s)	1120	1120	128	30	86	4	0	120
12879	8280s (+1.0s)	5072	5072	512	92	238	18	1	349
12880	8281s (+0.8s)	3420	3420	256	67	210	9	0	286
12881	8282s (+0.7s)	2924	2924	256	66	180	11	0	257
12882	8282s (+0.5s)	1864	1864	128	38	147	4	0	189
12883	8283s (+0.8s)	3304	3304	256	68	193	12	0	273
12884	8284s (+0.5s)	1824	1824	128	41	142	7	0	190
12885	8285s (+1.2s)	5808	5808	512	105	296	22	0	423
12886	8285s (+0.3s)	800	800	64	28	77	3	0	108
12887	8286s (+0.8s)	3072	3072	256	56	192	10	0	258
12888	8286s (+0.3s)	960	960	64	41	73	2	0	116
12889	8287s (+0.8s)	3256	3256	256	78	179	12	0	269
12890	8288s (+1.0s)	4268	4268	256	93	241	19	0	353
12891	8289s (+0.8s)	3388	3388	256	60	215	8	0	283
12892	8290s (+0.8s)	3468	3468	256	53	224	10	0	287
12893	8291s (+0.8s)	3184	3184	256	65	186	13	0	264
12894	8291s (+0.6s)	2232	2232	128	55	155	8	0	218
12895	8292s (+0.5s)	1572	1572	128	35	123	4	0	162
12896	8293s (+1.0s)	4508	4508	256	108	243	18	0	369
12897	8293s (+0.5s)	1852	1852	128	43	135	9	0	187
12898	8294s (+0.7s)	2748	2748	256	63	165	7	0	235
12899	8294s (+0.5s)	1832	1832	128	46	132	8	0	186
Episode	Time	Reward	Score	Highest	L	U	R	D	Steps
12900	8295s (+0.6s)	2688	2688	256	66	149	10	0	225
12901	8296s (+0.7s)	2936	2936	256	67	178	13	2	260
12902	8296s (+0.4s)	1368	1368	128	50	94	3	0	147
12903	8297s (+0.8s)	3344	3344	256	68	201	13	0	282
12904	8297s (+0.4s)	1204	1204	128	20	103	4	0	127
12905	8298s (+0.5s)	1556	1556	128	27	125	8	1	161
12906	8299s (+0.6s)	1924	1924	128	53	137	9	0	199
12907	8299s (+0.4s)	1416	1416	128	47	98	8	0	153
12908	8300s (+0.7s)	3080	3080	256	50	190	9	1	250
12909	8300s (+0.4s)	1464	1464	128	33	115	6	0	154
12910	8301s (+0.5s)	1748	1748	128	36	137	0	5	178
12911	8301s (+0.5s)	1508	1508	128	37	113	0	8	158
12912	8302s (+0.5s)	1792	1792	128	39	136	0	8	183
12913	8302s (+0.8s)	3528	3528	256	49	240	0	8	297
12914	8303s (+0.2s)	596	596	64	20	57	0	3	80
12915	8303s (+0.7s)	2792	2792	128	52	193	0	16	261
12916	8304s (+0.5s)	2280	2280	256	33	145	0	10	188
12917	8305s (+0.7s)	3220	3220	256	56	195	0	16	267
12918	8305s (+0.3s)	764	764	64	17	80	3	0	100
12919	8306s (+0.6s)	2036	2036	128	57	146	8	0	211
12920	8306s (+0.7s)	3192	3192	256	72	182	12	0	266
12921	8307s (+0.5s)	1344	1344	64	42	112	5	0	159
12922	8307s (+0.6s)	2304	2304	256	39	153	8	0	200
12923	8308s (+0.8s)	3540	3540	256	69	201	14	0	284
12924	8309s (+0.5s)	1636	1636	128	35	123	7	1	166
12925	8309s (+0.7s)	3140	3140	256	56	192	9	0	257
12926	8310s (+0.7s)	3188	3188	256	56	197	11	0	264
12927	8311s (+0.6s)	2548	2548	256	57	161	6	0	224
12928	8311s (+0.5s)	1948	1948	128	47	126	4	0	177
12929	8312s (+0.8s)	3736	3736	256	68	214	13	0	295
12930	8313s (+0.3s)	864	864	64	33	75	3	1	112
12931	8313s (+0.5s)	1796	1796	128	45	132	7	0	184
12932	8315s (+1.6s)	7700	7700	512	157	359	27	0	543
12933	8315s (+0.4s)	1452	1452	128	30	109	8	0	147
12934	8316s (+0.3s)	840	840	64	27	79	4	0	110
12935	8316s (+0.4s)	1348	1348	128	27	102	0	9	138
12936	8317s (+0.5s)	1752	1752	128	34	131	1	9	175
12937	8317s (+0.7s)	3028	3028	256	64	184	9	0	257
12938	8318s (+1.0s)	4268	4268	256	90	244	16	0	350
12939	8319s (+0.5s)	1572	1572	128	43	113	9	0	165
12940	8319s (+0.4s)	1144	1144	128	28	90	6	0	124
12941	8320s (+0.6s)	1948	1948	128	54	143	8	0	205
12942	8320s (+0.6s)	1948	1948	128	58	135	7	0	200
12943	8321s (+0.5s)	1776	1776	128	37	136	6	0	179
12944	8321s (+0.5s)	1940	1940	128	43	140	10	0	193
12945	8322s (+0.2s)	480	480	32	11	63	3	0	77
12946	8322s (+0.4s)	1144	1144	64	36	90	6	1	133
12947	8323s (+0.9s)	4100	4100	256	80	230	21	2	333
12948	8323s (+0.5s)	1668	1668	128	43	119	7	0	169
12949	8324s (+0.9s)	3972	3972	256	66	241	0	21	328
12950	8325s (+1.0s)	4168	4168	256	86	248	0	12	346
12951	8326s (+0.5s)	1696	1696	128	31	131	0	7	169
12952	8326s (+0.2s)	604	604	64	15	60	0	6	81
12953	8327s (+0.7s)	2888	2888	256	50	191	0	9	250
12954	8328s (+0.7s)	3004	3004	256	66	170	0	11	247
12955	8328s (+0.6s)	1896	1896	128	26	162	0	6	194
12956	8329s (+0.8s)	3360	3360	256	70	203	0	9	282
12957	8329s (+0.5s)	2200	2200	256	46	139	0	7	192
12958	8330s (+0.4s)	1256	1256	128	28	99	1	3	131
12959	8330s (+0.5s)	1764	1764	128	39	129	0	8	176
12960	8331s (+0.2s)	500	500	64	11	56	0	5	72
12961	8331s (+0.4s)	1340	1340	128	29	108	0	3	140
12962	8332s (+0.9s)	3964	3964	256	56	252	0	17	325
12963	8333s (+0.7s)	3080	3080	256	54	194	7	0	255
12964	8334s (+1.0s)	4284	4284	256	88	243	19	0	350
12965	8334s (+0.6s)	2160	2160	128	58	145	4	0	207
12966	8335s (+0.9s)	4148	4148	256	87	237	15	0	339
12967	8336s (+1.0s)	5092	5092	512	71	262	13	0	346
12968	8337s (+0.8s)	3204	3204	256	64	192	12	1	269
12969	8337s (+0.4s)	1472	1472	128	31	111	10	0	152
12970	8338s (+0.5s)	1876	1876	128	46	135	11	0	192
12971	8339s (+0.5s)	2012	2012	128	51	123	9	2	185
12972	8339s (+0.8s)	3440	3440	256	71	202	11	0	284
12973	8340s (+0.6s)	2608	2608	256	53	163	11	0	227
12974	8341s (+0.7s)	2516	2516	128	76	146	17	0	239
12975	8341s (+0.7s)	2784	2784	256	66	161	12	0	239
12976	8342s (+0.4s)	1384	1384	64	43	103	9	0	155
12977	8342s (+0.6s)	2488	2488	256	53	149	11	1	214
12978	8343s (+0.8s)	3556	3556	256	75	211	10	0	296
12979	8344s (+0.9s)	3864	3864	256	103	204	18	0	325
12980	8345s (+1.1s)	5536	5536	512	113	261	19	1	394
12981	8346s (+0.9s)	3532	3532	256	67	221	13	0	301
12982	8347s (+0.4s)	1528	1528	128	41	115	4	0	160
12983	8347s (+0.7s)	2824	2824	256	53	188	8	0	249
12984	8348s (+0.7s)	2876	2876	256	52	183	11	0	246
12985	8348s (+0.4s)	1484	1484	128	37	115	4	0	156
12986	8349s (+0.5s)	1732	1732	128	41	126	6	0	173
12987	8350s (+1.1s)	4760	4760	256	108	254	26	0	388
12988	8350s (+0.3s)	808	808	64	21	85	4	0	110
12989	8351s (+0.7s)	2972	2972	256	58	185	11	0	254
12990	8352s (+0.7s)	2912	2912	256	54	177	14	0	245
12991	8353s (+0.7s)	2876	2876	256	56	178	16	0	250
12992	8353s (+0.3s)	900	900	64	21	92	3	0	116
12993	8353s (+0.6s)	1848	1848	128	60	120	13	0	193
12994	8354s (+0.7s)	2792	2792	256	81	146	14	0	241
12995	8355s (+0.4s)	1444	1444	128	30	113	7	0	150
12996	8355s (+0.5s)	1792	1792	128	46	128	8	0	182
12997	8356s (+0.7s)	2472	2472	128	49	174	10	0	233
12998	8356s (+0.4s)	1456	1456	128	34	114	5	0	153
12999	8357s (+0.7s)	2784	2784	256	61	174	9	0	244
Episode	Time	Reward	Score	Highest	L	U	R	D	Steps
13000	8357s (+0.4s)	1496	1496	128	41	109	6	2	158
13001	8358s (+0.8s)	3440	3440	256	75	193	12	0	280
13002	8359s (+0.4s)	1264	1264	128	25	104	4	0	133
13003	8359s (+0.5s)	1648	1648	128	37	120	5	0	162
13004	8359s (+0.4s)	1416	1416	128	38	99	6	0	143
13005	8360s (+0.5s)	1608	1608	128	47	114	8	0	169
13006	8361s (+0.7s)	2476	2476	128	46	179	0	13	238
13007	8361s (+0.7s)	3188	3188	256	59	195	0	12	266
13008	8362s (+0.5s)	1508	1508	128	31	121	0	8	160
13009	8362s (+0.4s)	1452	1452	128	30	110	0	8	148
13010	8363s (+0.6s)	2584	2584	256	38	178	0	6	222
13011	8364s (+0.7s)	2744	2744	256	49	174	0	11	234
13012	8364s (+0.8s)	3532	3532	256	65	215	0	17	297
13013	8365s (+0.5s)	2220	2220	256	39	143	0	6	188
13014	8365s (+0.4s)	1424	1424	128	27	113	0	6	146
13015	8366s (+0.6s)	1924	1924	128	38	158	0	3	199
13016	8366s (+0.3s)	980	980	64	28	84	0	2	114
13017	8367s (+0.8s)	3468	3468	256	68	209	0	9	286
13018	8368s (+0.8s)	3404	3404	256	58	217	0	7	282
13019	8368s (+0.4s)	1268	1268	128	22	98	0	8	128
13020	8369s (+0.5s)	1636	1636	128	39	116	0	10	165
13021	8370s (+0.9s)	3964	3964	256	86	223	16	0	325
13022	8370s (+0.6s)	2608	2608	256	49	163	14	0	226
13023	8371s (+0.6s)	2652	2652	256	46	155	6	0	207
13024	8371s (+0.5s)	1644	1644	128	40	120	7	0	167
13025	8372s (+0.7s)	3092	3092	256	73	166	18	0	257
13026	8373s (+0.9s)	4208	4208	256	87	237	18	0	342
13027	8374s (+1.2s)	6100	6100	512	106	295	26	1	428
13028	8375s (+0.8s)	3200	3200	256	64	191	12	0	267
13029	8376s (+0.6s)	2660	2660	256	58	153	13	1	225
13030	8376s (+0.6s)	1944	1944	128	51	139	10	1	201
13031	8377s (+0.3s)	992	992	64	31	85	6	0	122
13032	8377s (+0.5s)	1552	1552	128	36	116	6	0	158
13033	8378s (+0.5s)	1620	1620	128	49	109	11	0	169
13034	8378s (+0.6s)	2520	2520	256	50	155	9	0	214
13035	8379s (+1.0s)	5292	5292	512	98	246	21	0	365
13036	8380s (+0.9s)	3648	3648	256	70	228	13	0	311
13037	8380s (+0.3s)	956	956	64	28	85	5	0	118
13038	8381s (+0.7s)	2744	2744	256	63	165	6	0	234
13039	8382s (+0.5s)	1896	1896	128	57	122	13	0	192
13040	8383s (+0.8s)	3436	3436	256	94	179	17	0	290
13041	8383s (+0.5s)	1700	1700	128	41	124	9	0	174
13042	8383s (+0.4s)	1156	1156	128	26	97	4	0	127
13043	8384s (+0.6s)	1940	1940	128	50	146	0	7	203
13044	8384s (+0.2s)	632	632	64	17	59	0	5	81
13045	8385s (+0.9s)	3960	3960	256	75	234	0	16	325
13046	8386s (+0.3s)	1080	1080	128	21	89	0	3	113
13047	8386s (+0.5s)	2112	2112	256	39	129	0	7	175
13048	8387s (+0.6s)	2092	2092	128	51	131	13	0	195
13049	8387s (+0.5s)	1796	1796	128	44	131	9	0	184
13050	8388s (+0.8s)	3428	3428	256	79	186	18	0	283
13051	8389s (+0.8s)	3192	3192	256	58	194	14	0	266
13052	8389s (+0.7s)	2800	2800	256	65	166	10	0	241
13053	8390s (+0.6s)	1844	1844	128	44	141	6	0	191
13054	8391s (+0.8s)	3308	3308	256	74	191	13	0	278
13055	8392s (+0.9s)	4032	4032	256	88	228	14	0	330
13056	8393s (+0.9s)	3908	3908	256	88	213	16	0	317
13057	8394s (+0.9s)	3960	3960	256	82	217	24	1	324
13058	8394s (+0.6s)	2616	2616	256	57	164	8	0	229
13059	8395s (+1.0s)	4196	4196	256	76	245	18	1	340
13060	8396s (+0.8s)	3352	3352	256	59	210	12	0	281
13061	8396s (+0.5s)	1596	1596	128	39	123	4	0	166
13062	8397s (+0.7s)	2804	2804	256	55	177	11	1	244
13063	8398s (+0.8s)	3672	3672	256	74	205	21	0	300
13064	8398s (+0.5s)	2272	2272	256	29	149	5	0	183
13065	8399s (+0.5s)	1956	1956	128	43	138	11	0	192
13066	8400s (+0.6s)	2776	2776	256	61	159	13	0	233
13067	8400s (+0.5s)	1636	1636	128	36	119	10	0	165
13068	8401s (+0.7s)	2792	2792	256	57	172	12	0	241
13069	8401s (+0.5s)	1956	1956	128	42	136	8	0	186
13070	8402s (+0.3s)	1084	1084	128	24	81	0	8	113
13071	8402s (+0.6s)	2656	2656	256	51	161	11	1	224
13072	8403s (+0.6s)	2500	2500	256	66	133	16	1	216
13073	8403s (+0.4s)	1444	1444	128	50	95	0	5	150
13074	8404s (+0.5s)	1928	1928	256	25	124	0	8	157
13075	8404s (+0.3s)	940	940	64	24	84	0	3	111
13076	8405s (+0.7s)	2868	2868	256	51	190	0	7	248
13077	8406s (+0.8s)	3268	3268	256	61	206	0	12	279
13078	8406s (+0.5s)	2112	2112	128	39	143	0	7	189
13079	8407s (+0.5s)	1784	1784	128	41	132	0	8	181
13080	8407s (+0.6s)	2340	2340	256	41	148	0	9	198
13081	8408s (+0.6s)	2404	2404	256	42	155	0	8	205
13082	8408s (+0.3s)	760	760	64	25	71	6	0	102
13083	8409s (+0.5s)	1740	1740	128	48	121	6	0	175
13084	8409s (+0.6s)	2600	2600	256	56	161	8	0	225
13085	8410s (+0.6s)	1900	1900	128	50	145	3	0	198
13086	8410s (+0.5s)	1764	1764	128	47	126	7	0	180
13087	8411s (+0.7s)	2916	2916	256	66	172	12	0	250
13088	8412s (+0.8s)	3484	3484	256	76	201	13	0	290
13089	8412s (+0.5s)	1720	1720	128	43	125	9	0	177
13090	8413s (+0.8s)	3264	3264	256	62	203	14	0	279
13091	8415s (+1.6s)	8492	8492	512	166	382	33	0	581
13092	8415s (+0.3s)	748	748	64	25	68	2	0	95
13093	8416s (+0.7s)	2824	2824	256	67	166	16	0	249
13094	8417s (+0.6s)	1980	1980	128	50	149	9	0	208
13095	8417s (+0.4s)	1528	1528	128	38	105	7	2	152
13096	8418s (+0.5s)	1648	1648	128	43	121	4	0	168
13097	8418s (+0.7s)	3228	3228	256	68	192	8	0	268
13098	8419s (+0.6s)	1884	1884	128	49	131	10	0	190
13099	8420s (+0.8s)	3012	3012	256	71	176	15	1	263
Episode	Time	Reward	Score	Highest	L	U	R	D	Steps
13100	8420s (+0.5s)	1860	1860	128	47	132	10	0	189
13101	8421s (+0.6s)	2468	2468	256	44	160	9	0	213
13102	8422s (+0.8s)	3648	3648	256	59	233	0	12	304
13103	8422s (+0.4s)	1456	1456	128	30	117	0	6	153
13104	8422s (+0.4s)	1304	1304	64	28	111	0	7	146
13105	8423s (+0.5s)	1704	1704	128	39	132	6	0	177
13106	8424s (+0.7s)	3140	3140	256	67	175	13	0	255
13107	8425s (+0.8s)	3324	3324	256	69	193	10	0	272
13108	8425s (+0.7s)	2956	2956	256	75	178	7	0	260
13109	8426s (+0.7s)	2808	2808	256	46	189	10	0	245
13110	8426s (+0.4s)	1260	1260	128	33	99	4	0	136
13111	8427s (+0.8s)	3520	3520	256	71	209	14	0	294
13112	8428s (+0.6s)	2176	2176	128	68	138	12	0	218
13113	8428s (+0.4s)	1336	1336	128	38	94	13	0	145
13114	8429s (+0.8s)	3284	3284	256	81	182	9	0	272
13115	8430s (+0.7s)	2800	2800	256	74	161	8	0	243
13116	8431s (+1.2s)	5740	5740	512	104	283	18	1	406
13117	8431s (+0.5s)	1968	1968	128	48	122	9	0	179
13118	8432s (+1.0s)	4100	4100	256	89	235	18	0	342
13119	8433s (+1.0s)	3996	3996	256	91	223	20	0	334
13120	8434s (+1.1s)	5684	5684	512	110	271	18	0	399
13121	8435s (+0.6s)	2516	2516	256	49	163	5	0	217
13122	8436s (+0.9s)	3788	3788	256	83	215	15	0	313
13123	8436s (+0.5s)	1584	1584	128	37	124	7	0	168
13124	8437s (+0.8s)	3332	3332	256	63	198	15	0	276
13125	8438s (+0.5s)	1760	1760	128	35	139	5	0	179
13126	8438s (+0.4s)	1140	1140	64	35	93	5	0	133
13127	8439s (+0.4s)	1188	1188	128	34	90	6	0	130
13128	8439s (+0.9s)	3996	3996	256	90	228	15	0	333
13129	8440s (+0.5s)	1784	1784	128	41	135	5	0	181
13130	8440s (+0.3s)	816	816	64	24	85	3	0	112
13131	8441s (+0.7s)	3256	3256	256	66	193	10	0	269
13132	8442s (+0.8s)	3816	3816	256	87	202	20	0	309
13133	8442s (+0.6s)	2420	2420	256	49	146	13	0	208
13134	8443s (+0.5s)	1636	1636	128	41	127	8	0	176
13135	8444s (+0.9s)	3988	3988	256	63	252	10	0	325
13136	8445s (+0.8s)	3436	3436	256	76	195	18	0	289
13137	8445s (+0.6s)	2540	2540	256	51	162	9	0	222
13138	8446s (+0.5s)	1588	1588	128	43	117	7	1	168
13139	8446s (+0.5s)	1564	1564	128	26	127	0	10	163
13140	8447s (+0.8s)	3184	3184	256	54	197	0	13	264
13141	8448s (+0.8s)	3552	3552	256	58	230	0	9	297
13142	8449s (+1.1s)	5736	5736	512	86	307	0	12	405
13143	8450s (+0.8s)	3296	3296	256	62	190	0	16	268
13144	8451s (+1.5s)	7608	7608	512	105	397	0	30	532
13145	8452s (+0.9s)	3824	3824	256	78	218	20	0	316
13146	8453s (+0.5s)	1836	1836	128	45	137	0	7	189
13147	8453s (+0.7s)	2868	2868	256	56	178	0	14	248
13148	8454s (+0.9s)	3608	3608	256	67	225	0	12	304
13149	8455s (+0.4s)	1492	1492	128	36	115	0	4	155
13150	8456s (+0.7s)	2900	2900	256	46	190	0	16	252
13151	8456s (+0.7s)	3172	3172	256	68	182	0	11	261
13152	8457s (+0.3s)	964	964	64	18	88	0	5	111
13153	8457s (+0.8s)	3212	3212	256	52	207	0	9	268
13154	8458s (+0.9s)	3696	3696	256	66	217	0	23	306
13155	8459s (+0.3s)	860	860	64	20	85	0	3	108
13156	8459s (+0.6s)	2588	2588	256	55	153	0	13	221
13157	8460s (+0.5s)	1768	1768	128	42	129	0	11	182
13158	8460s (+0.6s)	2404	2404	128	40	174	0	10	224
13159	8461s (+0.3s)	1140	1140	128	21	95	0	4	120
13160	8462s (+1.1s)	5484	5484	512	88	283	0	16	387
13161	8462s (+0.6s)	1928	1928	128	35	157	0	8	200
13162	8463s (+0.2s)	612	612	64	11	71	0	4	86
13163	8463s (+0.6s)	2080	2080	128	63	132	12	0	207
13164	8464s (+1.0s)	5008	5008	512	109	224	20	0	353
13165	8465s (+0.9s)	3952	3952	256	83	220	19	0	322
13166	8466s (+0.4s)	1080	1080	64	29	86	7	0	122
13167	8466s (+0.5s)	1804	1804	128	40	140	6	0	186
13168	8466s (+0.2s)	552	552	32	23	56	4	0	83
13169	8467s (+0.6s)	2396	2396	256	48	144	11	0	203
13170	8468s (+0.8s)	3504	3504	256	90	189	11	0	290
13171	8468s (+0.7s)	3160	3160	256	66	188	11	0	265
13172	8469s (+0.4s)	1216	1216	64	35	92	9	0	136
13173	8469s (+0.3s)	992	992	128	17	86	1	0	104
13174	8470s (+0.6s)	2480	2480	256	42	159	10	1	212
13175	8470s (+0.5s)	1804	1804	128	36	138	6	0	180
13176	8471s (+0.7s)	2712	2712	128	73	167	16	0	256
13177	8472s (+0.8s)	3556	3556	256	74	214	15	0	303
13178	8472s (+0.4s)	1472	1472	128	34	111	6	1	152
13179	8473s (+0.5s)	1684	1684	128	40	125	6	1	172
13180	8473s (+0.6s)	2628	2628	256	71	142	9	0	222
13181	8474s (+0.9s)	3568	3568	256	87	196	15	1	299
13182	8475s (+0.4s)	1412	1412	128	47	92	10	0	149
13183	8476s (+1.3s)	6348	6348	512	112	311	23	0	446
13184	8476s (+0.4s)	1456	1456	128	31	113	5	1	150
13185	8477s (+0.3s)	952	952	128	19	77	2	1	99
13186	8478s (+0.9s)	4036	4036	256	73	243	15	0	331
13187	8478s (+0.4s)	1476	1476	128	33	115	6	0	154
13188	8479s (+0.9s)	3964	3964	256	88	226	16	0	330
13189	8480s (+0.6s)	2488	2488	256	41	167	6	0	214
13190	8480s (+0.5s)	1648	1648	128	36	123	7	0	166
13191	8480s (+0.2s)	548	548	64	27	48	4	0	79
13192	8481s (+0.8s)	3256	3256	256	77	180	16	1	274
13193	8482s (+0.4s)	1428	1428	128	39	107	6	0	152
13194	8483s (+1.3s)	6564	6564	512	120	329	25	1	475
13195	8483s (+0.3s)	844	844	64	21	80	7	0	108
13196	8484s (+1.2s)	6020	6020	512	122	286	20	0	428
13197	8485s (+0.9s)	3720	3720	256	75	209	16	1	301
13198	8486s (+0.9s)	3844	3844	256	81	232	9	0	322
13199	8487s (+0.5s)	1516	1516	128	44	108	10	0	162
Episode	Time	Reward	Score	Highest	L	U	R	D	Steps
13200	8487s (+0.6s)	1932	1932	128	43	148	10	0	201
13201	8488s (+0.4s)	1484	1484	128	33	109	7	0	149
13202	8488s (+0.3s)	752	752	64	19	76	5	0	100
13203	8488s (+0.4s)	1308	1308	128	35	94	4	0	133
13204	8489s (+0.9s)	3640	3640	256	95	201	17	0	313
13205	8490s (+0.8s)	3528	3528	256	68	213	16	0	297
13206	8491s (+0.5s)	1828	1828	128	52	127	6	0	185
13207	8492s (+0.9s)	3988	3988	256	81	225	15	0	321
13208	8492s (+0.4s)	1372	1372	128	35	96	0	10	141
13209	8493s (+0.8s)	3240	3240	256	51	208	0	15	274
13210	8494s (+0.8s)	3232	3232	256	78	179	0	14	271
13211	8494s (+0.6s)	2448	2448	256	45	157	0	6	208
13212	8495s (+0.7s)	2772	2772	256	49	177	0	15	241
13213	8495s (+0.5s)	1600	1600	128	35	126	0	8	169
13214	8496s (+0.6s)	2428	2428	128	43	167	0	15	225
13215	8496s (+0.5s)	2156	2156	256	34	141	0	6	181
13216	8497s (+0.4s)	1460	1460	128	28	112	0	10	150
13217	8497s (+0.2s)	556	556	64	9	67	0	2	78
13218	8498s (+0.5s)	1548	1548	128	33	125	0	8	166
13219	8498s (+0.3s)	684	684	64	23	65	0	5	93
13220	8498s (+0.6s)	2472	2472	256	52	149	13	0	214
13221	8499s (+0.5s)	1756	1756	128	43	127	7	1	178
13222	8500s (+0.5s)	1740	1740	128	42	127	6	0	175
13223	8501s (+1.2s)	6212	6212	512	135	278	26	0	439
13224	8501s (+0.6s)	1936	1936	128	61	126	8	0	195
13225	8502s (+0.5s)	1668	1668	128	38	122	9	0	169
13226	8503s (+0.8s)	3356	3356	256	79	192	14	0	285
13227	8503s (+0.5s)	1860	1860	128	45	145	5	0	195
13228	8504s (+0.5s)	1600	1600	128	41	121	5	0	167
13229	8504s (+0.5s)	1872	1872	128	56	124	11	0	191
13230	8505s (+0.5s)	1636	1636	128	36	131	8	0	175
13231	8505s (+0.4s)	1148	1148	64	32	97	5	0	134
13232	8506s (+0.6s)	2624	2624	256	57	157	11	0	225
13233	8507s (+1.3s)	6468	6468	512	109	311	21	0	441
13234	8507s (+0.3s)	876	876	64	25	77	9	0	111
13235	8509s (+1.5s)	7512	7512	512	137	355	35	1	528
13236	8510s (+0.8s)	3444	3444	256	80	191	16	0	287
13237	8510s (+0.5s)	1536	1536	128	34	122	0	6	162
13238	8510s (+0.2s)	400	400	32	12	49	0	5	66
13239	8511s (+0.8s)	3416	3416	256	56	214	0	15	285
13240	8511s (+0.3s)	1080	1080	128	25	91	0	3	119
13241	8512s (+0.3s)	860	860	64	20	83	0	7	110
13242	8512s (+0.5s)	1488	1488	128	40	111	5	0	156
13243	8513s (+0.7s)	2796	2796	256	55	179	9	0	243
13244	8513s (+0.3s)	908	908	64	24	86	7	0	117
13245	8514s (+0.8s)	3564	3564	256	93	186	19	0	298
13246	8515s (+0.7s)	3224	3224	256	74	184	10	0	268
13247	8515s (+0.5s)	2072	2072	128	34	149	10	1	194
13248	8516s (+0.8s)	3304	3304	256	88	180	12	1	281
13249	8517s (+1.1s)	4664	4664	256	114	253	19	0	386
13250	8518s (+0.4s)	1184	1184	128	30	91	7	0	128
13251	8518s (+0.6s)	2288	2288	128	58	148	9	0	215
13252	8519s (+0.8s)	3216	3216	256	61	198	12	0	271
13253	8520s (+0.4s)	1488	1488	128	30	119	6	0	155
13254	8521s (+1.0s)	4344	4344	256	98	245	17	0	360
13255	8521s (+0.8s)	3500	3500	256	74	203	17	0	294
13256	8522s (+0.3s)	856	856	64	29	73	7	0	109
13257	8522s (+0.6s)	1832	1832	128	47	135	10	0	192
13258	8523s (+0.2s)	444	444	32	8	62	0	3	73
13259	8523s (+0.8s)	3088	3088	256	54	197	0	12	263
13260	8524s (+0.5s)	2332	2332	256	47	138	0	8	193
13261	8524s (+0.5s)	1780	1780	128	55	121	0	5	181
13262	8525s (+0.5s)	1656	1656	128	40	121	0	6	167
13263	8525s (+0.4s)	1468	1468	128	23	125	0	4	152
13264	8526s (+0.6s)	2436	2436	256	59	142	11	0	212
13265	8527s (+0.8s)	3480	3480	256	74	206	9	1	290
13266	8528s (+1.1s)	5500	5500	512	103	269	18	0	390
13267	8529s (+0.7s)	2904	2904	256	93	140	20	0	253
13268	8529s (+0.5s)	1892	1892	128	44	138	9	0	191
13269	8530s (+0.4s)	1244	1244	128	33	99	7	0	139
13270	8530s (+0.6s)	1996	1996	128	44	149	9	0	202
13271	8531s (+0.8s)	3500	3500	256	74	205	15	0	294
13272	8532s (+0.8s)	3316	3316	256	63	209	9	0	281
13273	8532s (+0.3s)	912	912	64	24	81	4	0	109
13274	8533s (+0.5s)	1600	1600	128	36	126	5	0	167
13275	8534s (+1.0s)	4264	4264	256	76	259	14	0	349
13276	8534s (+0.9s)	3584	3584	256	71	213	19	0	303
13277	8535s (+0.5s)	1688	1688	128	42	119	10	0	171
13278	8535s (+0.4s)	1276	1276	64	38	113	5	0	156
13279	8536s (+0.4s)	1444	1444	128	27	120	4	0	151
13280	8536s (+0.5s)	1584	1584	128	31	130	0	3	164
13281	8537s (+0.5s)	1740	1740	128	40	121	0	14	175
13282	8537s (+0.6s)	1912	1912	128	40	148	0	8	196
13283	8538s (+0.2s)	632	632	64	17	67	3	0	87
13284	8538s (+0.8s)	3528	3528	256	67	216	14	0	297
13285	8540s (+1.2s)	6376	6376	512	111	313	24	0	448
13286	8540s (+0.5s)	1780	1780	128	46	124	10	0	180
13287	8541s (+0.3s)	740	740	64	20	73	5	0	98
13288	8541s (+0.4s)	1412	1412	128	44	89	10	0	143
13289	8542s (+0.8s)	3432	3432	256	102	176	13	0	291
13290	8542s (+0.3s)	908	908	64	22	83	4	0	109
13291	8542s (+0.4s)	1416	1416	128	39	100	0	4	143
13292	8543s (+0.3s)	908	908	64	25	88	0	6	119
13293	8543s (+0.4s)	1352	1352	128	26	108	0	4	138
13294	8544s (+0.5s)	1888	1888	128	43	127	0	10	180
13295	8544s (+0.7s)	2780	2780	256	52	176	11	0	239
13296	8545s (+0.7s)	2780	2780	256	62	164	12	0	238
13297	8546s (+0.8s)	3284	3284	256	70	183	18	0	271
13298	8547s (+1.1s)	5440	5440	512	102	257	20	0	379
13299	8548s (+0.7s)	2676	2676	128	58	181	9	0	248
Episode	Time	Reward	Score	Highest	L	U	R	D	Steps
13300	8549s (+0.8s)	3492	3492	256	65	207	14	1	287
13301	8549s (+0.8s)	3360	3360	256	70	205	11	0	286
13302	8550s (+1.1s)	5496	5496	512	91	275	23	0	389
13303	8551s (+0.6s)	1964	1964	128	50	147	7	0	204
13304	8552s (+0.8s)	3204	3204	256	76	177	15	0	268
13305	8553s (+0.8s)	3164	3164	256	70	183	12	1	266
13306	8553s (+0.6s)	2384	2384	128	57	153	13	1	224
13307	8554s (+0.8s)	3356	3356	256	72	202	11	0	285
13308	8555s (+0.5s)	1588	1588	128	43	107	9	0	159
13309	8555s (+0.5s)	1772	1772	128	48	119	11	0	178
13310	8556s (+1.0s)	4152	4152	256	71	261	8	0	340
13311	8557s (+0.7s)	2992	2992	256	48	197	9	0	254
13312	8558s (+0.8s)	3188	3188	256	59	195	11	0	265
13313	8558s (+0.8s)	3252	3252	256	67	191	18	0	276
13314	8559s (+0.5s)	1808	1808	128	42	132	13	0	187
13315	8560s (+0.9s)	4748	4748	512	83	232	16	0	331
13316	8560s (+0.7s)	2972	2972	256	57	184	7	0	248
13317	8561s (+0.6s)	2552	2552	256	46	171	7	0	224
13318	8562s (+0.7s)	2604	2604	128	74	157	15	0	246
13319	8562s (+0.5s)	1608	1608	128	45	115	6	0	166
13320	8563s (+0.8s)	3500	3500	256	97	184	17	0	298
13321	8564s (+0.5s)	1608	1608	128	35	129	5	0	169
13322	8564s (+0.6s)	1880	1880	128	45	138	11	0	194
13323	8565s (+0.6s)	1944	1944	128	55	121	17	0	193
13324	8565s (+0.5s)	1704	1704	128	52	118	8	0	178
13325	8566s (+0.3s)	1012	1012	64	41	75	6	0	122
13326	8566s (+0.6s)	2180	2180	128	57	148	11	0	216
13327	8567s (+0.8s)	3188	3188	256	71	182	18	0	271
13328	8567s (+0.3s)	660	660	64	16	68	4	0	88
13329	8568s (+0.6s)	2628	2628	256	52	168	11	0	231
13330	8568s (+0.4s)	1580	1580	128	37	119	5	1	162
13331	8569s (+0.5s)	2128	2128	128	55	133	10	0	198
13332	8570s (+0.6s)	2568	2568	256	45	156	11	0	212
13333	8570s (+0.7s)	2712	2712	256	58	165	13	2	238
13334	8571s (+0.4s)	1188	1188	128	21	103	0	6	130
13335	8571s (+0.3s)	984	984	64	19	88	0	8	115
13336	8572s (+0.9s)	3948	3948	256	62	246	0	18	326
13337	8572s (+0.5s)	1600	1600	128	37	119	0	11	167
13338	8573s (+0.3s)	784	784	64	15	80	0	3	98
13339	8573s (+0.4s)	1352	1352	128	24	110	0	6	140
13340	8573s (+0.5s)	1604	1604	128	33	127	6	0	166
13341	8574s (+1.0s)	4316	4316	256	89	241	24	0	354
13342	8575s (+0.5s)	1620	1620	128	46	121	4	1	172
13343	8576s (+0.6s)	2520	2520	256	52	160	9	0	221
13344	8576s (+0.8s)	3176	3176	256	72	178	14	0	264
13345	8577s (+0.8s)	3224	3224	256	67	190	11	0	268
13346	8577s (+0.3s)	900	900	128	16	80	1	0	97
13347	8578s (+0.5s)	1868	1868	128	34	151	5	0	190
13348	8579s (+0.8s)	3240	3240	256	62	199	0	12	273
13349	8579s (+0.4s)	1080	1080	64	23	100	0	7	130
13350	8580s (+0.8s)	3504	3504	256	67	218	0	16	301
13351	8581s (+0.7s)	2908	2908	256	47	175	0	18	240
13352	8581s (+0.2s)	464	464	64	10	53	0	5	68
13353	8581s (+0.5s)	1624	1624	128	56	104	12	0	172
13354	8582s (+0.4s)	1392	1392	128	47	100	6	0	153
13355	8582s (+0.4s)	1076	1076	64	32	95	6	0	133
13356	8583s (+1.0s)	4288	4288	256	82	254	15	0	351
13357	8584s (+0.4s)	1428	1428	128	32	112	2	0	146
13358	8585s (+0.9s)	3840	3840	256	84	221	13	0	318
13359	8585s (+0.8s)	3344	3344	256	73	192	19	2	286
13360	8586s (+0.5s)	1664	1664	128	46	125	7	0	178
13361	8586s (+0.4s)	1496	1496	128	33	122	4	0	159
13362	8587s (+0.7s)	2808	2808	256	55	179	11	0	245
13363	8587s (+0.4s)	1288	1288	128	35	102	5	0	142
13364	8588s (+0.5s)	2276	2276	256	51	128	8	0	187
13365	8588s (+0.5s)	1720	1720	128	43	114	12	2	171
13366	8589s (+0.4s)	1400	1400	128	35	105	6	0	146
13367	8589s (+0.6s)	2252	2252	128	53	139	12	0	204
13368	8590s (+0.4s)	1552	1552	128	32	118	6	0	156
13369	8590s (+0.3s)	852	852	64	30	82	4	0	116
13370	8591s (+0.6s)	1960	1960	128	55	141	7	0	203
13371	8592s (+1.2s)	5812	5812	512	106	294	19	0	419
13372	8593s (+0.6s)	2236	2236	128	58	136	10	3	207
13373	8593s (+0.6s)	2648	2648	256	49	176	11	0	236
13374	8594s (+0.5s)	1624	1624	128	33	128	3	0	164
13375	8595s (+0.7s)	3272	3272	256	57	198	18	0	273
13376	8595s (+0.7s)	3160	3160	256	70	175	13	0	258
13377	8596s (+0.4s)	1224	1224	128	30	87	10	0	127
13378	8596s (+0.7s)	2936	2936	256	60	183	12	0	255
13379	8597s (+0.9s)	4132	4132	256	86	229	14	0	329
13380	8598s (+0.8s)	3376	3376	256	63	207	10	0	280
13381	8599s (+0.4s)	1472	1472	128	27	120	4	1	152
13382	8599s (+0.4s)	1228	1228	128	34	94	4	0	132
13383	8600s (+0.7s)	2796	2796	256	61	165	16	0	242
13384	8600s (+0.8s)	3480	3480	256	74	201	19	0	294
13385	8602s (+1.1s)	4564	4564	256	99	266	18	0	383
13386	8602s (+0.4s)	1176	1176	64	33	103	5	0	141
13387	8603s (+0.6s)	2100	2100	128	46	150	12	0	208
13388	8603s (+0.5s)	1856	1856	128	45	118	11	0	174
13389	8604s (+0.7s)	2772	2772	256	47	181	0	8	236
13390	8604s (+0.7s)	2952	2952	256	50	198	0	12	260
13391	8605s (+0.7s)	2744	2744	256	52	173	0	10	235
13392	8605s (+0.3s)	788	788	64	22	74	0	2	98
13393	8606s (+0.9s)	4092	4092	256	82	233	19	0	334
13394	8607s (+0.6s)	2780	2780	256	43	178	7	0	228
13395	8608s (+0.8s)	3372	3372	256	66	213	10	0	289
13396	8609s (+0.9s)	4028	4028	256	93	216	17	0	326
13397	8609s (+0.3s)	972	972	64	42	71	6	0	119
13398	8610s (+0.7s)	3016	3016	256	64	189	12	0	265
13399	8611s (+1.1s)	6016	6016	512	109	288	25	0	422
Episode	Time	Reward	Score	Highest	L	U	R	D	Steps
13400	8612s (+0.9s)	3836	3836	256	89	209	17	0	315
13401	8613s (+1.0s)	4256	4256	256	98	228	20	0	346
13402	8613s (+0.3s)	792	792	64	32	68	6	0	106
13403	8614s (+0.5s)	1856	1856	128	53	126	7	1	187
13404	8615s (+0.8s)	3556	3556	256	85	208	10	0	303
13405	8615s (+0.5s)	2300	2300	256	47	132	12	0	191
13406	8616s (+0.5s)	1804	1804	128	37	140	9	0	186
13407	8617s (+0.9s)	3644	3644	256	86	204	23	0	313
13408	8617s (+0.9s)	3828	3828	256	81	217	14	0	312
13409	8618s (+1.0s)	4184	4184	256	87	237	17	0	341
13410	8619s (+0.5s)	1752	1752	128	46	116	12	0	174
13411	8619s (+0.5s)	1808	1808	128	46	133	7	0	186
13412	8620s (+0.6s)	2316	2316	128	65	139	18	0	222
13413	8621s (+0.8s)	3436	3436	256	73	207	14	0	294
13414	8622s (+0.6s)	2128	2128	128	64	140	14	0	218
13415	8623s (+0.9s)	3884	3884	256	80	221	14	0	315
13416	8623s (+0.7s)	3176	3176	256	64	194	11	0	269
13417	8624s (+0.6s)	2388	2388	256	55	140	11	0	206
13418	8624s (+0.5s)	1760	1760	128	34	143	3	0	180
13419	8625s (+0.9s)	3596	3596	256	85	202	19	0	306
13420	8626s (+0.8s)	3408	3408	256	64	209	10	0	283
13421	8627s (+0.5s)	1796	1796	128	47	130	7	0	184
13422	8627s (+0.8s)	3216	3216	256	67	187	13	0	267
13423	8628s (+0.4s)	1456	1456	128	31	114	4	0	149
13424	8629s (+1.0s)	4340	4340	256	88	254	21	0	363
13425	8629s (+0.5s)	1688	1688	128	51	115	7	0	173
13426	8630s (+0.5s)	1624	1624	128	41	114	7	0	162
13427	8630s (+0.4s)	1184	1184	128	27	96	5	0	128
13428	8631s (+0.9s)	3612	3612	256	83	212	11	0	306
13429	8632s (+0.6s)	1940	1940	128	47	149	7	0	203
13430	8632s (+0.4s)	1500	1500	128	34	116	8	0	158
13431	8633s (+0.7s)	3216	3216	256	68	185	8	0	261
13432	8634s (+1.0s)	4064	4064	256	97	220	18	0	335
13433	8634s (+0.5s)	1772	1772	128	48	127	7	0	182
13434	8635s (+0.4s)	1468	1468	128	35	107	9	0	151
13435	8635s (+0.4s)	1468	1468	128	30	116	6	0	152
13436	8636s (+0.7s)	2924	2924	256	59	172	11	1	243
13437	8636s (+0.6s)	1904	1904	128	47	132	15	0	194
13438	8637s (+0.9s)	3632	3632	256	72	223	11	0	306
13439	8638s (+0.6s)	2476	2476	256	50	152	9	0	211
13440	8639s (+0.6s)	2560	2560	256	48	165	8	0	221
13441	8639s (+0.4s)	1492	1492	128	34	115	8	0	157
13442	8639s (+0.4s)	1320	1320	128	28	105	6	0	139
13443	8640s (+0.7s)	2736	2736	128	77	173	8	0	258
13444	8641s (+0.5s)	1792	1792	128	48	122	12	0	182
13445	8641s (+0.7s)	2672	2672	128	75	161	10	1	247
13446	8642s (+0.6s)	2280	2280	256	50	140	4	0	194
13447	8642s (+0.2s)	348	348	32	16	44	1	0	61
13448	8643s (+0.4s)	1504	1504	128	30	125	5	0	160
13449	8643s (+0.6s)	2304	2304	256	33	151	10	0	194
13450	8644s (+0.6s)	2440	2440	256	46	154	8	0	208
13451	8644s (+0.6s)	1872	1872	128	40	143	8	0	191
13452	8645s (+0.6s)	1948	1948	128	39	148	11	0	198
13453	8646s (+0.5s)	1832	1832	128	32	153	3	0	188
13454	8646s (+1.0s)	4048	4048	256	86	231	18	0	335
13455	8647s (+0.3s)	960	960	64	36	76	7	0	119
13456	8648s (+1.2s)	5752	5752	512	100	285	0	19	404
13457	8648s (+0.4s)	1500	1500	128	32	114	0	6	152
13458	8649s (+0.6s)	2604	2604	256	49	166	0	11	226
13459	8650s (+0.6s)	2092	2092	128	61	139	10	0	210
13460	8650s (+0.4s)	1244	1244	128	36	94	8	0	138
13461	8651s (+0.5s)	1764	1764	128	34	141	5	0	180
13462	8651s (+0.3s)	916	916	64	29	84	7	0	120
13463	8651s (+0.4s)	1312	1312	128	29	100	5	0	134
13464	8652s (+0.2s)	588	588	32	21	62	4	0	87
13465	8653s (+0.9s)	3624	3624	256	92	207	10	0	309
13466	8653s (+0.4s)	1516	1516	128	28	118	0	6	152
13467	8653s (+0.4s)	1544	1544	128	35	113	0	11	159
13468	8654s (+0.9s)	3568	3568	256	65	229	0	11	305
13469	8655s (+0.4s)	1404	1404	128	32	112	0	7	151
13470	8655s (+0.4s)	1452	1452	128	26	120	0	3	149
13471	8656s (+0.5s)	1756	1756	128	31	143	0	3	177
13472	8656s (+0.7s)	2912	2912	256	51	193	0	12	256
13473	8657s (+0.5s)	1812	1812	128	38	142	0	8	188
13474	8657s (+0.4s)	1408	1408	128	24	111	0	10	145
13475	8658s (+0.8s)	3304	3304	256	84	183	10	0	277
13476	8659s (+0.4s)	1528	1528	128	35	113	6	1	155
13477	8659s (+0.8s)	3228	3228	256	68	190	12	0	270
13478	8660s (+0.4s)	1516	1516	128	41	108	8	0	157
13479	8661s (+1.1s)	5228	5228	512	98	264	18	0	380
13480	8662s (+1.1s)	5536	5536	512	117	252	18	1	388
13481	8663s (+0.6s)	1904	1904	128	50	134	10	0	194
13482	8663s (+0.8s)	3276	3276	256	73	196	8	0	277
13483	8664s (+0.6s)	1996	1996	128	43	144	8	0	195
13484	8664s (+0.4s)	1608	1608	128	34	120	5	0	159
13485	8665s (+0.2s)	612	612	64	14	66	2	0	82
13486	8665s (+0.7s)	2540	2540	128	71	150	13	0	234
13487	8666s (+0.7s)	2800	2800	256	69	162	12	0	243
13488	8666s (+0.2s)	520	520	64	19	49	3	0	71
13489	8667s (+0.8s)	3216	3216	256	70	185	13	0	268
13490	8668s (+0.6s)	2580	2580	256	46	165	8	1	220
13491	8668s (+0.5s)	1880	1880	128	49	130	10	0	189
13492	8669s (+0.6s)	2676	2676	256	68	149	12	0	229
13493	8669s (+0.5s)	1876	1876	128	45	138	9	0	192
13494	8670s (+0.7s)	2684	2684	256	60	160	10	1	231
13495	8671s (+1.0s)	5116	5116	512	85	260	17	0	362
13496	8671s (+0.4s)	1424	1424	128	39	102	4	0	145
13497	8672s (+0.5s)	1784	1784	128	34	143	4	0	181
13498	8672s (+0.4s)	1584	1584	128	31	118	0	6	155
13499	8673s (+0.8s)	3256	3256	256	48	214	0	15	277
Episode	Time	Reward	Score	Highest	L	U	R	D	Steps
13500	8674s (+0.3s)	880	880	64	21	91	0	3	115
13501	8675s (+0.9s)	3776	3776	256	82	209	19	0	310
13502	8675s (+0.6s)	2152	2152	128	55	153	9	0	217
13503	8676s (+0.9s)	4084	4084	256	75	231	22	0	328
13504	8677s (+0.6s)	1928	1928	128	63	129	8	0	200
13505	8677s (+0.7s)	2784	2784	256	62	169	9	0	240
13506	8678s (+0.3s)	904	904	64	27	90	5	0	122
13507	8678s (+0.6s)	1920	1920	128	51	138	9	0	198
13508	8679s (+0.5s)	1704	1704	128	36	126	8	0	170
13509	8679s (+0.7s)	2416	2416	128	69	145	13	0	227
13510	8680s (+0.3s)	952	952	64	25	87	6	0	118
13511	8680s (+0.6s)	2612	2612	256	44	174	0	9	227
13512	8681s (+0.4s)	1236	1236	64	35	102	0	4	141
13513	8682s (+0.9s)	3952	3952	256	69	238	0	16	323
13514	8683s (+0.8s)	3228	3228	256	56	206	0	8	270
13515	8683s (+0.4s)	1188	1188	128	19	105	0	6	130
13516	8683s (+0.6s)	2360	2360	256	36	150	0	12	198
13517	8684s (+0.7s)	2888	2888	256	49	178	0	9	236
13518	8685s (+0.4s)	1384	1384	128	26	117	0	4	147
13519	8686s (+1.0s)	4016	4016	256	57	263	0	18	338
13520	8686s (+0.5s)	1760	1760	128	46	123	6	0	175
13521	8687s (+0.9s)	3584	3584	256	84	199	16	0	299
13522	8687s (+0.4s)	1276	1276	128	26	107	6	0	139
13523	8688s (+0.5s)	1660	1660	128	38	124	5	0	167
13524	8689s (+0.9s)	4048	4048	256	89	227	18	0	334
13525	8689s (+0.5s)	1476	1476	128	33	118	6	0	157
13526	8690s (+1.2s)	5784	5784	512	100	292	20	0	412
13527	8691s (+0.4s)	1140	1140	64	43	83	11	0	137
13528	8692s (+1.0s)	4224	4224	256	94	235	18	0	347
13529	8693s (+1.0s)	4200	4200	256	84	244	16	0	344
13530	8693s (+0.5s)	1732	1732	128	40	132	7	0	179
13531	8694s (+0.4s)	1060	1060	64	32	90	7	0	129
13532	8694s (+0.6s)	2048	2048	128	64	126	13	0	203
13533	8695s (+0.6s)	2328	2328	256	43	146	7	0	196
13534	8695s (+0.6s)	2064	2064	128	53	129	11	0	193
13535	8696s (+0.7s)	3040	3040	256	70	175	9	1	255
13536	8696s (+0.2s)	664	664	64	17	67	2	0	86
13537	8697s (+0.5s)	1888	1888	128	46	137	8	0	191
13538	8698s (+1.0s)	5036	5036	512	90	235	15	0	340
13539	8699s (+0.6s)	2308	2308	128	62	143	10	0	215
13540	8699s (+0.6s)	2492	2492	256	53	154	9	0	216
13541	8700s (+0.4s)	1184	1184	64	39	95	8	0	142
13542	8700s (+0.5s)	2288	2288	256	37	143	5	1	186
13543	8701s (+0.9s)	3512	3512	256	79	202	16	0	297
13544	8701s (+0.6s)	1940	1940	128	44	154	5	0	203
13545	8702s (+0.5s)	1692	1692	128	44	119	12	0	175
13546	8702s (+0.4s)	1444	1444	128	34	110	7	0	151
13547	8703s (+0.9s)	3744	3744	256	77	219	15	1	312
13548	8704s (+0.9s)	3704	3704	256	77	212	15	0	304
13549	8705s (+0.4s)	960	960	64	36	86	4	0	126
13550	8705s (+0.8s)	3340	3340	256	64	200	12	0	276
13551	8706s (+0.4s)	1020	1020	64	40	84	5	0	129
13552	8706s (+0.5s)	1700	1700	128	37	130	9	0	176
13553	8707s (+0.5s)	1604	1604	128	48	112	8	0	168
13554	8707s (+0.5s)	1788	1788	128	50	127	5	0	182
13555	8708s (+0.9s)	3844	3844	256	59	251	0	12	322
13556	8709s (+0.9s)	3720	3720	256	67	228	0	7	302
13557	8710s (+0.5s)	2212	2212	256	39	129	0	8	176
13558	8710s (+0.5s)	1640	1640	128	39	129	0	8	176
13559	8710s (+0.4s)	1464	1464	128	35	107	0	7	149
13560	8711s (+0.3s)	684	684	64	16	68	0	5	89
13561	8711s (+0.6s)	2460	2460	256	47	155	0	9	211
13562	8712s (+0.8s)	3248	3248	256	63	197	0	14	274
13563	8713s (+0.7s)	2852	2852	256	57	180	11	0	248
13564	8713s (+0.5s)	1780	1780	128	50	126	9	0	185
13565	8714s (+0.4s)	1392	1392	128	29	112	6	0	147
13566	8715s (+0.9s)	3956	3956	256	82	223	18	1	324
13567	8715s (+0.5s)	1792	1792	128	38	136	9	0	183
13568	8716s (+0.7s)	3068	3068	256	61	177	13	0	251
13569	8716s (+0.5s)	1792	1792	128	38	138	7	0	183
13570	8717s (+0.8s)	3216	3216	256	65	195	11	0	271
13571	8718s (+0.6s)	2308	2308	128	60	154	10	0	224
13572	8719s (+0.8s)	3360	3360	256	74	202	10	0	286
13573	8719s (+0.7s)	3048	3048	256	62	193	6	0	261
13574	8720s (+1.0s)	4044	4044	256	90	223	20	0	333
13575	8721s (+0.7s)	2928	2928	256	66	178	14	0	258
13576	8722s (+0.8s)	3232	3232	256	65	193	14	0	272
13577	8723s (+0.8s)	3344	3344	256	78	188	16	0	282
13578	8724s (+0.8s)	3668	3668	256	75	206	18	1	300
13579	8724s (+0.5s)	2112	2112	256	49	125	7	0	181
13580	8725s (+0.8s)	3224	3224	256	48	214	7	0	269
13581	8726s (+0.6s)	2668	2668	256	51	161	14	0	226
13582	8726s (+0.7s)	2920	2920	256	70	177	9	0	256
13583	8727s (+0.6s)	2300	2300	256	41	150	7	0	198
13584	8728s (+0.7s)	2976	2976	256	48	192	10	1	251
13585	8728s (+0.5s)	1672	1672	64	50	121	7	0	178
13586	8729s (+0.6s)	2464	2464	256	54	141	12	1	208
13587	8730s (+0.8s)	3552	3552	256	92	198	12	0	302
13588	8730s (+0.3s)	1136	1136	128	28	84	9	0	121
13589	8730s (+0.5s)	1568	1568	128	51	107	6	0	164
13590	8731s (+0.8s)	3524	3524	256	71	207	17	0	295
13591	8732s (+0.8s)	3612	3612	256	57	226	1	7	291
13592	8732s (+0.2s)	460	460	32	13	57	0	5	75
13593	8733s (+0.4s)	1220	1220	128	19	108	0	6	133
13594	8733s (+0.8s)	3368	3368	256	75	186	27	0	288
13595	8734s (+0.9s)	3892	3892	256	82	221	13	1	317
13596	8735s (+0.4s)	1484	1484	128	33	116	5	1	155
13597	8736s (+0.7s)	2588	2588	128	66	165	10	0	241
13598	8736s (+0.5s)	1492	1492	128	38	112	7	0	157
13599	8736s (+0.5s)	1640	1640	128	43	111	11	1	166
Episode	Time	Reward	Score	Highest	L	U	R	D	Steps
13600	8737s (+0.4s)	1408	1408	128	33	108	7	0	148
13601	8737s (+0.4s)	1272	1272	128	31	101	6	0	138
13602	8738s (+0.8s)	3252	3252	256	75	191	9	1	276
13603	8739s (+0.7s)	3172	3172	256	63	191	7	0	261
13604	8739s (+0.6s)	2640	2640	256	56	146	13	2	217
13605	8740s (+0.7s)	2904	2904	256	65	178	9	0	252
13606	8740s (+0.4s)	1208	1208	128	25	100	5	0	130
13607	8741s (+0.4s)	1088	1088	64	36	89	5	0	130
13608	8742s (+1.0s)	4496	4496	256	89	263	18	0	370
13609	8743s (+0.8s)	3420	3420	256	72	206	9	0	287
13610	8743s (+0.6s)	2500	2500	128	76	138	15	0	229
13611	8744s (+0.7s)	2860	2860	256	66	166	14	0	246
13612	8745s (+0.7s)	2936	2936	256	58	177	9	1	245
13613	8746s (+0.9s)	4664	4664	512	81	215	16	0	312
13614	8746s (+0.3s)	876	876	64	29	81	4	0	114
13615	8747s (+0.7s)	3160	3160	256	54	196	8	0	258
13616	8747s (+0.7s)	2804	2804	256	73	159	12	0	244
13617	8748s (+0.9s)	3540	3540	256	65	218	16	0	299
13618	8749s (+0.5s)	1616	1616	128	42	115	10	0	167
13619	8749s (+0.7s)	2764	2764	256	70	153	11	0	234
13620	8750s (+0.8s)	3412	3412	256	70	196	17	0	283
13621	8751s (+0.7s)	2332	2332	128	57	168	12	0	237
13622	8752s (+0.6s)	2152	2152	128	51	154	11	0	216
13623	8752s (+0.7s)	2960	2960	256	65	178	8	0	251
13624	8753s (+0.8s)	3248	3248	256	65	191	13	0	269
13625	8754s (+0.9s)	4668	4668	512	76	224	18	2	320
13626	8755s (+1.0s)	4236	4236	256	85	245	19	0	349
13627	8756s (+0.7s)	2732	2732	256	72	157	9	0	238
13628	8756s (+0.3s)	904	904	64	37	74	5	0	116
13629	8757s (+0.5s)	1828	1828	128	43	140	8	0	191
13630	8757s (+0.8s)	3560	3560	256	78	196	15	0	289
13631	8758s (+0.8s)	3260	3260	256	75	188	14	0	277
13632	8759s (+0.9s)	3820	3820	256	74	217	20	0	311
13633	8760s (+0.7s)	2736	2736	256	60	161	8	0	229
13634	8760s (+0.6s)	2640	2640	256	51	170	8	0	229
13635	8761s (+0.8s)	3236	3236	256	67	190	14	1	272
13636	8762s (+0.4s)	1452	1452	128	40	102	8	1	151
13637	8762s (+0.6s)	2612	2612	256	61	154	13	0	228
13638	8763s (+0.8s)	3516	3516	256	74	196	14	0	284
13639	8763s (+0.4s)	992	992	64	28	88	7	0	123
13640	8764s (+0.8s)	3296	3296	256	65	203	11	0	279
13641	8765s (+0.6s)	1888	1888	128	46	138	10	0	194
13642	8765s (+0.6s)	2340	2340	256	38	154	5	0	197
13643	8766s (+0.5s)	1848	1848	128	43	134	9	0	186
13644	8766s (+0.4s)	1312	1312	128	27	111	6	0	144
13645	8767s (+0.4s)	1512	1512	128	33	116	8	0	157
13646	8768s (+0.8s)	3444	3444	256	64	207	13	0	284
13647	8768s (+0.4s)	1500	1500	128	39	112	8	0	159
13648	8769s (+0.6s)	1896	1896	128	42	146	5	0	193
13649	8769s (+0.6s)	2732	2732	256	54	177	7	0	238
13650	8769s (+0.2s)	656	656	64	24	60	0	5	89
13651	8771s (+1.2s)	5812	5812	512	94	301	0	24	419
13652	8771s (+0.5s)	1604	1604	128	31	129	0	8	168
13653	8772s (+0.7s)	3060	3060	256	50	190	0	7	247
13654	8772s (+0.4s)	1500	1500	128	27	129	0	3	159
13655	8773s (+0.7s)	2532	2532	128	44	181	0	15	240
13656	8773s (+0.4s)	1424	1424	128	21	117	0	7	145
13657	8774s (+0.4s)	1440	1440	128	24	120	0	5	149
13658	8774s (+0.5s)	1596	1596	128	41	118	0	7	166
13659	8775s (+0.3s)	1132	1132	128	19	100	0	3	122
13660	8776s (+0.9s)	4112	4112	256	81	230	24	0	335
13661	8776s (+0.6s)	2044	2044	128	60	137	9	0	206
13662	8777s (+0.8s)	3652	3652	256	63	224	10	0	297
13663	8778s (+0.7s)	2796	2796	256	60	177	5	0	242
13664	8778s (+0.6s)	1936	1936	128	42	153	7	0	202
13665	8779s (+0.4s)	1236	1236	64	38	107	5	1	151
13666	8779s (+0.7s)	2496	2496	128	59	166	10	0	235
13667	8780s (+0.6s)	2176	2176	128	45	146	13	0	204
13668	8781s (+0.7s)	2780	2780	256	52	174	10	0	236
13669	8782s (+1.5s)	7520	7520	512	131	373	21	0	525
13670	8783s (+0.3s)	1172	1172	128	23	96	6	1	126
13671	8784s (+0.8s)	3536	3536	256	61	225	12	0	298
13672	8784s (+0.7s)	2772	2772	256	56	169	9	1	235
13673	8785s (+0.5s)	1604	1604	128	43	115	6	0	164
13674	8785s (+0.6s)	2236	2236	128	65	126	17	0	208
13675	8786s (+0.5s)	1636	1636	128	40	114	10	1	165
13676	8787s (+0.8s)	3372	3372	256	78	199	12	0	289
13677	8787s (+0.7s)	2908	2908	256	51	191	10	1	253
13678	8788s (+0.4s)	1188	1188	64	31	106	7	0	144
13679	8788s (+0.4s)	1516	1516	128	31	126	6	0	163
13680	8789s (+0.9s)	3776	3776	256	74	218	12	0	304
13681	8790s (+0.8s)	3216	3216	256	61	196	10	0	267
13682	8790s (+0.6s)	1904	1904	128	52	138	5	0	195
13683	8791s (+0.7s)	3028	3028	256	56	179	14	0	249
13684	8792s (+0.5s)	1624	1624	128	42	118	12	0	172
13685	8792s (+0.5s)	1768	1768	128	39	127	11	0	177
13686	8793s (+0.5s)	1784	1784	128	45	130	7	0	182
13687	8794s (+0.8s)	3392	3392	256	64	202	14	1	281
13688	8794s (+0.3s)	1104	1104	128	35	79	6	0	120
13689	8795s (+0.7s)	2960	2960	256	56	188	11	0	255
13690	8795s (+0.3s)	788	788	64	23	77	3	1	104
13691	8795s (+0.5s)	1632	1632	128	46	124	5	0	175
13692	8796s (+0.5s)	1816	1816	128	43	140	5	0	188
13693	8797s (+0.8s)	3520	3520	256	71	212	11	0	294
13694	8798s (+0.8s)	3296	3296	256	71	202	13	0	286
13695	8798s (+0.8s)	3432	3432	256	52	220	0	14	286
13696	8799s (+0.4s)	1052	1052	64	23	96	0	8	127
13697	8799s (+0.6s)	2592	2592	256	47	167	0	10	224
13698	8800s (+0.7s)	2932	2932	256	44	205	0	10	259
13699	8801s (+0.4s)	1244	1244	128	35	90	4	0	129
Episode	Time	Reward	Score	Highest	L	U	R	D	Steps
13700	8801s (+0.9s)	4496	4496	512	67	227	10	0	304
13701	8802s (+0.4s)	1228	1228	128	27	103	5	0	135
13702	8802s (+0.6s)	2592	2592	256	59	155	9	0	223
13703	8803s (+0.9s)	3724	3724	256	98	197	22	1	318
13704	8804s (+0.6s)	2340	2340	128	42	172	10	0	224
13705	8804s (+0.5s)	1688	1688	128	44	122	8	0	174
13706	8805s (+0.5s)	1640	1640	128	44	124	8	0	176
13707	8806s (+0.9s)	3644	3644	256	65	217	0	17	299
13708	8806s (+0.5s)	1536	1536	128	37	113	0	12	162
13709	8807s (+0.5s)	1900	1900	128	35	151	0	7	193
13710	8807s (+0.5s)	1836	1836	128	32	148	0	8	188
13711	8808s (+0.7s)	2860	2860	256	53	188	0	10	251
13712	8809s (+0.6s)	2404	2404	256	43	151	0	9	203
13713	8810s (+0.8s)	3316	3316	256	70	195	7	0	272
13714	8810s (+0.8s)	3416	3416	256	73	201	11	0	285
13715	8811s (+0.5s)	1792	1792	128	44	131	8	0	183
13716	8812s (+1.1s)	5608	5608	512	99	276	26	0	401
13717	8813s (+0.7s)	2456	2456	128	58	158	10	0	226
13718	8813s (+0.8s)	2920	2920	128	87	174	14	1	276
13719	8814s (+0.9s)	3744	3744	256	100	205	17	0	322
13720	8815s (+0.5s)	1644	1644	128	42	114	7	0	163
13721	8815s (+0.4s)	1480	1480	128	35	115	4	0	154
13722	8816s (+0.5s)	1672	1672	128	38	127	6	0	171
13723	8816s (+0.5s)	1828	1828	128	40	129	12	0	181
13724	8817s (+0.6s)	2024	2024	128	64	122	12	0	198
13725	8818s (+0.7s)	2920	2920	256	59	189	8	0	256
13726	8818s (+0.9s)	3780	3780	256	86	208	17	0	311
13727	8819s (+0.4s)	1164	1164	64	36	97	5	0	138
13728	8819s (+0.5s)	2036	2036	256	42	120	6	0	168
13729	8820s (+0.8s)	3344	3344	256	61	207	0	14	282
13730	8821s (+0.7s)	3104	3104	256	51	195	0	11	257
13731	8822s (+0.8s)	3492	3492	256	57	219	0	16	292
13732	8822s (+0.4s)	1280	1280	128	28	95	0	7	130
13733	8823s (+0.8s)	3128	3128	256	71	181	14	0	266
13734	8823s (+0.4s)	1168	1168	128	21	103	3	0	127
13735	8824s (+0.8s)	3288	3288	256	84	184	12	0	280
13736	8825s (+0.6s)	2492	2492	256	58	137	12	0	207
13737	8825s (+0.6s)	2416	2416	256	50	146	10	1	207
13738	8826s (+0.8s)	3428	3428	256	87	175	20	0	282
13739	8827s (+0.8s)	3464	3464	256	71	209	12	0	292
13740	8828s (+0.8s)	3312	3312	256	63	201	12	0	276
13741	8828s (+0.7s)	2912	2912	256	56	185	13	0	254
13742	8829s (+0.7s)	2904	2904	256	76	160	16	0	252
13743	8830s (+0.4s)	1228	1228	128	32	101	3	0	136
13744	8830s (+0.7s)	3048	3048	256	78	169	15	0	262
13745	8831s (+0.4s)	1436	1436	128	39	107	9	0	155
13746	8832s (+1.0s)	4064	4064	256	91	228	19	0	338
13747	8832s (+0.4s)	1376	1376	64	38	105	8	0	151
13748	8833s (+0.8s)	3176	3176	256	77	180	15	1	273
13749	8834s (+0.9s)	3844	3844	256	62	246	6	0	314
13750	8835s (+0.8s)	3560	3560	256	85	195	14	0	294
13751	8835s (+0.7s)	2804	2804	256	61	173	10	0	244
13752	8836s (+0.4s)	1188	1188	128	37	85	7	0	129
13753	8836s (+0.6s)	2512	2512	256	62	144	13	0	219
13754	8837s (+0.5s)	1768	1768	128	38	129	14	0	181
13755	8838s (+1.0s)	4036	4036	256	83	228	23	1	335
13756	8838s (+0.4s)	988	988	64	30	91	5	0	126
13757	8839s (+0.4s)	1468	1468	128	49	95	8	0	152
13758	8839s (+0.5s)	1684	1684	128	36	124	6	0	166
13759	8840s (+0.5s)	1648	1648	128	41	117	6	0	164
13760	8840s (+0.5s)	1648	1648	128	33	124	0	6	163
13761	8841s (+0.4s)	1480	1480	128	31	112	0	10	153
13762	8841s (+0.7s)	3144	3144	256	67	183	0	10	260
13763	8842s (+0.6s)	2280	2280	256	42	139	0	14	195
13764	8842s (+0.4s)	1240	1240	64	31	112	0	8	151
13765	8843s (+0.5s)	1652	1652	128	31	129	0	9	169
13766	8843s (+0.7s)	2924	2924	256	53	172	0	11	236
13767	8844s (+0.8s)	3224	3224	256	51	210	0	8	269
13768	8845s (+0.5s)	1784	1784	128	43	127	0	10	180
13769	8846s (+0.8s)	3348	3348	256	66	191	0	16	273
13770	8847s (+1.2s)	5764	5764	512	80	302	0	29	411
13771	8848s (+0.8s)	3264	3264	256	63	201	0	14	278
13772	8848s (+0.4s)	996	996	64	24	93	0	7	124
13773	8849s (+0.9s)	3772	3772	256	79	217	13	0	309
13774	8849s (+0.5s)	1628	1628	128	33	123	8	0	164
13775	8850s (+0.8s)	3432	3432	256	69	208	12	0	289
13776	8851s (+0.7s)	2624	2624	256	54	168	9	0	231
13777	8852s (+0.9s)	3580	3580	256	74	213	15	0	302
13778	8852s (+0.5s)	1552	1552	128	29	121	9	1	160
13779	8853s (+0.5s)	1616	1616	128	48	116	7	0	171
13780	8853s (+0.5s)	1668	1668	128	35	125	8	0	168
13781	8853s (+0.3s)	752	752	64	20	76	4	0	100
13782	8854s (+0.6s)	2440	2440	256	55	147	14	1	217
13783	8854s (+0.4s)	1160	1160	128	30	89	7	0	126
13784	8855s (+0.5s)	1788	1788	128	46	126	8	1	181
13785	8856s (+0.7s)	3208	3208	256	71	183	11	0	265
13786	8856s (+0.7s)	3076	3076	256	60	180	14	0	254
13787	8857s (+0.6s)	2772	2772	256	46	173	0	8	227
13788	8858s (+0.7s)	3096	3096	256	49	196	0	10	255
13789	8858s (+0.3s)	860	860	64	24	79	0	8	111
13790	8859s (+0.5s)	1808	1808	128	45	133	0	9	187
13791	8859s (+0.7s)	2940	2940	256	48	182	0	13	243
13792	8860s (+0.8s)	3368	3368	256	65	202	0	11	278
13793	8861s (+0.4s)	1512	1512	128	38	118	0	5	161
13794	8861s (+0.6s)	2180	2180	128	41	150	0	14	205
13795	8862s (+0.5s)	1748	1748	128	35	136	0	7	178
13796	8862s (+0.3s)	1036	1036	128	15	89	0	1	105
13797	8863s (+0.5s)	1768	1768	128	44	123	10	0	177
13798	8863s (+0.9s)	3968	3968	256	86	225	15	0	326
13799	8864s (+0.6s)	2056	2056	128	58	133	14	0	205
Episode	Time	Reward	Score	Highest	L	U	R	D	Steps
13800	8865s (+0.7s)	2828	2828	256	63	177	10	0	250
13801	8866s (+0.8s)	3280	3280	256	57	202	16	0	275
13802	8866s (+0.4s)	1424	1424	128	29	114	1	0	144
13803	8866s (+0.5s)	1720	1720	128	43	117	10	0	170
13804	8867s (+1.0s)	4188	4188	256	73	245	0	19	337
13805	8868s (+0.7s)	2932	2932	256	52	193	0	14	259
13806	8869s (+0.5s)	1724	1724	128	38	127	0	7	172
13807	8869s (+0.7s)	2888	2888	256	51	188	0	10	249
13808	8870s (+0.6s)	2412	2412	128	43	172	0	11	226
13809	8871s (+0.6s)	2456	2456	256	51	144	8	0	203
13810	8871s (+0.5s)	1852	1852	128	46	127	14	0	187
13811	8872s (+0.7s)	3024	3024	256	59	179	8	0	246
13812	8873s (+0.8s)	3228	3228	256	79	176	15	0	270
13813	8873s (+0.8s)	3376	3376	256	77	191	12	0	280
13814	8874s (+0.4s)	1500	1500	128	39	107	11	1	158
13815	8874s (+0.5s)	1536	1536	128	40	112	10	0	162
13816	8875s (+0.3s)	1128	1128	128	31	85	4	0	120
13817	8876s (+0.8s)	3480	3480	256	69	209	11	0	289
13818	8876s (+0.6s)	1940	1940	128	52	140	6	0	198
13819	8877s (+0.5s)	1996	1996	128	51	132	8	0	191
13820	8877s (+0.7s)	2948	2948	256	74	171	13	0	258
13821	8878s (+0.7s)	2812	2812	256	59	181	6	0	246
13822	8879s (+0.6s)	2024	2024	128	55	131	12	0	198
13823	8879s (+0.5s)	1784	1784	128	30	152	0	0	182
13824	8880s (+0.5s)	1944	1944	128	54	121	9	0	184
13825	8881s (+0.8s)	3336	3336	256	57	204	9	1	271
13826	8881s (+0.8s)	3608	3608	256	76	217	11	0	304
13827	8882s (+0.5s)	1620	1620	128	45	119	8	0	172
13828	8882s (+0.5s)	1632	1632	128	43	114	9	0	166
13829	8883s (+0.5s)	1864	1864	128	40	126	16	1	183
13830	8883s (+0.6s)	2476	2476	256	32	179	0	5	216
13831	8884s (+0.4s)	1028	1028	64	21	93	0	8	122
13832	8885s (+0.9s)	3608	3608	256	67	220	0	14	301
13833	8886s (+0.8s)	3352	3352	256	52	222	0	11	285
13834	8886s (+0.6s)	2484	2484	256	36	164	0	7	207
13835	8886s (+0.2s)	492	492	64	9	58	0	3	70
13836	8887s (+0.9s)	4004	4004	256	73	247	0	15	335
13837	8888s (+1.2s)	6144	6144	512	92	316	0	20	428
13838	8889s (+0.7s)	2776	2776	256	42	185	0	10	237
13839	8890s (+0.6s)	2392	2392	256	45	145	0	10	200
13840	8890s (+0.5s)	1756	1756	128	43	128	8	0	179
13841	8891s (+0.9s)	3968	3968	256	93	217	11	0	321
13842	8892s (+0.5s)	1672	1672	128	39	123	8	0	170
13843	8892s (+0.4s)	1396	1396	128	35	102	4	1	142
13844	8892s (+0.4s)	1168	1168	64	37	94	8	0	139
13845	8893s (+0.7s)	2960	2960	256	80	165	14	0	259
13846	8894s (+0.8s)	3688	3688	256	54	236	0	15	305
13847	8895s (+0.9s)	3844	3844	256	56	242	0	14	312
13848	8896s (+0.6s)	1916	1916	128	37	148	0	12	197
13849	8896s (+0.4s)	1468	1468	128	29	115	0	7	151
13850	8897s (+0.6s)	2532	2532	256	40	167	0	7	214
13851	8897s (+0.5s)	2052	2052	128	48	133	8	0	189
13852	8898s (+0.6s)	1980	1980	128	45	160	3	0	208
13853	8898s (+0.5s)	1688	1688	128	45	116	7	0	168
13854	8899s (+0.9s)	4148	4148	256	104	231	9	0	344
13855	8900s (+0.9s)	4672	4672	512	88	214	21	0	323
13856	8901s (+0.6s)	2452	2452	256	53	143	14	0	210
13857	8901s (+0.5s)	1640	1640	128	44	117	9	1	171
13858	8902s (+0.5s)	1892	1892	128	47	126	8	0	181
13859	8903s (+1.0s)	4160	4160	256	86	240	17	0	343
13860	8903s (+0.7s)	2780	2780	256	68	157	7	0	232
13861	8904s (+0.7s)	2788	2788	256	60	173	7	0	240
13862	8905s (+0.7s)	2788	2788	256	62	166	12	0	240
13863	8905s (+0.6s)	2816	2816	256	57	165	10	0	232
13864	8907s (+1.1s)	5760	5760	512	97	295	19	0	411
13865	8907s (+0.7s)	2656	2656	256	59	165	10	0	234
13866	8908s (+0.3s)	668	668	64	23	65	1	2	91
13867	8908s (+0.9s)	3664	3664	256	75	218	10	0	303
13868	8909s (+0.5s)	2148	2148	256	44	124	14	0	182
13869	8910s (+0.8s)	3604	3604	256	68	215	10	0	293
13870	8911s (+0.9s)	3788	3788	256	77	222	14	0	313
13871	8911s (+0.8s)	3236	3236	256	56	207	9	0	272
13872	8912s (+0.6s)	1908	1908	128	53	134	8	0	195
13873	8912s (+0.4s)	1412	1412	128	30	102	11	0	143
13874	8913s (+0.8s)	3460	3460	256	66	208	10	0	284
13875	8914s (+0.5s)	1440	1440	128	53	98	8	0	159
13876	8915s (+0.9s)	4472	4472	512	71	223	10	1	305
13877	8916s (+1.2s)	6172	6172	512	100	305	27	2	434
13878	8916s (+0.7s)	2900	2900	256	61	166	10	0	237
13879	8917s (+0.8s)	3428	3428	256	70	194	16	1	281
13880	8918s (+0.7s)	2740	2740	256	50	180	4	0	234
13881	8919s (+1.0s)	4160	4160	256	82	243	17	0	342
13882	8920s (+1.1s)	5468	5468	512	110	262	14	1	387
13883	8921s (+0.6s)	1920	1920	128	47	145	6	0	198
13884	8921s (+0.6s)	2472	2472	256	48	155	8	0	211
13885	8922s (+0.6s)	1928	1928	128	41	154	5	0	200
13886	8922s (+0.5s)	1820	1820	128	27	140	1	7	175
13887	8923s (+0.8s)	3548	3548	256	65	218	0	13	296
13888	8923s (+0.2s)	564	564	64	13	60	0	4	77
13889	8924s (+0.8s)	3592	3592	256	54	215	0	18	287
13890	8925s (+0.6s)	2268	2268	256	48	138	0	10	196
13891	8926s (+0.8s)	3340	3340	256	62	207	0	12	281
13892	8926s (+0.9s)	3772	3772	256	64	237	0	13	314
13893	8927s (+0.3s)	1056	1056	128	17	93	0	4	114
13894	8927s (+0.5s)	1836	1836	128	52	127	0	8	187
13895	8928s (+1.1s)	4660	4660	256	100	264	21	0	385
13896	8929s (+1.0s)	4108	4108	256	82	235	17	0	334
13897	8930s (+0.6s)	2176	2176	128	51	138	14	0	203
13898	8930s (+0.5s)	1676	1676	128	44	120	7	0	171
13899	8931s (+0.5s)	1896	1896	128	60	127	5	0	192
Episode	Time	Reward	Score	Highest	L	U	R	D	Steps
13900	8932s (+0.9s)	4768	4768	512	76	237	16	0	329
13901	8933s (+0.6s)	2748	2748	256	53	167	11	0	231
13902	8933s (+0.5s)	1804	1804	128	36	144	5	0	185
13903	8934s (+0.9s)	3572	3572	256	76	211	14	1	302
13904	8934s (+0.4s)	1256	1256	128	34	91	4	1	130
13905	8935s (+0.6s)	2128	2128	128	53	147	4	0	204
13906	8936s (+0.8s)	3288	3288	256	70	192	10	1	273
13907	8937s (+0.8s)	3480	3480	256	69	208	12	0	289
13908	8937s (+0.3s)	676	676	64	21	70	2	0	93
13909	8937s (+0.3s)	980	980	64	24	90	3	0	117
13910	8938s (+0.5s)	1768	1768	128	43	122	12	0	177
13911	8938s (+0.5s)	1604	1604	128	52	111	5	0	168
13912	8939s (+0.4s)	1276	1276	128	30	99	4	0	133
13913	8939s (+0.7s)	2932	2932	256	56	191	12	0	259
13914	8940s (+0.8s)	3532	3532	256	86	193	11	2	292
13915	8940s (+0.3s)	868	868	64	26	83	3	0	112
13916	8941s (+0.5s)	1928	1928	128	41	130	6	1	178
13917	8942s (+0.9s)	4736	4736	512	52	266	0	15	333
13918	8943s (+0.8s)	3448	3448	256	62	221	0	9	292
13919	8944s (+0.8s)	3204	3204	256	57	196	0	11	264
13920	8944s (+0.8s)	3328	3328	256	61	204	0	13	278
13921	8945s (+0.7s)	3080	3080	256	50	189	0	12	251
13922	8946s (+0.8s)	3240	3240	256	62	195	0	15	272
13923	8946s (+0.6s)	1908	1908	128	38	149	0	8	195
13924	8947s (+0.6s)	1956	1956	128	45	141	0	7	193
13925	8948s (+0.8s)	3176	3176	256	62	192	9	0	263
13926	8948s (+0.6s)	2640	2640	256	50	171	3	0	224
13927	8949s (+0.7s)	2720	2720	256	50	173	10	0	233
13928	8950s (+0.9s)	3944	3944	256	73	237	10	0	320
13929	8951s (+0.8s)	3228	3228	256	85	177	12	0	274
13930	8951s (+0.6s)	2096	2096	128	37	156	3	0	196
13931	8952s (+0.8s)	3360	3360	256	63	212	11	0	286
13932	8953s (+0.9s)	4200	4200	256	95	210	21	0	326
13933	8954s (+0.7s)	2956	2956	256	52	193	5	0	250
13934	8954s (+0.7s)	2828	2828	256	62	174	9	0	245
13935	8955s (+0.7s)	2936	2936	256	53	195	13	0	261
13936	8956s (+0.9s)	4120	4120	256	84	241	12	0	337
13937	8957s (+0.9s)	3576	3576	256	85	199	17	0	301
13938	8958s (+0.7s)	2936	2936	256	67	183	10	0	260
13939	8959s (+1.1s)	4380	4380	256	92	261	15	0	368
13940	8959s (+0.4s)	1212	1212	128	26	106	2	0	134
13941	8960s (+0.3s)	784	784	64	27	72	5	0	104
13942	8961s (+1.0s)	4284	4284	256	78	259	13	0	350
13943	8961s (+0.6s)	1972	1972	128	58	139	9	0	206
13944	8962s (+0.6s)	1908	1908	128	44	144	7	0	195
13945	8963s (+0.8s)	3552	3552	256	72	210	14	0	296
13946	8963s (+0.8s)	3376	3376	256	86	191	12	1	290
13947	8964s (+0.5s)	2172	2172	256	48	128	7	0	183
13948	8965s (+0.7s)	2800	2800	256	66	168	9	0	243
13949	8966s (+1.2s)	6428	6428	512	99	320	16	0	435
13950	8966s (+0.7s)	2780	2780	256	57	166	15	0	238
13951	8967s (+0.5s)	1696	1696	128	47	123	6	0	176
13952	8968s (+0.8s)	3524	3524	256	81	195	19	0	295
13953	8969s (+0.7s)	2904	2904	256	65	179	9	0	253
13954	8969s (+0.6s)	1924	1924	128	40	154	5	0	199
13955	8970s (+0.5s)	1608	1608	128	46	114	9	0	169
13956	8970s (+0.5s)	1684	1684	128	42	125	6	0	173
13957	8971s (+0.7s)	2752	2752	128	68	168	18	1	255
13958	8971s (+0.3s)	1008	1008	128	11	95	1	0	107
13959	8972s (+0.5s)	1504	1504	128	36	114	8	1	159
13960	8972s (+0.8s)	3380	3380	256	83	186	17	0	286
13961	8973s (+0.4s)	1348	1348	128	41	100	4	0	145
13962	8973s (+0.5s)	1656	1656	128	56	113	7	0	176
13963	8974s (+0.9s)	3680	3680	256	79	216	16	0	311
13964	8975s (+0.5s)	1592	1592	128	47	108	6	0	161
13965	8975s (+0.3s)	880	880	64	33	74	7	1	115
13966	8976s (+0.9s)	3648	3648	256	81	213	10	0	304
13967	8976s (+0.3s)	1104	1104	128	19	95	3	0	117
13968	8977s (+0.5s)	2000	2000	256	31	129	5	0	165
13969	8977s (+0.5s)	1812	1812	128	47	135	6	0	188
13970	8978s (+0.4s)	1480	1480	128	41	106	7	0	154
13971	8978s (+0.5s)	1580	1580	128	37	121	8	0	166
13972	8979s (+0.5s)	1828	1828	128	46	131	6	1	184
13973	8979s (+0.5s)	1724	1724	128	47	124	7	0	178
13974	8980s (+0.5s)	1684	1684	128	49	116	7	0	172
13975	8981s (+1.0s)	4360	4360	256	103	240	21	0	364
13976	8981s (+0.6s)	2488	2488	256	58	146	9	1	214
13977	8982s (+1.0s)	4336	4336	256	82	265	17	0	364
13978	8983s (+0.4s)	1516	1516	128	34	120	2	0	156
13979	8984s (+0.7s)	2576	2576	128	69	162	12	0	243
13980	8985s (+1.0s)	4068	4068	256	77	243	19	0	339
13981	8985s (+0.6s)	2320	2320	256	63	130	10	0	203
13982	8986s (+0.5s)	1748	1748	128	42	123	7	0	172
13983	8986s (+0.3s)	792	792	64	27	71	7	0	105
13984	8987s (+1.1s)	5136	5136	512	99	247	21	1	368
13985	8988s (+0.6s)	2260	2260	128	43	159	6	1	209
13986	8988s (+0.3s)	844	844	64	24	83	4	0	111
13987	8989s (+0.7s)	2656	2656	256	52	175	0	7	234
13988	8989s (+0.5s)	1856	1856	128	29	150	0	10	189
13989	8990s (+0.4s)	1248	1248	128	24	105	0	5	134
13990	8990s (+0.5s)	1828	1828	128	36	141	0	5	182
13991	8990s (+0.3s)	1184	1184	128	19	96	0	4	119
13992	8991s (+0.5s)	1824	1824	128	32	147	0	6	185
13993	8992s (+0.8s)	3508	3508	256	59	214	0	12	285
13994	8992s (+0.3s)	848	848	64	23	87	0	5	115
13995	8993s (+0.8s)	3556	3556	256	55	218	0	10	283
13996	8994s (+0.7s)	2796	2796	256	60	170	0	12	242
13997	8994s (+0.6s)	1848	1848	128	39	143	0	10	192
13998	8995s (+0.8s)	3240	3240	256	57	198	0	14	269
13999	8995s (+0.3s)	704	704	64	16	73	0	5	94
Episode	Time	Reward	Score	Highest	L	U	R	D	Steps
14000	8996s (+0.4s)	1108	1108	64	26	94	0	9	129
14001	8996s (+0.7s)	2772	2772	256	50	178	0	8	236
14002	8997s (+0.6s)	2120	2120	128	36	157	0	9	202
14003	8997s (+0.5s)	1776	1776	128	42	132	6	0	180
14004	8998s (+0.5s)	1588	1588	128	45	115	8	0	168
14005	8998s (+0.5s)	1704	1704	128	43	117	9	0	169
14006	8999s (+0.7s)	3136	3136	256	62	187	8	0	257
14007	9000s (+0.9s)	3968	3968	256	71	241	14	0	326
14008	9001s (+0.7s)	3076	3076	256	58	184	7	0	249
14009	9002s (+0.9s)	4008	4008	256	101	212	17	0	330
14010	9002s (+0.6s)	2540	2540	256	45	161	15	0	221
14011	9003s (+0.6s)	2456	2456	128	70	139	17	0	226
14012	9003s (+0.4s)	1480	1480	128	33	116	5	0	154
14013	9004s (+0.5s)	1808	1808	128	53	126	8	0	187
14014	9004s (+0.4s)	1376	1376	128	34	102	7	0	143
14015	9005s (+0.5s)	1664	1664	128	58	101	13	0	172
14016	9006s (+0.9s)	3572	3572	256	77	207	16	0	300
14017	9006s (+0.6s)	1836	1836	128	53	131	9	0	193
14018	9007s (+0.6s)	2692	2692	256	53	155	11	0	219
14019	9007s (+0.4s)	1500	1500	128	30	115	7	0	152
14020	9008s (+1.0s)	4200	4200	256	99	228	19	0	346
14021	9009s (+0.5s)	1888	1888	128	42	139	14	0	195
14022	9010s (+0.8s)	3320	3320	256	68	199	10	0	277
14023	9010s (+0.4s)	1320	1320	128	47	86	6	1	140
14024	9011s (+0.6s)	2596	2596	256	48	171	9	0	228
14025	9012s (+1.0s)	4260	4260	256	91	241	22	1	355
14026	9012s (+0.5s)	1604	1604	128	35	125	0	8	168
14027	9013s (+1.0s)	5168	5168	512	86	268	16	0	370
14028	9013s (+0.3s)	572	572	32	20	63	4	0	87
14029	9014s (+0.3s)	984	984	64	24	85	6	1	116
14030	9014s (+0.4s)	1308	1308	128	35	104	4	0	143
14031	9015s (+0.7s)	3120	3120	256	57	192	11	0	260
14032	9015s (+0.4s)	1292	1292	128	35	98	0	6	139
14033	9016s (+0.5s)	1612	1612	128	42	120	8	0	170
14034	9016s (+0.3s)	676	676	64	19	70	2	0	91
14035	9017s (+0.7s)	2764	2764	256	64	161	8	1	234
14036	9017s (+0.4s)	1376	1376	128	23	120	0	1	144
14037	9017s (+0.2s)	464	464	32	13	58	0	5	76
14038	9018s (+0.8s)	3460	3460	256	62	214	0	16	292
14039	9019s (+0.4s)	1480	1480	128	27	114	0	6	147
14040	9019s (+0.4s)	1324	1324	128	23	111	0	3	137
14041	9020s (+0.7s)	2812	2812	256	53	182	11	0	246
14042	9020s (+0.5s)	1672	1672	128	40	125	5	0	170
14043	9021s (+0.7s)	2996	2996	256	49	188	8	0	245
14044	9021s (+0.6s)	1944	1944	128	52	144	8	0	204
14045	9022s (+0.4s)	1312	1312	128	32	106	6	0	144
14046	9022s (+0.6s)	2060	2060	128	61	132	13	0	206
14047	9023s (+0.6s)	2712	2712	256	49	168	9	2	228
14048	9023s (+0.3s)	792	792	64	20	79	7	0	106
14049	9024s (+1.1s)	5668	5668	512	112	270	18	0	400
14050	9025s (+0.4s)	1368	1368	128	24	114	0	5	143
14051	9025s (+0.4s)	1480	1480	128	37	110	7	0	154
14052	9026s (+1.0s)	4308	4308	256	100	239	24	0	363
14053	9027s (+0.7s)	2916	2916	256	58	188	9	0	255
14054	9028s (+0.5s)	1624	1624	128	38	129	6	0	173
14055	9028s (+0.5s)	1736	1736	128	37	130	7	0	174
14056	9029s (+0.5s)	1800	1800	128	51	124	0	9	184
14057	9029s (+0.4s)	1168	1168	64	30	104	5	0	139
14058	9030s (+0.9s)	4848	4848	512	82	236	15	0	333
14059	9030s (+0.4s)	1352	1352	128	35	105	8	0	148
14060	9031s (+0.6s)	2228	2228	128	48	153	0	11	212
14061	9032s (+0.6s)	1932	1932	128	36	156	0	9	201
14062	9032s (+0.8s)	3532	3532	256	66	222	0	13	301
14063	9033s (+0.9s)	3844	3844	256	85	212	13	0	310
14064	9034s (+1.0s)	5124	5124	512	85	263	19	1	368
14065	9035s (+0.6s)	1928	1928	128	49	144	7	0	200
14066	9036s (+0.8s)	3388	3388	256	54	225	14	0	293
14067	9036s (+0.5s)	1796	1796	128	41	135	8	0	184
14068	9037s (+0.8s)	3608	3608	256	87	189	14	0	290
14069	9038s (+0.6s)	2444	2444	256	61	138	8	0	207
14070	9038s (+0.4s)	1324	1324	128	42	86	6	0	134
14071	9039s (+0.5s)	2260	2260	256	44	130	11	0	185
14072	9039s (+0.7s)	2576	2576	128	70	159	14	0	243
14073	9040s (+0.5s)	2148	2148	256	47	127	5	0	179
14074	9040s (+0.6s)	2768	2768	256	48	169	8	0	225
14075	9041s (+0.5s)	1508	1508	128	43	108	9	0	160
14076	9042s (+1.0s)	5320	5320	512	98	255	13	0	366
14077	9043s (+1.0s)	4356	4356	256	95	249	18	0	362
14078	9043s (+0.5s)	1776	1776	128	37	133	9	0	179
14079	9044s (+0.6s)	2696	2696	256	51	162	13	0	226
14080	9045s (+0.4s)	1480	1480	128	37	111	6	0	154
14081	9045s (+0.7s)	2984	2984	256	45	184	0	15	244
14082	9046s (+0.7s)	2848	2848	256	42	199	0	10	251
14083	9046s (+0.4s)	1528	1528	128	27	117	0	9	153
14084	9047s (+0.5s)	1928	1928	128	31	143	0	6	180
14085	9047s (+0.5s)	2240	2240	256	33	147	0	7	187
14086	9048s (+0.6s)	2620	2620	256	45	176	0	9	230
14087	9049s (+0.6s)	2596	2596	256	56	151	0	8	215
14088	9049s (+0.4s)	1324	1324	128	19	113	0	6	138
14089	9050s (+0.4s)	1272	1272	128	26	99	0	3	128
14090	9050s (+0.7s)	3216	3216	256	50	210	0	7	267
14091	9051s (+0.5s)	1716	1716	128	41	123	0	9	173
14092	9052s (+0.8s)	3512	3512	256	57	232	0	8	297
14093	9052s (+0.4s)	1164	1164	64	36	96	6	0	138
14094	9053s (+0.5s)	1608	1608	128	34	131	4	0	169
14095	9053s (+0.9s)	4008	4008	256	73	236	16	0	325
14096	9054s (+0.5s)	1616	1616	128	33	120	0	8	161
14097	9055s (+0.8s)	3248	3248	256	64	193	0	19	276
14098	9055s (+0.7s)	2844	2844	256	46	184	0	13	243
14099	9056s (+0.5s)	1800	1800	128	44	130	11	0	185
Episode	Time	Reward	Score	Highest	L	U	R	D	Steps
14100	9057s (+0.7s)	2976	2976	256	77	181	7	0	265
14101	9057s (+0.7s)	2848	2848	256	79	152	15	1	247
14102	9058s (+0.8s)	3364	3364	256	59	206	12	0	277
14103	9059s (+0.8s)	3496	3496	256	73	210	9	1	293
14104	9059s (+0.3s)	896	896	64	33	82	4	0	119
14105	9060s (+0.4s)	1472	1472	128	34	115	6	1	156
14106	9061s (+0.8s)	3408	3408	256	86	196	11	0	293
14107	9061s (+0.4s)	1072	1072	64	28	95	8	0	131
14108	9062s (+0.9s)	4188	4188	256	81	245	16	0	342
14109	9062s (+0.4s)	1064	1064	64	25	100	4	0	129
14110	9063s (+0.9s)	3860	3860	256	91	216	13	0	320
14111	9064s (+0.5s)	1904	1904	128	46	145	4	0	195
14112	9065s (+0.8s)	3364	3364	256	81	177	15	0	273
14113	9065s (+0.5s)	1668	1668	128	42	120	6	0	168
14114	9066s (+0.8s)	3256	3256	256	64	201	12	0	277
14115	9066s (+0.6s)	2312	2312	128	66	140	11	0	217
14116	9067s (+0.5s)	1648	1648	128	38	114	12	0	164
14117	9068s (+1.0s)	4140	4140	256	87	235	16	0	338
14118	9069s (+0.6s)	2596	2596	256	54	163	7	0	224
14119	9069s (+0.9s)	3772	3772	256	68	231	15	0	314
14120	9070s (+0.7s)	2660	2660	256	55	174	6	0	235
14121	9071s (+0.6s)	1996	1996	128	49	139	7	0	195
14122	9071s (+0.8s)	3700	3700	256	77	206	14	1	298
14123	9072s (+0.5s)	1772	1772	128	47	124	7	0	178
14124	9072s (+0.4s)	1008	1008	64	29	92	6	0	127
14125	9073s (+1.0s)	4144	4144	256	99	218	21	0	338
14126	9074s (+0.6s)	1916	1916	128	46	140	11	0	197
14127	9075s (+0.6s)	2400	2400	128	58	153	10	0	221
14128	9075s (+0.9s)	3720	3720	256	78	225	17	0	320
14129	9076s (+0.4s)	1316	1316	128	35	101	9	0	145
14130	9076s (+0.5s)	1640	1640	128	35	122	8	1	166
14131	9077s (+0.7s)	2924	2924	256	53	193	11	0	257
14132	9078s (+0.9s)	4560	4560	512	71	226	13	0	310
14133	9079s (+0.6s)	2548	2548	256	44	170	9	1	224
14134	9079s (+0.5s)	1520	1520	128	35	121	0	7	163
14135	9080s (+0.9s)	3788	3788	256	57	236	0	10	303
14136	9080s (+0.4s)	1036	1036	64	22	92	0	9	123
14137	9081s (+0.7s)	2952	2952	256	40	197	0	12	249
14138	9081s (+0.4s)	1172	1172	64	37	99	4	0	140
14139	9082s (+0.5s)	1752	1752	128	49	119	9	0	177
14140	9083s (+0.8s)	3324	3324	256	62	195	14	1	272
14141	9083s (+0.6s)	2700	2700	256	53	165	9	1	228
14142	9084s (+0.8s)	3560	3560	256	76	204	16	1	297
14143	9085s (+0.4s)	1232	1232	128	38	81	10	0	129
14144	9085s (+0.4s)	1516	1516	128	32	120	6	0	158
14145	9086s (+0.6s)	1908	1908	128	42	147	6	0	195
14146	9086s (+0.6s)	2228	2228	128	53	161	10	0	224
14147	9087s (+1.0s)	5020	5020	512	109	223	23	0	355
14148	9088s (+0.3s)	1124	1124	128	28	94	0	0	122
14149	9088s (+0.2s)	600	600	64	15	63	0	3	81
14150	9088s (+0.3s)	712	712	64	16	72	0	5	93
14151	9089s (+0.7s)	3216	3216	256	48	212	0	8	268
14152	9089s (+0.7s)	2540	2540	128	70	153	11	1	235
14153	9090s (+0.4s)	1416	1416	128	33	113	7	0	153
14154	9091s (+0.6s)	2236	2236	128	43	160	10	1	214
14155	9091s (+0.7s)	3220	3220	256	73	172	13	0	258
14156	9092s (+0.7s)	3100	3100	256	55	188	12	0	255
14157	9093s (+0.9s)	4092	4092	256	103	208	19	0	330
14158	9094s (+0.7s)	3168	3168	256	66	185	9	0	260
14159	9094s (+0.5s)	1908	1908	128	45	130	10	0	185
14160	9094s (+0.4s)	1116	1116	128	34	85	5	0	124
14161	9095s (+0.5s)	1624	1624	128	44	120	9	0	173
14162	9096s (+0.6s)	2452	2452	256	51	145	9	0	205
14163	9096s (+0.7s)	2840	2840	256	77	149	15	0	241
14164	9097s (+0.5s)	1848	1848	128	32	147	0	7	186
14165	9097s (+0.4s)	1320	1320	128	26	102	0	7	135
14166	9098s (+0.5s)	2344	2344	256	43	143	0	10	196
14167	9098s (+0.8s)	3220	3220	256	58	197	0	13	268
14168	9099s (+0.3s)	1072	1072	128	19	85	0	7	111
14169	9100s (+0.8s)	3372	3372	256	54	221	0	11	286
14170	9100s (+0.4s)	1476	1476	128	37	109	0	7	153
14171	9101s (+0.7s)	2720	2720	256	72	152	0	11	235
14172	9101s (+0.7s)	2800	2800	256	51	183	0	9	243
14173	9102s (+0.4s)	1408	1408	128	40	104	4	0	148
14174	9102s (+0.6s)	2120	2120	128	61	138	17	0	216
14175	9103s (+0.7s)	2784	2784	256	72	155	12	0	239
14176	9104s (+0.7s)	2948	2948	256	63	172	13	0	248
14177	9105s (+0.8s)	3380	3380	256	74	191	17	0	282
14178	9105s (+0.4s)	1436	1436	128	42	110	6	0	158
14179	9106s (+0.6s)	2540	2540	256	44	165	8	0	217
14180	9106s (+0.5s)	1604	1604	64	48	114	10	0	172
14181	9107s (+0.6s)	2408	2408	256	33	165	3	0	201
14182	9107s (+0.4s)	1156	1156	64	49	79	5	0	133
14183	9108s (+0.7s)	3148	3148	256	61	189	10	0	260
14184	9108s (+0.4s)	1184	1184	128	30	93	5	0	128
14185	9109s (+0.4s)	1264	1264	128	40	91	6	1	138
14186	9109s (+0.4s)	1596	1596	128	40	116	9	0	165
14187	9110s (+0.4s)	1336	1336	128	33	97	7	0	137
14188	9110s (+0.3s)	856	856	64	26	80	5	0	111
14189	9110s (+0.6s)	2712	2712	256	48	159	10	0	217
14190	9111s (+0.5s)	1580	1580	128	28	131	3	0	162
14191	9111s (+0.5s)	1752	1752	128	38	133	7	0	178
14192	9112s (+0.8s)	3436	3436	256	83	187	20	0	290
14193	9113s (+1.0s)	4504	4504	256	98	252	17	1	368
14194	9114s (+0.5s)	1624	1624	128	40	114	9	0	163
14195	9114s (+0.4s)	1256	1256	64	42	93	9	1	145
14196	9115s (+0.4s)	1540	1540	128	35	114	4	0	153
14197	9115s (+0.3s)	784	784	64	16	79	0	3	98
14198	9116s (+0.8s)	3292	3292	256	54	223	0	8	285
14199	9117s (+0.8s)	2992	2992	256	55	199	0	15	269
Episode	Time	Reward	Score	Highest	L	U	R	D	Steps
14200	9117s (+0.7s)	2932	2932	256	56	197	0	7	260
14201	9118s (+0.5s)	1544	1544	128	39	112	0	8	159
14202	9118s (+0.4s)	1056	1056	64	30	91	7	0	128
14203	9119s (+0.6s)	2384	2384	128	62	159	13	0	234
14204	9119s (+0.5s)	1756	1756	128	41	125	8	0	174
14205	9120s (+0.5s)	1748	1748	128	60	119	8	0	187
14206	9120s (+0.5s)	1916	1916	128	53	136	8	0	197
14207	9121s (+0.8s)	3768	3768	256	82	213	14	0	309
14208	9122s (+0.5s)	1588	1588	64	47	122	10	0	179
14209	9122s (+0.6s)	2068	2068	128	63	129	12	0	204
14210	9123s (+0.4s)	1240	1240	64	32	104	6	0	142
14211	9123s (+0.4s)	1432	1432	128	26	116	5	0	147
14212	9124s (+0.9s)	4020	4020	256	83	225	20	0	328
14213	9124s (+0.4s)	1204	1204	128	28	95	7	0	130
14214	9125s (+0.7s)	3100	3100	256	61	180	8	0	249
14215	9126s (+0.4s)	1220	1220	64	39	97	7	1	144
14216	9126s (+0.9s)	3948	3948	256	78	230	18	0	326
14217	9128s (+1.3s)	6376	6376	512	123	301	29	0	453
14218	9128s (+0.5s)	1692	1692	128	38	132	5	0	175
14219	9129s (+0.7s)	2948	2948	256	69	183	11	0	263
14220	9130s (+0.8s)	3352	3352	256	63	209	12	0	284
14221	9131s (+0.7s)	2500	2500	128	50	175	10	1	236
14222	9132s (+1.0s)	4332	4332	256	92	241	20	0	353
14223	9132s (+0.5s)	1856	1856	128	51	127	9	0	187
14224	9133s (+0.8s)	3412	3412	256	79	205	10	0	294
14225	9133s (+0.6s)	1932	1932	128	44	149	7	1	201
14226	9134s (+0.6s)	2168	2168	128	61	133	12	0	206
14227	9135s (+0.5s)	1644	1644	128	38	132	7	0	177
14228	9135s (+0.4s)	1504	1504	128	28	127	4	0	159
14229	9136s (+0.9s)	4640	4640	512	72	233	14	0	319
14230	9136s (+0.5s)	1676	1676	128	32	134	6	0	172
14231	9137s (+0.5s)	1664	1664	128	36	125	7	0	168
14232	9138s (+0.7s)	3044	3044	256	74	168	13	0	255
14233	9138s (+0.5s)	1936	1936	128	56	120	10	1	187
14234	9139s (+0.5s)	1780	1780	128	40	130	10	0	180
14235	9139s (+0.8s)	3260	3260	256	58	200	0	7	265
14236	9140s (+0.7s)	2924	2924	256	53	192	0	12	257
14237	9141s (+0.4s)	1476	1476	128	33	115	0	6	154
14238	9141s (+0.5s)	1876	1876	128	36	149	0	7	192
14239	9142s (+0.8s)	3404	3404	256	67	203	0	12	282
14240	9142s (+0.4s)	1376	1376	64	35	110	0	8	153
14241	9143s (+0.6s)	2572	2572	256	54	147	0	18	219
14242	9144s (+0.5s)	1812	1812	128	35	144	0	8	187
14243	9144s (+0.6s)	1924	1924	128	36	153	0	10	199
14244	9145s (+0.7s)	3152	3152	256	71	179	11	0	261
14245	9145s (+0.2s)	544	544	64	29	47	2	0	78
14246	9146s (+0.5s)	1628	1628	128	40	113	8	0	161
14247	9146s (+0.8s)	3232	3232	256	68	186	17	0	271
14248	9147s (+0.6s)	2452	2452	256	52	144	10	0	206
14249	9148s (+0.9s)	4820	4820	512	87	230	19	0	336
14250	9149s (+0.7s)	2712	2712	128	65	177	9	0	251
14251	9149s (+0.6s)	2448	2448	256	46	156	7	0	209
14252	9150s (+0.5s)	1928	1928	128	48	141	11	0	200
14253	9151s (+0.9s)	3908	3908	256	78	223	15	0	316
14254	9151s (+0.4s)	1248	1248	128	33	86	9	1	129
14255	9152s (+0.7s)	3004	3004	256	56	183	12	0	251
14256	9152s (+0.6s)	1912	1912	128	57	126	13	0	196
14257	9153s (+0.5s)	1756	1756	128	47	121	11	0	179
14258	9154s (+0.8s)	3240	3240	256	61	202	9	1	273
14259	9154s (+0.5s)	1500	1500	128	39	111	8	0	158
14260	9154s (+0.4s)	1120	1120	128	29	92	3	0	124
14261	9155s (+0.7s)	3304	3304	256	63	200	10	0	273
14262	9156s (+0.5s)	1856	1856	128	45	122	6	0	173
14263	9157s (+1.0s)	4512	4512	256	100	256	18	0	374
14264	9157s (+0.8s)	3284	3284	256	57	203	7	0	267
14265	9158s (+0.8s)	3244	3244	256	69	192	13	0	274
14266	9159s (+0.5s)	1916	1916	128	56	124	14	0	194
14267	9159s (+0.5s)	1788	1788	128	45	127	10	0	182
14268	9160s (+1.0s)	4204	4204	256	92	246	10	0	348
14269	9161s (+0.6s)	1924	1924	128	53	139	7	0	199
14270	9162s (+0.7s)	3004	3004	256	59	182	13	0	254
14271	9163s (+1.0s)	4368	4368	256	119	223	24	0	366
14272	9163s (+0.5s)	1864	1864	128	44	136	10	0	190
14273	9164s (+0.8s)	3360	3360	256	64	213	9	0	286
14274	9165s (+0.7s)	2740	2740	256	56	168	9	0	233
14275	9165s (+0.5s)	1740	1740	128	46	120	9	0	175
14276	9166s (+0.5s)	2200	2200	256	35	151	4	0	190
14277	9166s (+0.5s)	1664	1664	128	47	107	13	0	167
14278	9167s (+0.8s)	3368	3368	256	63	199	10	0	272
14279	9167s (+0.3s)	656	656	64	15	72	1	0	88
14280	9168s (+1.0s)	4176	4176	256	86	232	17	0	335
14281	9169s (+0.6s)	2744	2744	256	76	143	10	0	229
14282	9170s (+0.7s)	2556	2556	128	72	152	13	0	237
14283	9170s (+0.7s)	2928	2928	256	85	148	14	1	248
14284	9171s (+0.5s)	1560	1560	128	26	134	0	9	169
14285	9171s (+0.5s)	1788	1788	128	46	130	0	6	182
14286	9172s (+0.7s)	2796	2796	256	51	177	0	10	238
14287	9172s (+0.5s)	1816	1816	128	41	133	0	8	182
14288	9173s (+0.4s)	1324	1324	128	22	111	0	3	136
14289	9174s (+0.9s)	4152	4152	256	87	235	18	0	340
14290	9174s (+0.7s)	3420	3420	256	73	186	13	0	272
14291	9175s (+0.5s)	1520	1520	64	50	110	6	1	167
14292	9176s (+0.6s)	2188	2188	128	50	163	8	0	221
14293	9176s (+0.4s)	1172	1172	64	39	95	6	0	140
14294	9177s (+0.7s)	2804	2804	256	68	161	15	1	245
14295	9178s (+1.0s)	4872	4872	512	89	243	13	0	345
14296	9178s (+0.7s)	2776	2776	256	55	175	11	0	241
14297	9179s (+0.6s)	2456	2456	256	51	144	11	1	207
14298	9180s (+0.8s)	3352	3352	256	75	197	12	0	284
14299	9180s (+0.6s)	2488	2488	256	46	162	7	0	215
Episode	Time	Reward	Score	Highest	L	U	R	D	Steps
14300	9181s (+0.4s)	1044	1044	64	26	94	6	0	126
14301	9181s (+0.5s)	2240	2240	256	47	137	6	0	190
14302	9182s (+0.4s)	1060	1060	64	34	89	5	1	129
14303	9182s (+0.3s)	896	896	64	30	83	6	0	119
14304	9182s (+0.5s)	1672	1672	128	38	121	10	1	170
14305	9183s (+0.5s)	1708	1708	128	42	122	6	0	170
14306	9184s (+0.7s)	2984	2984	256	55	181	13	1	250
14307	9185s (+1.0s)	5040	5040	512	115	222	17	1	355
14308	9185s (+0.6s)	2460	2460	256	58	138	12	0	208
14309	9187s (+1.4s)	6952	6952	512	150	330	31	0	511
14310	9188s (+0.6s)	2484	2484	256	56	152	10	0	218
14311	9188s (+0.8s)	3424	3424	256	77	187	16	0	280
14312	9189s (+0.3s)	1144	1144	128	42	76	5	0	123
14313	9189s (+0.6s)	2360	2360	128	69	148	11	0	228
14314	9190s (+0.2s)	600	600	64	19	62	3	0	84
14315	9190s (+0.7s)	2844	2844	256	52	193	4	0	249
14316	9191s (+0.7s)	2884	2884	256	69	157	12	0	238
14317	9192s (+0.8s)	3192	3192	256	65	187	14	0	266
14318	9192s (+0.6s)	2228	2228	128	44	149	8	1	202
14319	9193s (+0.7s)	2856	2856	256	80	153	12	0	245
14320	9194s (+0.6s)	1924	1924	128	47	148	4	0	199
14321	9194s (+0.8s)	3244	3244	256	58	202	13	0	273
14322	9195s (+0.8s)	3424	3424	256	74	200	13	0	287
14323	9196s (+0.5s)	1820	1820	128	51	128	10	0	189
14324	9197s (+0.8s)	3552	3552	256	82	212	8	0	302
14325	9197s (+0.5s)	2132	2132	256	41	131	0	9	181
14326	9198s (+0.7s)	2456	2456	128	40	184	0	10	234
14327	9198s (+0.5s)	1940	1940	128	37	144	0	12	193
14328	9199s (+0.4s)	1364	1364	128	25	109	0	9	143
14329	9199s (+0.2s)	584	584	64	12	63	0	5	80
14330	9200s (+0.9s)	3844	3844	256	84	209	15	0	308
14331	9201s (+0.9s)	3904	3904	256	79	227	14	0	320
14332	9201s (+0.3s)	1120	1120	128	24	89	5	0	118
14333	9202s (+0.4s)	1340	1340	128	36	103	7	0	146
14334	9203s (+1.1s)	5648	5648	512	111	266	21	0	398
14335	9203s (+0.4s)	1436	1436	128	41	94	9	0	144
14336	9204s (+1.0s)	4308	4308	256	92	242	21	0	355
14337	9205s (+0.8s)	3312	3312	256	64	210	6	0	280
14338	9206s (+0.5s)	1676	1676	128	37	130	4	0	171
14339	9206s (+0.4s)	1304	1304	128	42	94	6	0	142
14340	9206s (+0.4s)	1452	1452	128	37	107	8	0	152
14341	9207s (+0.9s)	3792	3792	256	75	214	14	0	303
14342	9208s (+0.6s)	2676	2676	256	54	159	10	1	224
14343	9209s (+0.6s)	1952	1952	128	50	145	7	0	202
14344	9209s (+0.4s)	1244	1244	64	39	98	6	0	143
14345	9210s (+0.5s)	1812	1812	128	46	132	10	0	188
14346	9211s (+1.0s)	4308	4308	256	108	229	19	0	356
14347	9211s (+0.7s)	2692	2692	256	49	175	9	0	233
14348	9212s (+0.4s)	1072	1072	64	41	85	6	0	132
14349	9212s (+0.2s)	668	668	64	19	63	5	0	87
14350	9213s (+0.8s)	3372	3372	256	78	186	15	0	279
14351	9213s (+0.4s)	1312	1312	128	40	91	4	0	135
14352	9214s (+0.5s)	1608	1608	128	47	116	6	0	169
14353	9214s (+0.7s)	2904	2904	256	64	172	14	0	250
14354	9215s (+0.6s)	2528	2528	256	52	151	0	15	218
14355	9216s (+0.6s)	2612	2612	256	42	178	0	7	227
14356	9216s (+0.4s)	1084	1084	64	34	91	0	9	134
14357	9217s (+0.8s)	3372	3372	256	56	216	0	12	284
14358	9218s (+0.9s)	3548	3548	256	58	233	0	11	302
14359	9218s (+0.3s)	708	708	64	17	71	0	6	94
14360	9219s (+0.7s)	2904	2904	256	50	193	0	10	253
14361	9219s (+0.4s)	1232	1232	128	33	96	0	7	136
14362	9219s (+0.4s)	1228	1228	128	25	104	7	0	136
14363	9220s (+0.6s)	2304	2304	128	50	160	9	0	219
14364	9220s (+0.4s)	1500	1500	128	33	121	5	0	159
14365	9221s (+0.9s)	3888	3888	256	81	221	16	0	318
14366	9222s (+0.7s)	2888	2888	256	69	167	12	0	248
14367	9223s (+0.6s)	2096	2096	128	55	132	9	0	196
14368	9223s (+0.8s)	3256	3256	256	68	194	14	0	276
14369	9224s (+0.8s)	3224	3224	256	71	185	12	0	268
14370	9225s (+0.5s)	1720	1720	128	40	125	8	1	174
14371	9226s (+1.0s)	4428	4428	256	97	247	21	0	365
14372	9226s (+0.6s)	2356	2356	128	50	159	11	0	220
14373	9227s (+0.8s)	3712	3712	256	82	209	12	0	303
14374	9228s (+0.4s)	1304	1304	128	40	95	7	0	142
14375	9229s (+1.1s)	5456	5456	512	92	270	21	1	384
14376	9229s (+0.6s)	2648	2648	256	53	161	8	0	222
14377	9230s (+0.8s)	3528	3528	256	70	216	10	0	296
14378	9231s (+0.4s)	1188	1188	128	35	89	6	0	130
14379	9232s (+1.0s)	4268	4268	256	102	240	15	0	357
14380	9232s (+0.6s)	2412	2412	256	42	161	7	1	211
14381	9233s (+0.7s)	2768	2768	256	61	169	10	0	240
14382	9234s (+0.7s)	2908	2908	256	63	164	12	0	239
14383	9234s (+0.6s)	2180	2180	128	60	127	18	0	205
14384	9235s (+0.9s)	3536	3536	256	70	216	12	0	298
14385	9236s (+0.7s)	3068	3068	256	57	191	14	0	262
14386	9236s (+0.3s)	696	696	64	14	77	2	0	93
14387	9236s (+0.5s)	1788	1788	128	43	126	13	0	182
14388	9237s (+0.8s)	3428	3428	256	71	200	17	0	288
14389	9238s (+0.8s)	3468	3468	256	67	206	16	1	290
14390	9239s (+0.9s)	3600	3600	256	74	212	16	0	302
14391	9240s (+0.8s)	4512	4512	512	86	200	15	0	301
14392	9241s (+0.6s)	2644	2644	256	54	166	10	0	230
14393	9241s (+0.9s)	4048	4048	256	81	228	15	1	325
14394	9242s (+0.7s)	3036	3036	256	67	173	13	1	254
14395	9243s (+0.7s)	2772	2772	256	56	174	6	0	236
14396	9244s (+0.8s)	3384	3384	256	55	212	12	0	279
14397	9244s (+0.8s)	3420	3420	256	62	202	14	0	278
14398	9245s (+0.5s)	1644	1644	128	37	134	2	0	173
14399	9245s (+0.4s)	1460	1460	128	28	122	2	0	152
Episode	Time	Reward	Score	Highest	L	U	R	D	Steps
14400	9247s (+1.3s)	7020	7020	512	128	323	24	0	475
14401	9248s (+0.8s)	3184	3184	256	63	190	11	0	264
14402	9248s (+0.4s)	1540	1540	128	34	111	6	0	151
14403	9249s (+0.5s)	1896	1896	128	62	118	12	0	192
14404	9249s (+0.5s)	2324	2324	256	37	148	4	0	189
14405	9249s (+0.4s)	1252	1252	128	41	88	5	0	134
14406	9250s (+1.0s)	4140	4140	256	86	242	13	0	341
14407	9251s (+0.5s)	1816	1816	128	38	144	6	0	188
14408	9252s (+0.6s)	2456	2456	128	61	154	12	0	227
14409	9252s (+0.3s)	872	872	64	29	79	5	0	113
14410	9253s (+0.5s)	2028	2028	128	50	135	8	1	194
14411	9254s (+1.2s)	6144	6144	512	94	290	29	0	413
14412	9255s (+0.9s)	3768	3768	256	64	224	11	0	299
14413	9256s (+1.0s)	4340	4340	256	97	248	14	0	359
14414	9256s (+0.5s)	1796	1796	128	30	142	7	0	179
14415	9256s (+0.2s)	544	544	64	20	52	3	0	75
14416	9257s (+0.9s)	4216	4216	256	91	237	16	0	344
14417	9258s (+0.3s)	1236	1236	128	23	97	2	0	122
14418	9258s (+0.7s)	2956	2956	256	65	185	10	0	260
14419	9259s (+0.5s)	2188	2188	256	47	130	11	0	188
14420	9259s (+0.3s)	1080	1080	128	27	78	7	0	112
14421	9260s (+0.6s)	1916	1916	128	45	141	11	0	197
14422	9261s (+1.0s)	5448	5448	512	115	230	25	1	371
14423	9262s (+0.9s)	3944	3944	256	80	226	15	0	321
14424	9262s (+0.6s)	1912	1912	128	43	146	7	0	196
14425	9263s (+0.6s)	2040	2040	128	39	154	7	1	201
14426	9264s (+0.8s)	3600	3600	256	74	216	13	0	303
14427	9264s (+0.5s)	1504	1504	128	30	125	5	0	160
14428	9265s (+0.5s)	1852	1852	128	41	137	9	0	187
14429	9265s (+0.3s)	736	736	64	22	68	0	7	97
14430	9266s (+0.5s)	1624	1624	128	34	130	0	9	173
14431	9266s (+0.9s)	3576	3576	256	70	221	0	17	308
14432	9267s (+0.5s)	1792	1792	128	40	128	1	14	183
14433	9267s (+0.5s)	1720	1720	128	44	125	8	0	177
14434	9268s (+0.9s)	3884	3884	256	74	232	10	1	317
14435	9269s (+0.8s)	3548	3548	256	71	207	16	0	294
14436	9270s (+1.0s)	4244	4244	256	83	251	17	0	351
14437	9271s (+0.9s)	3552	3552	256	71	217	14	0	302
14438	9271s (+0.5s)	1628	1628	128	43	109	15	0	167
14439	9272s (+0.5s)	1836	1836	128	39	144	7	0	190
14440	9273s (+0.7s)	2944	2944	256	47	194	7	0	248
14441	9273s (+0.5s)	1620	1620	128	37	116	6	0	159
14442	9274s (+0.5s)	1864	1864	128	47	136	6	0	189
14443	9275s (+0.8s)	3288	3288	256	64	194	14	1	273
14444	9275s (+0.9s)	4612	4612	512	86	212	17	0	315
14445	9276s (+0.8s)	3420	3420	256	62	210	0	14	286
14446	9277s (+0.7s)	3148	3148	256	47	197	0	13	257
14447	9278s (+0.6s)	2280	2280	128	52	145	13	0	210
14448	9278s (+0.6s)	2456	2456	256	55	144	11	0	210
14449	9279s (+0.5s)	2260	2260	256	46	133	11	1	191
14450	9279s (+0.3s)	912	912	64	24	80	5	0	109
14451	9280s (+0.9s)	3684	3684	256	59	228	0	17	304
14452	9280s (+0.4s)	1212	1212	128	20	103	0	3	126
14453	9281s (+0.9s)	3844	3844	256	55	247	0	11	313
14454	9282s (+0.6s)	2456	2456	256	40	165	6	0	211
14455	9283s (+1.0s)	4116	4116	256	80	253	13	0	346
14456	9284s (+0.9s)	4896	4896	512	116	205	19	0	340
14457	9285s (+1.0s)	4332	4332	256	95	240	22	0	357
14458	9286s (+0.9s)	5012	5012	512	94	246	9	0	349
14459	9286s (+0.5s)	1616	1616	128	42	119	9	0	170
14460	9287s (+0.5s)	1892	1892	128	53	132	8	0	193
14461	9287s (+0.7s)	2592	2592	256	57	165	8	0	230
14462	9288s (+0.7s)	2560	2560	128	60	165	11	0	236
14463	9288s (+0.5s)	1700	1700	128	39	120	0	10	169
14464	9289s (+0.6s)	2464	2464	256	47	152	0	9	208
14465	9290s (+0.5s)	1884	1884	128	36	149	0	4	189
14466	9290s (+0.3s)	928	928	64	18	90	0	4	112
14467	9290s (+0.4s)	1440	1440	128	44	105	2	0	151
14468	9291s (+0.8s)	3492	3492	256	66	214	12	0	292
14469	9292s (+0.6s)	2152	2152	128	46	144	12	0	202
14470	9293s (+0.8s)	3360	3360	256	66	203	7	0	276
14471	9293s (+0.5s)	1816	1816	128	52	121	9	0	182
14472	9294s (+0.5s)	1564	1564	128	47	116	6	0	169
14473	9294s (+0.7s)	3224	3224	256	76	182	11	0	269
14474	9295s (+0.9s)	3616	3616	256	95	199	12	0	306
14475	9296s (+0.8s)	3260	3260	128	83	192	23	0	298
14476	9297s (+0.9s)	3888	3888	256	75	226	14	1	316
14477	9297s (+0.5s)	2200	2200	256	37	143	6	0	186
14478	9298s (+0.3s)	728	728	64	21	74	0	6	101
14479	9298s (+0.5s)	1820	1820	128	39	139	0	6	184
14480	9299s (+0.6s)	2408	2408	128	38	177	0	10	225
14481	9300s (+0.8s)	3352	3352	256	57	209	0	18	284
14482	9300s (+0.3s)	752	752	64	19	79	2	0	100
14483	9300s (+0.4s)	1480	1480	128	50	99	5	0	154
14484	9301s (+0.6s)	2332	2332	128	56	159	11	0	226
14485	9302s (+0.5s)	1796	1796	128	43	132	9	0	184
14486	9303s (+1.1s)	4612	4612	256	103	264	16	0	383
14487	9304s (+1.2s)	5828	5828	512	112	284	21	0	417
14488	9305s (+0.7s)	2304	2304	128	57	166	8	0	231
14489	9305s (+0.4s)	1440	1440	128	24	117	4	0	145
14490	9306s (+0.9s)	3544	3544	256	67	219	0	14	300
14491	9306s (+0.4s)	1132	1132	128	26	91	0	6	123
14492	9306s (+0.3s)	840	840	64	19	82	0	6	107
14493	9307s (+0.5s)	1612	1612	128	27	129	0	4	160
14494	9307s (+0.5s)	1800	1800	128	37	141	0	7	185
14495	9308s (+0.5s)	1636	1636	128	32	125	0	8	165
14496	9308s (+0.5s)	1576	1576	128	29	122	0	11	162
14497	9309s (+0.4s)	1560	1560	128	45	106	10	1	162
14498	9309s (+0.5s)	1920	1920	128	44	149	5	0	198
14499	9310s (+0.8s)	3688	3688	256	69	220	16	0	305
Episode	Time	Reward	Score	Highest	L	U	R	D	Steps
14500	9311s (+0.9s)	3800	3800	256	77	229	15	0	321
14501	9312s (+0.6s)	2028	2028	128	55	123	16	0	194
14502	9312s (+0.6s)	2468	2468	256	47	155	7	0	209
14503	9313s (+0.6s)	2520	2520	256	55	159	8	0	222
14504	9314s (+0.5s)	1912	1912	128	42	125	6	0	173
14505	9314s (+0.5s)	1860	1860	128	53	127	9	0	189
14506	9315s (+0.8s)	3504	3504	256	79	203	13	1	296
14507	9316s (+0.7s)	2840	2840	256	56	164	12	0	232
14508	9316s (+0.7s)	2900	2900	256	57	192	3	0	252
14509	9317s (+1.0s)	4124	4124	256	84	235	19	0	338
14510	9318s (+0.7s)	3084	3084	256	60	172	11	3	246
14511	9319s (+0.6s)	2036	2036	128	60	139	8	0	207
14512	9319s (+0.3s)	876	876	64	31	78	5	0	114
14513	9320s (+0.8s)	3300	3300	256	61	199	12	0	272
14514	9321s (+0.9s)	4036	4036	256	101	214	17	0	332
14515	9321s (+0.5s)	1908	1908	128	50	135	10	0	195
14516	9322s (+0.4s)	1448	1448	128	28	119	3	0	150
14517	9322s (+0.6s)	2336	2336	256	50	135	11	1	197
14518	9323s (+1.1s)	5628	5628	512	90	298	17	0	405
14519	9324s (+0.7s)	2880	2880	256	56	176	13	1	246
14520	9324s (+0.5s)	1588	1588	128	40	115	9	0	164
14521	9325s (+0.6s)	2288	2288	128	59	142	14	0	215
14522	9326s (+0.7s)	2864	2864	256	55	174	13	0	242
14523	9327s (+0.8s)	3520	3520	256	60	219	13	0	292
14524	9327s (+0.4s)	1484	1484	128	36	110	9	0	155
14525	9328s (+0.6s)	1924	1924	128	37	156	0	6	199
14526	9328s (+0.6s)	1956	1956	128	41	153	0	8	202
14527	9329s (+0.4s)	1080	1080	64	29	95	0	5	129
14528	9329s (+0.6s)	2236	2236	128	45	157	0	12	214
14529	9330s (+0.6s)	2540	2540	256	39	175	0	8	222
14530	9331s (+0.7s)	2868	2868	256	62	177	0	6	245
14531	9331s (+0.4s)	1480	1480	128	32	115	0	7	154
14532	9332s (+0.6s)	2464	2464	256	40	160	0	9	209
14533	9332s (+0.5s)	1860	1860	128	34	147	0	8	189
14534	9333s (+0.6s)	2548	2548	256	51	155	0	7	213
14535	9334s (+0.8s)	3328	3328	256	50	217	0	12	279
14536	9334s (+0.3s)	1020	1020	128	22	82	4	1	109
14537	9334s (+0.4s)	1508	1508	128	32	118	6	0	156
14538	9335s (+0.6s)	2004	2004	128	45	140	11	0	196
14539	9335s (+0.5s)	1720	1720	128	49	116	8	0	173
14540	9336s (+0.5s)	1916	1916	128	42	147	8	0	197
14541	9336s (+0.4s)	1344	1344	128	41	98	8	0	147
14542	9337s (+0.4s)	1324	1324	128	35	93	0	8	136
14543	9338s (+0.7s)	2828	2828	256	54	182	9	0	245
14544	9338s (+0.3s)	788	788	64	17	83	4	0	104
14545	9338s (+0.3s)	1188	1188	128	27	84	9	0	120
14546	9339s (+0.7s)	3040	3040	256	72	171	10	0	253
14547	9339s (+0.5s)	1812	1812	128	64	110	14	0	188
14548	9340s (+0.4s)	1516	1516	128	44	103	5	0	152
14549	9341s (+0.9s)	4084	4084	256	88	224	17	0	329
14550	9342s (+0.8s)	3332	3332	256	66	195	7	1	269
14551	9342s (+0.3s)	908	908	64	27	81	9	0	117
14552	9342s (+0.5s)	1860	1860	128	44	130	14	1	189
14553	9343s (+0.8s)	3420	3420	256	79	191	17	0	287
14554	9344s (+0.9s)	3924	3924	256	61	249	0	10	320
14555	9344s (+0.3s)	700	700	64	16	73	0	4	93
14556	9345s (+0.5s)	1564	1564	128	29	128	0	8	165
14557	9346s (+0.6s)	2532	2532	256	44	172	9	0	225
14558	9346s (+0.7s)	2768	2768	256	58	171	6	0	235
14559	9347s (+0.8s)	3556	3556	256	70	215	18	0	303
14560	9348s (+1.0s)	4248	4248	256	85	247	19	1	352
14561	9348s (+0.4s)	1208	1208	128	28	97	5	0	130
14562	9349s (+0.7s)	2992	2992	256	64	181	6	1	252
14563	9350s (+0.5s)	1896	1896	128	49	131	14	0	194
14564	9351s (+0.9s)	4012	4012	256	80	222	20	0	322
14565	9351s (+0.5s)	1788	1788	128	38	133	11	0	182
14566	9352s (+0.7s)	2936	2936	256	53	177	7	0	237
14567	9352s (+0.4s)	1376	1376	128	32	109	6	1	148
14568	9353s (+0.4s)	1340	1340	128	26	108	2	0	136
14569	9353s (+0.3s)	1040	1040	64	29	88	6	0	123
14570	9354s (+0.5s)	1648	1648	128	33	137	0	4	174
14571	9354s (+0.8s)	3260	3260	256	63	200	0	10	273
14572	9355s (+0.3s)	936	936	64	19	92	0	5	116
14573	9356s (+0.9s)	3932	3932	256	61	245	0	13	319
14574	9356s (+0.8s)	3220	3220	256	56	204	0	8	268
14575	9357s (+0.3s)	752	752	64	16	78	0	6	100
14576	9357s (+0.6s)	2376	2376	128	48	159	0	12	219
14577	9358s (+1.0s)	4176	4176	256	67	265	0	14	346
14578	9359s (+0.7s)	3012	3012	256	64	172	17	0	253
14579	9360s (+0.7s)	2952	2952	256	72	178	14	0	264
14580	9360s (+0.5s)	1824	1824	128	45	133	8	0	186
14581	9361s (+0.5s)	1780	1780	128	32	148	5	0	185
14582	9361s (+0.6s)	2480	2480	256	53	152	6	0	211
14583	9362s (+0.9s)	4204	4204	256	91	242	13	0	346
14584	9363s (+0.7s)	2984	2984	256	60	173	10	0	243
14585	9364s (+1.0s)	5044	5044	512	85	253	18	0	356
14586	9365s (+0.5s)	1732	1732	128	46	119	8	0	173
14587	9365s (+0.4s)	1192	1192	128	34	85	11	0	130
14588	9366s (+0.5s)	2056	2056	128	34	146	10	1	191
14589	9366s (+0.5s)	1560	1560	128	43	109	10	0	162
14590	9367s (+0.8s)	3244	3244	256	88	178	8	0	274
14591	9367s (+0.7s)	2756	2756	256	65	151	17	0	233
14592	9368s (+0.6s)	2084	2084	128	46	141	7	0	194
14593	9369s (+0.9s)	3920	3920	256	72	234	13	0	319
14594	9370s (+0.9s)	3964	3964	256	87	219	19	0	325
14595	9370s (+0.3s)	1040	1040	128	28	82	4	0	114
14596	9371s (+0.6s)	2404	2404	256	49	140	10	0	199
14597	9371s (+0.4s)	1464	1464	128	32	114	5	0	151
14598	9372s (+0.6s)	2240	2240	128	64	142	8	0	214
14599	9372s (+0.4s)	1512	1512	128	48	97	10	0	155
Episode	Time	Reward	Score	Highest	L	U	R	D	Steps
14600	9373s (+0.6s)	2108	2108	128	64	128	7	0	199
14601	9373s (+0.5s)	1904	1904	128	46	140	8	0	194
14602	9374s (+0.6s)	2412	2412	256	46	146	14	0	206
14603	9375s (+0.6s)	2536	2536	256	59	153	9	0	221
14604	9375s (+0.8s)	3576	3576	256	66	216	15	0	297
14605	9376s (+0.4s)	1492	1492	128	33	118	5	0	156
14606	9376s (+0.5s)	1776	1776	128	46	125	8	0	179
14607	9377s (+0.8s)	3440	3440	256	76	200	15	0	291
14608	9378s (+0.6s)	2596	2596	256	52	164	8	0	224
14609	9378s (+0.5s)	1692	1692	128	44	118	10	2	174
14610	9379s (+0.4s)	1460	1460	128	31	114	4	0	149
14611	9379s (+0.5s)	1684	1684	128	39	128	6	0	173
14612	9380s (+0.7s)	2672	2672	256	50	173	5	0	228
14613	9380s (+0.3s)	916	916	64	28	83	3	0	114
14614	9381s (+0.5s)	1908	1908	128	42	141	9	0	192
14615	9381s (+0.6s)	2488	2488	128	73	145	15	0	233
14616	9382s (+0.5s)	1708	1708	128	43	116	9	0	168
14617	9382s (+0.4s)	976	976	64	32	88	3	0	123
14618	9383s (+0.8s)	3412	3412	256	78	191	14	1	284
14619	9384s (+0.5s)	1848	1848	128	44	135	7	0	186
14620	9384s (+0.7s)	3144	3144	256	71	183	9	1	264
14621	9385s (+0.9s)	3924	3924	256	69	235	16	0	320
14622	9386s (+0.6s)	2844	2844	256	54	171	7	0	232
14623	9387s (+1.5s)	7392	7392	512	139	344	26	1	510
14624	9388s (+0.3s)	972	972	64	32	79	5	0	116
14625	9388s (+0.4s)	1064	1064	64	23	102	4	0	129
14626	9389s (+0.5s)	1864	1864	128	60	118	11	0	189
14627	9390s (+1.0s)	4400	4400	256	81	265	23	0	369
14628	9391s (+1.2s)	5620	5620	512	99	288	16	0	403
14629	9392s (+1.0s)	4216	4216	256	83	246	14	1	344
14630	9392s (+0.3s)	1124	1124	128	21	96	3	0	120
14631	9393s (+0.5s)	1676	1676	128	33	132	6	0	171
14632	9393s (+0.7s)	2872	2872	256	48	200	8	0	256
14633	9394s (+0.4s)	1448	1448	128	34	108	6	1	149
14634	9395s (+0.6s)	2476	2476	256	47	159	5	0	211
14635	9395s (+0.8s)	3300	3300	256	60	198	18	0	276
14636	9396s (+0.5s)	1812	1812	128	45	124	12	0	181
14637	9397s (+1.3s)	6644	6644	512	124	320	23	0	467
14638	9398s (+0.8s)	3436	3436	256	64	207	12	0	283
14639	9399s (+0.5s)	1740	1740	128	39	126	9	1	175
14640	9399s (+0.5s)	1768	1768	128	34	136	0	11	181
14641	9400s (+0.4s)	1484	1484	128	35	113	6	0	154
14642	9400s (+0.8s)	3192	3192	256	56	198	11	0	265
14643	9401s (+0.7s)	2780	2780	256	61	168	13	0	242
14644	9402s (+1.1s)	5184	5184	512	99	259	16	0	374
14645	9403s (+0.6s)	2084	2084	128	63	125	13	0	201
14646	9403s (+0.4s)	1560	1560	128	40	109	3	0	152
14647	9404s (+0.6s)	2132	2132	128	62	141	9	0	212
14648	9404s (+0.6s)	2672	2672	256	72	144	11	0	227
14649	9405s (+0.9s)	3976	3976	256	71	246	11	0	328
14650	9406s (+0.7s)	3140	3140	256	59	198	7	0	264
14651	9407s (+1.0s)	4440	4440	256	96	251	21	0	368
14652	9407s (+0.3s)	1116	1116	128	31	78	8	0	117
14653	9408s (+0.7s)	2632	2632	256	59	163	10	0	232
14654	9409s (+0.4s)	1456	1456	128	42	105	5	0	152
14655	9409s (+0.3s)	848	848	64	39	74	2	0	115
14656	9410s (+0.7s)	2996	2996	256	61	173	15	0	249
14657	9410s (+0.6s)	2032	2032	128	59	138	13	0	210
14658	9411s (+0.5s)	1636	1636	128	36	127	0	9	172
14659	9411s (+0.5s)	1704	1704	128	36	129	0	9	174
14660	9412s (+0.5s)	1796	1796	128	39	134	0	10	183
14661	9412s (+0.8s)	3580	3580	256	52	221	0	14	287
14662	9413s (+0.5s)	1860	1860	128	39	141	9	0	189
14663	9414s (+1.0s)	5028	5028	512	94	234	24	0	352
14664	9415s (+0.6s)	2224	2224	256	46	141	5	0	192
14665	9415s (+0.8s)	3576	3576	256	93	193	15	0	301
14666	9416s (+0.3s)	1052	1052	128	19	94	3	0	116
14667	9417s (+0.8s)	3464	3464	256	67	215	8	0	290
14668	9417s (+0.7s)	3144	3144	256	73	166	15	0	254
14669	9418s (+0.7s)	3164	3164	256	57	192	10	0	259
14670	9418s (+0.4s)	1448	1448	128	47	97	7	0	151
14671	9419s (+0.7s)	2808	2808	256	54	178	11	2	245
14672	9420s (+0.4s)	1000	1000	64	34	88	6	0	128
14673	9420s (+0.5s)	1816	1816	128	42	137	9	0	188
14674	9421s (+0.9s)	3688	3688	256	83	211	15	0	309
14675	9421s (+0.5s)	1740	1740	128	39	128	0	10	177
14676	9422s (+0.7s)	2808	2808	256	66	167	0	12	245
14677	9423s (+0.4s)	1452	1452	128	31	119	0	4	154
14678	9423s (+0.6s)	2648	2648	256	47	172	7	0	226
14679	9424s (+0.5s)	1988	1988	256	22	136	5	0	163
14680	9425s (+1.0s)	4360	4360	256	101	241	21	0	363
14681	9425s (+0.7s)	2812	2812	256	55	177	10	0	242
14682	9426s (+0.4s)	1184	1184	64	40	95	8	0	143
14683	9427s (+0.8s)	3332	3332	256	87	184	13	0	284
14684	9427s (+0.6s)	2340	2340	128	55	150	11	1	217
14685	9428s (+0.5s)	1528	1528	128	39	115	5	2	161
14686	9429s (+0.8s)	3184	3184	256	59	195	10	0	264
14687	9429s (+0.6s)	2592	2592	256	39	170	0	14	223
14688	9429s (+0.2s)	684	684	64	14	73	0	2	89
14689	9430s (+0.7s)	2960	2960	256	66	172	13	0	251
14690	9431s (+0.5s)	1852	1852	128	45	130	11	0	186
14691	9431s (+0.7s)	2504	2504	128	53	172	12	0	237
14692	9432s (+0.9s)	3792	3792	256	69	236	9	0	314
14693	9433s (+0.5s)	1832	1832	128	40	137	5	0	182
14694	9433s (+0.3s)	1040	1040	128	23	79	3	0	105
14695	9433s (+0.3s)	856	856	64	24	80	6	0	110
14696	9434s (+0.5s)	1784	1784	128	44	129	7	1	181
14697	9434s (+0.3s)	800	800	64	26	76	0	5	107
14698	9435s (+0.5s)	1716	1716	128	37	124	0	9	170
14699	9435s (+0.6s)	2344	2344	256	41	153	0	5	199
Episode	Time	Reward	Score	Highest	L	U	R	D	Steps
14700	9436s (+0.7s)	2748	2748	256	45	183	0	8	236
14701	9437s (+0.4s)	1388	1388	64	38	112	6	1	157
14702	9437s (+0.6s)	2464	2464	256	46	157	9	0	212
14703	9438s (+0.5s)	1584	1584	128	44	110	8	1	163
14704	9438s (+0.4s)	1380	1380	128	36	107	6	0	149
14705	9439s (+0.7s)	2864	2864	256	81	157	16	0	254
14706	9439s (+0.5s)	1852	1852	128	47	141	5	0	193
14707	9440s (+0.5s)	1640	1640	128	40	120	0	7	167
14708	9440s (+0.5s)	1792	1792	128	37	139	0	6	182
14709	9441s (+0.6s)	2440	2440	256	52	142	13	0	207
14710	9442s (+0.9s)	3836	3836	256	83	226	11	0	320
14711	9442s (+0.5s)	1612	1612	128	41	122	7	0	170
14712	9443s (+0.8s)	3448	3448	256	86	184	18	0	288
14713	9444s (+0.5s)	1768	1768	128	42	129	0	7	178
14714	9444s (+0.2s)	428	428	32	13	52	0	4	69
14715	9444s (+0.3s)	908	908	64	33	83	2	0	118
14716	9445s (+0.8s)	3248	3248	256	73	181	13	0	267
14717	9446s (+0.8s)	3464	3464	256	73	193	18	0	284
14718	9446s (+0.4s)	1316	1316	128	28	100	6	0	134
14719	9447s (+0.4s)	1048	1048	64	27	94	5	0	126
14720	9447s (+0.6s)	1908	1908	128	47	137	11	0	195
14721	9448s (+0.4s)	1240	1240	128	42	90	5	0	137
14722	9448s (+0.7s)	2436	2436	128	64	162	14	0	240
14723	9449s (+0.4s)	1472	1472	128	37	109	0	10	156
14724	9449s (+0.3s)	728	728	64	18	72	0	6	96
14725	9450s (+0.7s)	2804	2804	256	58	176	0	10	244
14726	9450s (+0.5s)	1976	1976	256	28	127	0	9	164
14727	9451s (+0.5s)	1820	1820	128	38	142	0	5	185
14728	9451s (+0.7s)	2760	2760	256	52	173	0	8	233
14729	9452s (+0.8s)	3224	3224	256	57	206	0	6	269
14730	9453s (+0.5s)	1860	1860	128	42	135	0	9	186
14731	9453s (+0.3s)	892	892	64	16	89	0	4	109
14732	9454s (+0.6s)	2576	2576	256	54	158	0	8	220
14733	9454s (+0.6s)	2264	2264	128	44	162	0	10	216
14734	9455s (+0.3s)	1048	1048	128	20	88	2	0	110
14735	9455s (+0.7s)	2592	2592	128	77	150	15	0	242
14736	9456s (+0.3s)	864	864	64	32	74	6	0	112
14737	9456s (+0.7s)	3016	3016	256	57	188	9	0	254
14738	9457s (+1.0s)	4280	4280	256	99	232	17	0	348
14739	9458s (+1.0s)	4324	4324	256	102	230	24	0	356
14740	9459s (+0.6s)	2464	2464	256	48	152	7	0	207
14741	9459s (+0.5s)	1784	1784	128	41	129	11	0	181
14742	9460s (+0.4s)	1432	1432	128	45	94	8	0	147
14743	9460s (+0.5s)	1800	1800	128	50	130	6	0	186
14744	9461s (+0.3s)	1168	1168	128	22	95	7	0	124
14745	9461s (+0.6s)	2372	2372	256	42	152	0	8	202
14746	9462s (+0.7s)	2812	2812	128	58	192	0	12	262
14747	9463s (+1.1s)	5492	5492	512	86	282	0	19	387
14748	9464s (+0.5s)	1600	1600	128	36	125	0	6	167
14749	9464s (+0.7s)	2804	2804	256	48	185	0	11	244
14750	9465s (+0.3s)	1124	1124	128	27	88	0	4	119
14751	9466s (+0.9s)	3784	3784	256	64	234	0	15	313
14752	9466s (+0.6s)	2480	2480	256	54	147	11	0	212
14753	9467s (+0.8s)	3344	3344	256	64	212	10	0	286
14754	9468s (+0.6s)	2132	2132	128	45	145	8	0	198
14755	9468s (+0.5s)	1792	1792	128	50	119	14	0	183
14756	9469s (+0.4s)	1356	1356	128	25	110	4	0	139
14757	9469s (+0.5s)	1508	1508	128	36	116	8	0	160
14758	9470s (+0.6s)	2000	2000	128	55	137	11	0	203
14759	9470s (+0.8s)	3180	3180	256	54	198	12	0	264
14760	9471s (+1.0s)	4544	4544	256	112	246	19	0	377
14761	9472s (+0.8s)	3224	3224	256	73	181	15	0	269
14762	9473s (+0.4s)	1304	1304	128	36	101	5	0	142
14763	9473s (+0.4s)	1468	1468	128	34	114	4	0	152
14764	9474s (+0.8s)	3500	3500	256	80	199	14	0	293
14765	9475s (+0.7s)	2824	2824	256	66	171	12	0	249
14766	9475s (+0.4s)	1392	1392	64	43	101	12	0	156
14767	9476s (+0.5s)	1796	1796	128	49	128	6	0	183
14768	9476s (+0.8s)	3704	3704	256	73	209	15	0	297
14769	9477s (+0.8s)	3532	3532	256	77	209	11	0	297
14770	9478s (+0.5s)	1740	1740	128	57	110	8	0	175
14771	9478s (+0.5s)	1692	1692	128	50	108	10	0	168
14772	9479s (+0.7s)	3148	3148	256	69	173	13	1	256
14773	9479s (+0.4s)	1140	1140	128	32	87	4	0	123
14774	9480s (+0.9s)	4720	4720	512	77	228	20	0	325
14775	9481s (+0.4s)	1456	1456	128	38	101	9	1	149
14776	9481s (+0.6s)	2616	2616	256	44	165	9	0	218
14777	9482s (+0.7s)	2604	2604	128	84	146	17	0	247
14778	9483s (+0.5s)	1788	1788	128	53	119	0	10	182
14779	9483s (+0.4s)	1324	1324	128	29	101	0	7	137
14780	9483s (+0.5s)	1776	1776	128	34	141	0	9	184
14781	9484s (+0.6s)	2376	2376	128	47	164	0	12	223
14782	9485s (+1.2s)	6328	6328	512	100	324	0	22	446
14783	9486s (+0.6s)	2460	2460	256	58	142	0	8	208
14784	9487s (+0.9s)	4124	4124	256	77	244	0	16	337
14785	9487s (+0.5s)	2244	2244	256	50	124	10	1	185
14786	9488s (+0.9s)	3812	3812	256	63	238	9	0	310
14787	9489s (+0.3s)	704	704	64	11	81	1	0	93
14788	9489s (+0.4s)	1220	1220	128	25	102	5	0	132
14789	9489s (+0.4s)	1360	1360	128	37	93	10	0	140
14790	9490s (+0.7s)	2936	2936	256	73	159	10	0	242
14791	9490s (+0.3s)	1136	1136	128	24	91	6	0	121
14792	9491s (+0.4s)	1408	1408	128	34	102	6	0	142
14793	9492s (+0.7s)	2900	2900	256	53	189	9	0	251
14794	9492s (+0.4s)	1376	1376	128	41	95	8	0	144
14795	9492s (+0.3s)	748	748	64	36	58	6	0	100
14796	9493s (+0.4s)	1388	1388	64	50	97	8	0	155
14797	9493s (+0.5s)	1920	1920	128	45	147	6	0	198
14798	9494s (+0.5s)	1784	1784	128	31	135	3	0	169
14799	9495s (+0.8s)	3448	3448	256	74	195	14	0	283
Episode	Time	Reward	Score	Highest	L	U	R	D	Steps
14800	9496s (+1.1s)	5628	5628	512	105	281	19	0	405
14801	9496s (+0.5s)	1540	1540	128	46	112	5	0	163
14802	9497s (+0.7s)	2492	2492	128	57	166	11	0	234
14803	9498s (+0.8s)	3504	3504	256	74	207	14	0	295
14804	9498s (+0.4s)	1540	1540	128	36	113	6	1	156
14805	9499s (+0.8s)	3108	3108	256	55	203	11	0	269
14806	9499s (+0.4s)	1216	1216	64	38	102	6	0	146
14807	9500s (+0.5s)	1804	1804	128	42	120	10	1	173
14808	9500s (+0.5s)	1588	1588	128	49	104	11	0	164
14809	9501s (+0.7s)	2808	2808	256	65	170	9	1	245
14810	9502s (+0.5s)	1824	1824	128	39	130	7	1	177
14811	9502s (+0.5s)	1824	1824	128	59	113	13	0	185
14812	9503s (+0.5s)	1784	1784	128	48	126	7	0	181
14813	9503s (+0.7s)	3136	3136	256	57	189	9	2	257
14814	9504s (+0.7s)	2816	2816	256	47	186	0	10	243
14815	9504s (+0.4s)	1492	1492	128	33	113	0	10	156
14816	9505s (+0.6s)	2484	2484	256	55	153	0	7	215
14817	9506s (+1.0s)	5156	5156	512	87	260	20	0	367
14818	9507s (+0.4s)	1084	1084	64	37	87	7	0	131
14819	9507s (+0.4s)	1440	1440	128	36	101	8	0	145
14820	9508s (+1.0s)	5072	5072	512	86	257	20	0	363
14821	9508s (+0.4s)	1448	1448	128	43	102	5	1	151
14822	9509s (+0.8s)	3384	3384	256	77	200	15	0	292
14823	9510s (+0.6s)	2268	2268	128	56	138	17	0	211
14824	9511s (+0.8s)	3368	3368	256	72	184	19	0	275
14825	9511s (+0.4s)	1444	1444	128	25	124	2	0	151
14826	9512s (+0.6s)	2252	2252	128	59	136	16	0	211
14827	9512s (+0.6s)	1964	1964	128	53	140	10	0	203
14828	9513s (+0.9s)	4132	4132	256	92	231	12	0	335
14829	9514s (+0.9s)	4040	4040	256	86	231	12	0	329
14830	9515s (+1.0s)	4332	4332	256	101	233	23	0	357
14831	9516s (+0.6s)	2760	2760	256	37	182	5	0	224
14832	9517s (+0.8s)	3284	3284	256	63	197	9	0	269
14833	9517s (+0.5s)	1736	1736	128	40	123	7	0	170
14834	9518s (+0.4s)	1436	1436	128	35	98	9	0	142
14835	9518s (+0.4s)	1332	1332	128	18	116	4	0	138
14836	9519s (+1.2s)	5980	5980	512	117	284	22	0	423
14837	9520s (+1.2s)	5868	5868	512	107	298	17	0	422
14838	9521s (+0.5s)	1800	1800	128	40	137	7	0	184
14839	9522s (+1.1s)	4572	4572	256	104	254	19	0	377
14840	9522s (+0.5s)	1556	1556	128	34	124	3	0	161
14841	9523s (+1.0s)	4196	4196	256	74	259	13	0	346
14842	9524s (+0.8s)	3548	3548	256	69	214	13	0	296
14843	9525s (+0.5s)	1768	1768	128	39	130	12	0	181
14844	9525s (+0.6s)	2552	2552	256	55	153	10	0	218
14845	9526s (+0.7s)	2476	2476	128	72	147	11	0	230
14846	9527s (+0.5s)	1764	1764	128	40	131	7	0	178
14847	9528s (+1.2s)	6080	6080	512	102	301	18	0	421
14848	9528s (+0.3s)	992	992	128	25	81	4	0	110
14849	9529s (+0.9s)	3644	3644	256	76	218	15	0	309
14850	9529s (+0.3s)	716	716	64	17	73	6	0	96
14851	9530s (+0.7s)	2964	2964	256	77	163	20	0	260
14852	9531s (+0.4s)	1504	1504	128	45	108	6	0	159
14853	9531s (+0.5s)	1608	1608	128	53	102	13	1	169
14854	9532s (+0.9s)	3864	3864	256	96	204	17	0	317
14855	9533s (+0.5s)	1828	1828	128	49	127	8	0	184
14856	9533s (+0.7s)	2764	2764	256	56	169	10	0	235
14857	9534s (+0.5s)	1692	1692	128	46	119	9	0	174
14858	9534s (+0.6s)	2080	2080	128	52	132	12	0	196
14859	9535s (+0.5s)	1760	1760	128	36	133	8	0	177
14860	9536s (+0.8s)	3492	3492	256	73	206	13	0	292
14861	9536s (+0.7s)	2796	2796	256	65	167	10	0	242
14862	9537s (+0.6s)	2604	2604	256	56	163	7	0	226
14863	9538s (+0.8s)	3544	3544	256	92	185	23	0	300
14864	9539s (+1.0s)	4216	4216	256	78	254	14	0	346
14865	9539s (+0.5s)	2060	2060	128	44	138	7	0	189
14866	9540s (+0.7s)	2836	2836	256	53	177	10	0	240
14867	9540s (+0.3s)	1032	1032	64	30	88	8	0	126
14868	9541s (+0.5s)	1808	1808	128	57	123	7	0	187
14869	9542s (+0.6s)	2524	2524	256	57	154	8	0	219
14870	9542s (+0.7s)	2824	2824	256	73	159	10	0	242
14871	9543s (+0.8s)	3180	3180	256	62	186	14	1	263
14872	9544s (+0.5s)	1600	1600	128	39	121	7	0	167
14873	9544s (+0.3s)	928	928	64	31	73	8	0	112
14874	9544s (+0.5s)	1500	1500	128	32	120	6	0	158
14875	9545s (+0.7s)	2772	2772	256	71	156	13	0	240
14876	9546s (+0.6s)	2608	2608	256	48	164	0	12	224
14877	9546s (+0.4s)	1376	1376	128	28	114	0	4	146
14878	9546s (+0.1s)	264	264	32	7	39	0	5	51
14879	9547s (+0.8s)	3572	3572	256	68	206	12	0	286
14880	9547s (+0.3s)	1048	1048	64	29	89	7	0	125
14881	9548s (+0.6s)	2232	2232	128	59	137	17	0	213
14882	9549s (+1.0s)	4276	4276	256	108	230	21	0	359
14883	9550s (+0.5s)	1788	1788	128	49	125	8	1	183
14884	9550s (+0.4s)	1220	1220	128	22	101	5	0	128
14885	9551s (+0.7s)	2912	2912	256	62	180	12	0	254
14886	9552s (+1.0s)	4324	4324	256	97	240	18	0	355
14887	9552s (+0.3s)	756	756	64	17	82	3	0	102
14888	9553s (+0.7s)	2764	2764	256	54	173	8	0	235
14889	9553s (+0.7s)	2936	2936	256	51	186	9	0	246
14890	9554s (+0.6s)	1856	1856	128	61	124	9	0	194
14891	9554s (+0.4s)	1448	1448	128	36	109	6	0	151
14892	9555s (+0.7s)	2788	2788	256	58	175	11	0	244
14893	9556s (+0.5s)	1636	1636	128	40	116	10	1	167
14894	9556s (+0.4s)	1208	1208	128	25	99	6	0	130
14895	9557s (+0.5s)	1920	1920	128	54	135	9	0	198
14896	9557s (+0.8s)	3352	3352	256	71	200	13	0	284
14897	9558s (+0.3s)	876	876	64	28	82	5	0	115
14898	9558s (+0.4s)	1248	1248	128	29	100	0	4	133
14899	9559s (+0.5s)	2152	2152	256	32	131	0	10	173
Episode	Time	Reward	Score	Highest	L	U	R	D	Steps
14900	9559s (+0.7s)	2948	2948	256	58	191	0	14	263
14901	9560s (+0.7s)	2656	2656	256	53	170	0	10	233
14902	9561s (+0.6s)	2340	2340	256	38	154	0	3	195
14903	9561s (+0.5s)	1768	1768	128	41	125	0	11	177
14904	9562s (+0.5s)	1824	1824	128	35	143	0	13	191
14905	9562s (+0.5s)	1696	1696	128	41	124	14	0	179
14906	9563s (+0.4s)	1500	1500	128	54	89	10	0	153
14907	9563s (+0.9s)	3516	3516	256	83	201	15	0	299
14908	9564s (+0.8s)	3180	3180	256	83	166	13	0	262
14909	9565s (+0.6s)	2544	2544	256	44	169	4	0	217
14910	9565s (+0.6s)	2356	2356	256	41	152	6	0	199
14911	9566s (+0.4s)	1216	1216	64	41	98	7	0	146
14912	9566s (+0.2s)	424	424	32	14	52	2	0	68
14913	9566s (+0.3s)	880	880	64	34	76	5	0	115
14914	9567s (+0.9s)	3660	3660	256	71	230	11	1	313
14915	9568s (+0.4s)	1520	1520	128	38	113	8	0	159
14916	9568s (+0.6s)	2092	2092	128	59	135	9	1	204
14917	9569s (+0.3s)	748	748	64	22	74	4	0	100
14918	9569s (+0.8s)	3520	3520	256	78	203	15	0	296
14919	9570s (+0.7s)	2860	2860	256	68	167	10	1	246
14920	9571s (+0.6s)	1880	1880	128	41	145	7	0	193
14921	9572s (+0.8s)	3280	3280	256	62	193	17	0	272
14922	9572s (+0.8s)	3268	3268	256	66	199	14	0	279
14923	9573s (+0.5s)	1884	1884	128	52	129	12	0	193
14924	9574s (+1.2s)	5784	5784	512	118	271	23	0	412
14925	9575s (+0.5s)	1800	1800	128	48	128	9	0	185
14926	9575s (+0.6s)	1920	1920	128	41	154	3	0	198
14927	9576s (+0.6s)	2384	2384	256	52	146	7	0	205
14928	9577s (+0.8s)	3488	3488	256	66	214	11	0	291
14929	9577s (+0.3s)	1036	1036	128	26	80	6	0	112
14930	9577s (+0.5s)	1900	1900	128	47	138	8	0	193
14931	9578s (+0.6s)	2404	2404	256	47	147	11	0	205
14932	9579s (+1.0s)	4196	4196	256	85	253	13	0	351
14933	9580s (+0.4s)	1448	1448	128	38	103	9	0	150
14934	9580s (+0.5s)	1620	1620	128	42	123	7	0	172
14935	9581s (+0.9s)	4004	4004	256	72	247	0	16	335
14936	9582s (+0.6s)	2464	2464	256	46	154	0	8	208
14937	9582s (+0.2s)	488	488	32	10	62	0	3	75
14938	9583s (+0.8s)	3348	3348	256	60	202	0	15	277
14939	9583s (+0.8s)	3300	3300	256	54	202	0	14	270
14940	9584s (+1.0s)	4248	4248	256	72	270	0	10	352
14941	9585s (+0.6s)	2088	2088	128	42	143	0	9	194
14942	9586s (+0.5s)	1804	1804	128	37	147	0	2	186
14943	9586s (+0.5s)	1844	1844	128	38	146	0	6	190
14944	9586s (+0.3s)	900	900	64	36	75	9	0	120
14945	9587s (+0.8s)	3316	3316	256	72	192	16	0	280
14946	9588s (+0.5s)	1924	1924	128	52	139	8	0	199
14947	9588s (+0.6s)	1932	1932	128	63	126	12	0	201
14948	9589s (+0.6s)	1932	1932	128	56	129	9	0	194
14949	9590s (+0.6s)	2224	2224	128	54	147	10	0	211
14950	9590s (+0.8s)	3412	3412	256	64	206	14	0	284
14951	9591s (+0.9s)	3840	3840	256	86	213	12	0	311
14952	9592s (+0.8s)	3572	3572	256	97	175	19	1	292
14953	9593s (+0.7s)	2760	2760	256	57	172	6	0	235
14954	9593s (+0.5s)	1796	1796	128	38	129	6	0	173
14955	9594s (+0.5s)	1676	1676	128	42	131	8	0	181
14956	9594s (+0.5s)	1504	1504	128	40	113	6	0	159
14957	9595s (+0.6s)	1900	1900	128	49	137	7	0	193
14958	9595s (+0.5s)	1528	1528	128	25	130	0	4	159
14959	9596s (+0.5s)	1632	1632	128	30	127	0	8	165
14960	9596s (+0.4s)	1340	1340	128	31	102	0	7	140
14961	9596s (+0.3s)	664	664	64	18	70	0	3	91
14962	9597s (+0.8s)	3660	3660	256	68	219	0	10	297
14963	9598s (+0.6s)	2340	2340	256	44	136	0	15	195
14964	9599s (+0.8s)	3520	3520	256	50	219	0	15	284
14965	9599s (+0.3s)	724	724	64	22	70	0	3	95
14966	9599s (+0.4s)	1332	1332	128	31	101	0	3	135
14967	9600s (+0.5s)	1516	1516	128	29	123	0	10	162
14968	9600s (+0.4s)	1488	1488	128	31	116	7	1	155
14969	9601s (+0.6s)	2112	2112	128	55	138	14	0	207
14970	9602s (+0.7s)	3072	3072	256	57	181	12	0	250
14971	9602s (+0.8s)	3292	3292	256	73	187	14	0	274
14972	9603s (+0.5s)	1612	1612	128	32	125	4	0	161
14973	9604s (+0.8s)	3488	3488	256	79	199	14	0	292
14974	9604s (+0.5s)	1764	1764	128	40	130	11	0	181
14975	9605s (+0.8s)	3608	3608	256	75	208	17	1	301
14976	9605s (+0.3s)	1120	1120	128	29	92	2	0	123
14977	9606s (+0.5s)	1840	1840	128	37	142	4	0	183
14978	9606s (+0.5s)	1668	1668	128	35	129	0	5	169
14979	9607s (+0.5s)	1780	1780	128	42	138	0	5	185
14980	9608s (+0.7s)	2892	2892	256	40	207	0	9	256
14981	9609s (+0.9s)	4232	4232	256	81	234	13	1	329
14982	9609s (+0.7s)	3020	3020	256	60	179	14	0	253
14983	9610s (+1.0s)	4968	4968	512	79	250	14	1	344
14984	9611s (+0.6s)	2440	2440	256	58	136	12	0	206
14985	9611s (+0.4s)	1480	1480	128	37	109	8	0	154
14986	9612s (+0.7s)	2612	2612	256	64	153	11	0	228
14987	9613s (+1.0s)	5368	5368	512	83	268	21	1	373
14988	9614s (+1.1s)	4596	4596	256	107	260	16	0	383
14989	9615s (+0.5s)	1512	1512	128	31	127	2	0	160
14990	9615s (+0.7s)	2648	2648	128	66	170	10	1	247
14991	9616s (+0.8s)	3432	3432	256	69	205	15	0	289
14992	9617s (+0.4s)	1212	1212	128	25	101	6	0	132
14993	9617s (+0.8s)	3312	3312	256	74	188	18	0	280
14994	9618s (+0.7s)	3196	3196	256	76	177	13	1	267
14995	9619s (+0.8s)	3196	3196	256	62	203	8	0	273
14996	9619s (+0.4s)	1528	1528	128	35	114	6	0	155
14997	9620s (+0.6s)	2364	2364	256	44	147	8	1	200
14998	9621s (+1.2s)	5728	5728	512	112	270	22	0	404
14999	9622s (+0.8s)	3240	3240	256	74	189	9	0	272
Episode	Time	Reward	Score	Highest	L	U	R	D	Steps
15000	9622s (+0.4s)	1416	1416	128	37	103	7	0	147
15001	9623s (+0.6s)	2612	2612	256	70	148	10	0	228
15002	9624s (+0.8s)	3420	3420	256	67	204	15	0	286
15003	9624s (+0.5s)	1824	1824	128	45	131	9	0	185
15004	9625s (+0.7s)	2800	2800	256	58	173	11	0	242
15005	9625s (+0.4s)	1224	1224	128	31	98	4	0	133
15006	9626s (+0.7s)	2944	2944	256	70	177	15	0	262
15007	9627s (+0.6s)	2668	2668	256	58	159	10	0	227
15008	9628s (+1.1s)	4532	4532	256	112	244	18	0	374
15009	9628s (+0.4s)	1484	1484	128	38	114	3	0	155
15010	9629s (+0.9s)	3632	3632	256	81	212	13	0	306
15011	9630s (+0.7s)	3104	3104	256	61	194	10	0	265
15012	9630s (+0.4s)	1392	1392	128	28	114	6	0	148
15013	9631s (+0.6s)	1912	1912	128	49	141	7	0	197
15014	9632s (+0.9s)	3788	3788	256	74	224	15	0	313
15015	9632s (+0.4s)	1348	1348	128	32	97	6	0	135
15016	9633s (+0.5s)	1660	1660	128	42	116	9	0	167
15017	9633s (+0.5s)	1660	1660	128	36	120	11	0	167
15018	9634s (+1.0s)	4340	4340	256	100	240	18	1	359
15019	9635s (+0.9s)	3788	3788	256	90	213	15	0	318
15020	9636s (+0.4s)	1480	1480	128	48	101	9	0	158
15021	9636s (+0.7s)	2640	2640	256	50	176	9	0	235
15022	9637s (+0.4s)	1496	1496	128	31	115	5	0	151
15023	9638s (+0.8s)	3384	3384	256	93	173	23	0	289
15024	9638s (+0.7s)	3028	3028	256	60	174	14	0	248
15025	9639s (+0.5s)	2300	2300	256	38	145	7	0	190
15026	9640s (+0.7s)	2880	2880	256	45	198	0	8	251
15027	9640s (+0.7s)	2836	2836	256	49	190	0	8	247
15028	9641s (+1.0s)	4444	4444	256	67	278	0	21	366
15029	9642s (+0.8s)	3404	3404	256	53	216	0	13	282
15030	9643s (+0.7s)	2844	2844	256	56	181	0	16	253
15031	9644s (+0.9s)	3556	3556	256	54	233	0	16	303
15032	9644s (+0.6s)	2084	2084	128	37	147	0	9	193
15033	9645s (+0.7s)	3220	3220	256	61	187	0	13	261
15034	9646s (+0.5s)	1656	1656	128	35	133	0	8	176
15035	9646s (+0.5s)	1700	1700	128	25	144	0	2	171
15036	9647s (+0.7s)	3128	3128	256	64	174	1	12	251
15037	9648s (+0.9s)	3976	3976	256	64	245	0	19	328
15038	9648s (+0.3s)	1068	1068	128	11	100	0	4	115
15039	9649s (+0.7s)	2640	2640	128	60	167	0	12	239
15040	9649s (+0.7s)	2920	2920	256	61	182	13	0	256
15041	9650s (+0.5s)	1580	1580	128	30	124	4	1	159
15042	9650s (+0.5s)	1684	1684	128	45	117	11	0	173
15043	9651s (+0.8s)	3184	3184	256	73	177	14	0	264
15044	9652s (+0.6s)	2392	2392	256	59	138	8	0	205
15045	9652s (+0.4s)	1492	1492	128	35	113	9	0	157
15046	9653s (+0.6s)	2240	2240	128	47	157	11	0	215
15047	9653s (+0.5s)	1708	1708	128	42	118	11	0	171
15048	9654s (+0.9s)	4032	4032	256	76	237	14	1	328
15049	9655s (+0.7s)	2800	2800	256	44	176	12	0	232
15050	9655s (+0.4s)	1480	1480	128	41	105	7	1	154
15051	9656s (+1.0s)	4096	4096	256	88	242	11	0	341
15052	9657s (+0.9s)	3732	3732	256	78	218	12	0	308
15053	9658s (+1.0s)	4320	4320	256	93	245	20	0	358
15054	9659s (+0.8s)	3400	3400	256	66	201	15	0	282
15055	9659s (+0.4s)	1300	1300	128	39	96	5	0	140
15056	9660s (+0.7s)	3260	3260	256	54	205	8	0	267
15057	9661s (+0.5s)	1612	1612	128	42	123	5	0	170
15058	9661s (+0.7s)	3272	3272	256	55	202	8	1	266
15059	9662s (+0.9s)	3644	3644	256	79	215	13	1	308
15060	9663s (+0.6s)	2512	2512	256	47	159	7	0	213
15061	9664s (+0.6s)	2404	2404	256	48	153	7	1	209
15062	9664s (+0.7s)	2808	2808	256	60	173	12	0	245
15063	9665s (+0.5s)	1880	1880	128	56	126	10	1	193
15064	9666s (+1.1s)	4568	4568	256	102	264	18	0	384
15065	9667s (+0.8s)	3576	3576	256	76	209	11	0	296
15066	9668s (+0.8s)	3564	3564	256	88	191	19	0	298
15067	9668s (+0.5s)	1764	1764	128	50	109	8	0	167
15068	9669s (+0.8s)	3244	3244	256	86	173	15	0	274
15069	9669s (+0.5s)	1404	1404	64	42	104	12	0	158
15070	9670s (+0.4s)	1484	1484	128	43	107	5	0	155
15071	9670s (+0.1s)	268	268	32	8	40	3	0	51
15072	9671s (+0.5s)	1528	1528	128	37	121	7	0	165
15073	9671s (+1.0s)	4128	4128	256	83	239	16	0	338
15074	9672s (+0.7s)	3076	3076	256	68	176	9	0	253
15075	9673s (+1.0s)	4404	4404	256	95	246	23	0	364
15076	9674s (+1.2s)	5828	5828	512	101	291	24	0	416
15077	9675s (+0.5s)	1540	1540	128	34	124	5	1	164
15078	9675s (+0.5s)	1508	1508	128	36	120	4	0	160
15079	9676s (+0.7s)	2632	2632	256	49	179	5	0	233
15080	9677s (+0.5s)	1660	1660	128	35	137	5	0	177
15081	9678s (+0.9s)	4028	4028	256	88	236	12	0	336
15082	9678s (+0.7s)	2740	2740	256	61	159	13	1	234
15083	9679s (+0.8s)	3516	3516	256	81	196	14	0	291
15084	9680s (+0.8s)	3368	3368	256	74	191	13	0	278
15085	9680s (+0.6s)	2292	2292	128	50	152	10	0	212
15086	9681s (+0.6s)	2448	2448	256	58	135	14	0	207
15087	9682s (+0.5s)	1912	1912	128	46	146	4	0	196
15088	9682s (+0.5s)	1580	1580	128	38	120	5	0	163
15089	9683s (+0.6s)	1944	1944	128	55	139	5	0	199
15090	9683s (+0.3s)	1096	1096	128	38	79	4	1	122
15091	9683s (+0.3s)	868	868	64	30	76	6	0	112
15092	9684s (+0.8s)	3288	3288	256	52	209	0	12	273
15093	9685s (+0.7s)	3216	3216	256	65	195	0	7	267
15094	9685s (+0.6s)	1868	1868	128	36	157	0	4	197
15095	9686s (+0.8s)	3508	3508	256	56	224	0	12	292
15096	9687s (+0.9s)	4060	4060	256	71	252	0	14	337
15097	9688s (+0.5s)	1724	1724	128	37	127	0	9	173
15098	9688s (+0.7s)	2796	2796	256	55	176	0	12	243
15099	9689s (+0.8s)	3452	3452	256	61	221	0	11	293
Episode	Time	Reward	Score	Highest	L	U	R	D	Steps
15100	9689s (+0.3s)	736	736	64	19	75	0	3	97
15101	9690s (+0.3s)	728	728	64	18	75	0	4	97
15102	9690s (+0.2s)	560	560	64	14	58	0	3	75
15103	9691s (+0.5s)	2248	2248	256	56	125	0	10	191
15104	9691s (+0.5s)	1780	1780	128	40	128	0	12	180
15105	9692s (+0.5s)	2192	2192	256	42	132	0	9	183
15106	9692s (+0.4s)	1364	1364	128	37	99	0	6	142
15107	9693s (+0.6s)	1916	1916	128	45	144	8	0	197
15108	9693s (+0.7s)	2796	2796	256	44	192	6	0	242
15109	9694s (+0.7s)	2924	2924	256	64	169	10	1	244
15110	9695s (+0.8s)	3256	3256	256	84	181	12	0	277
15111	9695s (+0.4s)	1052	1052	64	33	87	6	1	127
15112	9696s (+0.5s)	1692	1692	128	33	135	6	0	174
15113	9696s (+0.8s)	3604	3604	256	80	200	13	0	293
15114	9697s (+0.5s)	1760	1760	128	46	122	12	0	180
15115	9698s (+1.1s)	5572	5572	512	87	289	15	1	392
15116	9699s (+0.6s)	1904	1904	128	43	144	6	1	194
15117	9699s (+0.4s)	1568	1568	128	25	125	4	0	154
15118	9700s (+0.5s)	1776	1776	128	60	111	10	0	181
15119	9700s (+0.8s)	3180	3180	256	69	184	9	0	262
15120	9701s (+0.7s)	2780	2780	256	66	163	10	0	239
15121	9702s (+0.6s)	2032	2032	128	44	146	11	0	201
15122	9702s (+0.5s)	1872	1872	128	45	132	7	0	184
15123	9703s (+0.5s)	1552	1552	64	42	115	8	0	165
15124	9703s (+0.7s)	2704	2704	128	74	159	15	0	248
15125	9704s (+0.4s)	984	984	64	20	97	5	0	122
15126	9704s (+0.7s)	3052	3052	256	56	178	12	2	248
15127	9705s (+0.5s)	1708	1708	128	50	117	11	0	178
15128	9705s (+0.3s)	856	856	64	27	77	6	0	110
15129	9706s (+0.4s)	1480	1480	128	28	120	0	6	154
15130	9706s (+0.3s)	876	876	64	30	75	0	10	115
15131	9706s (+0.3s)	1020	1020	64	20	90	0	4	114
15132	9707s (+0.6s)	2168	2168	128	39	151	0	13	203
15133	9707s (+0.5s)	2100	2100	128	53	124	13	0	190
15134	9708s (+0.4s)	1408	1408	128	25	115	6	1	147
15135	9708s (+0.6s)	2104	2104	128	43	145	9	1	198
15136	9709s (+0.4s)	1448	1448	64	42	113	6	0	161
15137	9709s (+0.3s)	756	756	64	32	61	6	0	99
15138	9710s (+0.4s)	1296	1296	64	31	106	7	0	144
15139	9710s (+0.4s)	1388	1388	128	42	107	4	0	153
15140	9711s (+0.5s)	1600	1600	128	38	118	7	1	164
15141	9711s (+0.4s)	1292	1292	128	33	93	6	0	132
15142	9712s (+1.0s)	4208	4208	256	89	240	13	0	342
15143	9713s (+0.6s)	2504	2504	256	39	170	9	0	218
15144	9713s (+0.9s)	3640	3640	256	73	224	15	0	312
15145	9714s (+0.4s)	1552	1552	128	41	101	9	0	151
15146	9715s (+0.8s)	3416	3416	256	63	208	14	0	285
15147	9715s (+0.5s)	2224	2224	256	41	131	6	0	178
15148	9716s (+0.8s)	3204	3204	256	80	171	12	1	264
15149	9717s (+0.7s)	3164	3164	256	66	184	12	0	262
15150	9717s (+0.4s)	1496	1496	128	36	109	10	0	155
15151	9718s (+0.4s)	1240	1240	128	39	86	6	0	131
15152	9718s (+0.6s)	2436	2436	256	50	148	8	0	206
15153	9719s (+0.5s)	1840	1840	128	51	127	12	0	190
15154	9719s (+0.7s)	2768	2768	256	61	166	12	0	239
15155	9720s (+0.5s)	1840	1840	128	44	141	0	4	189
15156	9720s (+0.4s)	1484	1484	128	28	121	0	6	155
15157	9721s (+0.6s)	2656	2656	256	43	171	0	13	227
15158	9722s (+0.5s)	1920	1920	128	36	157	0	5	198
15159	9722s (+0.4s)	1084	1084	64	34	93	0	3	130
15160	9723s (+0.7s)	2768	2768	256	54	174	0	13	241
15161	9724s (+1.0s)	4248	4248	256	68	266	0	18	352
15162	9724s (+0.4s)	1032	1032	64	24	96	0	2	122
15163	9725s (+0.7s)	2972	2972	256	71	183	10	0	264
15164	9725s (+0.6s)	1900	1900	128	39	155	4	0	198
15165	9726s (+0.8s)	3500	3500	256	64	198	16	1	279
15166	9727s (+0.8s)	3368	3368	256	86	191	11	0	288
15167	9728s (+0.8s)	3324	3324	256	60	210	7	0	277
15168	9728s (+0.4s)	1352	1352	128	38	96	5	0	139
15169	9729s (+0.6s)	2596	2596	256	64	149	11	1	225
15170	9730s (+1.0s)	4184	4184	256	83	243	16	0	342
15171	9730s (+0.4s)	1500	1500	128	31	120	8	1	160
15172	9731s (+0.4s)	1124	1124	64	42	85	6	1	134
15173	9731s (+0.5s)	1684	1684	128	45	116	11	0	172
15174	9732s (+0.5s)	1632	1632	128	44	115	5	0	164
15175	9732s (+0.7s)	3124	3124	256	65	192	12	0	269
15176	9733s (+0.6s)	2608	2608	256	49	167	0	11	227
15177	9734s (+0.7s)	2904	2904	256	49	197	0	7	253
15178	9734s (+0.6s)	2332	2332	128	50	152	0	15	217
15179	9735s (+0.7s)	2912	2912	256	58	180	16	0	254
15180	9736s (+0.5s)	1724	1724	128	47	118	13	0	178
15181	9736s (+0.5s)	1580	1580	128	45	109	9	0	163
15182	9736s (+0.5s)	1508	1508	128	39	114	7	0	160
15183	9737s (+0.7s)	2748	2748	128	77	156	21	0	254
15184	9738s (+1.2s)	5852	5852	512	100	299	19	0	418
15185	9739s (+1.0s)	4328	4328	256	91	253	16	0	360
15186	9740s (+0.7s)	2856	2856	256	73	160	12	0	245
15187	9740s (+0.4s)	1176	1176	64	34	89	8	0	131
15188	9741s (+0.4s)	1152	1152	64	34	98	3	0	135
15189	9742s (+0.7s)	2704	2704	256	59	166	10	0	235
15190	9742s (+0.5s)	1696	1696	128	38	132	6	0	176
15191	9743s (+0.7s)	2792	2792	256	59	161	13	2	235
15192	9743s (+0.5s)	1572	1572	128	41	123	7	0	171
15193	9744s (+1.0s)	4228	4228	256	86	243	18	0	347
15194	9745s (+1.1s)	5420	5420	512	95	267	19	0	381
15195	9746s (+0.3s)	700	700	64	24	65	4	0	93
15196	9746s (+0.3s)	880	880	64	23	87	5	0	115
15197	9747s (+0.7s)	2904	2904	256	64	178	11	0	253
15198	9747s (+0.6s)	2548	2548	256	40	164	8	0	212
15199	9748s (+0.6s)	2504	2504	256	55	156	7	0	218
Episode	Time	Reward	Score	Highest	L	U	R	D	Steps
15200	9749s (+0.7s)	2972	2972	256	60	178	6	0	244
15201	9749s (+0.4s)	1444	1444	128	35	109	3	0	147
15202	9750s (+1.2s)	5716	5716	512	95	289	20	0	404
15203	9751s (+0.3s)	1076	1076	128	27	86	4	0	117
15204	9751s (+0.7s)	2540	2540	128	67	160	10	1	238
15205	9752s (+0.6s)	2444	2444	256	39	158	13	0	210
15206	9753s (+0.7s)	2740	2740	256	64	157	10	1	232
15207	9753s (+0.4s)	1192	1192	64	23	108	3	0	134
15208	9753s (+0.3s)	932	932	64	28	79	0	5	112
15209	9754s (+0.4s)	1388	1388	128	45	92	0	7	144
15210	9754s (+0.6s)	2488	2488	256	41	163	0	5	209
15211	9755s (+1.2s)	6020	6020	512	132	265	26	0	423
15212	9756s (+0.3s)	864	864	64	32	74	6	0	112
15213	9756s (+0.5s)	1788	1788	128	57	116	9	0	182
15214	9757s (+0.3s)	1132	1132	128	26	89	3	2	120
15215	9758s (+1.1s)	5308	5308	512	90	270	13	1	374
15216	9759s (+0.8s)	3396	3396	256	98	169	17	0	284
15217	9759s (+0.6s)	2584	2584	256	50	158	14	0	222
15218	9760s (+0.5s)	1748	1748	128	46	121	10	0	177
15219	9760s (+0.8s)	3188	3188	256	73	178	14	0	265
15220	9761s (+0.6s)	1880	1880	128	38	146	10	0	194
15221	9762s (+0.8s)	3444	3444	256	87	188	17	0	292
15222	9762s (+0.5s)	1924	1924	128	37	142	10	1	190
15223	9763s (+0.5s)	2416	2416	256	52	140	9	0	201
15224	9764s (+1.0s)	4092	4092	256	104	216	20	1	341
15225	9764s (+0.5s)	1484	1484	64	48	107	11	0	166
15226	9765s (+0.9s)	4016	4016	256	78	236	23	1	338
15227	9766s (+0.5s)	1924	1924	128	44	144	8	0	196
15228	9767s (+0.8s)	3308	3308	256	79	185	14	0	278
15229	9767s (+0.4s)	1068	1068	64	32	91	3	0	126
15230	9768s (+0.7s)	2756	2756	256	53	176	7	1	237
15231	9768s (+0.5s)	1792	1792	128	48	127	11	1	187
15232	9769s (+0.6s)	2560	2560	256	60	156	9	0	225
15233	9770s (+1.4s)	6868	6868	512	141	325	29	0	495
15234	9772s (+1.4s)	6896	6896	512	155	327	24	0	506
15235	9772s (+0.5s)	1712	1712	128	42	124	7	1	174
15236	9773s (+0.9s)	4192	4192	256	70	235	17	1	323
15237	9774s (+0.7s)	3160	3160	256	57	190	11	0	258
15238	9775s (+0.6s)	2728	2728	256	50	175	7	0	232
15239	9775s (+0.7s)	2952	2952	256	52	184	8	0	244
15240	9776s (+0.9s)	4032	4032	256	87	224	19	0	330
15241	9777s (+0.6s)	2152	2152	128	58	141	13	0	212
15242	9777s (+0.4s)	1392	1392	128	38	104	6	0	148
15243	9778s (+0.6s)	2508	2508	256	39	177	3	0	219
15244	9779s (+0.7s)	2860	2860	256	75	154	16	1	246
15245	9779s (+0.8s)	3576	3576	256	67	219	11	0	297
15246	9780s (+0.3s)	1024	1024	64	31	86	7	0	124
15247	9780s (+0.3s)	584	584	32	27	58	5	0	90
15248	9781s (+0.5s)	1752	1752	128	47	118	10	0	175
15249	9782s (+1.0s)	4104	4104	256	88	232	14	0	334
15250	9782s (+0.3s)	812	812	64	23	76	5	0	104
15251	9782s (+0.2s)	556	556	32	16	61	0	6	83
15252	9783s (+0.7s)	3004	3004	256	54	175	0	12	241
15253	9784s (+0.7s)	3220	3220	256	57	192	0	13	262
15254	9785s (+0.9s)	4776	4776	512	68	250	0	14	332
15255	9785s (+0.6s)	1908	1908	128	34	154	0	8	196
15256	9786s (+0.5s)	2200	2200	256	32	140	0	5	177
15257	9786s (+0.7s)	2848	2848	256	57	175	13	0	245
15258	9787s (+0.8s)	4520	4520	512	68	214	14	0	296
15259	9788s (+0.7s)	2856	2856	256	59	173	12	1	245
15260	9789s (+0.7s)	2552	2552	128	72	152	14	0	238
15261	9789s (+0.8s)	3384	3384	256	74	195	12	0	281
15262	9790s (+0.6s)	2080	2080	128	56	133	10	1	200
15263	9791s (+0.7s)	2780	2780	128	72	156	15	1	244
15264	9792s (+0.9s)	3668	3668	256	54	245	0	15	314
15265	9792s (+0.5s)	1820	1820	128	33	151	0	6	190
15266	9793s (+0.5s)	1736	1736	128	44	119	0	13	176
15267	9793s (+0.3s)	788	788	64	18	80	0	4	102
15268	9793s (+0.5s)	2132	2132	256	40	136	4	1	181
15269	9794s (+0.7s)	2832	2832	256	73	154	16	0	243
15270	9795s (+0.8s)	3396	3396	256	75	205	10	0	290
15271	9796s (+0.7s)	2920	2920	256	44	194	11	0	249
15272	9796s (+0.3s)	936	936	64	38	76	4	0	118
15273	9797s (+0.7s)	3112	3112	256	64	179	15	0	258
15274	9797s (+0.5s)	1740	1740	128	29	139	7	0	175
15275	9798s (+0.4s)	1236	1236	128	29	100	7	0	136
15276	9798s (+0.7s)	2808	2808	256	52	184	9	0	245
15277	9799s (+0.4s)	1408	1408	128	33	105	7	0	145
15278	9799s (+0.6s)	2160	2160	128	48	144	9	0	201
15279	9800s (+0.4s)	1292	1292	128	37	98	8	0	143
15280	9801s (+1.0s)	4200	4200	256	91	238	16	0	345
15281	9801s (+0.6s)	2460	2460	256	39	157	11	1	208
15282	9802s (+0.8s)	3228	3228	256	51	207	11	1	270
15283	9803s (+0.8s)	3340	3340	256	92	162	18	1	273
15284	9804s (+0.9s)	3800	3800	256	81	224	15	0	320
15285	9804s (+0.6s)	2236	2236	128	52	147	15	0	214
15286	9805s (+0.8s)	3428	3428	256	76	196	16	0	288
15287	9806s (+0.5s)	1584	1584	128	49	106	9	0	164
15288	9806s (+0.4s)	1172	1172	64	45	85	10	0	140
15289	9807s (+0.8s)	2812	2812	128	96	155	14	0	265
15290	9808s (+0.8s)	3324	3324	256	76	195	11	0	282
15291	9808s (+0.4s)	1380	1380	128	45	94	6	0	145
15292	9809s (+0.4s)	1480	1480	128	36	112	7	0	155
15293	9809s (+0.4s)	1356	1356	128	32	102	6	0	140
15294	9810s (+0.6s)	2644	2644	256	59	151	11	0	221
15295	9810s (+0.4s)	1424	1424	128	38	102	5	0	145
15296	9811s (+0.6s)	1924	1924	128	45	138	10	0	193
15297	9811s (+0.6s)	2560	2560	256	51	162	7	0	220
15298	9812s (+0.4s)	1236	1236	64	45	82	13	1	141
15299	9812s (+0.3s)	768	768	64	24	77	3	0	104
Episode	Time	Reward	Score	Highest	L	U	R	D	Steps
15300	9813s (+0.6s)	1900	1900	128	47	142	6	0	195
15301	9814s (+1.0s)	4316	4316	256	85	254	17	1	357
15302	9815s (+1.4s)	7016	7016	512	127	337	21	0	485
15303	9816s (+0.8s)	3224	3224	256	68	192	8	0	268
15304	9816s (+0.3s)	1024	1024	128	31	73	5	1	110
15305	9817s (+0.5s)	1808	1808	128	38	140	0	9	187
15306	9818s (+0.8s)	3248	3248	256	50	217	0	8	275
15307	9818s (+0.8s)	3364	3364	256	62	214	0	11	287
15308	9819s (+0.6s)	2576	2576	256	43	160	0	12	215
15309	9820s (+0.6s)	2628	2628	256	43	175	0	13	231
15310	9820s (+0.5s)	1884	1884	128	35	131	0	11	177
15311	9821s (+0.6s)	2588	2588	256	53	159	0	12	224
15312	9822s (+0.7s)	2808	2808	256	60	181	0	4	245
15313	9822s (+0.8s)	3180	3180	256	44	216	8	0	268
15314	9823s (+0.7s)	2912	2912	256	57	185	12	0	254
15315	9824s (+0.8s)	3176	3176	256	69	193	16	0	278
15316	9825s (+0.6s)	2180	2180	128	54	156	10	0	220
15317	9825s (+0.3s)	772	772	64	29	67	4	1	101
15318	9825s (+0.5s)	1728	1728	128	31	136	7	0	174
15319	9826s (+0.9s)	3848	3848	256	76	218	20	1	315
15320	9827s (+0.5s)	1892	1892	128	56	116	11	0	183
15321	9827s (+0.5s)	1868	1868	128	39	140	0	8	187
15322	9828s (+0.9s)	3864	3864	256	59	241	0	17	317
15323	9828s (+0.3s)	788	788	64	17	77	0	6	100
15324	9829s (+0.7s)	2972	2972	256	42	194	0	5	241
15325	9830s (+1.0s)	4488	4488	256	89	258	17	0	364
15326	9832s (+1.5s)	7432	7432	512	132	366	22	0	520
15327	9832s (+0.3s)	1136	1136	128	27	90	5	0	122
15328	9833s (+0.9s)	3992	3992	256	77	244	11	0	332
15329	9834s (+0.8s)	3524	3524	256	64	214	14	0	292
15330	9835s (+0.9s)	3796	3796	256	82	227	11	0	320
15331	9835s (+0.3s)	580	580	32	21	59	5	1	86
15332	9836s (+0.9s)	4012	4012	256	91	220	19	0	330
15333	9837s (+0.7s)	3056	3056	256	69	168	14	0	251
15334	9838s (+0.7s)	2908	2908	256	50	180	10	0	240
15335	9838s (+0.5s)	1708	1708	128	43	128	7	0	178
15336	9839s (+0.5s)	1528	1528	128	31	126	8	0	165
15337	9839s (+0.1s)	256	256	32	7	43	1	0	51
15338	9840s (+0.9s)	4464	4464	512	75	222	11	0	308
15339	9840s (+0.7s)	3084	3084	256	57	190	8	0	255
15340	9841s (+0.5s)	1756	1756	128	47	127	5	0	179
15341	9841s (+0.3s)	1200	1200	128	30	91	1	0	122
15342	9842s (+0.5s)	1564	1564	128	33	122	8	0	163
15343	9842s (+0.3s)	908	908	64	31	78	8	0	117
15344	9842s (+0.2s)	492	492	64	10	59	1	0	70
15345	9843s (+0.6s)	1964	1964	128	56	141	7	0	204
15346	9843s (+0.3s)	896	896	64	33	71	5	1	110
15347	9844s (+0.5s)	1796	1796	128	49	125	10	1	185
15348	9845s (+0.8s)	3332	3332	256	68	198	14	0	280
15349	9845s (+0.5s)	2316	2316	256	37	156	10	0	203
15350	9846s (+0.7s)	3124	3124	256	57	186	12	1	256
15351	9847s (+0.8s)	3308	3308	256	73	193	12	0	278
15352	9847s (+0.4s)	1328	1328	128	29	105	3	0	137
15353	9848s (+0.7s)	2716	2716	256	52	171	8	0	231
15354	9848s (+0.4s)	1296	1296	128	28	97	6	0	131
15355	9849s (+0.7s)	2656	2656	256	47	166	13	0	226
15356	9850s (+1.2s)	5848	5848	512	114	292	16	0	422
15357	9851s (+0.5s)	1616	1616	128	53	110	8	0	171
15358	9851s (+0.6s)	2544	2544	128	64	163	9	0	236
15359	9852s (+0.6s)	2440	2440	128	48	167	10	1	226
15360	9852s (+0.4s)	1048	1048	64	20	103	3	0	126
15361	9853s (+0.6s)	2140	2140	128	52	143	8	0	203
15362	9854s (+0.8s)	3212	3212	256	81	169	15	2	267
15363	9854s (+0.8s)	3568	3568	256	59	217	14	0	290
15364	9855s (+0.5s)	1880	1880	128	55	124	6	0	185
15365	9855s (+0.5s)	1808	1808	128	47	133	6	1	187
15366	9856s (+0.7s)	2908	2908	256	49	186	5	0	240
15367	9857s (+0.4s)	1496	1496	128	47	103	8	0	158
15368	9857s (+0.7s)	2944	2944	256	55	185	8	0	248
15369	9858s (+0.5s)	1616	1616	128	36	122	3	0	161
15370	9859s (+0.7s)	2976	2976	256	70	183	12	0	265
15371	9859s (+0.8s)	3256	3256	256	64	204	9	0	277
15372	9860s (+0.3s)	716	716	64	28	68	3	0	99
15373	9860s (+0.6s)	2180	2180	128	45	150	9	1	205
15374	9861s (+0.5s)	1720	1720	128	40	128	8	1	177
15375	9861s (+0.3s)	764	764	64	23	77	3	0	103
15376	9861s (+0.4s)	1360	1360	128	29	109	3	0	141
15377	9862s (+0.2s)	556	556	64	22	55	4	0	81
15378	9862s (+0.4s)	1120	1120	64	29	96	0	3	128
15379	9863s (+0.7s)	2580	2580	256	51	158	0	13	222
15380	9863s (+0.4s)	1496	1496	128	31	117	0	9	157
15381	9864s (+0.7s)	2752	2752	256	41	180	0	12	233
15382	9865s (+0.8s)	3236	3236	256	56	208	0	12	276
15383	9865s (+0.8s)	3576	3576	256	93	178	24	2	297
15384	9866s (+0.6s)	2676	2676	256	55	164	10	0	229
15385	9867s (+0.5s)	2196	2196	256	42	140	8	0	190
15386	9867s (+0.8s)	3632	3632	256	72	222	16	0	310
15387	9868s (+0.7s)	2788	2788	256	56	170	14	1	241
15388	9869s (+0.6s)	2636	2636	256	49	163	12	0	224
15389	9870s (+1.1s)	5292	5292	512	72	281	0	17	370
15390	9870s (+0.6s)	2236	2236	128	45	159	0	10	214
15391	9871s (+0.7s)	2636	2636	256	54	167	0	13	234
15392	9872s (+0.8s)	3488	3488	256	76	199	20	0	295
15393	9872s (+0.4s)	1496	1496	128	37	116	5	0	158
15394	9873s (+0.3s)	668	668	32	20	72	4	0	96
15395	9873s (+0.4s)	1040	1040	64	28	90	6	0	124
15396	9874s (+0.5s)	1804	1804	128	46	128	0	8	182
15397	9874s (+0.3s)	800	800	64	17	80	0	5	102
15398	9874s (+0.5s)	1536	1536	128	34	123	0	6	163
15399	9875s (+0.4s)	1356	1356	128	26	113	0	2	141
Episode	Time	Reward	Score	Highest	L	U	R	D	Steps
15400	9875s (+0.4s)	1472	1472	128	28	117	0	12	157
15401	9877s (+1.4s)	6680	6680	512	101	352	0	27	480
15402	9878s (+0.9s)	3504	3504	256	56	233	0	13	302
15403	9878s (+0.2s)	572	572	64	11	62	0	5	78
15404	9878s (+0.7s)	2800	2800	256	51	179	0	12	242
15405	9879s (+0.2s)	556	556	32	21	61	0	2	84
15406	9879s (+0.3s)	904	904	64	26	86	5	0	117
15407	9880s (+0.5s)	1752	1752	128	38	127	12	0	177
15408	9880s (+0.6s)	2168	2168	128	68	139	13	0	220
15409	9881s (+0.7s)	2940	2940	256	72	175	9	0	256
15410	9881s (+0.5s)	1740	1740	128	41	127	7	0	175
15411	9882s (+0.9s)	3536	3536	256	86	201	11	0	298
15412	9883s (+0.8s)	3388	3388	256	58	206	16	0	280
15413	9884s (+0.7s)	2804	2804	256	68	159	14	0	241
15414	9884s (+0.5s)	1492	1492	128	36	116	6	0	158
15415	9885s (+0.7s)	3084	3084	256	64	176	11	0	251
15416	9886s (+0.9s)	3568	3568	256	75	222	9	0	306
15417	9887s (+0.7s)	2792	2792	256	59	168	13	0	240
15418	9887s (+0.8s)	3080	3080	256	74	179	11	0	264
15419	9888s (+0.9s)	3924	3924	256	83	223	14	0	320
15420	9889s (+0.6s)	2400	2400	256	53	140	10	0	203
15421	9889s (+0.6s)	2460	2460	256	53	143	12	0	208
15422	9890s (+0.4s)	1448	1448	128	47	98	6	0	151
15423	9891s (+1.1s)	5440	5440	512	105	256	20	0	381
15424	9892s (+0.7s)	2716	2716	256	56	169	9	0	234
15425	9892s (+0.8s)	3488	3488	256	69	211	11	0	291
15426	9893s (+0.6s)	2540	2540	256	44	167	10	0	221
15427	9893s (+0.3s)	828	828	64	23	84	3	0	110
15428	9894s (+0.6s)	2664	2664	256	47	161	12	0	220
15429	9894s (+0.4s)	1296	1296	128	32	99	5	0	136
15430	9895s (+0.9s)	3856	3856	256	83	218	14	0	315
15431	9896s (+0.3s)	1052	1052	128	26	82	2	0	110
15432	9896s (+0.6s)	2620	2620	256	65	138	14	0	217
15433	9897s (+0.5s)	1628	1628	128	35	120	9	0	164
15434	9897s (+0.4s)	1196	1196	128	34	90	7	0	131
15435	9898s (+0.5s)	1668	1668	128	43	130	6	0	179
15436	9898s (+0.3s)	992	992	64	28	82	7	0	117
15437	9899s (+0.5s)	1936	1936	128	42	133	12	1	188
15438	9899s (+0.4s)	1228	1228	128	32	87	7	0	126
15439	9900s (+0.8s)	3380	3380	256	75	203	13	0	291
15440	9900s (+0.6s)	2612	2612	256	55	162	11	0	228
15441	9901s (+0.9s)	3568	3568	256	79	206	15	1	301
15442	9902s (+1.0s)	4336	4336	256	103	240	20	0	363
15443	9903s (+0.4s)	1452	1452	128	24	120	0	8	152
15444	9903s (+0.4s)	1268	1268	128	41	92	0	3	136
15445	9904s (+0.5s)	1564	1564	128	30	126	0	6	162
15446	9904s (+0.5s)	2064	2064	128	39	144	0	11	194
15447	9905s (+0.4s)	1344	1344	128	34	98	0	6	138
15448	9905s (+0.5s)	1720	1720	128	33	141	3	0	177
15449	9905s (+0.3s)	1252	1252	128	19	101	3	0	123
15450	9907s (+1.2s)	6160	6160	512	131	275	26	0	432
15451	9907s (+0.4s)	1124	1124	64	35	93	5	0	133
15452	9907s (+0.2s)	576	576	64	16	57	5	0	78
15453	9908s (+0.7s)	3220	3220	256	81	177	10	0	268
15454	9909s (+0.8s)	3408	3408	256	60	211	12	0	283
15455	9909s (+0.6s)	1932	1932	128	38	155	8	0	201
15456	9910s (+0.4s)	1460	1460	128	29	119	0	5	153
15457	9910s (+0.6s)	1920	1920	128	47	139	0	12	198
15458	9912s (+1.2s)	5684	5684	512	92	292	0	20	404
15459	9912s (+0.8s)	3216	3216	256	68	192	1	8	269
15460	9913s (+0.7s)	3088	3088	256	60	180	0	16	256
15461	9914s (+0.5s)	2276	2276	256	40	149	0	5	194
15462	9915s (+0.9s)	3916	3916	256	60	249	0	10	319
15463	9915s (+0.5s)	1520	1520	128	35	123	1	5	164
15464	9916s (+0.6s)	2516	2516	256	38	170	0	8	216
15465	9916s (+0.9s)	3536	3536	256	57	227	0	14	298
15466	9917s (+0.9s)	3596	3596	256	57	230	0	14	301
15467	9918s (+0.3s)	1072	1072	128	16	93	0	3	112
15468	9918s (+0.7s)	2920	2920	256	53	178	0	14	245
15469	9919s (+0.7s)	3164	3164	256	54	190	16	0	260
15470	9920s (+0.8s)	3448	3448	256	73	203	12	0	288
15471	9920s (+0.4s)	1460	1460	128	47	98	11	0	156
15472	9921s (+0.6s)	2528	2528	256	57	144	15	0	216
15473	9922s (+0.6s)	2800	2800	256	50	168	10	0	228
15474	9922s (+0.8s)	3436	3436	256	62	209	12	0	283
15475	9924s (+1.1s)	4704	4704	256	104	276	17	0	397
15476	9924s (+0.7s)	3012	3012	256	56	183	13	0	252
15477	9925s (+0.8s)	3572	3572	256	73	214	9	0	296
15478	9926s (+0.6s)	2140	2140	128	58	138	14	0	210
15479	9926s (+0.5s)	1840	1840	128	50	131	7	0	188
15480	9927s (+0.6s)	1920	1920	128	40	151	7	0	198
15481	9927s (+0.5s)	1728	1728	128	36	128	8	0	172
15482	9928s (+0.3s)	1160	1160	128	34	83	6	0	123
15483	9928s (+0.4s)	1360	1360	128	44	93	4	0	141
15484	9929s (+0.6s)	2548	2548	256	46	172	7	0	225
15485	9929s (+0.5s)	1520	1520	128	40	111	8	0	159
15486	9930s (+0.8s)	3280	3280	256	71	189	14	1	275
15487	9930s (+0.4s)	1300	1300	128	36	96	8	0	140
15488	9931s (+0.6s)	2668	2668	256	44	174	8	1	227
15489	9932s (+0.9s)	3672	3672	256	88	197	18	2	305
15490	9933s (+0.8s)	3316	3316	256	68	197	10	1	276
15491	9933s (+0.4s)	1472	1472	128	36	112	7	0	155
15492	9934s (+0.7s)	3096	3096	256	66	182	7	0	255
15493	9934s (+0.3s)	764	764	64	37	58	3	1	99
15494	9935s (+0.8s)	3484	3484	256	84	200	12	0	296
15495	9936s (+0.8s)	3660	3660	256	73	209	15	0	297
15496	9937s (+0.6s)	2628	2628	256	41	170	10	0	221
15497	9937s (+0.4s)	1228	1228	64	41	104	4	0	149
15498	9938s (+0.7s)	3008	3008	256	58	186	8	0	252
15499	9939s (+0.7s)	2932	2932	256	65	186	8	0	259
Episode	Time	Reward	Score	Highest	L	U	R	D	Steps
15500	9939s (+0.5s)	1864	1864	128	46	134	9	0	189
15501	9939s (+0.4s)	1320	1320	64	38	105	7	0	150
15502	9941s (+1.6s)	7760	7760	512	138	369	39	0	546
15503	9942s (+0.4s)	1476	1476	128	37	108	8	0	153
15504	9942s (+0.4s)	1232	1232	128	32	93	6	0	131
15505	9943s (+0.7s)	3004	3004	256	51	178	14	0	243
15506	9944s (+0.7s)	2792	2792	256	52	181	9	0	242
15507	9944s (+0.6s)	1880	1880	128	52	128	13	0	193
15508	9945s (+0.6s)	2476	2476	256	50	152	9	0	211
15509	9945s (+0.5s)	1884	1884	128	39	150	6	0	195
15510	9946s (+0.8s)	3536	3536	256	86	195	15	0	296
15511	9947s (+0.7s)	3140	3140	256	50	201	10	0	261
15512	9948s (+0.8s)	3360	3360	256	58	209	11	0	278
15513	9948s (+0.4s)	1400	1400	128	32	110	8	0	150
15514	9949s (+0.4s)	1336	1336	64	43	104	7	0	154
15515	9949s (+0.7s)	2720	2720	256	56	161	14	1	232
15516	9950s (+0.4s)	1160	1160	64	34	88	5	1	128
15517	9950s (+0.6s)	2524	2524	256	43	167	12	0	222
15518	9951s (+0.6s)	2532	2532	256	56	157	11	0	224
15519	9951s (+0.4s)	1424	1424	128	34	112	5	0	151
15520	9952s (+0.5s)	1600	1600	128	38	119	10	0	167
15521	9952s (+0.3s)	816	816	64	25	70	4	0	99
15522	9952s (+0.4s)	1284	1284	128	31	103	8	0	142
15523	9953s (+0.6s)	2296	2296	256	51	140	7	0	198
15524	9954s (+0.5s)	1808	1808	128	50	125	8	0	183
15525	9954s (+0.8s)	3456	3456	256	76	203	0	11	290
15526	9955s (+0.6s)	1924	1924	128	40	151	0	8	199
15527	9955s (+0.4s)	1384	1384	128	29	110	0	4	143
15528	9956s (+0.6s)	2508	2508	256	45	165	0	8	218
15529	9957s (+0.7s)	2848	2848	256	71	163	14	0	248
15530	9957s (+0.7s)	3124	3124	256	69	178	14	0	261
15531	9958s (+0.7s)	2880	2880	256	57	183	8	0	248
15532	9959s (+0.7s)	2864	2864	256	75	161	11	0	247
15533	9959s (+0.5s)	1844	1844	128	42	136	6	0	184
15534	9960s (+0.3s)	780	780	64	23	75	4	1	103
15535	9961s (+0.9s)	3956	3956	256	79	229	19	0	327
15536	9961s (+0.4s)	1496	1496	128	47	102	7	0	156
15537	9962s (+0.8s)	3596	3596	256	65	207	15	0	287
15538	9963s (+1.0s)	4872	4872	512	84	247	14	0	345
15539	9964s (+0.8s)	3132	3132	256	74	182	13	0	269
15540	9964s (+0.5s)	1660	1660	128	46	112	9	0	167
15541	9965s (+0.4s)	1124	1124	64	31	94	5	0	130
15542	9966s (+1.0s)	4300	4300	256	86	249	19	0	354
15543	9966s (+0.8s)	3364	3364	256	75	203	9	0	287
15544	9967s (+0.5s)	1820	1820	128	45	134	10	1	190
15545	9968s (+0.8s)	3240	3240	256	60	202	11	0	273
15546	9969s (+0.8s)	3308	3308	256	70	206	9	0	285
15547	9969s (+0.5s)	1576	1576	128	58	95	10	0	163
15548	9970s (+0.4s)	1276	1276	64	43	107	6	0	156
15549	9970s (+0.6s)	2464	2464	256	49	159	7	0	215
15550	9971s (+0.6s)	1900	1900	128	49	134	10	0	193
15551	9971s (+0.5s)	1668	1668	128	30	134	4	0	168
15552	9972s (+0.8s)	3348	3348	256	61	204	18	0	283
15553	9973s (+0.5s)	1764	1764	128	43	135	5	0	183
15554	9973s (+0.4s)	1476	1476	128	32	117	4	0	153
15555	9973s (+0.5s)	1632	1632	128	44	112	9	0	165
15556	9974s (+0.5s)	1664	1664	128	44	112	11	1	168
15557	9974s (+0.5s)	1792	1792	128	54	111	11	0	176
15558	9975s (+0.6s)	2300	2300	256	38	149	6	0	193
15559	9976s (+0.6s)	2472	2472	256	41	160	0	10	211
15560	9976s (+0.5s)	1672	1672	128	34	129	0	7	170
15561	9977s (+0.7s)	2920	2920	256	54	179	0	9	242
15562	9977s (+0.6s)	2332	2332	256	42	143	0	11	196
15563	9978s (+0.5s)	1656	1656	128	27	141	2	0	170
15564	9979s (+0.7s)	2752	2752	256	52	179	4	0	235
15565	9979s (+0.4s)	1432	1432	128	19	126	1	0	146
15566	9980s (+0.7s)	3012	3012	256	54	181	8	0	243
15567	9980s (+0.3s)	860	860	64	32	72	7	0	111
15568	9981s (+1.0s)	4056	4056	256	91	232	13	0	336
15569	9981s (+0.5s)	1756	1756	128	43	125	0	8	176
15570	9982s (+0.6s)	2488	2488	256	40	167	0	11	218
15571	9983s (+1.1s)	5384	5384	512	96	257	25	0	378
15572	9984s (+0.6s)	2076	2076	128	65	129	16	0	210
15573	9984s (+0.5s)	1936	1936	128	60	114	13	1	188
15574	9985s (+0.5s)	1592	1592	128	39	129	4	0	172
15575	9985s (+0.6s)	2144	2144	128	57	145	14	0	216
15576	9986s (+0.7s)	2852	2852	256	56	171	9	0	236
15577	9987s (+0.8s)	3336	3336	256	73	199	8	1	281
15578	9987s (+0.3s)	1116	1116	128	22	90	0	5	117
15579	9988s (+0.9s)	3564	3564	256	59	233	0	13	305
15580	9989s (+0.4s)	1360	1360	128	25	106	3	0	134
15581	9989s (+0.2s)	608	608	64	19	62	2	1	84
15582	9989s (+0.5s)	1600	1600	128	41	121	5	0	167
15583	9990s (+0.7s)	2916	2916	256	64	167	10	0	241
15584	9991s (+0.8s)	3584	3584	256	54	243	0	8	305
15585	9991s (+0.3s)	1124	1124	128	31	85	0	8	124
15586	9992s (+0.8s)	3628	3628	256	83	193	19	0	295
15587	9992s (+0.4s)	1296	1296	64	37	102	4	1	144
15588	9993s (+0.9s)	3640	3640	256	80	211	17	0	308
15589	9994s (+0.7s)	3156	3156	256	59	189	13	0	261
15590	9995s (+0.6s)	1932	1932	128	50	141	10	0	201
15591	9995s (+0.5s)	1648	1648	128	36	121	8	0	165
15592	9996s (+0.4s)	1380	1380	128	25	113	0	9	147
15593	9996s (+0.4s)	1408	1408	128	29	110	0	7	146
15594	9996s (+0.4s)	1168	1168	64	34	98	0	7	139
15595	9997s (+0.5s)	1672	1672	128	32	131	0	7	170
15596	9997s (+0.5s)	1912	1912	128	49	140	7	0	196
15597	9998s (+0.9s)	3800	3800	256	105	196	19	0	320
15598	10000s (+1.6s)	8472	8472	512	166	384	31	0	581
15599	10000s (+0.5s)	1484	1484	128	30	115	10	0	155
Episode	Time	Reward	Score	Highest	L	U	R	D	Steps
15600	10001s (+0.7s)	2776	2776	256	58	170	9	0	237
15601	10002s (+0.5s)	1604	1604	128	39	123	6	0	168
15602	10003s (+1.0s)	4236	4236	256	94	232	23	0	349
15603	10003s (+0.6s)	2312	2312	128	72	133	15	0	220
15604	10004s (+0.8s)	3436	3436	256	67	215	7	0	289
15605	10005s (+0.6s)	2704	2704	256	64	156	8	0	228
15606	10005s (+0.5s)	1604	1604	128	40	125	3	0	168
15607	10006s (+0.5s)	1976	1976	128	42	143	11	0	196
15608	10006s (+0.6s)	2160	2160	128	45	147	8	0	200
15609	10007s (+0.9s)	3632	3632	256	83	207	20	0	310
15610	10008s (+0.6s)	2844	2844	256	54	165	9	0	228
15611	10009s (+0.8s)	3512	3512	256	59	212	13	0	284
15612	10009s (+0.4s)	1424	1424	128	32	112	7	0	151
15613	10010s (+0.5s)	1608	1608	128	40	118	10	0	168
15614	10010s (+0.6s)	2644	2644	256	42	184	0	9	235
15615	10011s (+0.7s)	2788	2788	256	42	189	0	9	240
15616	10012s (+0.9s)	3936	3936	256	64	245	0	14	323
15617	10013s (+0.7s)	3148	3148	256	57	188	0	11	256
15618	10013s (+0.7s)	3276	3276	256	73	173	0	15	261
15619	10014s (+0.5s)	1792	1792	128	33	126	0	9	168
15620	10014s (+0.4s)	1408	1408	128	27	119	0	2	148
15621	10015s (+0.7s)	2620	2620	256	48	176	0	6	230
15622	10016s (+0.9s)	4044	4044	256	71	240	0	19	330
15623	10017s (+0.9s)	3852	3852	256	66	238	0	10	314
15624	10018s (+1.3s)	6256	6256	512	107	313	23	0	443
15625	10019s (+0.6s)	1916	1916	128	56	135	6	0	197
15626	10019s (+0.8s)	3396	3396	256	77	201	12	0	290
15627	10020s (+0.8s)	3412	3412	256	63	201	13	0	277
15628	10021s (+0.5s)	1488	1488	128	35	116	5	0	156
15629	10021s (+0.7s)	3136	3136	256	71	175	10	0	256
15630	10022s (+0.5s)	1884	1884	128	33	153	8	0	194
15631	10023s (+0.7s)	2952	2952	256	45	179	11	0	235
15632	10023s (+0.7s)	3096	3096	256	52	197	7	0	256
15633	10024s (+0.5s)	1572	1572	128	36	123	5	1	165
15634	10024s (+0.3s)	848	848	64	27	72	9	0	108
15635	10026s (+1.4s)	7268	7268	512	130	341	29	0	500
15636	10026s (+0.5s)	1664	1664	128	37	122	9	0	168
15637	10026s (+0.4s)	1396	1396	128	23	120	3	0	146
15638	10027s (+0.7s)	3224	3224	256	75	180	14	0	269
15639	10028s (+0.5s)	1740	1740	128	43	124	7	0	174
15640	10029s (+0.9s)	3516	3516	256	76	199	23	0	298
15641	10029s (+0.8s)	3340	3340	256	59	210	13	0	282
15642	10030s (+1.0s)	4424	4424	256	99	246	19	0	364
15643	10031s (+0.9s)	3660	3660	256	86	211	15	0	312
15644	10032s (+0.4s)	1516	1516	128	26	120	6	0	152
15645	10032s (+0.5s)	2200	2200	256	49	129	12	0	190
15646	10033s (+0.7s)	2760	2760	256	57	165	12	1	235
15647	10034s (+0.6s)	2520	2520	128	59	159	17	0	235
15648	10034s (+0.5s)	1756	1756	128	43	121	14	0	178
15649	10035s (+0.5s)	1800	1800	128	43	133	9	0	185
15650	10035s (+0.8s)	3336	3336	256	71	195	15	0	281
15651	10036s (+0.5s)	1764	1764	128	48	121	10	0	179
15652	10036s (+0.2s)	512	512	64	12	59	3	0	74
15653	10037s (+0.4s)	1468	1468	128	31	115	5	0	151
15654	10037s (+0.5s)	1588	1588	128	32	128	0	8	168
15655	10038s (+0.5s)	1820	1820	128	31	148	0	8	187
15656	10038s (+0.5s)	2360	2360	256	35	158	0	6	199
15657	10039s (+0.9s)	3964	3964	256	58	253	0	14	325
15658	10040s (+0.5s)	1768	1768	128	41	131	9	0	181
15659	10040s (+0.4s)	1452	1452	128	32	117	3	0	152
15660	10041s (+0.9s)	4200	4200	256	88	233	20	0	341
15661	10042s (+0.6s)	2340	2340	256	49	149	6	0	204
15662	10042s (+0.8s)	3380	3380	256	81	197	13	0	291
15663	10043s (+0.5s)	1532	1532	128	43	110	9	0	162
15664	10044s (+0.7s)	3080	3080	256	73	173	14	0	260
15665	10044s (+0.6s)	2352	2352	256	46	142	9	0	197
15666	10045s (+0.6s)	1928	1928	128	38	156	6	0	200
15667	10046s (+1.2s)	5848	5848	512	125	269	26	1	421
15668	10047s (+0.8s)	3508	3508	256	75	204	17	0	296
15669	10047s (+0.5s)	1720	1720	128	49	121	10	0	180
15670	10048s (+0.7s)	3056	3056	256	47	194	8	0	249
15671	10049s (+1.0s)	4352	4352	256	81	259	18	0	358
15672	10050s (+1.0s)	4300	4300	256	88	251	15	0	354
15673	10051s (+0.7s)	3068	3068	256	67	174	12	0	253
15674	10052s (+0.8s)	3256	3256	256	65	197	9	1	272
15675	10052s (+0.6s)	2524	2524	256	55	155	8	0	218
15676	10053s (+0.4s)	1468	1468	128	33	115	3	0	151
15677	10053s (+0.8s)	3612	3612	256	88	201	13	0	302
15678	10054s (+0.7s)	2620	2620	256	56	170	4	0	230
15679	10055s (+0.8s)	3496	3496	256	72	207	14	0	293
15680	10056s (+0.8s)	3552	3552	256	74	212	16	0	302
15681	10056s (+0.5s)	1496	1496	128	37	108	12	0	157
15682	10057s (+0.4s)	932	932	64	31	85	7	0	123
15683	10057s (+0.8s)	3344	3344	256	67	201	14	0	282
15684	10058s (+0.5s)	1596	1596	128	40	111	11	1	163
15685	10059s (+0.9s)	3716	3716	256	81	220	15	0	316
15686	10059s (+0.2s)	532	532	64	12	66	0	0	78
15687	10060s (+1.0s)	4324	4324	256	102	237	20	0	359
15688	10061s (+0.6s)	2116	2116	128	46	153	9	0	208
15689	10061s (+0.6s)	2444	2444	256	50	151	6	0	207
15690	10062s (+0.4s)	1492	1492	128	39	109	8	0	156
15691	10062s (+0.3s)	656	656	64	20	65	2	0	87
15692	10063s (+0.7s)	3012	3012	256	63	173	10	0	246
15693	10064s (+0.9s)	4000	4000	256	79	235	13	0	327
15694	10064s (+0.3s)	808	808	64	25	77	7	0	109
15695	10065s (+0.6s)	1888	1888	128	59	126	8	1	194
15696	10065s (+0.5s)	1656	1656	128	46	109	10	0	165
15697	10065s (+0.5s)	1688	1688	128	51	116	7	0	174
15698	10066s (+0.6s)	2120	2120	128	53	141	14	0	208
15699	10067s (+0.6s)	2688	2688	256	51	169	5	0	225
Episode	Time	Reward	Score	Highest	L	U	R	D	Steps
15700	10068s (+1.0s)	4132	4132	256	92	226	22	0	340
15701	10069s (+1.1s)	4656	4656	256	101	264	21	0	386
15702	10069s (+0.5s)	1820	1820	128	41	139	0	10	190
15703	10070s (+0.5s)	1592	1592	128	35	120	0	10	165
15704	10071s (+0.7s)	3036	3036	256	46	186	12	0	244
15705	10071s (+0.4s)	1432	1432	128	29	109	8	1	147
15706	10071s (+0.5s)	1496	1496	128	39	113	6	0	158
15707	10072s (+0.8s)	3316	3316	256	66	199	15	0	280
15708	10073s (+1.0s)	4176	4176	256	95	226	18	1	340
15709	10074s (+1.0s)	4940	4940	512	89	243	16	0	348
15710	10075s (+0.8s)	3552	3552	256	79	206	17	0	302
15711	10076s (+0.7s)	2984	2984	256	49	196	0	9	254
15712	10076s (+0.6s)	2516	2516	256	34	171	0	12	217
15713	10077s (+0.6s)	2096	2096	128	44	158	0	9	211
15714	10077s (+0.4s)	1364	1364	128	27	110	0	5	142
15715	10078s (+0.8s)	3264	3264	256	52	215	0	11	278
15716	10079s (+0.5s)	1736	1736	128	34	131	0	11	176
15717	10079s (+0.5s)	2360	2360	256	46	143	0	10	199
15718	10079s (+0.3s)	1096	1096	128	33	70	0	10	113
15719	10080s (+0.5s)	2304	2304	256	39	144	8	0	191
15720	10081s (+0.7s)	2616	2616	256	62	159	8	0	229
15721	10082s (+0.8s)	3440	3440	256	74	193	17	0	284
15722	10082s (+0.8s)	3404	3404	256	74	204	8	0	286
15723	10083s (+0.6s)	2412	2412	128	67	143	16	0	226
15724	10083s (+0.3s)	1016	1016	128	21	83	5	0	109
15725	10084s (+0.5s)	1688	1688	128	35	131	7	0	173
15726	10084s (+0.7s)	2856	2856	256	51	179	14	1	245
15727	10085s (+0.4s)	1176	1176	128	34	88	5	0	127
15728	10086s (+1.1s)	4568	4568	256	101	259	19	0	379
15729	10087s (+0.9s)	3544	3544	256	63	223	13	1	300
15730	10088s (+0.9s)	3932	3932	256	91	214	15	1	321
15731	10089s (+0.9s)	3972	3972	256	76	236	15	0	327
15732	10090s (+1.0s)	4204	4204	256	86	250	17	0	353
15733	10091s (+1.4s)	6892	6892	512	126	335	19	1	481
15734	10092s (+0.5s)	2068	2068	128	49	129	13	0	191
15735	10093s (+1.0s)	4260	4260	256	90	238	16	0	344
15736	10093s (+0.7s)	2832	2832	256	49	192	10	0	251
15737	10094s (+0.9s)	4004	4004	256	74	247	14	0	335
15738	10095s (+0.6s)	1948	1948	128	43	153	4	0	200
15739	10096s (+0.8s)	3432	3432	256	78	178	22	0	278
15740	10097s (+0.9s)	3880	3880	256	74	231	15	0	320
15741	10097s (+0.6s)	2560	2560	256	41	178	5	0	224
15742	10098s (+1.0s)	4280	4280	256	100	237	16	0	353
15743	10099s (+0.4s)	996	996	64	28	95	5	0	128
15744	10099s (+0.6s)	2568	2568	256	49	167	6	0	222
15745	10100s (+0.9s)	4024	4024	256	74	244	12	1	331
15746	10101s (+1.3s)	6612	6612	512	116	313	30	0	459
15747	10102s (+0.5s)	1592	1592	128	50	107	8	0	165
15748	10102s (+0.5s)	1824	1824	128	42	131	10	1	184
15749	10103s (+0.3s)	760	760	64	25	73	4	0	102
15750	10103s (+0.6s)	2004	2004	128	54	154	6	0	214
15751	10104s (+0.8s)	3572	3572	256	67	214	11	0	292
15752	10105s (+0.7s)	2836	2836	256	63	153	14	1	231
15753	10105s (+0.3s)	856	856	64	30	74	5	0	109
15754	10106s (+0.5s)	1852	1852	128	40	143	3	0	186
15755	10106s (+0.5s)	1664	1664	128	49	111	7	0	167
15756	10107s (+0.4s)	1488	1488	128	40	107	8	0	155
15757	10107s (+0.6s)	2308	2308	256	48	146	7	0	201
15758	10108s (+0.6s)	2148	2148	128	61	141	13	0	215
15759	10109s (+0.7s)	3180	3180	256	66	180	16	1	263
15760	10110s (+1.0s)	4928	4928	512	77	253	14	0	344
15761	10110s (+0.7s)	2760	2760	256	54	166	12	1	233
15762	10111s (+0.6s)	2508	2508	256	49	168	5	0	222
15763	10111s (+0.5s)	1752	1752	128	53	115	9	0	177
15764	10112s (+0.4s)	1440	1440	128	33	110	6	0	149
15765	10113s (+1.3s)	6192	6192	512	129	281	28	1	439
15766	10114s (+0.7s)	2820	2820	256	64	167	12	0	243
15767	10114s (+0.5s)	1672	1672	128	35	128	6	0	169
15768	10115s (+0.6s)	2476	2476	256	59	139	13	0	211
15769	10115s (+0.5s)	1948	1948	128	53	143	4	0	200
15770	10116s (+0.7s)	3136	3136	256	57	191	14	1	263
15771	10117s (+0.7s)	3128	3128	256	57	195	9	0	261
15772	10118s (+0.7s)	2536	2536	128	76	151	13	0	240
15773	10118s (+0.8s)	3468	3468	256	69	205	12	0	286
15774	10119s (+0.9s)	4000	4000	256	91	223	20	0	334
15775	10120s (+0.3s)	664	664	64	11	75	3	0	89
15776	10120s (+0.7s)	2504	2504	128	65	156	16	0	237
15777	10121s (+0.6s)	2216	2216	128	64	135	10	0	209
15778	10121s (+0.6s)	2044	2044	128	47	142	4	1	194
15779	10122s (+0.6s)	2020	2020	128	59	140	9	0	208
15780	10123s (+0.4s)	1540	1540	128	36	119	9	0	164
15781	10123s (+0.3s)	596	596	32	22	64	3	0	89
15782	10124s (+0.7s)	2644	2644	128	52	193	10	0	255
15783	10124s (+0.5s)	1980	1980	128	50	126	9	0	185
15784	10125s (+0.5s)	1764	1764	128	53	119	9	0	181
15785	10126s (+1.0s)	4156	4156	256	91	238	17	0	346
15786	10126s (+0.3s)	1084	1084	64	26	88	9	0	123
15787	10126s (+0.4s)	1348	1348	64	34	111	7	0	152
15788	10127s (+0.9s)	3992	3992	256	73	249	10	0	332
15789	10128s (+0.4s)	1412	1412	128	44	89	9	0	142
15790	10128s (+0.5s)	1580	1580	128	44	116	8	0	168
15791	10129s (+0.5s)	1844	1844	128	35	147	0	8	190
15792	10129s (+0.5s)	1540	1540	128	35	124	0	5	164
15793	10130s (+0.3s)	904	904	64	21	81	0	5	107
15794	10130s (+0.3s)	1040	1040	128	22	86	0	5	113
15795	10130s (+0.5s)	1640	1640	128	38	115	0	9	162
15796	10131s (+0.9s)	3548	3548	256	56	233	0	13	302
15797	10132s (+0.6s)	1912	1912	128	25	167	0	6	198
15798	10132s (+0.2s)	572	572	64	13	62	0	2	77
15799	10133s (+0.5s)	1528	1528	128	38	117	0	6	161
Episode	Time	Reward	Score	Highest	L	U	R	D	Steps
15800	10133s (+0.3s)	824	824	64	24	76	0	4	104
15801	10133s (+0.5s)	1632	1632	128	39	126	0	10	175
15802	10134s (+0.8s)	3404	3404	256	79	188	14	1	282
15803	10135s (+0.6s)	1988	1988	128	53	151	6	0	210
15804	10135s (+0.7s)	3196	3196	256	79	167	16	1	263
15805	10136s (+0.9s)	4016	4016	256	73	254	11	0	338
15806	10137s (+0.5s)	2308	2308	256	55	135	9	1	200
15807	10138s (+0.7s)	3000	3000	256	59	181	13	0	253
15808	10138s (+0.3s)	880	880	64	21	88	5	1	115
15809	10138s (+0.4s)	1292	1292	64	40	104	6	0	150
15810	10139s (+0.7s)	3156	3156	256	59	190	10	0	259
15811	10140s (+0.8s)	3772	3772	256	77	218	14	0	309
15812	10140s (+0.5s)	1700	1700	128	37	122	10	0	169
15813	10141s (+0.6s)	2492	2492	256	40	168	7	0	215
15814	10142s (+0.6s)	2596	2596	256	52	155	16	1	224
15815	10142s (+0.5s)	1924	1924	128	52	140	7	0	199
15816	10143s (+0.5s)	1536	1536	128	38	119	5	0	162
15817	10143s (+0.5s)	1920	1920	128	65	115	12	0	192
15818	10144s (+0.8s)	3644	3644	256	72	216	18	0	306
15819	10145s (+0.8s)	3504	3504	256	68	216	11	0	295
15820	10145s (+0.4s)	1476	1476	128	41	108	8	0	157
15821	10146s (+0.4s)	1480	1480	128	47	103	8	0	158
15822	10147s (+0.7s)	3192	3192	256	59	197	10	0	266
15823	10147s (+0.6s)	2596	2596	256	54	164	6	0	224
15824	10148s (+0.3s)	628	628	64	25	57	4	0	86
15825	10148s (+0.9s)	3668	3668	256	89	211	14	1	315
15826	10149s (+0.5s)	1712	1712	128	39	129	7	0	175
15827	10149s (+0.5s)	1840	1840	128	38	141	8	0	187
15828	10150s (+0.5s)	1540	1540	128	40	111	5	1	157
15829	10151s (+0.7s)	2448	2448	128	53	161	13	0	227
15830	10151s (+0.7s)	2896	2896	256	53	185	0	12	250
15831	10152s (+0.5s)	1796	1796	128	38	138	0	9	185
15832	10152s (+0.5s)	1912	1912	128	45	136	0	5	186
15833	10153s (+0.7s)	3252	3252	256	70	192	0	14	276
15834	10153s (+0.3s)	1160	1160	128	22	99	0	3	124
15835	10154s (+0.6s)	1936	1936	128	47	148	7	0	202
15836	10155s (+0.6s)	2004	2004	128	57	139	8	0	204
15837	10156s (+1.0s)	4216	4216	256	94	234	17	0	345
15838	10156s (+0.8s)	3348	3348	256	68	204	11	0	283
15839	10157s (+0.3s)	776	776	64	21	80	4	0	105
15840	10157s (+0.3s)	1148	1148	128	25	94	3	0	122
15841	10158s (+0.5s)	1588	1588	128	37	120	4	0	161
15842	10158s (+0.9s)	3772	3772	256	55	246	0	9	310
15843	10159s (+0.2s)	452	452	32	16	50	0	2	68
15844	10160s (+0.9s)	3612	3612	256	50	252	0	10	312
15845	10160s (+0.4s)	1468	1468	128	33	109	0	8	150
15846	10161s (+0.8s)	3240	3240	256	56	205	0	12	273
15847	10161s (+0.3s)	1128	1128	128	26	91	0	3	120
15848	10162s (+1.0s)	4268	4268	256	75	259	0	23	357
15849	10163s (+0.7s)	2800	2800	256	49	182	0	12	243
15850	10163s (+0.2s)	468	468	64	13	52	0	3	68
15851	10163s (+0.2s)	572	572	64	15	56	0	6	77
15852	10164s (+0.6s)	2692	2692	256	70	148	8	0	226
15853	10165s (+0.7s)	2900	2900	256	71	170	10	0	251
15854	10165s (+0.6s)	2144	2144	128	57	144	13	0	214
15855	10166s (+0.3s)	1088	1088	128	20	88	4	0	112
15856	10166s (+0.6s)	2528	2528	256	57	150	12	0	219
15857	10167s (+0.7s)	2820	2820	256	59	176	12	1	248
15858	10168s (+0.7s)	2972	2972	256	62	173	14	0	249
15859	10168s (+0.7s)	2624	2624	128	57	175	14	0	246
15860	10169s (+0.6s)	2716	2716	256	64	150	13	0	227
15861	10170s (+1.0s)	4208	4208	256	84	243	15	0	342
15862	10170s (+0.4s)	1344	1344	128	32	98	7	0	137
15863	10171s (+0.6s)	1928	1928	128	44	149	7	0	200
15864	10171s (+0.3s)	796	796	64	29	76	2	0	107
15865	10172s (+0.7s)	2516	2516	128	72	153	15	0	240
15866	10173s (+1.0s)	4144	4144	256	88	233	17	0	338
15867	10174s (+0.9s)	3708	3708	256	83	209	17	0	309
15868	10175s (+1.2s)	5828	5828	512	113	287	18	0	418
15869	10176s (+1.0s)	4324	4324	256	86	250	19	0	355
15870	10176s (+0.4s)	1336	1336	128	31	107	2	0	140
15871	10177s (+0.3s)	1088	1088	128	30	84	7	0	121
15872	10177s (+0.3s)	668	668	64	26	62	3	0	91
15873	10178s (+0.7s)	2540	2540	128	51	167	18	0	236
15874	10178s (+0.7s)	2624	2624	256	48	179	3	0	230
15875	10179s (+0.6s)	2520	2520	256	62	146	9	0	217
15876	10180s (+1.0s)	4180	4180	256	92	234	15	0	341
15877	10181s (+0.9s)	3840	3840	256	94	212	13	0	319
15878	10181s (+0.4s)	1344	1344	128	37	96	5	0	138
15879	10182s (+0.8s)	3564	3564	256	73	193	14	1	281
15880	10183s (+1.4s)	6808	6808	512	117	361	18	0	496
15881	10184s (+0.6s)	2668	2668	256	50	164	12	0	226
15882	10185s (+0.8s)	3528	3528	256	67	210	19	0	296
15883	10186s (+0.6s)	2428	2428	256	49	145	8	1	203
15884	10186s (+0.6s)	2368	2368	128	50	159	10	0	219
15885	10186s (+0.3s)	1036	1036	64	25	95	4	0	124
15886	10187s (+0.3s)	912	912	64	29	84	6	0	119
15887	10187s (+0.5s)	2300	2300	256	47	135	7	0	189
15888	10188s (+0.9s)	3780	3780	256	84	216	19	0	319
15889	10189s (+0.6s)	1928	1928	128	48	141	6	0	195
15890	10190s (+0.9s)	3756	3756	256	70	224	11	0	305
15891	10190s (+0.5s)	1768	1768	128	44	129	8	0	181
15892	10191s (+0.7s)	3216	3216	256	49	199	0	18	266
15893	10191s (+0.3s)	988	988	64	21	90	0	6	117
15894	10192s (+0.6s)	2432	2432	256	41	151	0	15	207
15895	10193s (+0.8s)	3216	3216	256	49	201	0	19	269
15896	10193s (+0.8s)	3408	3408	256	77	205	0	11	293
15897	10194s (+0.6s)	2436	2436	128	46	163	0	14	223
15898	10195s (+0.4s)	1448	1448	128	36	110	0	5	151
15899	10195s (+0.4s)	1404	1404	128	34	104	0	7	145
Episode	Time	Reward	Score	Highest	L	U	R	D	Steps
15900	10196s (+0.9s)	3956	3956	256	59	255	0	14	328
15901	10197s (+0.9s)	3972	3972	256	62	250	0	15	327
15902	10197s (+0.4s)	1244	1244	64	27	107	0	9	143
15903	10198s (+0.6s)	2644	2644	256	42	171	0	10	223
15904	10199s (+0.8s)	3296	3296	256	75	190	9	0	274
15905	10199s (+0.6s)	2520	2520	256	51	152	12	1	216
15906	10200s (+0.7s)	2864	2864	256	64	172	15	0	251
15907	10200s (+0.4s)	1496	1496	128	33	122	2	0	157
15908	10201s (+0.7s)	2884	2884	256	60	174	13	0	247
15909	10202s (+0.4s)	1492	1492	128	29	124	3	0	156
15910	10202s (+0.6s)	2480	2480	256	49	157	6	0	212
15911	10203s (+0.4s)	1456	1456	128	39	108	6	0	153
15912	10203s (+0.6s)	2672	2672	256	48	164	10	0	222
15913	10204s (+0.6s)	2496	2496	256	67	136	12	1	216
15914	10205s (+0.6s)	2628	2628	256	49	170	7	1	227
15915	10205s (+0.8s)	3280	3280	256	67	191	14	0	272
15916	10206s (+0.5s)	1776	1776	128	46	126	7	0	179
15917	10207s (+0.8s)	3336	3336	256	69	198	13	0	280
15918	10207s (+0.5s)	1580	1580	128	27	131	7	0	165
15919	10208s (+0.8s)	3300	3300	256	77	182	17	0	276
15920	10209s (+0.7s)	2900	2900	256	76	168	11	0	255
15921	10209s (+0.7s)	2812	2812	256	82	153	11	0	246
15922	10210s (+0.7s)	2548	2548	128	60	172	11	0	243
15923	10211s (+1.0s)	4356	4356	256	114	227	21	1	363
15924	10211s (+0.4s)	1408	1408	128	35	104	9	0	148
15925	10212s (+0.7s)	2808	2808	256	50	186	9	0	245
15926	10213s (+0.5s)	1804	1804	128	40	138	8	0	186
15927	10213s (+0.4s)	1124	1124	64	29	95	6	0	130
15928	10214s (+1.1s)	4672	4672	256	107	259	23	0	389
15929	10215s (+0.6s)	2592	2592	256	50	155	12	0	217
15930	10216s (+0.9s)	4348	4348	256	91	224	16	1	332
15931	10216s (+0.4s)	1476	1476	128	33	113	7	0	153
15932	10217s (+0.6s)	2436	2436	256	49	152	6	0	207
15933	10218s (+0.8s)	3544	3544	256	61	220	12	0	293
15934	10218s (+0.4s)	1444	1444	128	36	107	7	0	150
15935	10219s (+0.7s)	3172	3172	256	66	185	14	1	266
15936	10220s (+0.7s)	2776	2776	256	52	163	12	0	227
15937	10220s (+0.9s)	3952	3952	256	82	229	11	0	322
15938	10221s (+0.3s)	860	860	64	38	69	4	0	111
15939	10222s (+0.7s)	3028	3028	256	48	192	7	0	247
15940	10223s (+1.0s)	4268	4268	256	87	243	15	0	345
15941	10223s (+0.7s)	2548	2548	128	56	166	13	1	236
15942	10224s (+0.4s)	1580	1580	128	40	109	7	0	156
15943	10224s (+0.7s)	3064	3064	256	63	188	0	10	261
15944	10225s (+0.7s)	2816	2816	256	63	169	14	0	246
15945	10226s (+0.7s)	2844	2844	128	77	173	12	0	262
15946	10226s (+0.6s)	1928	1928	128	41	150	9	0	200
15947	10227s (+0.6s)	1908	1908	128	54	134	7	0	195
15948	10228s (+0.7s)	2656	2656	256	35	184	0	10	229
15949	10229s (+0.8s)	3360	3360	256	51	225	0	10	286
15950	10229s (+0.7s)	2892	2892	256	50	189	0	11	250
15951	10231s (+1.4s)	7252	7252	512	129	350	27	1	507
15952	10231s (+0.5s)	2268	2268	256	39	149	8	0	196
15953	10232s (+0.9s)	3784	3784	256	93	204	20	0	317
15954	10232s (+0.3s)	964	964	64	36	75	4	0	115
15955	10233s (+0.8s)	3488	3488	256	66	212	13	0	291
15956	10234s (+0.4s)	1036	1036	64	30	86	6	1	123
15957	10234s (+0.8s)	3428	3428	256	77	182	20	2	281
15958	10235s (+0.4s)	1484	1484	128	36	114	5	0	155
15959	10235s (+0.3s)	1116	1116	128	25	91	3	0	119
15960	10236s (+0.9s)	4204	4204	256	85	218	18	1	322
15961	10237s (+0.4s)	1300	1300	128	18	111	0	6	135
15962	10238s (+1.2s)	5828	5828	512	98	288	0	19	405
15963	10238s (+0.7s)	3072	3072	256	63	171	0	14	248
15964	10239s (+0.5s)	1716	1716	128	33	129	0	11	173
15965	10240s (+0.7s)	2988	2988	256	44	185	0	15	244
15966	10240s (+0.2s)	568	568	64	13	61	0	3	77
15967	10241s (+0.8s)	3428	3428	256	65	207	8	0	280
15968	10242s (+1.3s)	6576	6576	512	124	330	20	0	474
15969	10243s (+1.0s)	4056	4056	256	86	231	19	0	336
15970	10244s (+0.4s)	1196	1196	64	37	100	4	0	141
15971	10244s (+0.8s)	3284	3284	256	74	192	10	1	277
15972	10245s (+1.0s)	4392	4392	256	81	273	13	0	367
15973	10247s (+1.1s)	4540	4540	256	97	264	15	0	376
15974	10247s (+0.6s)	2584	2584	256	52	155	13	2	222
15975	10247s (+0.2s)	548	548	64	19	55	5	0	79
15976	10248s (+0.7s)	2572	2572	128	62	167	13	0	242
15977	10249s (+0.7s)	3024	3024	256	62	180	10	0	252
15978	10249s (+0.5s)	1624	1624	128	35	120	7	1	163
15979	10250s (+0.6s)	2728	2728	256	53	155	11	0	219
15980	10250s (+0.5s)	2128	2128	256	53	125	6	0	184
15981	10251s (+1.0s)	4452	4452	256	93	256	17	0	366
15982	10252s (+0.5s)	1820	1820	128	40	143	7	0	190
15983	10253s (+0.7s)	3084	3084	256	53	192	12	0	257
15984	10254s (+0.9s)	3808	3808	256	87	203	18	0	308
15985	10254s (+0.7s)	2960	2960	256	71	182	8	0	261
15986	10255s (+0.7s)	3044	3044	256	47	190	10	0	247
15987	10256s (+0.6s)	2592	2592	256	56	150	16	1	223
15988	10257s (+1.0s)	4260	4260	256	63	273	13	0	349
15989	10257s (+0.3s)	764	764	64	28	69	6	0	103
15990	10258s (+0.9s)	3976	3976	256	76	231	15	0	322
15991	10259s (+0.6s)	2388	2388	256	52	139	9	0	200
15992	10260s (+1.2s)	6080	6080	512	107	302	17	0	426
15993	10261s (+0.8s)	3624	3624	256	65	216	13	0	294
15994	10261s (+0.6s)	2860	2860	256	51	170	12	0	233
15995	10262s (+0.4s)	1400	1400	64	47	105	9	0	161
15996	10263s (+1.0s)	4260	4260	256	85	258	12	0	355
15997	10263s (+0.5s)	1676	1676	128	42	123	6	0	171
15998	10264s (+0.9s)	4120	4120	256	85	237	15	0	337
15999	10264s (+0.3s)	1044	1044	64	31	88	7	0	126
Episode	Time	Reward	Score	Highest	L	U	R	D	Steps
16000	10265s (+0.4s)	1424	1424	128	38	104	3	0	145
16001	10265s (+0.5s)	1828	1828	128	38	139	9	0	186
16002	10266s (+0.4s)	1384	1384	128	36	103	7	0	146
16003	10266s (+0.6s)	1916	1916	128	50	137	10	0	197
16004	10267s (+0.9s)	3916	3916	256	108	199	21	1	329
16005	10268s (+0.5s)	1788	1788	128	38	139	5	0	182
16006	10268s (+0.3s)	708	708	64	29	63	4	1	97
16007	10269s (+0.6s)	1936	1936	128	48	145	9	0	202
16008	10269s (+0.4s)	1312	1312	128	31	93	6	0	130
16009	10270s (+0.4s)	1116	1116	64	45	84	8	0	137
16010	10270s (+0.5s)	1820	1820	128	51	126	6	0	183
16011	10271s (+0.5s)	1800	1800	128	40	132	11	1	184
16012	10271s (+0.5s)	1784	1784	128	31	144	6	0	181
16013	10272s (+0.7s)	2912	2912	256	73	170	11	0	254
16014	10272s (+0.6s)	2424	2424	256	51	149	9	0	209
16015	10273s (+0.5s)	1668	1668	128	40	133	6	0	179
16016	10274s (+0.8s)	3596	3596	256	71	207	0	11	289
16017	10274s (+0.4s)	1344	1344	128	28	108	0	6	142
16018	10275s (+0.5s)	1736	1736	128	30	131	0	13	174
16019	10276s (+0.9s)	3912	3912	256	49	251	0	16	316
16020	10276s (+0.7s)	3092	3092	256	75	171	11	0	257
16021	10277s (+1.0s)	5052	5052	512	83	263	14	0	360
16022	10278s (+0.7s)	2944	2944	256	64	170	13	0	247
16023	10278s (+0.3s)	880	880	64	26	84	5	1	116
16024	10279s (+0.5s)	1784	1784	128	40	134	7	0	181
16025	10279s (+0.5s)	1800	1800	128	38	142	5	0	185
16026	10280s (+0.4s)	1044	1044	64	38	90	7	0	135
16027	10280s (+0.5s)	1844	1844	128	44	135	5	0	184
16028	10281s (+0.9s)	3688	3688	256	73	217	19	0	309
16029	10282s (+0.9s)	4048	4048	256	92	223	19	0	334
16030	10283s (+0.3s)	960	960	64	45	72	7	0	124
16031	10283s (+0.3s)	1016	1016	64	31	81	7	0	119
16032	10284s (+1.0s)	4140	4140	256	88	231	18	0	337
16033	10285s (+0.9s)	3588	3588	256	64	225	14	0	303
16034	10285s (+0.4s)	1060	1060	64	35	85	8	0	128
16035	10286s (+0.9s)	3724	3724	256	81	221	15	0	317
16036	10287s (+0.7s)	2512	2512	128	66	160	13	0	239
16037	10287s (+0.2s)	408	408	64	10	47	0	2	59
16038	10288s (+0.6s)	2424	2424	128	43	172	0	14	229
16039	10288s (+0.7s)	3056	3056	256	47	186	0	16	249
16040	10289s (+0.4s)	1404	1404	128	40	98	8	1	147
16041	10290s (+1.4s)	6888	6888	512	146	304	30	0	480
16042	10291s (+0.6s)	2552	2552	256	52	155	10	1	218
16043	10291s (+0.7s)	3048	3048	256	58	178	12	0	248
16044	10292s (+0.8s)	3420	3420	256	76	191	19	0	286
16045	10293s (+0.7s)	2820	2820	256	55	183	10	0	248
16046	10294s (+0.6s)	2308	2308	256	43	147	8	0	198
16047	10294s (+0.8s)	3364	3364	256	62	204	15	0	281
16048	10295s (+0.7s)	2884	2884	256	46	196	9	0	251
16049	10295s (+0.3s)	692	692	64	16	74	0	0	90
16050	10296s (+0.6s)	2576	2576	256	62	151	11	0	224
16051	10297s (+0.9s)	4000	4000	256	88	219	19	1	327
16052	10297s (+0.6s)	2000	2000	128	61	130	11	0	202
16053	10298s (+0.4s)	1396	1396	128	41	88	10	0	139
16054	10299s (+0.6s)	2612	2612	256	52	158	9	0	219
16055	10299s (+0.4s)	1340	1340	128	28	103	6	0	137
16056	10300s (+1.0s)	5164	5164	512	90	257	17	1	365
16057	10301s (+0.9s)	3768	3768	256	94	210	13	0	317
16058	10302s (+0.8s)	3408	3408	256	61	212	10	0	283
16059	10303s (+0.8s)	3628	3628	256	78	208	9	1	296
16060	10303s (+0.6s)	1964	1964	128	49	149	6	0	204
16061	10304s (+0.4s)	1460	1460	128	28	119	6	0	153
16062	10304s (+0.5s)	1888	1888	128	40	143	7	0	190
16063	10305s (+0.6s)	2072	2072	128	59	136	14	0	209
16064	10305s (+0.5s)	1944	1944	128	45	146	6	0	197
16065	10306s (+0.4s)	1424	1424	128	35	109	7	0	151
16066	10306s (+0.6s)	2436	2436	256	50	153	7	0	210
16067	10307s (+0.9s)	3572	3572	256	76	218	13	0	307
16068	10308s (+0.6s)	2616	2616	256	52	163	0	13	228
16069	10308s (+0.6s)	2788	2788	256	50	164	0	12	226
16070	10309s (+0.4s)	1264	1264	128	36	96	0	5	137
16071	10309s (+0.4s)	1332	1332	128	27	104	0	6	137
16072	10310s (+0.4s)	1100	1100	64	29	85	0	13	127
16073	10310s (+0.7s)	2772	2772	256	64	165	12	0	241
16074	10311s (+0.7s)	3160	3160	256	72	177	12	2	263
16075	10311s (+0.3s)	892	892	64	31	80	7	0	118
16076	10312s (+0.6s)	1924	1924	128	48	142	9	0	199
16077	10312s (+0.4s)	1148	1148	64	37	88	9	0	134
16078	10313s (+0.7s)	2808	2808	256	59	179	7	0	245
16079	10314s (+0.5s)	1540	1540	128	50	108	6	0	164
16080	10314s (+0.7s)	2900	2900	256	56	183	12	0	251
16081	10315s (+1.0s)	4248	4248	256	91	247	14	0	352
16082	10316s (+0.8s)	3288	3288	256	64	195	11	0	270
16083	10316s (+0.3s)	1072	1072	128	23	90	4	0	117
16084	10317s (+0.6s)	2664	2664	256	53	160	11	2	226
16085	10318s (+0.5s)	1752	1752	128	39	132	7	0	178
16086	10318s (+0.9s)	3800	3800	256	80	210	17	0	307
16087	10319s (+0.9s)	4052	4052	256	83	228	24	1	336
16088	10320s (+0.9s)	3824	3824	256	89	200	18	0	307
16089	10321s (+0.8s)	3072	3072	256	85	168	14	0	267
16090	10322s (+0.5s)	1836	1836	128	39	141	7	0	187
16091	10322s (+0.5s)	1608	1608	128	35	127	7	0	169
16092	10323s (+0.8s)	3320	3320	256	80	189	12	0	281
16093	10323s (+0.5s)	1620	1620	128	43	125	4	0	172
16094	10324s (+0.3s)	732	732	64	21	70	5	1	97
16095	10324s (+0.7s)	2640	2640	128	71	156	17	0	244
16096	10325s (+0.4s)	1180	1180	128	20	105	2	0	127
16097	10326s (+1.5s)	7860	7860	512	144	358	37	1	540
16098	10327s (+0.6s)	2796	2796	256	64	167	11	0	242
16099	10328s (+0.9s)	3660	3660	256	105	193	15	0	313
Episode	Time	Reward	Score	Highest	L	U	R	D	Steps
16100	10329s (+0.7s)	3020	3020	256	57	183	11	0	251
16101	10329s (+0.6s)	2276	2276	256	44	145	4	0	193
16102	10330s (+0.5s)	1812	1812	128	53	117	12	0	182
16103	10331s (+0.9s)	3980	3980	256	76	238	15	0	329
16104	10331s (+0.6s)	1960	1960	128	43	142	0	9	194
16105	10332s (+0.4s)	1300	1300	64	32	106	0	7	145
16106	10333s (+0.8s)	3404	3404	256	71	198	13	0	282
16107	10333s (+0.4s)	1488	1488	128	38	111	7	0	156
16108	10334s (+0.9s)	3520	3520	256	80	207	11	1	299
16109	10335s (+0.8s)	3244	3244	256	56	206	12	0	274
16110	10335s (+0.4s)	1420	1420	128	37	110	3	0	150
16111	10336s (+0.6s)	2252	2252	128	36	165	0	7	208
16112	10336s (+0.7s)	3280	3280	256	55	197	0	16	268
16113	10337s (+0.6s)	2516	2516	256	45	165	0	10	220
16114	10338s (+1.1s)	5484	5484	512	102	264	0	20	386
16115	10339s (+0.5s)	1784	1784	128	42	132	0	7	181
16116	10340s (+0.9s)	3972	3972	256	79	235	0	10	324
16117	10340s (+0.6s)	2584	2584	256	43	169	0	10	222
16118	10341s (+0.5s)	1696	1696	128	29	135	0	11	175
16119	10341s (+0.7s)	2796	2796	256	40	192	0	10	242
16120	10342s (+0.6s)	2392	2392	256	34	159	0	9	202
16121	10343s (+0.5s)	1792	1792	128	36	137	0	11	184
16122	10343s (+0.7s)	2632	2632	256	60	163	9	0	232
16123	10344s (+0.4s)	1380	1380	128	24	117	5	0	146
16124	10344s (+0.8s)	3236	3236	256	75	187	10	0	272
16125	10345s (+0.4s)	1448	1448	128	21	126	1	0	148
16126	10346s (+1.0s)	4528	4528	256	84	279	15	0	378
16127	10346s (+0.4s)	1472	1472	128	35	110	7	0	152
16128	10347s (+0.8s)	3448	3448	256	67	206	9	0	282
16129	10347s (+0.3s)	812	812	64	25	81	4	0	110
16130	10348s (+0.5s)	1604	1604	128	36	125	7	0	168
16131	10349s (+0.8s)	3452	3452	256	63	205	18	1	287
16132	10350s (+0.9s)	4084	4084	256	92	222	14	0	328
16133	10350s (+0.7s)	2748	2748	256	65	152	17	1	235
16134	10352s (+1.3s)	6496	6496	512	136	310	20	0	466
16135	10352s (+0.6s)	2416	2416	256	65	130	13	0	208
16136	10353s (+0.5s)	1788	1788	128	52	123	8	0	183
16137	10354s (+0.7s)	2908	2908	256	44	201	10	0	255
16138	10354s (+0.4s)	1256	1256	128	39	88	8	0	135
16139	10354s (+0.5s)	1612	1612	128	55	105	10	0	170
16140	10355s (+0.4s)	1308	1308	128	40	95	8	0	143
16141	10355s (+0.4s)	1484	1484	128	30	119	6	0	155
16142	10356s (+0.5s)	1492	1492	128	33	117	7	0	157
16143	10357s (+0.9s)	4016	4016	256	69	241	0	13	323
16144	10358s (+0.9s)	3800	3800	256	69	233	0	14	316
16145	10358s (+0.7s)	2428	2428	128	49	170	0	11	230
16146	10359s (+0.5s)	2288	2288	256	30	150	0	10	190
16147	10359s (+0.6s)	2484	2484	256	53	150	0	6	209
16148	10360s (+0.8s)	3424	3424	256	70	215	0	13	298
16149	10361s (+0.5s)	1788	1788	128	31	144	0	7	182
16150	10361s (+0.4s)	1328	1328	128	22	109	0	6	137
16151	10362s (+0.6s)	2276	2276	128	44	167	0	8	219
16152	10362s (+0.4s)	1376	1376	128	29	104	0	5	138
16153	10363s (+1.1s)	5104	5104	512	92	257	0	21	370
16154	10364s (+0.7s)	2516	2516	128	59	169	12	0	240
16155	10364s (+0.3s)	1092	1092	128	24	90	2	0	116
16156	10365s (+0.7s)	2696	2696	256	50	176	7	0	233
16157	10366s (+0.6s)	2468	2468	256	42	162	6	0	210
16158	10366s (+0.8s)	3192	3192	256	69	181	16	0	266
16159	10367s (+0.6s)	1984	1984	128	53	138	8	0	199
16160	10367s (+0.4s)	1440	1440	128	29	117	3	0	149
16161	10368s (+0.5s)	1624	1624	128	52	112	8	0	172
16162	10368s (+0.2s)	616	616	64	17	62	0	5	84
16163	10369s (+1.0s)	4180	4180	256	90	233	18	0	341
16164	10370s (+0.6s)	2440	2440	128	69	141	12	0	222
16165	10370s (+0.8s)	3180	3180	256	64	186	13	0	263
16166	10371s (+0.9s)	3908	3908	256	80	221	16	0	317
16167	10372s (+1.0s)	4304	4304	256	105	229	25	0	359
16168	10373s (+0.7s)	2696	2696	256	64	159	10	0	233
16169	10374s (+0.6s)	2380	2380	256	46	144	8	0	198
16170	10374s (+0.8s)	3240	3240	256	69	191	13	0	273
16171	10376s (+1.4s)	6756	6756	512	144	310	28	0	482
16172	10377s (+0.9s)	4188	4188	256	99	221	22	0	342
16173	10377s (+0.3s)	1144	1144	128	37	79	7	0	123
16174	10378s (+0.7s)	2864	2864	256	75	159	13	0	247
16175	10378s (+0.5s)	1876	1876	128	39	142	7	0	188
16176	10379s (+0.7s)	2528	2528	128	74	151	13	0	238
16177	10380s (+1.0s)	4476	4476	256	103	240	22	0	365
16178	10381s (+0.4s)	1116	1116	128	31	88	5	0	124
16179	10381s (+0.7s)	2940	2940	256	70	166	12	0	248
16180	10382s (+0.3s)	1004	1004	64	23	94	3	0	120
16181	10382s (+0.7s)	2812	2812	256	57	175	6	0	238
16182	10383s (+0.6s)	2388	2388	256	55	143	8	0	206
16183	10384s (+0.7s)	2772	2772	256	57	170	11	0	238
16184	10384s (+0.4s)	1428	1428	128	32	106	0	10	148
16185	10384s (+0.4s)	1144	1144	64	24	105	0	4	133
16186	10385s (+0.4s)	1376	1376	128	27	113	0	4	144
16187	10386s (+0.8s)	3372	3372	256	60	212	0	17	289
16188	10386s (+0.5s)	1736	1736	128	37	128	0	9	174
16189	10387s (+0.4s)	1356	1356	128	28	117	5	0	150
16190	10388s (+0.9s)	3948	3948	256	59	254	0	13	326
16191	10388s (+0.5s)	1656	1656	128	39	117	0	9	165
16192	10389s (+0.9s)	3992	3992	256	91	221	19	1	332
16193	10389s (+0.4s)	996	996	64	26	98	4	0	128
16194	10390s (+0.5s)	1928	1928	128	46	130	14	0	190
16195	10390s (+0.6s)	2120	2120	128	49	141	11	1	202
16196	10391s (+0.8s)	3244	3244	256	64	197	13	0	274
16197	10392s (+0.4s)	1156	1156	128	32	89	5	0	126
16198	10392s (+0.4s)	1380	1380	128	31	107	6	1	145
16199	10393s (+0.8s)	3348	3348	256	75	195	13	0	283
Episode	Time	Reward	Score	Highest	L	U	R	D	Steps
16200	10394s (+0.7s)	3096	3096	256	72	169	13	2	256
16201	10394s (+0.5s)	2072	2072	256	35	133	7	0	175
16202	10395s (+0.6s)	1956	1956	128	46	150	6	0	202
16203	10395s (+0.4s)	1384	1384	128	29	102	6	0	137
16204	10396s (+0.5s)	1516	1516	128	32	116	9	0	157
16205	10396s (+0.7s)	2644	2644	128	43	191	0	18	252
16206	10397s (+0.9s)	3840	3840	256	105	211	14	0	330
16207	10398s (+0.6s)	2576	2576	256	53	160	10	0	223
16208	10399s (+0.7s)	2920	2920	256	65	174	14	0	253
16209	10399s (+0.7s)	2352	2352	128	61	154	16	0	231
16210	10400s (+1.2s)	6136	6136	512	125	278	27	0	430
16211	10401s (+0.7s)	2488	2488	128	72	151	10	0	233
16212	10402s (+1.0s)	4340	4340	256	103	241	14	0	358
16213	10403s (+0.5s)	1688	1688	128	39	127	9	0	175
16214	10403s (+0.4s)	996	996	64	45	71	8	0	124
16215	10404s (+0.6s)	2720	2720	256	57	156	14	1	228
16216	10404s (+0.5s)	1548	1548	128	41	118	6	0	165
16217	10405s (+0.7s)	2960	2960	256	56	194	11	0	261
16218	10405s (+0.5s)	1680	1680	128	40	123	8	0	171
16219	10406s (+0.6s)	2588	2588	256	51	149	13	0	213
16220	10407s (+0.5s)	1732	1732	128	44	121	8	0	173
16221	10407s (+0.4s)	1480	1480	128	36	110	7	0	153
16222	10407s (+0.4s)	1384	1384	128	29	113	4	0	146
16223	10409s (+1.7s)	8272	8272	512	179	373	33	0	585
16224	10410s (+0.8s)	3356	3356	256	73	197	15	0	285
16225	10411s (+1.0s)	3984	3984	256	76	237	16	1	330
16226	10411s (+0.3s)	720	720	64	14	78	4	0	96
16227	10412s (+0.6s)	2672	2672	256	52	161	9	0	222
16228	10413s (+1.1s)	4512	4512	256	115	235	24	0	374
16229	10414s (+0.8s)	3516	3516	256	67	204	18	1	290
16230	10415s (+0.8s)	3228	3228	256	82	172	16	0	270
16231	10415s (+0.8s)	3336	3336	256	67	206	8	0	281
16232	10416s (+0.9s)	3612	3612	256	89	196	16	1	302
16233	10417s (+0.3s)	1004	1004	64	26	86	5	0	117
16234	10417s (+0.3s)	992	992	64	26	86	6	0	118
16235	10418s (+0.5s)	1808	1808	128	38	134	8	1	181
16236	10418s (+0.2s)	592	592	64	18	62	2	0	82
16237	10419s (+0.9s)	3592	3592	256	65	220	15	0	300
16238	10419s (+0.7s)	3080	3080	256	47	201	6	0	254
16239	10420s (+0.5s)	1688	1688	128	32	133	7	1	173
16240	10421s (+0.6s)	2568	2568	256	49	169	6	0	224
16241	10421s (+0.4s)	1352	1352	128	45	91	6	0	142
16242	10421s (+0.5s)	1692	1692	128	48	121	6	0	175
16243	10422s (+0.4s)	1532	1532	128	38	108	9	1	156
16244	10423s (+0.8s)	3604	3604	256	83	201	15	0	299
16245	10424s (+0.9s)	3908	3908	256	59	245	0	13	317
16246	10424s (+0.7s)	2788	2788	256	47	183	0	11	241
16247	10425s (+0.8s)	3512	3512	256	55	228	0	9	292
16248	10426s (+0.6s)	2188	2188	128	33	161	0	12	206
16249	10426s (+0.4s)	1336	1336	128	41	89	6	0	136
16250	10427s (+0.8s)	3272	3272	256	70	183	14	0	267
16251	10427s (+0.3s)	1164	1164	128	28	85	5	0	118
16252	10428s (+0.6s)	2556	2556	256	54	163	8	0	225
16253	10428s (+0.5s)	1752	1752	128	38	131	9	0	178
16254	10429s (+0.7s)	2724	2724	256	42	177	11	0	230
16255	10430s (+0.6s)	1940	1940	128	53	135	9	0	197
16256	10430s (+0.5s)	1836	1836	128	41	135	10	0	186
16257	10431s (+0.6s)	1888	1888	128	48	137	10	0	195
16258	10431s (+0.5s)	1516	1516	128	42	109	8	0	159
16259	10432s (+0.5s)	1528	1528	128	43	115	7	0	165
16260	10433s (+0.9s)	3580	3580	256	65	221	10	1	297
16261	10433s (+0.8s)	3588	3588	256	87	199	18	0	304
16262	10434s (+0.5s)	1540	1540	128	44	117	3	0	164
16263	10435s (+0.7s)	2800	2800	256	54	181	7	1	243
16264	10435s (+0.9s)	3592	3592	256	77	208	16	0	301
16265	10436s (+0.3s)	752	752	64	24	74	3	0	101
16266	10436s (+0.5s)	1748	1748	128	47	128	3	0	178
16267	10437s (+0.7s)	2688	2688	128	65	170	16	0	251
16268	10438s (+0.5s)	1928	1928	128	41	151	8	0	200
16269	10438s (+0.7s)	2904	2904	256	64	179	13	1	257
16270	10439s (+0.6s)	2640	2640	256	52	167	8	1	228
16271	10439s (+0.3s)	860	860	64	26	71	10	0	107
16272	10440s (+1.0s)	4536	4536	256	92	246	17	1	356
16273	10441s (+0.4s)	1216	1216	128	34	92	6	0	132
16274	10442s (+0.8s)	3476	3476	256	71	209	13	0	293
16275	10442s (+0.3s)	972	972	64	34	76	7	0	117
16276	10443s (+1.0s)	5072	5072	512	85	259	19	0	363
16277	10444s (+0.6s)	2308	2308	128	61	143	15	0	219
16278	10444s (+1.0s)	4072	4072	256	83	237	20	0	340
16279	10445s (+0.3s)	1144	1144	128	32	85	6	0	123
16280	10445s (+0.6s)	2456	2456	256	52	146	8	0	206
16281	10446s (+0.5s)	1612	1612	128	38	118	5	0	161
16282	10447s (+0.6s)	2256	2256	128	62	144	13	0	219
16283	10447s (+0.3s)	912	912	64	30	85	4	0	119
16284	10448s (+0.8s)	3376	3376	256	87	189	13	1	290
16285	10448s (+0.4s)	1356	1356	128	38	96	5	1	140
16286	10448s (+0.3s)	1080	1080	128	21	93	4	0	118
16287	10449s (+0.8s)	3536	3536	256	66	218	14	0	298
16288	10450s (+0.8s)	3600	3600	256	80	207	15	0	302
16289	10451s (+0.3s)	920	920	64	34	73	4	0	111
16290	10451s (+0.9s)	3904	3904	256	78	241	12	0	331
16291	10452s (+0.6s)	2240	2240	128	67	152	6	1	226
16292	10453s (+0.8s)	3276	3276	256	51	213	7	0	271
16293	10453s (+0.5s)	1536	1536	128	47	108	8	0	163
16294	10454s (+0.8s)	3180	3180	256	83	181	14	0	278
16295	10455s (+0.7s)	2888	2888	256	61	175	12	0	248
16296	10455s (+0.6s)	1928	1928	128	48	143	9	0	200
16297	10456s (+0.5s)	2120	2120	128	46	142	8	0	196
16298	10456s (+0.5s)	1672	1672	128	47	129	4	0	180
16299	10457s (+0.9s)	3888	3888	256	95	196	20	0	311
Episode	Time	Reward	Score	Highest	L	U	R	D	Steps
16300	10458s (+0.5s)	1588	1588	128	25	137	3	0	165
16301	10459s (+0.7s)	3152	3152	256	53	195	13	0	261
16302	10459s (+0.5s)	1868	1868	128	43	142	5	0	190
16303	10460s (+0.5s)	1728	1728	128	33	140	0	5	178
16304	10460s (+0.2s)	612	612	64	17	63	0	1	81
16305	10460s (+0.5s)	1620	1620	128	42	124	0	6	172
16306	10461s (+0.3s)	1012	1012	64	29	85	0	8	122
16307	10461s (+0.5s)	2328	2328	256	35	152	0	6	193
16308	10462s (+0.5s)	1552	1552	128	30	127	0	4	161
16309	10462s (+0.7s)	2828	2828	256	42	198	0	6	246
16310	10463s (+0.8s)	3148	3148	256	56	196	0	15	267
16311	10464s (+0.3s)	708	708	64	17	73	0	5	95
16312	10464s (+0.6s)	2280	2280	256	35	152	6	1	194
16313	10465s (+0.5s)	1712	1712	128	54	116	5	0	175
16314	10465s (+0.6s)	2500	2500	256	52	157	7	0	216
16315	10466s (+0.7s)	3068	3068	256	57	182	11	1	251
16316	10466s (+0.4s)	1168	1168	64	33	97	9	0	139
16317	10467s (+0.9s)	3812	3812	256	91	211	20	1	323
16318	10468s (+1.0s)	4152	4152	256	82	231	20	0	333
16319	10469s (+0.6s)	2524	2524	256	63	146	9	0	218
16320	10470s (+1.1s)	5504	5504	512	105	270	16	0	391
16321	10471s (+0.7s)	3212	3212	256	66	185	14	0	265
16322	10471s (+0.5s)	1788	1788	128	43	129	13	1	186
16323	10472s (+0.6s)	2620	2620	256	65	151	9	0	225
16324	10472s (+0.5s)	1884	1884	128	38	144	7	0	189
16325	10473s (+0.6s)	2440	2440	256	61	139	13	0	213
16326	10474s (+1.0s)	4328	4328	256	85	256	19	0	360
16327	10475s (+0.6s)	2832	2832	256	58	161	10	0	229
16328	10475s (+0.5s)	1712	1712	128	42	119	11	0	172
16329	10476s (+0.3s)	804	804	64	21	75	6	0	102
16330	10476s (+0.3s)	828	828	64	25	74	5	0	104
16331	10476s (+0.3s)	676	676	32	25	67	5	0	97
16332	10477s (+0.8s)	3264	3264	256	76	180	15	1	272
16333	10477s (+0.3s)	764	764	64	17	82	4	0	103
16334	10478s (+0.8s)	3348	3348	256	63	205	15	0	283
16335	10479s (+0.7s)	2832	2832	256	46	196	8	0	250
16336	10479s (+0.3s)	956	956	64	27	87	4	0	118
16337	10481s (+1.4s)	7072	7072	512	102	352	0	25	479
16338	10481s (+0.5s)	1492	1492	128	32	123	0	3	158
16339	10482s (+1.0s)	5384	5384	512	87	266	0	19	372
16340	10483s (+0.8s)	3192	3192	256	60	206	1	11	278
16341	10483s (+0.5s)	1684	1684	128	33	134	0	5	172
16342	10484s (+0.9s)	3724	3724	256	58	240	0	11	309
16343	10485s (+0.7s)	2896	2896	256	44	186	0	11	241
16344	10486s (+1.0s)	4164	4164	256	69	261	0	13	343
16345	10487s (+0.8s)	3432	3432	256	54	221	0	14	289
16346	10488s (+0.9s)	4192	4192	256	75	254	0	16	345
16347	10488s (+0.3s)	1012	1012	64	24	89	0	8	121
16348	10488s (+0.4s)	1272	1272	128	29	100	0	5	134
16349	10489s (+0.4s)	1028	1028	64	25	93	0	7	125
16350	10489s (+0.5s)	1660	1660	128	33	126	0	9	168
16351	10490s (+0.5s)	2124	2124	256	33	142	3	0	178
16352	10490s (+0.6s)	2604	2604	256	70	146	10	0	226
16353	10491s (+0.5s)	1560	1560	128	40	117	8	0	165
16354	10492s (+0.6s)	2520	2520	256	47	166	8	0	221
16355	10492s (+0.8s)	3308	3308	256	66	193	16	0	275
16356	10493s (+0.7s)	2908	2908	256	60	178	15	0	253
16357	10493s (+0.3s)	832	832	64	31	73	5	0	109
16358	10494s (+0.9s)	4656	4656	512	77	230	17	0	324
16359	10495s (+0.8s)	3204	3204	256	62	195	7	0	264
16360	10495s (+0.4s)	1180	1180	64	39	94	9	0	142
16361	10496s (+0.4s)	1180	1180	64	34	100	8	0	142
16362	10497s (+0.9s)	3988	3988	256	91	226	8	0	325
16363	10497s (+0.7s)	2732	2732	256	49	172	10	0	231
16364	10498s (+0.9s)	3768	3768	256	73	223	17	0	313
16365	10499s (+0.7s)	3096	3096	256	54	193	7	0	254
16366	10500s (+0.5s)	1736	1736	128	35	131	8	0	174
16367	10500s (+0.7s)	2668	2668	256	51	164	12	0	227
16368	10501s (+0.8s)	3292	3292	256	68	194	12	0	274
16369	10501s (+0.3s)	888	888	64	30	83	4	0	117
16370	10502s (+0.4s)	1504	1504	128	41	109	4	0	154
16371	10502s (+0.5s)	1724	1724	128	39	135	7	0	181
16372	10503s (+0.6s)	1908	1908	128	44	141	10	0	195
16373	10503s (+0.4s)	1056	1056	64	34	90	4	0	128
16374	10504s (+1.0s)	4140	4140	256	74	255	13	0	342
16375	10505s (+0.5s)	1576	1576	128	42	118	7	1	168
16376	10505s (+0.3s)	756	756	64	33	65	3	0	101
16377	10506s (+0.8s)	3464	3464	256	84	196	11	0	291
16378	10506s (+0.5s)	1732	1732	128	56	107	14	1	178
16379	10507s (+0.7s)	2940	2940	256	78	168	15	0	261
16380	10508s (+1.0s)	4164	4164	256	79	247	17	0	343
16381	10508s (+0.4s)	1060	1060	64	34	83	11	0	128
16382	10509s (+0.5s)	1704	1704	128	32	132	7	0	171
16383	10510s (+0.8s)	3568	3568	256	79	201	15	0	295
16384	10510s (+0.3s)	584	584	32	21	63	5	0	89
16385	10511s (+0.6s)	2548	2548	256	64	147	11	0	222
16386	10512s (+0.9s)	4092	4092	256	97	231	13	0	341
16387	10512s (+0.6s)	2420	2420	128	64	148	16	0	228
16388	10513s (+0.5s)	1688	1688	128	45	123	6	0	174
16389	10513s (+0.3s)	936	936	64	25	83	5	1	114
16390	10514s (+0.5s)	1792	1792	128	41	129	8	0	178
16391	10514s (+0.7s)	3120	3120	256	56	188	14	1	259
16392	10515s (+0.6s)	2572	2572	256	56	150	9	0	215
16393	10516s (+0.6s)	2232	2232	128	55	151	7	0	213
16394	10516s (+0.4s)	1312	1312	64	45	92	10	0	147
16395	10517s (+0.6s)	2160	2160	128	52	136	12	1	201
16396	10518s (+1.1s)	5608	5608	512	105	271	24	0	400
16397	10518s (+0.4s)	1244	1244	128	33	93	3	0	129
16398	10519s (+0.6s)	2612	2612	256	45	167	0	11	223
16399	10519s (+0.3s)	812	812	64	18	72	0	7	97
Episode	Time	Reward	Score	Highest	L	U	R	D	Steps
16400	10520s (+0.9s)	3888	3888	256	64	243	0	13	320
16401	10521s (+0.8s)	3164	3164	256	63	190	0	12	265
16402	10521s (+0.5s)	1700	1700	128	37	119	0	13	169
16403	10522s (+0.5s)	1716	1716	128	32	137	0	7	176
16404	10522s (+0.7s)	2904	2904	256	64	177	10	1	252
16405	10523s (+0.9s)	3596	3596	256	64	227	10	0	301
16406	10524s (+0.8s)	3416	3416	256	69	193	11	0	273
16407	10525s (+0.7s)	3244	3244	256	64	190	9	0	263
16408	10526s (+1.4s)	6864	6864	512	148	322	28	0	498
16409	10527s (+0.6s)	1904	1904	128	40	148	6	0	194
16410	10527s (+0.4s)	1372	1372	128	28	110	4	1	143
16411	10528s (+0.7s)	2776	2776	256	50	187	5	0	242
16412	10529s (+0.5s)	1776	1776	128	48	126	9	0	183
16413	10529s (+0.6s)	2136	2136	128	47	158	8	0	213
16414	10530s (+0.4s)	1176	1176	64	45	89	7	0	141
16415	10530s (+0.9s)	3644	3644	256	75	219	12	0	306
16416	10531s (+0.8s)	3392	3392	256	73	199	16	0	288
16417	10532s (+0.8s)	3400	3400	256	54	211	17	0	282
16418	10533s (+0.8s)	3420	3420	256	74	203	10	0	287
16419	10534s (+0.7s)	3004	3004	256	60	181	11	0	252
16420	10534s (+0.7s)	2768	2768	256	47	180	9	0	236
16421	10535s (+0.5s)	1828	1828	128	43	135	9	0	187
16422	10536s (+0.7s)	3160	3160	256	57	195	7	0	259
16423	10536s (+0.6s)	2352	2352	256	60	132	9	0	201
16424	10537s (+0.7s)	2848	2848	256	55	178	10	0	243
16425	10537s (+0.5s)	1504	1504	128	51	101	7	0	159
16426	10538s (+0.9s)	4004	4004	256	80	232	13	0	325
16427	10538s (+0.2s)	552	552	64	11	64	2	0	77
16428	10539s (+0.8s)	3204	3204	256	75	178	15	0	268
16429	10540s (+0.5s)	1824	1824	128	49	134	7	0	190
16430	10540s (+0.4s)	1492	1492	128	30	118	8	1	157
16431	10541s (+0.5s)	1708	1708	128	29	140	4	0	173
16432	10542s (+0.9s)	3968	3968	256	91	219	18	0	328
16433	10542s (+0.5s)	1840	1840	128	38	134	11	1	184
16434	10543s (+0.9s)	3784	3784	256	82	216	14	0	312
16435	10544s (+0.5s)	1816	1816	128	38	146	2	0	186
16436	10544s (+0.5s)	1884	1884	128	41	140	13	1	195
16437	10545s (+0.6s)	1940	1940	128	54	126	14	0	194
16438	10545s (+0.7s)	3172	3172	256	67	180	14	0	261
16439	10546s (+0.8s)	3192	3192	256	54	203	8	1	266
16440	10547s (+0.5s)	1600	1600	128	42	114	11	0	167
16441	10548s (+1.0s)	4432	4432	256	108	239	19	0	366
16442	10549s (+0.8s)	2852	2852	128	78	170	16	0	264
16443	10550s (+1.0s)	4332	4332	256	87	256	15	0	358
16444	10550s (+0.6s)	2416	2416	256	43	151	8	0	202
16445	10551s (+0.7s)	2552	2552	128	68	160	12	0	240
16446	10551s (+0.4s)	1384	1384	128	26	116	0	4	146
16447	10552s (+0.7s)	2664	2664	256	54	164	0	12	230
16448	10553s (+0.8s)	3264	3264	256	58	197	0	20	275
16449	10553s (+0.7s)	2728	2728	256	39	182	0	10	231
16450	10554s (+0.7s)	2760	2760	256	45	176	0	12	233
16451	10555s (+0.7s)	2916	2916	256	58	184	0	13	255
16452	10556s (+0.8s)	3612	3612	256	64	222	0	11	297
16453	10556s (+0.5s)	1552	1552	128	41	113	6	0	160
16454	10557s (+0.4s)	1524	1524	128	36	117	8	0	161
16455	10557s (+0.9s)	3564	3564	256	86	208	11	0	305
16456	10559s (+1.3s)	6604	6604	512	131	300	24	0	455
16457	10560s (+0.9s)	3828	3828	256	77	215	15	0	307
16458	10560s (+0.6s)	2416	2416	256	52	147	9	0	208
16459	10561s (+0.4s)	1404	1404	128	24	119	2	0	145
16460	10561s (+0.8s)	3236	3236	256	49	209	14	0	272
16461	10562s (+0.7s)	3136	3136	256	61	185	13	0	259
16462	10563s (+0.8s)	3472	3472	256	82	189	16	0	287
16463	10564s (+0.5s)	2360	2360	256	38	151	6	0	195
16464	10564s (+0.5s)	1908	1908	128	50	134	8	0	192
16465	10565s (+0.8s)	3548	3548	256	76	213	7	0	296
16466	10566s (+0.6s)	2712	2712	256	60	155	11	0	226
16467	10566s (+0.4s)	1472	1472	128	29	115	8	0	152
16468	10566s (+0.5s)	1732	1732	128	49	115	9	0	173
16469	10567s (+0.4s)	1304	1304	128	37	97	7	0	141
16470	10568s (+0.8s)	3496	3496	256	75	202	16	0	293
16471	10568s (+0.5s)	1496	1496	128	41	108	9	0	158
16472	10569s (+0.8s)	3404	3404	256	80	197	15	0	292
16473	10570s (+0.5s)	1624	1624	128	38	127	4	0	169
16474	10570s (+0.5s)	1724	1724	128	41	132	5	0	178
16475	10570s (+0.4s)	1476	1476	128	32	115	6	0	153
16476	10571s (+0.5s)	1836	1836	128	40	132	14	0	186
16477	10571s (+0.3s)	940	940	64	30	78	4	0	112
16478	10572s (+0.5s)	1784	1784	128	42	132	7	0	181
16479	10572s (+0.3s)	796	796	64	20	75	0	6	101
16480	10573s (+0.7s)	2792	2792	256	49	181	0	11	241
16481	10573s (+0.5s)	1796	1796	128	38	136	0	10	184
16482	10574s (+0.9s)	3788	3788	256	58	243	0	13	314
16483	10575s (+0.5s)	1740	1740	128	32	135	0	5	172
16484	10575s (+0.3s)	796	796	64	20	79	0	6	105
16485	10576s (+0.8s)	3364	3364	256	56	217	0	14	287
16486	10576s (+0.4s)	1164	1164	64	34	100	0	4	138
16487	10577s (+0.7s)	3128	3128	256	54	192	0	9	255
16488	10578s (+0.8s)	3328	3328	256	55	212	0	11	278
16489	10579s (+0.8s)	3432	3432	256	55	216	0	17	288
16490	10579s (+0.8s)	3400	3400	256	53	229	0	9	291
16491	10580s (+0.6s)	2380	2380	256	57	139	0	7	203
16492	10580s (+0.2s)	336	336	32	8	50	0	2	60
16493	10581s (+0.5s)	1684	1684	128	23	147	0	3	173
16494	10581s (+0.6s)	2376	2376	256	45	145	0	12	202
16495	10582s (+0.4s)	1184	1184	128	19	103	0	7	129
16496	10582s (+0.8s)	3176	3176	256	56	190	0	16	262
16497	10583s (+0.9s)	3872	3872	256	80	221	11	0	312
16498	10584s (+0.7s)	3024	3024	256	68	172	11	0	251
16499	10585s (+0.6s)	2652	2652	256	55	161	11	0	227
Episode	Time	Reward	Score	Highest	L	U	R	D	Steps
16500	10586s (+1.0s)	4188	4188	256	99	225	14	0	338
16501	10586s (+0.8s)	3376	3376	256	81	190	14	0	285
16502	10587s (+1.0s)	4728	4728	256	94	258	11	2	365
16503	10588s (+0.8s)	3460	3460	256	68	201	15	0	284
16504	10589s (+0.6s)	2140	2140	128	56	146	12	0	214
16505	10590s (+0.8s)	3332	3332	256	83	184	17	0	284
16506	10590s (+0.4s)	1188	1188	64	44	96	4	0	144
16507	10591s (+0.5s)	1464	1464	128	48	107	5	0	160
16508	10591s (+0.9s)	3872	3872	256	99	202	18	0	319
16509	10592s (+0.4s)	1304	1304	64	49	100	7	0	156
16510	10592s (+0.4s)	1216	1216	64	45	99	2	0	146
16511	10593s (+0.5s)	1780	1780	128	47	127	10	0	184
16512	10594s (+0.7s)	2928	2928	256	62	180	16	0	258
16513	10594s (+0.7s)	2828	2828	256	50	187	13	0	250
16514	10595s (+0.4s)	1360	1360	128	28	114	5	0	147
16515	10596s (+0.8s)	3212	3212	256	67	196	10	0	273
16516	10596s (+0.5s)	1692	1692	128	48	114	12	0	174
16517	10597s (+0.6s)	2496	2496	256	45	164	6	1	216
16518	10597s (+0.6s)	2604	2604	256	54	151	11	0	216
16519	10598s (+0.3s)	724	724	64	24	68	5	0	97
16520	10598s (+0.7s)	2916	2916	256	55	187	13	0	255
16521	10599s (+0.5s)	1704	1704	128	46	113	11	0	170
16522	10599s (+0.7s)	2736	2736	256	51	168	13	0	232
16523	10600s (+0.8s)	3536	3536	256	80	204	14	0	298
16524	10601s (+0.9s)	3932	3932	256	80	227	14	1	322
16525	10602s (+1.0s)	3928	3928	256	83	241	13	0	337
16526	10603s (+0.5s)	2020	2020	128	50	128	11	0	189
16527	10603s (+0.4s)	1184	1184	128	33	89	6	0	128
16528	10604s (+0.8s)	3440	3440	256	76	199	14	2	291
16529	10604s (+0.4s)	1348	1348	128	28	107	3	0	138
16530	10605s (+0.5s)	1812	1812	128	58	117	13	0	188
16531	10605s (+0.6s)	2332	2332	256	45	154	3	0	202
16532	10606s (+0.4s)	1452	1452	128	34	109	8	0	151
16533	10606s (+0.4s)	1192	1192	128	32	95	4	0	131
16534	10607s (+0.9s)	3688	3688	256	86	205	18	0	309
16535	10608s (+0.5s)	2096	2096	256	38	131	5	1	175
16536	10608s (+0.7s)	2928	2928	256	58	189	11	0	258
16537	10609s (+0.6s)	2424	2424	128	51	160	11	0	222
16538	10609s (+0.4s)	1380	1380	128	35	104	6	0	145
16539	10610s (+0.7s)	2828	2828	256	72	158	16	0	246
16540	10611s (+1.0s)	4264	4264	256	110	226	15	1	352
16541	10612s (+0.6s)	2364	2364	256	57	147	6	0	210
16542	10613s (+0.8s)	3460	3460	256	73	197	16	0	286
16543	10613s (+0.6s)	1948	1948	128	51	143	6	0	200
16544	10614s (+0.3s)	836	836	64	27	77	5	0	109
16545	10614s (+0.5s)	1776	1776	128	52	120	11	0	183
16546	10615s (+0.5s)	1892	1892	128	50	133	8	0	191
16547	10616s (+0.9s)	3944	3944	256	88	221	11	0	320
16548	10616s (+0.5s)	1432	1432	64	51	101	9	0	161
16549	10617s (+0.6s)	2412	2412	256	44	150	7	0	201
16550	10617s (+0.9s)	3764	3764	256	72	214	15	0	301
16551	10618s (+0.6s)	2228	2228	128	53	147	12	0	212
16552	10619s (+0.5s)	1856	1856	128	38	143	10	0	191
16553	10620s (+1.2s)	5876	5876	512	111	282	25	0	418
16554	10620s (+0.5s)	1844	1844	128	44	137	7	0	188
16555	10621s (+0.7s)	2900	2900	256	60	168	9	0	237
16556	10621s (+0.2s)	344	344	32	23	36	5	0	64
16557	10622s (+1.0s)	4296	4296	256	94	240	18	0	352
16558	10623s (+0.5s)	1596	1596	128	36	130	4	0	170
16559	10624s (+1.0s)	4256	4256	256	96	239	19	0	354
16560	10625s (+1.1s)	5452	5452	512	83	277	19	0	379
16561	10626s (+0.8s)	3472	3472	256	66	209	12	0	287
16562	10626s (+0.6s)	2492	2492	256	44	163	0	9	216
16563	10626s (+0.2s)	444	444	32	15	53	0	5	73
16564	10627s (+0.5s)	1800	1800	128	42	131	0	11	184
16565	10627s (+0.5s)	1584	1584	128	32	123	0	9	164
16566	10628s (+0.5s)	1824	1824	128	38	143	0	10	191
16567	10628s (+0.5s)	1552	1552	128	36	114	11	0	161
16568	10629s (+1.0s)	4296	4296	256	82	258	13	0	353
16569	10630s (+0.6s)	2024	2024	128	51	128	13	0	192
16570	10630s (+0.5s)	1624	1624	128	46	111	6	0	163
16571	10631s (+0.7s)	2620	2620	128	74	160	12	0	246
16572	10632s (+0.8s)	3576	3576	256	70	217	13	1	301
16573	10633s (+1.3s)	6188	6188	512	111	306	21	0	438
16574	10634s (+0.8s)	3200	3200	256	75	192	13	0	280
16575	10635s (+0.5s)	1808	1808	128	48	130	9	0	187
16576	10636s (+0.8s)	3160	3160	256	84	168	18	0	270
16577	10636s (+0.3s)	808	808	64	25	81	3	0	109
16578	10636s (+0.3s)	980	980	64	25	90	6	0	121
16579	10637s (+0.7s)	3160	3160	256	61	189	15	0	265
16580	10638s (+0.4s)	1540	1540	128	52	98	7	0	157
16581	10638s (+0.7s)	3088	3088	256	72	179	13	0	264
16582	10639s (+0.5s)	1536	1536	128	39	116	8	0	163
16583	10640s (+0.8s)	4420	4420	512	65	219	14	0	298
16584	10640s (+0.8s)	3380	3380	256	78	187	16	0	281
16585	10641s (+0.5s)	1776	1776	128	53	114	12	0	179
16586	10642s (+0.8s)	3472	3472	256	71	206	14	1	292
16587	10642s (+0.7s)	2724	2724	256	42	182	5	0	229
16588	10643s (+0.6s)	1952	1952	128	49	148	4	0	201
16589	10644s (+0.8s)	3356	3356	256	66	205	14	0	285
16590	10645s (+0.7s)	3172	3172	256	63	189	10	0	262
16591	10645s (+0.7s)	2984	2984	256	55	183	14	0	252
16592	10646s (+0.5s)	1664	1664	128	47	117	14	0	178
16593	10647s (+0.9s)	4028	4028	256	89	224	16	1	330
16594	10648s (+0.9s)	3764	3764	256	73	226	13	0	312
16595	10648s (+0.5s)	1688	1688	128	43	123	4	0	170
16596	10648s (+0.3s)	892	892	64	30	71	7	0	108
16597	10649s (+0.6s)	2552	2552	256	36	168	4	0	208
16598	10650s (+0.5s)	1808	1808	128	46	134	7	0	187
16599	10650s (+0.6s)	1972	1972	128	59	135	12	0	206
Episode	Time	Reward	Score	Highest	L	U	R	D	Steps
16600	10651s (+0.9s)	4080	4080	256	89	231	17	0	337
16601	10652s (+0.9s)	3788	3788	256	77	221	15	0	313
16602	10653s (+0.5s)	1532	1532	128	43	116	3	0	162
16603	10653s (+0.4s)	1348	1348	128	27	108	7	0	142
16604	10653s (+0.4s)	1552	1552	128	43	107	6	0	156
16605	10654s (+0.7s)	3160	3160	256	69	175	14	0	258
16606	10655s (+1.0s)	4336	4336	256	98	246	18	0	362
16607	10656s (+0.4s)	1124	1124	128	20	98	2	0	120
16608	10656s (+0.8s)	3524	3524	256	69	216	10	0	295
16609	10657s (+0.7s)	2512	2512	128	61	155	17	0	233
16610	10657s (+0.4s)	1288	1288	128	35	95	8	0	138
16611	10658s (+0.5s)	1484	1484	64	37	119	3	0	159
16612	10659s (+0.8s)	3376	3376	256	70	195	16	0	281
16613	10659s (+0.5s)	1896	1896	128	44	143	10	0	197
16614	10660s (+0.5s)	1840	1840	128	42	139	4	0	185
16615	10661s (+0.8s)	2868	2868	128	77	179	11	1	268
16616	10661s (+0.6s)	2520	2520	256	59	149	8	0	216
16617	10662s (+0.6s)	2508	2508	256	58	150	10	1	219
16618	10663s (+0.8s)	3508	3508	256	101	180	14	1	296
16619	10663s (+0.4s)	1444	1444	128	44	101	7	0	152
16620	10664s (+0.8s)	3572	3572	256	78	200	22	0	300
16621	10665s (+0.6s)	2412	2412	256	47	154	3	0	204
16622	10665s (+0.5s)	1908	1908	128	35	141	9	1	186
16623	10666s (+0.5s)	1792	1792	128	38	139	6	0	183
16624	10666s (+0.6s)	2312	2312	128	66	145	10	0	221
16625	10667s (+0.6s)	2204	2204	128	57	153	12	0	222
16626	10667s (+0.5s)	2128	2128	256	36	135	0	8	179
16627	10668s (+0.5s)	1796	1796	128	42	127	0	15	184
16628	10669s (+0.7s)	2636	2636	256	51	173	0	9	233
16629	10669s (+0.6s)	2424	2424	256	41	158	0	8	207
16630	10670s (+0.4s)	1420	1420	128	34	106	8	0	148
16631	10670s (+0.8s)	3644	3644	256	74	211	9	0	294
16632	10671s (+0.9s)	4028	4028	256	89	224	16	1	330
16633	10672s (+0.3s)	968	968	64	28	84	3	0	115
16634	10673s (+1.0s)	5364	5364	512	81	273	17	1	372
16635	10673s (+0.4s)	1412	1412	128	47	90	10	0	147
16636	10674s (+0.8s)	3536	3536	256	88	197	12	1	298
16637	10675s (+1.2s)	5776	5776	512	102	287	20	1	410
16638	10676s (+0.9s)	3840	3840	256	82	226	13	0	321
16639	10677s (+0.4s)	1204	1204	128	29	96	7	0	132
16640	10677s (+0.9s)	3984	3984	256	96	212	22	0	330
16641	10679s (+1.2s)	5872	5872	512	131	266	26	0	423
16642	10679s (+0.8s)	2756	2756	128	73	168	21	0	262
16643	10680s (+0.6s)	1912	1912	128	55	130	11	0	196
16644	10681s (+0.6s)	2420	2420	256	44	150	9	0	203
16645	10681s (+0.5s)	1752	1752	128	54	112	11	1	178
16646	10682s (+0.7s)	2916	2916	256	59	189	7	0	255
16647	10682s (+0.4s)	1416	1416	128	35	107	4	0	146
16648	10682s (+0.2s)	340	340	32	11	43	0	5	59
16649	10683s (+0.5s)	1748	1748	128	51	115	10	0	176
16650	10684s (+0.6s)	2120	2120	128	49	137	12	0	198
16651	10684s (+0.7s)	2896	2896	256	51	174	11	0	236
16652	10685s (+0.6s)	2544	2544	256	50	159	13	1	223
16653	10685s (+0.6s)	1900	1900	128	44	144	5	0	193
16654	10686s (+1.0s)	4216	4216	256	82	248	14	0	344
16655	10687s (+0.6s)	2476	2476	256	62	133	15	0	210
16656	10688s (+0.8s)	3388	3388	256	72	205	12	0	289
16657	10689s (+0.9s)	3528	3528	256	81	208	12	0	301
16658	10690s (+1.0s)	4184	4184	256	81	244	16	0	341
16659	10691s (+0.8s)	3396	3396	256	69	212	6	0	287
16660	10691s (+0.2s)	632	632	64	19	59	5	0	83
16661	10691s (+0.4s)	1420	1420	128	32	109	4	0	145
16662	10692s (+0.8s)	3544	3544	256	79	212	13	0	304
16663	10693s (+0.4s)	1464	1464	128	31	116	4	0	151
16664	10693s (+0.9s)	4056	4056	256	86	230	20	0	336
16665	10694s (+0.6s)	2788	2788	256	67	162	11	0	240
16666	10694s (+0.4s)	1248	1248	128	23	104	2	0	129
16667	10695s (+0.6s)	2012	2012	128	51	138	12	0	201
16668	10695s (+0.5s)	1600	1600	128	33	114	11	0	158
16669	10696s (+0.3s)	904	904	64	27	75	5	0	107
16670	10697s (+1.3s)	6284	6284	512	124	293	25	0	442
16671	10698s (+0.5s)	1676	1676	128	29	130	6	0	165
16672	10698s (+0.5s)	1496	1496	128	28	125	4	0	157
16673	10699s (+0.5s)	1796	1796	128	46	131	7	0	184
16674	10699s (+0.3s)	680	680	64	28	61	5	0	94
16675	10700s (+0.7s)	2764	2764	256	55	176	8	0	239
16676	10700s (+0.3s)	736	736	64	26	70	1	0	97
16677	10701s (+0.8s)	3372	3372	256	66	197	16	1	280
16678	10701s (+0.7s)	2780	2780	256	57	174	7	0	238
16679	10702s (+0.5s)	1600	1600	128	37	122	8	0	167
16680	10703s (+0.9s)	3856	3856	256	85	212	18	0	315
16681	10704s (+0.9s)	3904	3904	256	86	218	11	0	315
16682	10704s (+0.6s)	2636	2636	256	58	165	11	0	234
16683	10705s (+0.6s)	1908	1908	128	54	128	11	0	193
16684	10705s (+0.6s)	2396	2396	256	45	148	8	0	201
16685	10706s (+0.5s)	1624	1624	128	46	114	9	0	169
16686	10707s (+0.7s)	3140	3140	256	63	181	13	1	258
16687	10708s (+0.9s)	3592	3592	256	69	221	10	0	300
16688	10708s (+0.5s)	2012	2012	128	48	131	10	1	190
16689	10709s (+0.6s)	2192	2192	128	51	150	7	0	208
16690	10709s (+0.4s)	1440	1440	128	44	98	7	0	149
16691	10710s (+0.7s)	2932	2932	256	45	189	0	11	245
16692	10711s (+0.9s)	3668	3668	256	58	233	0	14	305
16693	10711s (+0.6s)	2540	2540	256	46	162	0	8	216
16694	10712s (+0.4s)	1152	1152	128	17	106	0	3	126
16695	10712s (+0.3s)	768	768	64	14	86	0	4	104
16696	10713s (+0.7s)	2672	2672	128	42	191	0	14	247
16697	10714s (+0.8s)	3600	3600	256	74	201	13	1	289
16698	10714s (+0.8s)	3340	3340	256	59	212	10	0	281
16699	10715s (+1.0s)	4940	4940	512	104	224	18	0	346
Episode	Time	Reward	Score	Highest	L	U	R	D	Steps
16700	10716s (+0.5s)	1808	1808	128	52	117	8	0	177
16701	10716s (+0.4s)	1304	1304	128	32	93	7	0	132
16702	10717s (+0.7s)	2792	2792	256	62	163	16	0	241
16703	10718s (+1.2s)	5788	5788	512	112	278	22	1	413
16704	10719s (+0.9s)	3852	3852	256	90	215	17	0	322
16705	10720s (+0.8s)	3404	3404	256	71	199	12	0	282
16706	10720s (+0.5s)	1904	1904	128	40	149	5	0	194
16707	10721s (+0.3s)	860	860	64	25	80	5	1	111
16708	10721s (+0.7s)	2820	2820	256	61	164	14	2	241
16709	10722s (+0.6s)	1856	1856	128	36	153	5	0	194
16710	10723s (+0.8s)	3472	3472	256	65	209	13	0	287
16711	10723s (+0.4s)	1468	1468	128	40	101	8	0	149
16712	10724s (+0.8s)	3184	3184	256	64	186	13	0	263
16713	10725s (+1.3s)	6440	6440	512	122	307	28	0	457
16714	10726s (+0.7s)	2808	2808	256	75	148	16	0	239
16715	10727s (+0.7s)	3144	3144	256	69	184	8	0	261
16716	10727s (+0.7s)	2992	2992	256	68	175	16	1	260
16717	10728s (+0.8s)	3440	3440	256	74	198	12	0	284
16718	10729s (+0.7s)	2816	2816	256	65	164	12	0	241
16719	10730s (+1.1s)	4648	4648	256	92	272	20	0	384
16720	10731s (+0.7s)	2612	2612	128	73	164	11	0	248
16721	10732s (+0.7s)	2908	2908	256	58	182	13	0	253
16722	10732s (+0.5s)	2272	2272	256	38	158	2	0	198
16723	10732s (+0.3s)	856	856	64	23	82	5	0	110
16724	10733s (+0.2s)	624	624	64	12	69	0	5	86
16725	10733s (+0.4s)	1336	1336	128	29	103	4	0	136
16726	10734s (+0.5s)	1576	1576	128	42	118	5	1	166
16727	10734s (+0.6s)	2880	2880	256	48	175	10	0	233
16728	10735s (+0.4s)	1320	1320	128	30	95	7	0	132
16729	10735s (+0.9s)	4236	4236	256	84	229	16	1	330
16730	10736s (+0.6s)	1908	1908	128	50	139	6	0	195
16731	10736s (+0.3s)	700	700	64	24	65	4	0	93
16732	10737s (+0.7s)	3064	3064	256	57	195	9	0	261
16733	10738s (+1.0s)	4380	4380	256	115	227	22	0	364
16734	10739s (+0.8s)	3404	3404	256	73	198	15	0	286
16735	10740s (+0.9s)	4024	4024	256	90	215	20	0	325
16736	10741s (+1.2s)	5376	5376	256	121	274	28	0	423
16737	10742s (+0.5s)	1672	1672	128	52	110	8	0	170
16738	10742s (+0.9s)	3876	3876	256	86	217	17	0	320
16739	10743s (+0.8s)	3432	3432	256	71	208	10	0	289
16740	10744s (+0.8s)	2932	2932	256	54	194	10	1	259
16741	10745s (+0.5s)	1616	1616	128	44	109	9	0	162
16742	10745s (+0.7s)	2660	2660	256	53	163	12	1	229
16743	10746s (+0.7s)	3108	3108	256	55	188	12	1	256
16744	10746s (+0.5s)	1704	1704	128	40	122	9	0	171
16745	10747s (+0.6s)	1852	1852	128	53	125	15	0	193
16746	10748s (+0.9s)	3976	3976	256	95	208	19	0	322
16747	10749s (+0.6s)	2328	2328	128	44	164	16	0	224
16748	10749s (+0.5s)	1740	1740	128	51	116	8	0	175
16749	10750s (+0.7s)	2848	2848	256	57	168	11	0	236
16750	10750s (+0.4s)	1100	1100	64	34	88	6	0	128
16751	10750s (+0.3s)	700	700	64	28	62	3	0	93
16752	10751s (+0.8s)	3660	3660	256	67	221	10	0	298
16753	10752s (+0.6s)	2612	2612	256	45	164	11	0	220
16754	10752s (+0.3s)	760	760	64	27	70	5	0	102
16755	10753s (+0.6s)	2476	2476	256	55	156	8	0	219
16756	10753s (+0.4s)	1104	1104	64	37	84	6	0	127
16757	10754s (+0.4s)	1500	1500	128	31	120	7	1	159
16758	10754s (+0.4s)	1568	1568	128	36	119	0	6	161
16759	10755s (+0.8s)	3428	3428	256	66	204	0	18	288
16760	10756s (+0.9s)	4004	4004	256	72	251	0	12	335
16761	10756s (+0.6s)	2636	2636	256	39	183	0	7	229
16762	10757s (+0.8s)	3364	3364	256	60	220	0	8	288
16763	10758s (+0.2s)	616	616	64	20	58	0	5	83
16764	10758s (+0.5s)	1816	1816	128	34	152	3	0	189
16765	10759s (+0.9s)	3528	3528	256	81	201	15	0	297
16766	10760s (+1.0s)	4480	4480	256	107	248	18	0	373
16767	10761s (+1.0s)	4364	4364	256	103	234	23	0	360
16768	10762s (+0.5s)	1760	1760	128	38	137	5	0	180
16769	10762s (+0.9s)	3532	3532	256	89	192	20	1	302
16770	10763s (+0.4s)	1432	1432	128	44	96	7	0	147
16771	10763s (+0.6s)	2728	2728	256	56	143	16	0	215
16772	10764s (+0.5s)	1884	1884	128	37	147	5	0	189
16773	10765s (+0.6s)	2484	2484	256	40	159	10	1	210
16774	10765s (+0.7s)	2740	2740	256	60	165	9	0	234
16775	10766s (+0.9s)	3892	3892	256	81	225	17	0	323
16776	10766s (+0.2s)	584	584	64	17	58	3	0	78
16777	10767s (+0.5s)	1528	1528	128	36	117	8	0	161
16778	10767s (+0.4s)	924	924	64	33	85	4	0	122
16779	10768s (+0.7s)	2764	2764	256	59	166	10	0	235
16780	10768s (+0.3s)	720	720	64	21	71	4	0	96
16781	10769s (+0.6s)	2260	2260	256	39	142	13	0	194
16782	10769s (+0.5s)	1800	1800	128	50	120	9	0	179
16783	10770s (+0.7s)	3128	3128	256	52	192	11	0	255
16784	10771s (+0.5s)	1772	1772	128	42	126	7	0	175
16785	10772s (+1.0s)	4088	4088	256	86	245	8	0	339
16786	10773s (+1.0s)	4264	4264	256	99	228	14	0	341
16787	10773s (+0.5s)	1796	1796	128	43	133	8	0	184
16788	10774s (+0.8s)	3220	3220	256	78	174	17	0	269
16789	10774s (+0.5s)	1620	1620	128	40	123	9	0	172
16790	10775s (+0.4s)	1100	1100	64	40	85	9	0	134
16791	10775s (+0.5s)	1828	1828	128	54	123	10	1	188
16792	10776s (+0.8s)	3316	3316	256	62	206	12	0	280
16793	10777s (+0.6s)	2852	2852	256	62	164	8	0	234
16794	10778s (+0.9s)	4104	4104	256	92	224	17	0	333
16795	10778s (+0.6s)	2240	2240	128	46	156	12	1	215
16796	10779s (+0.4s)	1056	1056	64	24	95	5	0	124
16797	10779s (+0.6s)	1936	1936	128	59	128	9	0	196
16798	10780s (+0.7s)	3092	3092	256	58	180	15	0	253
16799	10780s (+0.3s)	1096	1096	128	23	93	4	0	120
Episode	Time	Reward	Score	Highest	L	U	R	D	Steps
16800	10781s (+0.3s)	928	928	64	23	84	4	1	112
16801	10782s (+1.0s)	4220	4220	256	90	242	17	0	349
16802	10782s (+0.4s)	1392	1392	128	37	105	6	0	148
16803	10783s (+0.6s)	2648	2648	256	43	169	0	11	223
16804	10783s (+0.5s)	1548	1548	128	37	116	0	13	166
16805	10784s (+0.5s)	1712	1712	128	39	129	0	7	175
16806	10784s (+0.7s)	2768	2768	256	54	176	6	0	236
16807	10785s (+0.4s)	1384	1384	128	32	104	6	0	142
16808	10785s (+0.4s)	1480	1480	128	30	117	8	0	155
16809	10786s (+0.4s)	1496	1496	128	36	104	6	0	146
16810	10786s (+0.7s)	2996	2996	256	60	168	11	0	239
16811	10787s (+0.5s)	1680	1680	128	46	115	10	0	171
16812	10787s (+0.5s)	1608	1608	128	36	125	8	0	169
16813	10788s (+0.6s)	2492	2492	256	36	160	9	0	205
16814	10788s (+0.4s)	1348	1348	128	27	107	0	5	139
16815	10789s (+0.8s)	3388	3388	256	56	213	0	14	283
16816	10790s (+0.5s)	1940	1940	128	39	140	0	9	188
16817	10790s (+0.4s)	936	936	64	26	89	0	9	124
16818	10791s (+0.5s)	1752	1752	128	32	138	0	9	179
16819	10791s (+0.8s)	3572	3572	256	53	238	0	13	304
16820	10792s (+0.8s)	3232	3232	256	50	214	7	0	271
16821	10793s (+0.7s)	3180	3180	256	69	177	17	0	263
16822	10793s (+0.4s)	1072	1072	64	28	97	6	0	131
16823	10794s (+0.7s)	3024	3024	256	88	154	10	1	253
16824	10795s (+0.7s)	2828	2828	256	63	165	15	0	243
16825	10795s (+0.3s)	744	744	64	23	77	5	0	105
16826	10795s (+0.4s)	1332	1332	128	27	108	3	0	138
16827	10796s (+0.3s)	864	864	64	32	74	6	0	112
16828	10796s (+0.5s)	1704	1704	128	39	134	3	0	176
16829	10797s (+0.3s)	752	752	64	23	74	4	0	101
16830	10797s (+0.4s)	1456	1456	128	33	111	0	6	150
16831	10798s (+0.9s)	3668	3668	256	68	215	0	17	300
16832	10799s (+0.9s)	4080	4080	256	76	232	0	19	327
16833	10799s (+0.5s)	1796	1796	128	38	137	0	9	184
16834	10800s (+0.7s)	2808	2808	256	62	167	16	0	245
16835	10801s (+0.8s)	3316	3316	256	79	190	11	0	280
16836	10802s (+0.9s)	3980	3980	256	78	237	14	0	329
16837	10802s (+0.5s)	1816	1816	128	39	144	5	0	188
16838	10804s (+1.3s)	6360	6360	512	116	314	19	0	449
16839	10804s (+0.6s)	2160	2160	128	50	140	10	0	200
16840	10805s (+0.9s)	3804	3804	256	72	232	13	0	317
16841	10806s (+0.6s)	2228	2228	128	57	143	11	1	212
16842	10806s (+0.3s)	880	880	64	27	75	6	1	109
16843	10807s (+1.0s)	4420	4420	256	81	266	16	0	363
16844	10808s (+0.5s)	1816	1816	128	36	146	6	0	188
16845	10808s (+0.7s)	2856	2856	256	52	185	8	0	245
16846	10809s (+0.7s)	2768	2768	256	56	173	10	0	239
16847	10810s (+0.6s)	2456	2456	256	56	145	11	1	213
16848	10810s (+0.5s)	1632	1632	128	39	129	6	0	174
16849	10811s (+0.5s)	2060	2060	128	51	132	8	1	192
16850	10811s (+0.7s)	2992	2992	256	67	163	14	1	245
16851	10812s (+0.5s)	1876	1876	128	37	143	7	0	187
16852	10813s (+0.8s)	3412	3412	256	76	194	14	0	284
16853	10813s (+0.4s)	1460	1460	128	45	101	6	0	152
16854	10814s (+0.5s)	1512	1512	128	30	125	6	0	161
16855	10814s (+0.3s)	816	816	64	12	85	0	4	101
16856	10815s (+0.5s)	1552	1552	128	31	130	0	6	167
16857	10815s (+0.2s)	580	580	64	15	61	0	3	79
16858	10816s (+0.8s)	3668	3668	256	58	226	0	17	301
16859	10816s (+0.8s)	3504	3504	256	53	226	0	13	292
16860	10817s (+0.7s)	3128	3128	256	66	185	10	0	261
16861	10817s (+0.3s)	768	768	64	17	77	3	1	98
16862	10818s (+0.4s)	1300	1300	128	30	106	5	0	141
16863	10819s (+0.7s)	3016	3016	256	55	177	12	1	245
16864	10819s (+0.7s)	2900	2900	256	69	170	12	0	251
16865	10820s (+0.8s)	3392	3392	256	77	191	9	0	277
16866	10821s (+0.5s)	1520	1520	128	48	106	8	1	163
16867	10821s (+0.7s)	2908	2908	256	59	185	9	0	253
16868	10822s (+0.4s)	1268	1268	128	23	112	5	0	140
16869	10822s (+0.5s)	1644	1644	128	34	127	8	1	170
16870	10823s (+0.5s)	1860	1860	128	31	149	0	8	188
16871	10823s (+0.5s)	1608	1608	128	37	120	0	11	168
16872	10824s (+1.0s)	4296	4296	256	63	280	0	17	360
16873	10825s (+0.4s)	1216	1216	64	44	97	5	0	146
16874	10825s (+0.5s)	1848	1848	128	51	122	13	0	186
16875	10826s (+0.5s)	1564	1564	128	36	120	7	0	163
16876	10826s (+0.8s)	3244	3244	256	69	191	13	0	273
16877	10827s (+0.7s)	2620	2620	256	71	146	13	0	230
16878	10828s (+0.9s)	3972	3972	256	82	229	18	0	329
16879	10829s (+1.0s)	4812	4812	512	89	239	13	0	341
16880	10830s (+0.5s)	1664	1664	128	42	120	6	1	169
16881	10830s (+0.5s)	2280	2280	256	57	119	11	2	189
16882	10831s (+0.8s)	3296	3296	256	73	189	13	0	275
16883	10832s (+0.9s)	3928	3928	256	86	215	20	0	321
16884	10833s (+0.7s)	2932	2932	256	58	189	12	0	259
16885	10833s (+0.8s)	3208	3208	256	67	183	16	0	266
16886	10834s (+0.7s)	3196	3196	256	61	195	6	0	262
16887	10835s (+0.7s)	3220	3220	256	66	187	9	0	262
16888	10836s (+0.8s)	2892	2892	128	72	186	12	0	270
16889	10836s (+0.7s)	3220	3220	256	63	193	12	0	268
16890	10837s (+0.8s)	3460	3460	256	74	197	13	0	284
16891	10837s (+0.3s)	684	684	32	26	65	3	0	94
16892	10838s (+0.5s)	1800	1800	128	40	142	3	0	185
16893	10839s (+1.3s)	6508	6508	512	108	341	20	0	469
16894	10840s (+0.7s)	2824	2824	256	69	163	17	0	249
16895	10841s (+0.5s)	1784	1784	128	40	135	6	0	181
16896	10841s (+0.4s)	1348	1348	128	40	103	5	0	148
16897	10842s (+1.2s)	5912	5912	512	107	306	14	0	427
16898	10843s (+1.0s)	4152	4152	256	101	224	15	0	340
16899	10844s (+0.6s)	1992	1992	128	61	126	14	0	201
Episode	Time	Reward	Score	Highest	L	U	R	D	Steps
16900	10845s (+0.6s)	1960	1960	128	51	143	9	0	203
16901	10845s (+0.9s)	3560	3560	256	70	220	9	0	299
16902	10846s (+0.6s)	1968	1968	128	54	141	10	0	205
16903	10846s (+0.4s)	1452	1452	128	40	104	8	0	152
16904	10847s (+0.5s)	1840	1840	128	52	124	11	0	187
16905	10848s (+0.9s)	3628	3628	256	76	213	21	0	310
16906	10848s (+0.5s)	1960	1960	128	44	125	9	1	179
16907	10849s (+0.5s)	1752	1752	128	41	131	4	0	176
16908	10850s (+0.7s)	2788	2788	256	54	174	12	0	240
16909	10850s (+0.7s)	2728	2728	256	66	160	14	0	240
16910	10851s (+0.3s)	972	972	64	26	91	6	0	123
16911	10851s (+0.5s)	1940	1940	128	42	128	8	0	178
16912	10852s (+0.9s)	3852	3852	256	66	247	0	11	324
16913	10853s (+0.6s)	2452	2452	256	46	152	0	11	209
16914	10853s (+0.5s)	1532	1532	128	32	125	0	5	162
16915	10854s (+0.7s)	3176	3176	256	50	207	0	10	267
16916	10854s (+0.5s)	2296	2296	256	39	135	0	14	188
16917	10855s (+0.5s)	1792	1792	128	44	135	0	4	183
16918	10856s (+0.7s)	2808	2808	256	59	179	0	7	245
16919	10856s (+0.3s)	800	800	64	24	74	0	9	107
16920	10856s (+0.6s)	2556	2556	256	48	173	0	4	225
16921	10857s (+0.7s)	2428	2428	128	48	172	0	10	230
16922	10858s (+0.5s)	1792	1792	128	30	146	0	7	183
16923	10858s (+0.6s)	2484	2484	256	47	151	0	8	206
16924	10859s (+1.1s)	4536	4536	256	82	274	0	20	376
16925	10860s (+0.6s)	2336	2336	256	41	141	0	15	197
16926	10860s (+0.5s)	2140	2140	256	35	139	0	7	181
16927	10861s (+0.5s)	1628	1628	128	40	124	0	10	174
16928	10862s (+0.9s)	3756	3756	256	70	228	0	18	316
16929	10862s (+0.6s)	1908	1908	128	46	140	0	9	195
16930	10863s (+0.3s)	996	996	128	19	81	0	4	104
16931	10863s (+0.5s)	1532	1532	128	39	115	7	0	161
16932	10864s (+1.0s)	4040	4040	256	100	223	16	0	339
16933	10865s (+0.7s)	2916	2916	256	47	185	8	0	240
16934	10866s (+0.8s)	3424	3424	256	74	201	13	0	288
16935	10866s (+0.7s)	2624	2624	256	55	164	12	0	231
16936	10868s (+1.1s)	5688	5688	512	106	274	18	0	398
16937	10868s (+0.3s)	752	752	64	25	66	5	0	96
16938	10869s (+0.7s)	2500	2500	128	66	158	12	0	236
16939	10869s (+0.3s)	748	748	64	18	78	3	0	99
16940	10870s (+0.8s)	3268	3268	256	70	178	15	2	265
16941	10870s (+0.8s)	3480	3480	256	52	225	14	0	291
16942	10871s (+0.8s)	3192	3192	256	64	190	12	0	266
16943	10872s (+0.5s)	1812	1812	128	49	128	11	0	188
16944	10872s (+0.5s)	1624	1624	128	50	116	7	0	173
16945	10873s (+0.6s)	2468	2468	256	43	161	7	0	211
16946	10873s (+0.5s)	1668	1668	128	45	130	4	0	179
16947	10874s (+0.8s)	3504	3504	256	76	207	9	0	292
16948	10875s (+0.6s)	2608	2608	256	58	157	12	0	227
16949	10876s (+0.9s)	3764	3764	256	81	218	17	0	316
16950	10876s (+0.7s)	2816	2816	256	57	178	11	0	246
16951	10877s (+0.5s)	2224	2224	256	33	151	8	0	192
16952	10878s (+0.7s)	3004	3004	256	71	164	11	0	246
16953	10878s (+0.5s)	1904	1904	128	43	145	6	0	194
16954	10879s (+0.6s)	2384	2384	256	55	136	12	0	203
16955	10879s (+0.6s)	1924	1924	128	53	137	9	0	199
16956	10880s (+0.7s)	2780	2780	128	64	185	13	0	262
16957	10881s (+0.8s)	3008	3008	128	78	182	11	0	271
16958	10881s (+0.5s)	1780	1780	128	35	136	9	0	180
16959	10882s (+0.7s)	2956	2956	256	68	177	16	0	261
16960	10883s (+0.8s)	2984	2984	256	70	177	18	0	265
16961	10884s (+0.5s)	1812	1812	128	42	137	8	0	187
16962	10884s (+0.5s)	1868	1868	128	53	125	11	1	190
16963	10885s (+1.2s)	5752	5752	512	102	282	20	1	405
16964	10886s (+0.8s)	3416	3416	256	86	185	18	0	289
16965	10887s (+0.5s)	1900	1900	128	52	134	7	0	193
16966	10888s (+1.1s)	5288	5288	512	98	257	17	1	373
16967	10888s (+0.5s)	1916	1916	128	42	147	7	1	197
16968	10889s (+0.6s)	2348	2348	128	70	136	15	1	222
16969	10890s (+0.8s)	3308	3308	256	65	206	14	0	285
16970	10891s (+1.1s)	5496	5496	512	100	271	17	0	388
16971	10892s (+1.0s)	4316	4316	256	93	244	16	0	353
16972	10893s (+0.7s)	3036	3036	256	64	185	13	0	262
16973	10893s (+0.6s)	2648	2648	256	55	158	9	0	222
16974	10894s (+0.5s)	1564	1564	128	37	115	11	0	163
16975	10894s (+0.7s)	2836	2836	256	41	197	0	9	247
16976	10895s (+0.6s)	2588	2588	256	45	169	1	8	223
16977	10896s (+0.6s)	2488	2488	256	41	166	0	7	214
16978	10896s (+0.7s)	2820	2820	256	60	172	1	15	248
16979	10897s (+0.8s)	3268	3268	256	55	209	0	11	275
16980	10898s (+0.8s)	3484	3484	256	53	222	0	17	292
16981	10899s (+0.7s)	3096	3096	256	46	190	0	18	254
16982	10899s (+0.5s)	2016	2016	256	35	119	0	12	166
16983	10900s (+0.5s)	1812	1812	128	32	150	0	6	188
16984	10900s (+0.4s)	1508	1508	128	40	115	5	0	160
16985	10901s (+0.5s)	1576	1576	128	32	124	6	0	162
16986	10901s (+0.5s)	1604	1604	128	34	126	8	0	168
16987	10902s (+0.9s)	4664	4664	512	65	234	15	1	315
16988	10903s (+0.6s)	2412	2412	256	44	154	8	1	207
16989	10903s (+0.7s)	2796	2796	256	56	180	10	0	246
16990	10904s (+0.7s)	2860	2860	256	63	163	11	0	237
16991	10904s (+0.3s)	880	880	64	28	81	5	0	114
16992	10905s (+0.5s)	1896	1896	128	52	131	9	0	192
16993	10906s (+0.7s)	2852	2852	256	53	188	10	0	251
16994	10907s (+1.0s)	4076	4076	256	91	237	13	0	341
16995	10907s (+0.3s)	664	664	64	17	67	3	0	87
16996	10908s (+0.7s)	3108	3108	256	53	196	12	0	261
16997	10908s (+0.4s)	1564	1564	128	34	118	0	10	162
16998	10909s (+0.5s)	1972	1972	128	36	154	0	7	197
16999	10909s (+0.3s)	1004	1004	64	24	92	0	4	120
Episode	Time	Reward	Score	Highest	L	U	R	D	Steps
17000	10909s (+0.3s)	972	972	64	17	95	0	7	119
17001	10910s (+0.4s)	1484	1484	128	33	113	8	0	154
17002	10910s (+0.4s)	1268	1268	64	45	90	7	0	142
17003	10911s (+0.8s)	3808	3808	256	73	221	14	0	308
17004	10911s (+0.4s)	1208	1208	128	30	92	6	0	128
17005	10912s (+0.6s)	2352	2352	256	53	143	11	0	207
17006	10912s (+0.3s)	832	832	64	30	73	6	0	109
17007	10913s (+0.7s)	2744	2744	256	58	168	8	0	234
17008	10913s (+0.6s)	1928	1928	128	51	143	6	0	200
17009	10914s (+0.8s)	3492	3492	256	63	213	15	1	292
17010	10915s (+1.1s)	4608	4608	256	96	263	19	0	378
17011	10916s (+1.0s)	5420	5420	512	98	260	15	2	375
17012	10917s (+1.0s)	4308	4308	256	88	252	18	1	359
17013	10918s (+0.5s)	1896	1896	128	51	134	7	0	192
17014	10918s (+0.3s)	1052	1052	128	23	85	4	0	112
17015	10919s (+0.5s)	2104	2104	256	41	134	3	0	178
17016	10920s (+0.8s)	3340	3340	256	76	190	15	0	281
17017	10920s (+0.6s)	2404	2404	128	63	153	8	0	224
17018	10921s (+0.8s)	3380	3380	256	69	206	6	0	281
17019	10922s (+0.5s)	1812	1812	128	50	127	6	0	183
17020	10923s (+1.0s)	4552	4552	256	93	236	23	1	353
17021	10923s (+0.5s)	1648	1648	128	38	121	9	0	168
17022	10924s (+0.7s)	3048	3048	256	59	189	9	0	257
17023	10925s (+0.7s)	3160	3160	256	68	180	16	0	264
17024	10925s (+0.5s)	1908	1908	128	52	137	6	0	195
17025	10925s (+0.4s)	1128	1128	64	30	99	5	0	134
17026	10926s (+0.5s)	1624	1624	128	40	118	7	0	165
17027	10927s (+0.7s)	2924	2924	256	61	188	8	0	257
17028	10927s (+0.7s)	2904	2904	256	64	178	10	0	252
17029	10928s (+0.9s)	3788	3788	256	80	219	14	0	313
17030	10930s (+1.3s)	6508	6508	512	136	313	20	0	469
17031	10930s (+0.6s)	2548	2548	256	64	143	17	0	224
17032	10931s (+0.6s)	1892	1892	128	48	147	7	1	203
17033	10931s (+0.4s)	1500	1500	128	28	122	0	6	156
17034	10932s (+0.5s)	1580	1580	128	29	130	0	8	167
17035	10932s (+0.5s)	1740	1740	128	36	128	0	11	175
17036	10933s (+0.6s)	2524	2524	256	50	158	11	0	219
17037	10933s (+0.5s)	1748	1748	128	44	124	8	0	176
17038	10934s (+0.6s)	2048	2048	128	49	141	13	0	203
17039	10935s (+0.5s)	1908	1908	128	44	140	8	0	192
17040	10935s (+0.3s)	736	736	64	24	66	6	1	97
17041	10935s (+0.7s)	2640	2640	256	44	178	0	12	234
17042	10936s (+0.7s)	2860	2860	256	64	170	0	12	246
17043	10937s (+0.4s)	1472	1472	128	35	111	1	9	156
17044	10937s (+0.3s)	820	820	64	19	77	0	5	101
17045	10938s (+0.9s)	3852	3852	256	70	225	0	19	314
17046	10939s (+0.7s)	2792	2792	256	48	186	10	1	245
17047	10939s (+0.6s)	1932	1932	128	58	133	7	0	198
17048	10939s (+0.1s)	236	236	32	10	30	3	0	43
17049	10940s (+0.6s)	2432	2432	128	53	162	8	0	223
17050	10941s (+0.7s)	2976	2976	256	84	170	11	0	265
17051	10942s (+1.0s)	4996	4996	512	86	245	16	1	348
17052	10942s (+0.5s)	1580	1580	128	31	128	7	0	166
17053	10943s (+0.7s)	2740	2740	256	68	154	8	0	230
17054	10943s (+0.3s)	876	876	64	31	78	5	0	114
17055	10944s (+0.7s)	3092	3092	256	66	177	10	1	254
17056	10945s (+0.7s)	2420	2420	128	46	175	7	1	229
17057	10945s (+0.8s)	3324	3324	256	76	188	14	0	278
17058	10946s (+0.7s)	2556	2556	128	71	154	13	0	238
17059	10947s (+0.9s)	3580	3580	256	79	209	13	0	301
17060	10947s (+0.5s)	1620	1620	128	43	123	6	0	172
17061	10948s (+1.0s)	4316	4316	256	102	234	21	0	357
17062	10949s (+0.3s)	1032	1032	128	29	79	1	0	109
17063	10950s (+1.0s)	4244	4244	256	97	238	16	0	351
17064	10951s (+0.8s)	3432	3432	256	79	195	15	0	289
17065	10952s (+1.0s)	4240	4240	256	126	204	21	0	351
17066	10952s (+0.7s)	2792	2792	256	50	178	12	0	240
17067	10954s (+1.3s)	6644	6644	512	121	310	21	4	456
17068	10954s (+0.4s)	1484	1484	128	29	123	3	0	155
17069	10955s (+0.7s)	2284	2284	128	65	157	7	0	229
17070	10955s (+0.5s)	1708	1708	128	48	112	11	1	172
17071	10956s (+0.5s)	1672	1672	128	33	143	5	0	181
17072	10956s (+0.6s)	1924	1924	128	53	137	9	0	199
17073	10957s (+1.0s)	4300	4300	256	95	236	20	0	351
17074	10958s (+0.5s)	1788	1788	128	29	152	1	0	182
17075	10959s (+1.0s)	4276	4276	256	98	244	17	0	359
17076	10960s (+0.8s)	3420	3420	256	60	215	11	0	286
17077	10960s (+0.5s)	1824	1824	128	40	134	11	0	185
17078	10961s (+0.8s)	3472	3472	256	57	221	13	0	291
17079	10962s (+0.7s)	2500	2500	128	65	157	15	0	237
17080	10962s (+0.7s)	2940	2940	256	53	180	11	0	244
17081	10963s (+0.7s)	2908	2908	256	48	174	9	0	231
17082	10964s (+0.6s)	2460	2460	256	49	154	5	0	208
17083	10965s (+1.3s)	6632	6632	512	135	322	25	1	483
17084	10965s (+0.2s)	568	568	32	25	57	4	0	86
17085	10965s (+0.2s)	488	488	32	17	59	2	0	78
17086	10966s (+0.6s)	2408	2408	256	49	141	10	0	200
17087	10967s (+0.8s)	3140	3140	256	73	185	10	0	268
17088	10967s (+0.3s)	804	804	64	19	87	2	0	108
17089	10968s (+0.6s)	2172	2172	128	55	151	11	0	217
17090	10968s (+0.4s)	1460	1460	128	35	112	5	0	152
17091	10969s (+0.5s)	1608	1608	128	42	119	8	0	169
17092	10969s (+0.6s)	2352	2352	256	49	138	9	0	196
17093	10970s (+0.7s)	2852	2852	256	67	175	9	0	251
17094	10970s (+0.3s)	808	808	64	20	83	6	0	109
17095	10971s (+0.8s)	3492	3492	256	63	212	17	0	292
17096	10972s (+0.6s)	2556	2556	256	61	143	14	1	219
17097	10972s (+0.4s)	1432	1432	128	30	111	5	0	146
17098	10973s (+0.6s)	2660	2660	256	57	162	10	0	229
17099	10974s (+1.0s)	4244	4244	256	81	255	15	0	351
Episode	Time	Reward	Score	Highest	L	U	R	D	Steps
17100	10975s (+0.8s)	3532	3532	256	62	216	13	0	291
17101	10976s (+1.2s)	5988	5988	512	133	274	20	0	427
17102	10976s (+0.6s)	1908	1908	128	34	156	5	0	195
17103	10977s (+0.5s)	1792	1792	128	42	127	7	0	176
17104	10978s (+0.7s)	2844	2844	256	57	177	15	0	249
17105	10979s (+1.1s)	4516	4516	256	91	257	23	0	371
17106	10979s (+0.4s)	1584	1584	128	52	102	10	0	164
17107	10980s (+0.4s)	1432	1432	128	32	106	9	0	147
17108	10980s (+0.2s)	352	352	32	12	48	2	0	62
17109	10981s (+0.7s)	2820	2820	256	46	188	0	14	248
17110	10981s (+0.9s)	3700	3700	256	61	229	0	13	303
17111	10982s (+0.4s)	1192	1192	128	26	96	0	5	127
17112	10982s (+0.4s)	1456	1456	128	33	107	0	8	148
17113	10983s (+0.7s)	3244	3244	256	48	211	0	5	264
17114	10983s (+0.3s)	752	752	64	23	66	0	4	93
17115	10984s (+0.6s)	2476	2476	256	42	162	0	7	211
17116	10984s (+0.6s)	2512	2512	256	44	159	0	7	210
17117	10985s (+0.5s)	1624	1624	128	34	131	0	8	173
17118	10986s (+1.0s)	4276	4276	256	80	248	19	0	347
17119	10986s (+0.4s)	1240	1240	128	42	82	7	0	131
17120	10987s (+0.9s)	3768	3768	256	77	215	16	0	308
17121	10988s (+0.6s)	2328	2328	256	40	148	8	0	196
17122	10989s (+0.7s)	3012	3012	256	75	161	14	0	250
17123	10989s (+0.7s)	2844	2844	256	63	176	10	0	249
17124	10990s (+0.7s)	2928	2928	256	75	170	13	0	258
17125	10991s (+0.6s)	2592	2592	256	51	162	10	0	223
17126	10991s (+0.6s)	2216	2216	128	61	137	11	0	209
17127	10992s (+1.0s)	5036	5036	512	80	255	16	1	352
17128	10993s (+0.9s)	3964	3964	256	78	230	17	0	325
17129	10993s (+0.4s)	1112	1112	128	32	85	6	0	123
17130	10994s (+0.5s)	1724	1724	128	39	126	7	0	172
17131	10995s (+0.7s)	2760	2760	256	56	168	13	1	238
17132	10995s (+0.7s)	3056	3056	256	56	183	10	0	249
17133	10996s (+1.1s)	4648	4648	256	116	247	29	0	392
17134	10997s (+0.6s)	2476	2476	256	50	155	5	2	212
17135	10998s (+0.6s)	1824	1824	128	40	147	3	0	190
17136	10998s (+0.5s)	1516	1516	128	39	110	7	0	156
17137	10999s (+0.8s)	3280	3280	256	88	174	14	0	276
17138	11000s (+0.6s)	2512	2512	256	48	156	11	1	216
17139	11000s (+0.7s)	3200	3200	256	61	190	12	1	264
17140	11001s (+0.5s)	1624	1624	128	45	120	8	0	173
17141	11001s (+0.5s)	1812	1812	128	47	139	2	0	188
17142	11002s (+0.8s)	3604	3604	256	79	212	17	0	308
17143	11003s (+0.8s)	3512	3512	256	74	207	12	0	293
17144	11004s (+0.6s)	2240	2240	128	59	149	8	0	216
17145	11004s (+0.5s)	1620	1620	128	40	126	7	0	173
17146	11005s (+0.6s)	2488	2488	256	40	168	6	0	214
17147	11005s (+0.8s)	3232	3232	256	54	209	8	0	271
17148	11006s (+0.3s)	1000	1000	64	28	87	5	0	120
17149	11006s (+0.7s)	2856	2856	256	66	161	10	0	237
17150	11008s (+1.2s)	5784	5784	512	100	280	25	0	405
17151	11008s (+0.7s)	2832	2832	256	63	181	7	0	251
17152	11009s (+0.4s)	1412	1412	128	29	114	4	0	147
17153	11009s (+0.5s)	1404	1404	64	44	109	6	0	159
17154	11010s (+0.5s)	1872	1872	128	56	123	8	0	187
17155	11010s (+0.5s)	1768	1768	128	39	131	8	0	178
17156	11011s (+0.6s)	2516	2516	256	62	145	7	0	214
17157	11012s (+0.7s)	2584	2584	128	61	170	13	1	245
17158	11013s (+0.9s)	3656	3656	256	94	199	18	0	311
17159	11013s (+0.8s)	3292	3292	256	69	193	10	0	272
17160	11014s (+0.9s)	3892	3892	256	78	228	18	0	324
17161	11015s (+0.9s)	3568	3568	256	87	204	15	0	306
17162	11015s (+0.4s)	1188	1188	128	38	90	5	0	133
17163	11016s (+0.4s)	1192	1192	128	29	97	4	1	131
17164	11017s (+0.8s)	3476	3476	256	83	201	11	0	295
17165	11017s (+0.7s)	2996	2996	256	68	171	16	0	255
17166	11018s (+0.5s)	1796	1796	128	44	130	9	0	183
17167	11019s (+0.7s)	3024	3024	256	51	188	9	1	249
17168	11019s (+0.5s)	1508	1508	128	39	111	9	1	160
17169	11020s (+0.7s)	2460	2460	128	67	162	13	0	242
17170	11021s (+0.9s)	3752	3752	256	83	207	19	0	309
17171	11021s (+0.4s)	1244	1244	128	34	99	5	0	138
17172	11022s (+0.5s)	1780	1780	128	46	123	11	0	180
17173	11022s (+0.4s)	1364	1364	128	36	94	9	0	139
17174	11022s (+0.3s)	1164	1164	128	25	94	0	6	125
17175	11023s (+0.7s)	2796	2796	256	55	175	0	12	242
17176	11024s (+0.7s)	3048	3048	256	74	172	11	0	257
17177	11025s (+1.0s)	4068	4068	256	76	244	20	0	340
17178	11025s (+0.4s)	1488	1488	128	29	123	4	0	156
17179	11026s (+0.6s)	1928	1928	128	40	150	10	0	200
17180	11026s (+0.6s)	1900	1900	128	47	137	9	0	193
17181	11027s (+0.3s)	896	896	64	27	81	7	0	115
17182	11027s (+0.6s)	2464	2464	256	42	161	10	0	213
17183	11028s (+0.7s)	2816	2816	256	50	181	0	12	243
17184	11029s (+0.7s)	3204	3204	256	60	190	0	14	264
17185	11029s (+0.7s)	3076	3076	256	44	203	0	7	254
17186	11030s (+0.5s)	2224	2224	256	50	130	0	12	192
17187	11031s (+0.5s)	1804	1804	128	39	137	0	10	186
17188	11031s (+0.3s)	972	972	64	19	92	0	6	117
17189	11031s (+0.5s)	1664	1664	128	41	120	5	2	168
17190	11032s (+0.6s)	1908	1908	128	47	140	8	0	195
17191	11033s (+0.9s)	4048	4048	256	99	215	20	0	334
17192	11034s (+1.0s)	4364	4364	256	91	249	21	0	361
17193	11034s (+0.4s)	1264	1264	128	22	107	1	0	130
17194	11035s (+0.6s)	2636	2636	256	60	163	7	0	230
17195	11036s (+0.7s)	3044	3044	256	63	174	11	0	248
17196	11036s (+0.6s)	2384	2384	128	69	139	12	0	220
17197	11037s (+0.6s)	1928	1928	128	57	121	15	1	194
17198	11038s (+0.8s)	3256	3256	256	80	173	16	0	269
17199	11038s (+0.7s)	2924	2924	256	70	166	18	0	254
Episode	Time	Reward	Score	Highest	L	U	R	D	Steps
17200	11040s (+1.2s)	5664	5664	512	115	280	17	1	413
17201	11040s (+0.5s)	1808	1808	128	45	128	7	0	180
17202	11041s (+0.7s)	2912	2912	256	63	180	11	0	254
17203	11041s (+0.5s)	1804	1804	128	46	132	0	8	186
17204	11042s (+0.5s)	1900	1900	128	36	152	0	6	194
17205	11043s (+0.8s)	3240	3240	256	62	197	0	10	269
17206	11043s (+0.8s)	3356	3356	256	60	214	0	9	283
17207	11044s (+0.4s)	1360	1360	128	23	108	0	10	141
17208	11045s (+0.9s)	4776	4776	512	76	247	0	19	342
17209	11045s (+0.6s)	1928	1928	128	34	157	0	9	200
17210	11046s (+0.8s)	3532	3532	256	56	229	0	12	297
17211	11047s (+0.5s)	1708	1708	128	25	140	0	3	168
17212	11048s (+0.9s)	4136	4136	256	68	260	0	14	342
17213	11048s (+0.6s)	1936	1936	128	41	156	0	5	202
17214	11049s (+0.6s)	2736	2736	256	40	185	0	7	232
17215	11050s (+1.0s)	4124	4124	256	66	256	0	12	334
17216	11050s (+0.4s)	1436	1436	128	33	112	0	3	148
17217	11051s (+1.0s)	4128	4128	256	73	251	0	15	339
17218	11052s (+0.4s)	1600	1600	128	39	118	0	6	163
17219	11053s (+0.7s)	3092	3092	256	46	191	0	15	252
17220	11053s (+0.4s)	1472	1472	128	29	118	0	5	152
17221	11053s (+0.4s)	1280	1280	128	27	104	0	5	136
17222	11054s (+0.9s)	4080	4080	256	91	230	17	0	338
17223	11055s (+0.8s)	3372	3372	256	69	197	14	0	280
17224	11056s (+0.5s)	1800	1800	128	50	126	9	1	186
17225	11056s (+0.6s)	2464	2464	256	51	153	9	0	213
17226	11057s (+0.4s)	1500	1500	128	33	115	7	0	155
17227	11057s (+0.8s)	3488	3488	256	68	213	10	0	291
17228	11058s (+0.4s)	1432	1432	128	29	113	6	0	148
17229	11058s (+0.4s)	1104	1104	64	31	86	5	0	122
17230	11059s (+0.7s)	2812	2812	256	48	185	0	8	241
17231	11060s (+0.6s)	2696	2696	256	58	150	15	0	223
17232	11060s (+0.4s)	1492	1492	128	32	117	8	0	157
17233	11061s (+0.6s)	2356	2356	256	38	155	5	0	198
17234	11061s (+0.3s)	940	940	64	22	95	4	0	121
17235	11061s (+0.2s)	452	452	64	14	48	1	1	64
17236	11062s (+0.7s)	2788	2788	256	80	147	13	0	240
17237	11062s (+0.6s)	1972	1972	128	49	141	9	1	200
17238	11063s (+0.6s)	2620	2620	256	72	146	12	0	230
17239	11064s (+0.5s)	1844	1844	128	39	140	6	0	185
17240	11065s (+1.0s)	4252	4252	256	90	246	17	0	353
17241	11065s (+0.7s)	2760	2760	256	48	179	0	11	238
17242	11066s (+0.6s)	2456	2456	256	44	158	0	10	212
17243	11067s (+0.7s)	2840	2840	256	39	202	0	7	248
17244	11067s (+0.9s)	3948	3948	256	81	221	0	19	321
17245	11068s (+0.6s)	2488	2488	256	42	167	0	6	215
17246	11069s (+0.8s)	3340	3340	256	51	217	0	13	281
17247	11069s (+0.4s)	1500	1500	128	48	92	0	15	155
17248	11070s (+0.9s)	3788	3788	256	68	234	11	0	313
17249	11071s (+0.6s)	1944	1944	128	58	137	9	0	204
17250	11072s (+1.2s)	5952	5952	512	113	291	19	0	423
17251	11072s (+0.4s)	1144	1144	128	29	89	5	0	123
17252	11073s (+0.4s)	1424	1424	128	33	103	9	0	145
17253	11073s (+0.5s)	1852	1852	128	69	108	9	0	186
17254	11074s (+0.6s)	2132	2132	128	50	138	10	0	198
17255	11074s (+0.5s)	1664	1664	128	40	121	10	0	171
17256	11075s (+0.9s)	3596	3596	256	92	192	18	0	302
17257	11076s (+0.5s)	1728	1728	128	66	100	11	1	178
17258	11076s (+0.4s)	1292	1292	128	25	104	0	4	133
17259	11077s (+0.5s)	1660	1660	128	37	131	0	9	177
17260	11077s (+0.5s)	1736	1736	128	36	129	0	9	174
17261	11078s (+0.4s)	1076	1076	64	34	90	8	0	132
17262	11078s (+0.6s)	1936	1936	128	44	146	12	0	202
17263	11079s (+0.7s)	3208	3208	256	61	192	13	0	266
17264	11080s (+0.6s)	2688	2688	256	47	170	0	12	229
17265	11080s (+0.7s)	3104	3104	256	66	184	10	1	261
17266	11081s (+0.5s)	1484	1484	128	30	117	8	0	155
17267	11081s (+0.6s)	2016	2016	128	41	151	7	0	199
17268	11082s (+0.8s)	3232	3232	256	65	191	15	0	271
17269	11082s (+0.2s)	552	552	64	11	63	0	0	74
17270	11083s (+0.7s)	2932	2932	256	55	193	0	11	259
17271	11084s (+0.6s)	1940	1940	128	39	158	0	6	203
17272	11084s (+0.2s)	644	644	64	14	67	2	1	84
17273	11085s (+0.9s)	3556	3556	256	65	225	13	0	303
17274	11085s (+0.5s)	1768	1768	128	40	136	6	0	182
17275	11086s (+1.0s)	4504	4504	256	92	262	18	0	372
17276	11087s (+0.9s)	3848	3848	256	87	213	13	0	313
17277	11088s (+0.5s)	1656	1656	128	55	112	9	0	176
17278	11089s (+1.0s)	4088	4088	256	98	225	16	0	339
17279	11090s (+0.8s)	3376	3376	256	75	200	15	0	290
17280	11090s (+0.4s)	1424	1424	128	35	113	2	0	150
17281	11091s (+0.6s)	1920	1920	128	51	140	7	0	198
17282	11091s (+0.5s)	1732	1732	128	51	117	5	0	173
17283	11092s (+0.7s)	2804	2804	256	64	168	12	0	244
17284	11093s (+0.8s)	3408	3408	256	67	201	15	0	283
17285	11093s (+0.5s)	1524	1524	128	31	124	5	0	160
17286	11093s (+0.4s)	1492	1492	128	40	110	7	0	157
17287	11094s (+0.6s)	2488	2488	256	45	156	12	0	213
17288	11095s (+0.8s)	3536	3536	256	74	209	15	0	298
17289	11095s (+0.4s)	1184	1184	128	31	93	4	0	128
17290	11096s (+0.6s)	2332	2332	256	52	133	10	0	195
17291	11097s (+0.8s)	3464	3464	256	72	198	13	1	284
17292	11097s (+0.5s)	2024	2024	256	35	125	5	0	165
17293	11098s (+0.5s)	1564	1564	128	56	95	11	0	162
17294	11098s (+0.8s)	3604	3604	256	80	196	19	0	295
17295	11099s (+0.6s)	2504	2504	128	60	168	9	0	237
17296	11100s (+0.5s)	1868	1868	128	45	126	8	0	179
17297	11100s (+0.5s)	1600	1600	128	46	115	6	0	167
17298	11101s (+1.1s)	4572	4572	256	106	254	20	0	380
17299	11102s (+1.3s)	6168	6168	512	117	298	30	0	445
Episode	Time	Reward	Score	Highest	L	U	R	D	Steps
17300	11103s (+0.5s)	1572	1572	128	47	110	8	0	165
17301	11104s (+0.6s)	2168	2168	128	58	133	11	0	202
17302	11104s (+0.5s)	1868	1868	128	46	133	11	0	190
17303	11105s (+0.9s)	3476	3476	256	80	203	17	0	300
17304	11106s (+0.7s)	2664	2664	256	58	167	5	0	230
17305	11107s (+0.8s)	3188	3188	256	61	195	10	0	266
17306	11107s (+0.4s)	1408	1408	128	26	114	3	0	143
17307	11107s (+0.5s)	1664	1664	128	43	119	6	0	168
17308	11108s (+0.8s)	3428	3428	256	54	223	10	0	287
17309	11110s (+1.3s)	6496	6496	512	119	324	23	0	466
17310	11111s (+1.0s)	4120	4120	256	75	249	12	0	336
17311	11111s (+0.3s)	928	928	64	32	76	5	0	113
17312	11111s (+0.3s)	1000	1000	128	23	78	4	0	105
17313	11112s (+0.8s)	3232	3232	256	63	194	12	1	270
17314	11113s (+0.6s)	2424	2424	256	44	153	0	7	204
17315	11113s (+0.7s)	2796	2796	256	56	168	0	18	242
17316	11114s (+0.5s)	1796	1796	128	31	148	0	6	185
17317	11114s (+0.5s)	1784	1784	128	35	137	0	8	180
17318	11115s (+0.5s)	1508	1508	128	32	121	0	7	160
17319	11116s (+0.8s)	3416	3416	256	72	210	13	0	295
17320	11116s (+0.8s)	3528	3528	256	87	191	18	0	296
17321	11117s (+0.5s)	1676	1676	128	34	131	5	0	170
17322	11117s (+0.5s)	1660	1660	128	43	117	7	0	167
17323	11118s (+0.3s)	936	936	64	32	87	6	0	125
17324	11118s (+0.4s)	1460	1460	128	38	108	7	1	154
17325	11119s (+0.5s)	1788	1788	128	38	131	0	7	176
17326	11119s (+0.5s)	1560	1560	128	16	140	1	5	162
17327	11120s (+0.9s)	3848	3848	256	53	247	0	13	313
17328	11120s (+0.3s)	1132	1132	128	26	90	0	4	120
17329	11121s (+0.6s)	2616	2616	256	59	163	0	7	229
17330	11122s (+0.7s)	2620	2620	256	46	174	0	10	230
17331	11122s (+0.6s)	2536	2536	256	45	165	10	0	220
17332	11123s (+0.3s)	840	840	64	23	72	5	0	100
17333	11123s (+0.5s)	1912	1912	128	56	134	6	0	196
17334	11124s (+0.5s)	1912	1912	128	48	142	6	0	196
17335	11124s (+0.7s)	2752	2752	256	61	162	12	0	235
17336	11125s (+0.5s)	1756	1756	128	37	135	7	0	179
17337	11126s (+0.7s)	3152	3152	256	59	194	9	0	262
17338	11126s (+0.6s)	2024	2024	128	57	132	10	0	199
17339	11127s (+0.8s)	3204	3204	256	64	189	13	0	266
17340	11127s (+0.4s)	1096	1096	64	40	89	4	0	133
17341	11128s (+0.4s)	1400	1400	128	33	107	5	1	146
17342	11129s (+1.0s)	4140	4140	256	98	227	17	0	342
17343	11129s (+0.3s)	600	600	32	22	63	5	0	90
17344	11130s (+0.8s)	3492	3492	256	75	203	14	0	292
17345	11130s (+0.6s)	2588	2588	256	50	155	8	0	213
17346	11131s (+0.7s)	3028	3028	256	45	189	9	0	243
17347	11131s (+0.4s)	1164	1164	128	22	99	3	0	124
17348	11132s (+0.3s)	828	828	64	21	79	5	0	105
17349	11132s (+0.5s)	1604	1604	128	45	117	6	0	168
17350	11133s (+0.8s)	3416	3416	256	69	220	6	0	295
17351	11134s (+0.6s)	2568	2568	256	60	144	15	0	219
17352	11135s (+1.1s)	4556	4556	256	93	272	16	0	381
17353	11135s (+0.6s)	2416	2416	256	66	131	11	0	208
17354	11136s (+0.7s)	2948	2948	256	64	175	9	0	248
17355	11137s (+0.7s)	2788	2788	256	50	181	9	0	240
17356	11137s (+0.5s)	1660	1660	128	39	117	11	0	167
17357	11138s (+0.6s)	1968	1968	128	51	140	11	0	202
17358	11138s (+0.4s)	1340	1340	128	33	98	0	9	140
17359	11139s (+0.4s)	1224	1224	64	38	92	8	0	138
17360	11139s (+0.6s)	2660	2660	256	56	153	14	1	224
17361	11140s (+0.6s)	2488	2488	256	58	143	13	0	214
17362	11141s (+1.0s)	4544	4544	256	99	229	23	1	352
17363	11142s (+0.7s)	2760	2760	256	61	166	11	0	238
17364	11142s (+0.6s)	2472	2472	256	52	152	10	0	214
17365	11143s (+0.5s)	1880	1880	128	44	140	8	0	192
17366	11143s (+0.5s)	1864	1864	128	50	130	9	0	189
17367	11144s (+0.4s)	1256	1256	128	40	97	5	0	142
17368	11144s (+0.5s)	1780	1780	128	50	124	6	0	180
17369	11145s (+0.5s)	1588	1588	128	48	108	8	0	164
17370	11145s (+0.6s)	1928	1928	128	53	141	6	0	200
17371	11146s (+0.8s)	3232	3232	256	52	207	13	0	272
17372	11147s (+1.0s)	5260	5260	512	78	268	15	2	363
17373	11148s (+0.4s)	1184	1184	64	37	98	7	1	143
17374	11148s (+0.4s)	1344	1344	128	27	106	7	1	141
17375	11149s (+1.1s)	5692	5692	512	101	283	22	0	406
17376	11149s (+0.4s)	1172	1172	64	34	103	3	0	140
17377	11150s (+0.7s)	2968	2968	256	64	182	11	0	257
17378	11151s (+0.8s)	3272	3272	256	42	219	0	16	277
17379	11152s (+0.5s)	1712	1712	128	37	129	0	7	173
17380	11152s (+0.4s)	1352	1352	128	21	114	0	4	139
17381	11152s (+0.4s)	1248	1248	64	36	100	0	8	144
17382	11153s (+0.3s)	828	828	64	22	81	4	0	107
17383	11153s (+0.5s)	1836	1836	128	53	119	10	1	183
17384	11154s (+0.7s)	2792	2792	256	49	179	9	0	237
17385	11154s (+0.6s)	2164	2164	128	54	140	8	0	202
17386	11155s (+0.4s)	1496	1496	128	37	117	4	0	158
17387	11156s (+0.9s)	3940	3940	256	85	212	22	0	319
17388	11156s (+0.5s)	1792	1792	128	41	135	0	7	183
17389	11157s (+0.9s)	3896	3896	256	63	238	0	13	314
17390	11158s (+0.4s)	1120	1120	128	19	95	0	8	122
17391	11158s (+0.5s)	1724	1724	128	35	142	8	0	185
17392	11159s (+0.9s)	3712	3712	256	78	223	16	1	318
17393	11159s (+0.4s)	1492	1492	128	27	125	4	1	157
17394	11160s (+0.8s)	3336	3336	256	71	201	8	0	280
17395	11161s (+0.6s)	2360	2360	128	55	159	14	0	228
17396	11162s (+1.0s)	4064	4064	256	111	208	19	0	338
17397	11163s (+0.9s)	3660	3660	256	84	200	13	0	297
17398	11164s (+1.1s)	4616	4616	256	103	260	21	0	384
17399	11164s (+0.3s)	780	780	64	25	77	5	0	107
Episode	Time	Reward	Score	Highest	L	U	R	D	Steps
17400	11165s (+0.5s)	1764	1764	128	42	132	7	0	181
17401	11165s (+0.7s)	2752	2752	256	61	167	9	0	237
17402	11166s (+0.3s)	924	924	64	33	86	3	0	122
17403	11167s (+0.7s)	3228	3228	256	81	169	13	0	263
17404	11167s (+0.3s)	732	732	64	18	76	0	3	97
17405	11168s (+0.7s)	3196	3196	256	49	209	9	0	267
17406	11168s (+0.7s)	2976	2976	256	45	197	7	1	250
17407	11169s (+0.8s)	3496	3496	256	74	198	16	0	288
17408	11170s (+0.7s)	2556	2556	128	64	166	11	0	241
17409	11170s (+0.5s)	2148	2148	128	55	134	9	0	198
17410	11171s (+0.4s)	1348	1348	128	18	115	0	5	138
17411	11171s (+0.5s)	1828	1828	128	26	150	0	9	185
17412	11172s (+0.7s)	2960	2960	256	52	191	0	8	251
17413	11173s (+0.8s)	3616	3616	256	58	217	0	14	289
17414	11173s (+0.6s)	2400	2400	256	44	148	0	12	204
17415	11174s (+0.9s)	3844	3844	256	61	234	0	17	312
17416	11175s (+0.9s)	3980	3980	256	72	237	0	19	328
17417	11176s (+0.7s)	3124	3124	256	50	198	0	13	261
17418	11177s (+0.6s)	2360	2360	128	42	168	0	8	218
17419	11177s (+0.7s)	2780	2780	256	48	181	0	9	238
17420	11178s (+0.6s)	2464	2464	256	40	159	0	9	208
17421	11179s (+0.7s)	2792	2792	256	39	179	0	9	227
17422	11179s (+0.9s)	3912	3912	256	71	237	16	0	324
17423	11180s (+0.6s)	2436	2436	128	65	147	15	0	227
17424	11181s (+0.9s)	3564	3564	256	96	186	16	0	298
17425	11182s (+0.9s)	3556	3556	256	67	221	15	0	303
17426	11182s (+0.4s)	1504	1504	128	45	99	8	0	152
17427	11183s (+0.9s)	3652	3652	256	76	224	10	0	310
17428	11184s (+1.0s)	5076	5076	512	85	246	21	0	352
17429	11185s (+0.5s)	1444	1444	128	41	111	8	0	160
17430	11185s (+0.8s)	3316	3316	256	88	173	13	0	274
17431	11186s (+0.3s)	908	908	64	28	83	6	0	117
17432	11186s (+0.5s)	1788	1788	128	46	125	10	0	181
17433	11187s (+0.4s)	1184	1184	128	36	87	5	0	128
17434	11187s (+0.6s)	1916	1916	128	51	137	9	0	197
17435	11188s (+0.5s)	1600	1600	128	34	114	9	0	157
17436	11188s (+0.5s)	1816	1816	128	52	129	7	0	188
17437	11189s (+0.4s)	1224	1224	64	35	92	10	1	138
17438	11189s (+0.7s)	2784	2784	256	61	166	12	0	239
17439	11190s (+0.5s)	1720	1720	128	43	122	6	0	171
17440	11190s (+0.4s)	1308	1308	128	32	92	8	0	132
17441	11191s (+0.6s)	2416	2416	256	45	146	16	0	207
17442	11192s (+0.9s)	3616	3616	256	67	217	16	0	300
17443	11192s (+0.3s)	872	872	64	29	82	3	0	114
17444	11192s (+0.3s)	1044	1044	128	33	74	5	0	112
17445	11193s (+0.5s)	1656	1656	128	49	123	4	0	176
17446	11193s (+0.5s)	1680	1680	128	40	124	8	0	172
17447	11194s (+0.7s)	2980	2980	256	62	182	12	0	256
17448	11195s (+1.0s)	5436	5436	512	90	273	0	17	380
17449	11196s (+0.8s)	3108	3108	256	48	204	0	6	258
17450	11196s (+0.7s)	2784	2784	256	52	173	0	14	239
17451	11197s (+0.5s)	1548	1548	128	48	101	0	8	157
17452	11198s (+0.6s)	2184	2184	128	42	151	0	12	205
17453	11198s (+0.7s)	2936	2936	256	52	181	0	13	246
17454	11199s (+0.4s)	1100	1100	64	21	98	0	9	128
17455	11199s (+0.4s)	1472	1472	128	40	106	0	7	153
17456	11200s (+0.7s)	3276	3276	256	63	190	14	0	267
17457	11201s (+1.0s)	4404	4404	256	99	256	15	0	370
17458	11201s (+0.5s)	1684	1684	128	34	136	3	0	173
17459	11202s (+0.8s)	3408	3408	256	71	199	13	0	283
17460	11203s (+0.5s)	1808	1808	128	52	129	6	0	187
17461	11203s (+0.4s)	1140	1140	128	29	89	5	0	123
17462	11204s (+0.9s)	3572	3572	256	70	228	9	0	307
17463	11205s (+0.8s)	3400	3400	256	72	194	16	0	282
17464	11205s (+0.5s)	1528	1528	128	46	109	5	1	161
17465	11206s (+0.6s)	2644	2644	256	42	175	7	0	224
17466	11207s (+0.8s)	3376	3376	256	66	212	12	0	290
17467	11207s (+0.7s)	2576	2576	128	57	175	11	0	243
17468	11208s (+0.7s)	2504	2504	128	65	159	14	0	238
17469	11209s (+0.5s)	1880	1880	128	44	140	9	0	193
17470	11209s (+0.6s)	2088	2088	128	50	135	9	0	194
17471	11210s (+0.6s)	2288	2288	128	70	143	7	1	221
17472	11210s (+0.6s)	1976	1976	128	49	141	7	0	197
17473	11211s (+0.4s)	1076	1076	64	29	92	5	0	126
17474	11211s (+0.3s)	856	856	64	30	77	3	0	110
17475	11212s (+0.6s)	1928	1928	128	46	146	8	0	200
17476	11212s (+0.5s)	1660	1660	128	36	128	3	0	167
17477	11213s (+0.8s)	3476	3476	256	66	207	15	0	288
17478	11213s (+0.3s)	716	716	64	21	71	5	0	97
17479	11214s (+0.4s)	1056	1056	64	29	94	4	0	127
17480	11214s (+0.6s)	2040	2040	128	41	143	12	1	197
17481	11215s (+0.5s)	1884	1884	128	41	141	7	0	189
17482	11216s (+0.9s)	3888	3888	256	91	224	16	0	331
17483	11216s (+0.7s)	2752	2752	128	72	165	15	0	252
17484	11217s (+0.5s)	1604	1604	128	31	124	6	0	161
17485	11217s (+0.3s)	1012	1012	128	16	91	0	0	107
17486	11218s (+0.6s)	2512	2512	256	42	171	6	0	219
17487	11219s (+1.1s)	5696	5696	512	93	292	22	0	407
17488	11219s (+0.4s)	1528	1528	128	39	111	4	0	154
17489	11220s (+0.4s)	1572	1572	128	28	125	1	0	154
17490	11221s (+0.7s)	3212	3212	256	76	176	14	0	266
17491	11222s (+1.3s)	6508	6508	512	125	313	24	0	462
17492	11222s (+0.6s)	1932	1932	128	45	148	8	0	201
17493	11223s (+0.7s)	2936	2936	256	62	186	12	0	260
17494	11224s (+0.6s)	2488	2488	256	53	155	7	0	215
17495	11224s (+0.7s)	2800	2800	256	60	171	12	0	243
17496	11225s (+0.9s)	3608	3608	256	68	224	14	0	306
17497	11226s (+0.6s)	2588	2588	256	46	161	7	0	214
17498	11226s (+0.4s)	1392	1392	128	28	108	6	0	142
17499	11227s (+0.5s)	1596	1596	128	41	120	8	1	170
Episode	Time	Reward	Score	Highest	L	U	R	D	Steps
17500	11228s (+0.6s)	2592	2592	256	44	163	7	0	214
17501	11229s (+1.5s)	7844	7844	512	169	340	37	0	546
17502	11230s (+0.5s)	1708	1708	128	38	128	8	0	174
17503	11230s (+0.4s)	1304	1304	128	36	96	9	0	141
17504	11231s (+0.7s)	2848	2848	256	56	178	9	0	243
17505	11231s (+0.4s)	1448	1448	128	31	114	6	0	151
17506	11232s (+0.7s)	2896	2896	256	69	172	9	0	250
17507	11232s (+0.4s)	1576	1576	128	39	117	7	0	163
17508	11233s (+1.0s)	4288	4288	256	77	255	16	0	348
17509	11234s (+0.8s)	3412	3412	256	70	193	15	0	278
17510	11234s (+0.2s)	544	544	32	27	48	6	0	81
17511	11235s (+0.6s)	1920	1920	128	43	147	8	0	198
17512	11236s (+1.1s)	5764	5764	512	115	259	25	0	399
17513	11236s (+0.3s)	804	804	64	23	80	5	0	108
17514	11237s (+0.5s)	1616	1616	128	39	119	6	1	165
17515	11238s (+0.9s)	3560	3560	256	64	227	14	0	305
17516	11238s (+0.4s)	1256	1256	128	37	98	6	0	141
17517	11239s (+0.4s)	1260	1260	64	47	100	3	0	150
17518	11239s (+0.4s)	1372	1372	128	31	104	0	4	139
17519	11239s (+0.5s)	1840	1840	128	45	143	0	2	190
17520	11240s (+0.8s)	3316	3316	256	62	211	0	14	287
17521	11241s (+0.6s)	1936	1936	128	43	153	0	6	202
17522	11242s (+0.7s)	2928	2928	256	50	185	0	9	244
17523	11242s (+0.4s)	1444	1444	128	34	108	8	0	150
17524	11242s (+0.5s)	1800	1800	128	29	153	3	0	185
17525	11243s (+0.4s)	1100	1100	64	26	102	0	6	134
17526	11244s (+0.7s)	3212	3212	256	51	203	0	12	266
17527	11244s (+0.6s)	1984	1984	128	38	150	0	7	195
17528	11245s (+0.9s)	3776	3776	256	63	229	0	16	308
17529	11246s (+0.7s)	2736	2736	256	49	174	0	10	233
17530	11247s (+0.8s)	3484	3484	256	59	221	0	11	291
17531	11247s (+0.6s)	2376	2376	256	36	154	0	6	196
17532	11248s (+0.5s)	1524	1524	128	28	127	0	6	161
17533	11248s (+0.3s)	860	860	64	26	78	0	7	111
17534	11249s (+0.7s)	3128	3128	256	58	190	0	9	257
17535	11250s (+1.4s)	6668	6668	512	152	297	27	1	477
17536	11251s (+0.7s)	3024	3024	256	64	176	11	0	251
17537	11252s (+0.8s)	3368	3368	256	58	215	15	0	288
17538	11252s (+0.7s)	2780	2780	256	61	162	13	2	238
17539	11253s (+0.6s)	2480	2480	256	49	155	8	0	212
17540	11254s (+1.1s)	4524	4524	256	95	256	22	0	373
17541	11254s (+0.4s)	1420	1420	128	37	102	6	0	145
17542	11255s (+0.4s)	1520	1520	128	32	117	5	0	154
17543	11256s (+0.9s)	4112	4112	256	89	229	17	0	335
17544	11256s (+0.5s)	1964	1964	128	52	130	11	1	194
17545	11257s (+0.7s)	2556	2556	128	62	166	10	0	238
17546	11258s (+0.7s)	3228	3228	256	59	200	11	0	270
17547	11258s (+0.6s)	2308	2308	128	60	152	8	0	220
17548	11259s (+0.5s)	1656	1656	128	39	117	10	0	166
17549	11260s (+0.9s)	3884	3884	256	80	226	15	0	321
17550	11261s (+0.8s)	3180	3180	256	57	202	6	0	265
17551	11261s (+0.6s)	1892	1892	128	40	144	9	0	193
17552	11262s (+0.8s)	3452	3452	256	63	221	10	0	294
17553	11263s (+0.6s)	1948	1948	128	43	155	2	0	200
17554	11263s (+0.3s)	1216	1216	128	28	91	7	0	126
17555	11264s (+0.6s)	2796	2796	256	65	157	14	0	236
17556	11265s (+1.1s)	5680	5680	512	120	261	22	3	406
17557	11266s (+0.8s)	3464	3464	256	64	208	18	0	290
17558	11266s (+0.9s)	3584	3584	256	85	201	13	0	299
17559	11267s (+0.4s)	1176	1176	128	28	97	2	0	127
17560	11267s (+0.6s)	2372	2372	256	51	144	7	0	202
17561	11268s (+0.7s)	3224	3224	256	80	175	14	1	270
17562	11269s (+0.9s)	3764	3764	256	83	206	18	1	308
17563	11269s (+0.4s)	1292	1292	128	27	110	3	0	140
17564	11270s (+0.4s)	1288	1288	128	28	103	7	0	138
17565	11270s (+0.7s)	2768	2768	256	68	157	14	0	239
17566	11271s (+0.9s)	4824	4824	512	82	235	21	0	338
17567	11272s (+0.8s)	3504	3504	256	78	205	12	0	295
17568	11273s (+0.4s)	1464	1464	128	33	116	3	0	152
17569	11274s (+0.8s)	3368	3368	256	65	198	15	0	278
17570	11274s (+0.3s)	1028	1028	128	33	73	5	0	111
17571	11274s (+0.2s)	484	484	32	15	55	4	0	74
17572	11275s (+0.7s)	2724	2724	256	53	163	13	1	230
17573	11275s (+0.3s)	940	940	64	17	93	3	0	113
17574	11275s (+0.4s)	1032	1032	64	24	93	6	0	123
17575	11276s (+0.5s)	1808	1808	128	51	127	9	0	187
17576	11277s (+0.8s)	3272	3272	256	77	185	12	0	274
17577	11278s (+0.8s)	2972	2972	256	66	186	12	0	264
17578	11278s (+0.9s)	3960	3960	256	91	215	18	0	324
17579	11279s (+0.7s)	2756	2756	256	50	176	7	0	233
17580	11280s (+0.7s)	3068	3068	256	72	178	7	0	257
17581	11280s (+0.3s)	696	696	64	27	61	4	0	92
17582	11281s (+0.6s)	1924	1924	128	42	154	3	0	199
17583	11282s (+0.9s)	4044	4044	256	89	222	18	1	330
17584	11282s (+0.6s)	2684	2684	256	56	159	10	0	225
17585	11284s (+1.2s)	6216	6216	512	117	299	24	0	440
17586	11284s (+0.3s)	644	644	64	34	49	3	0	86
17587	11285s (+0.9s)	3776	3776	256	79	203	18	0	300
17588	11285s (+0.8s)	3472	3472	256	62	210	9	0	281
17589	11286s (+1.0s)	4248	4248	256	91	247	14	0	352
17590	11287s (+0.5s)	1808	1808	128	49	122	12	0	183
17591	11288s (+0.8s)	3276	3276	256	70	196	10	0	276
17592	11288s (+0.5s)	2016	2016	128	48	140	7	0	195
17593	11289s (+0.6s)	2432	2432	256	52	151	9	1	213
17594	11290s (+0.9s)	3936	3936	256	82	224	17	0	323
17595	11290s (+0.4s)	1416	1416	128	38	103	8	0	149
17596	11291s (+0.5s)	1756	1756	128	47	120	14	0	181
17597	11291s (+0.5s)	1952	1952	128	44	135	9	0	188
17598	11292s (+0.7s)	2936	2936	256	66	171	8	0	245
17599	11293s (+0.9s)	3704	3704	256	83	217	13	0	313
Episode	Time	Reward	Score	Highest	L	U	R	D	Steps
17600	11294s (+0.9s)	3848	3848	256	88	219	16	0	323
17601	11294s (+0.4s)	1484	1484	128	27	124	4	0	155
17602	11295s (+0.3s)	852	852	64	30	77	8	1	116
17603	11295s (+0.7s)	2840	2840	256	55	179	10	0	244
17604	11296s (+0.8s)	3192	3192	256	66	180	18	1	265
17605	11297s (+0.5s)	1776	1776	128	43	130	7	0	180
17606	11298s (+1.0s)	4388	4388	256	89	247	19	0	355
17607	11299s (+1.0s)	4000	4000	256	90	227	12	0	329
17608	11299s (+0.8s)	3164	3164	256	65	191	10	0	266
17609	11300s (+0.6s)	2544	2544	256	52	154	11	0	217
17610	11301s (+0.7s)	2936	2936	256	64	182	10	0	256
17611	11301s (+0.3s)	856	856	64	35	67	8	0	110
17612	11302s (+0.8s)	3380	3380	256	65	214	12	0	291
17613	11302s (+0.6s)	1908	1908	128	41	145	9	0	195
17614	11303s (+0.5s)	1572	1572	128	34	120	8	0	162
17615	11304s (+1.2s)	5736	5736	512	118	269	18	0	405
17616	11305s (+1.0s)	4140	4140	256	86	237	20	0	343
17617	11306s (+0.4s)	1548	1548	128	32	121	6	0	159
17618	11307s (+1.4s)	6884	6884	512	146	318	35	0	499
17619	11308s (+0.5s)	1820	1820	128	50	121	12	0	183
17620	11309s (+0.8s)	3552	3552	256	76	211	12	0	299
17621	11309s (+0.4s)	1332	1332	128	40	102	2	0	144
17622	11310s (+0.5s)	1856	1856	128	51	133	7	0	191
17623	11311s (+1.0s)	4212	4212	256	87	241	15	0	343
17624	11312s (+1.3s)	6580	6580	512	135	310	30	0	475
17625	11313s (+0.8s)	3244	3244	256	59	200	14	1	274
17626	11313s (+0.5s)	1816	1816	128	42	140	6	0	188
17627	11314s (+0.9s)	3976	3976	256	81	234	13	0	328
17628	11315s (+0.6s)	2384	2384	256	50	142	13	0	205
17629	11316s (+1.0s)	4972	4972	512	83	257	13	1	354
17630	11316s (+0.5s)	1816	1816	128	49	129	10	0	188
17631	11317s (+1.1s)	5552	5552	512	89	285	21	0	395
17632	11318s (+0.4s)	1180	1180	64	41	90	6	0	137
17633	11318s (+0.5s)	1764	1764	128	32	137	8	0	177
17634	11319s (+0.4s)	1340	1340	128	34	96	9	0	139
17635	11319s (+0.7s)	3084	3084	256	64	180	11	0	255
17636	11320s (+0.6s)	2488	2488	256	39	161	0	14	214
17637	11321s (+0.9s)	3520	3520	256	60	228	0	10	298
17638	11321s (+0.4s)	1612	1612	128	34	116	0	7	157
17639	11322s (+0.3s)	896	896	64	26	86	0	4	116
17640	11322s (+0.8s)	3124	3124	256	60	205	0	10	275
17641	11323s (+1.0s)	4212	4212	256	75	248	0	20	343
17642	11324s (+0.5s)	1828	1828	128	42	138	0	11	191
17643	11325s (+0.8s)	3272	3272	256	62	204	0	10	276
17644	11325s (+0.4s)	1064	1064	64	39	87	0	3	129
17645	11326s (+0.6s)	2500	2500	256	44	159	0	13	216
17646	11326s (+0.6s)	2148	2148	128	45	148	0	6	199
17647	11327s (+0.7s)	2888	2888	256	53	188	0	11	252
17648	11327s (+0.4s)	1116	1116	64	28	106	0	4	138
17649	11328s (+0.7s)	2592	2592	128	54	180	0	9	243
17650	11329s (+0.6s)	2384	2384	256	35	159	0	7	201
17651	11329s (+0.4s)	1400	1400	128	29	111	0	3	143
17652	11330s (+0.5s)	1764	1764	128	31	142	0	4	177
17653	11330s (+0.4s)	1308	1308	64	40	97	10	0	147
17654	11331s (+0.5s)	1740	1740	128	39	126	10	0	175
17655	11331s (+0.3s)	732	732	64	25	69	2	0	96
17656	11332s (+0.8s)	2796	2796	128	90	157	15	0	262
17657	11332s (+0.8s)	3508	3508	256	71	211	9	0	291
17658	11333s (+0.6s)	2728	2728	256	54	174	7	0	235
17659	11333s (+0.4s)	1480	1480	128	34	113	7	0	154
17660	11334s (+0.6s)	2588	2588	256	57	163	7	0	227
17661	11335s (+0.7s)	2536	2536	128	69	159	12	0	240
17662	11336s (+0.9s)	3916	3916	256	84	220	14	1	319
17663	11336s (+0.7s)	2556	2556	128	66	166	14	0	246
17664	11337s (+0.7s)	2764	2764	256	63	163	12	0	238
17665	11338s (+0.6s)	2468	2468	256	35	165	8	0	208
17666	11338s (+0.6s)	2416	2416	256	55	138	14	1	208
17667	11339s (+0.9s)	3584	3584	256	81	211	18	0	310
17668	11340s (+0.9s)	3916	3916	256	85	223	11	0	319
17669	11341s (+0.8s)	3320	3320	256	77	192	12	0	281
17670	11342s (+1.0s)	4196	4196	256	87	237	19	0	343
17671	11342s (+0.5s)	1584	1584	128	39	124	0	4	167
17672	11343s (+0.7s)	2908	2908	256	63	183	0	12	258
17673	11344s (+0.9s)	3884	3884	256	67	238	0	17	322
17674	11344s (+0.3s)	628	628	64	12	71	0	4	87
17675	11345s (+0.6s)	2560	2560	256	58	149	13	0	220
17676	11346s (+0.7s)	2848	2848	256	48	176	12	0	236
17677	11346s (+0.6s)	1944	1944	128	63	125	11	0	199
17678	11347s (+0.6s)	2232	2232	128	57	146	8	0	211
17679	11347s (+0.5s)	1588	1588	128	39	111	9	1	160
17680	11348s (+0.5s)	1924	1924	128	47	131	11	0	189
17681	11349s (+0.8s)	3288	3288	256	74	192	7	0	273
17682	11349s (+0.5s)	1856	1856	128	56	114	5	1	176
17683	11350s (+0.4s)	1420	1420	128	30	117	4	0	151
17684	11350s (+0.9s)	3952	3952	256	78	236	13	0	327
17685	11351s (+0.8s)	3424	3424	256	73	202	12	0	287
17686	11352s (+0.6s)	1856	1856	128	42	146	6	0	194
17687	11353s (+0.7s)	2992	2992	256	67	164	12	0	243
17688	11353s (+0.9s)	3972	3972	256	79	236	12	0	327
17689	11354s (+0.9s)	4092	4092	256	90	223	18	0	331
17690	11355s (+0.4s)	1192	1192	128	24	99	7	1	131
17691	11355s (+0.5s)	1852	1852	128	44	135	11	0	190
17692	11356s (+0.5s)	1776	1776	128	37	133	9	0	179
17693	11356s (+0.5s)	1804	1804	128	43	134	9	0	186
17694	11357s (+0.6s)	2460	2460	256	48	154	9	0	211
17695	11358s (+0.5s)	1784	1784	128	46	128	8	0	182
17696	11358s (+0.5s)	1884	1884	128	45	135	9	0	189
17697	11359s (+0.6s)	2536	2536	256	55	162	8	0	225
17698	11359s (+0.5s)	1804	1804	128	39	136	10	0	185
17699	11360s (+0.5s)	1808	1808	128	41	138	8	0	187
Episode	Time	Reward	Score	Highest	L	U	R	D	Steps
17700	11361s (+1.1s)	4640	4640	256	105	269	15	0	389
17701	11362s (+0.7s)	2912	2912	256	69	171	14	0	254
17702	11363s (+0.8s)	3452	3452	256	99	177	13	0	289
17703	11363s (+0.8s)	3232	3232	256	61	199	10	1	271
17704	11364s (+0.5s)	1504	1504	128	40	116	4	0	160
17705	11365s (+0.8s)	3208	3208	256	60	192	13	0	265
17706	11365s (+0.9s)	3536	3536	256	88	202	8	0	298
17707	11366s (+0.5s)	1628	1628	128	35	134	5	0	174
17708	11366s (+0.3s)	1016	1016	128	18	83	0	8	109
17709	11367s (+0.5s)	1824	1824	128	27	155	0	6	188
17710	11368s (+0.8s)	3232	3232	256	71	189	0	11	271
17711	11368s (+0.3s)	896	896	64	22	79	0	5	106
17712	11369s (+1.0s)	4252	4252	256	99	233	21	0	353
17713	11370s (+0.7s)	2888	2888	256	50	177	9	0	236
17714	11370s (+0.5s)	1608	1608	128	40	125	4	0	169
17715	11371s (+1.0s)	4264	4264	256	103	224	24	0	351
17716	11372s (+0.7s)	3140	3140	256	58	196	7	0	261
17717	11372s (+0.4s)	1044	1044	64	34	88	3	0	125
17718	11373s (+0.5s)	1740	1740	128	42	122	10	0	174
17719	11374s (+0.9s)	3944	3944	256	82	229	10	0	321
17720	11374s (+0.7s)	2892	2892	256	71	169	12	1	253
17721	11375s (+0.6s)	2376	2376	256	46	150	7	0	203
17722	11376s (+0.9s)	3692	3692	256	84	221	15	0	320
17723	11377s (+0.8s)	3396	3396	256	63	205	12	0	280
17724	11377s (+0.5s)	1584	1584	128	40	118	5	0	163
17725	11378s (+0.4s)	1192	1192	64	50	87	5	0	142
17726	11378s (+0.8s)	3300	3300	256	54	215	11	0	280
17727	11379s (+0.7s)	2656	2656	256	69	150	8	1	228
17728	11379s (+0.3s)	812	812	64	20	85	5	0	110
17729	11381s (+1.2s)	6112	6112	512	117	286	27	0	430
17730	11382s (+1.0s)	4184	4184	256	88	232	22	0	342
17731	11382s (+0.6s)	2636	2636	256	56	154	9	0	219
17732	11383s (+0.6s)	2052	2052	128	58	137	9	0	204
17733	11383s (+0.3s)	1036	1036	128	18	87	3	1	109
17734	11383s (+0.4s)	1340	1340	128	29	103	6	0	138
17735	11384s (+0.4s)	1496	1496	128	39	111	7	0	157
17736	11385s (+0.9s)	3568	3568	256	71	220	10	0	301
17737	11386s (+1.0s)	4576	4576	256	96	257	21	0	374
17738	11387s (+1.0s)	4196	4196	256	104	223	17	0	344
17739	11388s (+0.8s)	3304	3304	256	73	195	10	0	278
17740	11388s (+0.6s)	2192	2192	128	52	151	13	0	216
17741	11389s (+0.6s)	1904	1904	128	39	148	7	0	194
17742	11390s (+0.7s)	3064	3064	256	65	177	8	0	250
17743	11390s (+0.5s)	1908	1908	128	50	137	12	0	199
17744	11391s (+0.6s)	2672	2672	256	64	152	12	0	228
17745	11392s (+0.9s)	4032	4032	256	98	201	22	0	321
17746	11392s (+0.9s)	3952	3952	256	68	239	15	0	322
17747	11393s (+0.4s)	1364	1364	64	33	107	8	0	148
17748	11394s (+0.8s)	3440	3440	256	67	214	11	0	292
17749	11394s (+0.7s)	2744	2744	256	65	161	9	0	235
17750	11396s (+1.1s)	5692	5692	512	111	277	17	1	406
17751	11396s (+0.4s)	1452	1452	128	47	97	8	0	152
17752	11397s (+0.9s)	3664	3664	256	67	217	15	0	299
17753	11398s (+1.5s)	7472	7472	512	124	370	23	2	519
17754	11399s (+0.5s)	2188	2188	256	44	139	4	1	188
17755	11400s (+0.5s)	1584	1584	128	38	108	14	0	160
17756	11400s (+0.5s)	1792	1792	128	38	136	8	1	183
17757	11401s (+0.7s)	2776	2776	256	74	150	13	0	237
17758	11401s (+0.5s)	1732	1732	128	36	133	4	0	173
17759	11402s (+0.3s)	876	876	64	33	75	6	0	114
17760	11403s (+0.9s)	3632	3632	256	81	209	16	0	306
17761	11404s (+1.0s)	4280	4280	256	75	260	18	0	353
17762	11404s (+0.6s)	1940	1940	128	53	143	7	0	203
17763	11405s (+0.4s)	1404	1404	64	48	102	8	0	158
17764	11405s (+0.6s)	2740	2740	256	64	153	15	1	233
17765	11406s (+0.7s)	2420	2420	128	41	175	0	12	228
17766	11406s (+0.5s)	1692	1692	128	55	109	0	11	175
17767	11407s (+0.5s)	1748	1748	128	42	130	0	6	178
17768	11408s (+0.8s)	3404	3404	256	64	206	0	12	282
17769	11408s (+0.5s)	1536	1536	128	27	121	0	9	157
17770	11409s (+0.8s)	3436	3436	256	65	204	0	20	289
17771	11410s (+0.8s)	3384	3384	256	68	209	0	10	287
17772	11411s (+0.7s)	2696	2696	256	50	174	9	0	233
17773	11411s (+0.7s)	3024	3024	256	61	173	17	0	251
17774	11412s (+0.9s)	3684	3684	256	91	197	15	0	303
17775	11413s (+0.7s)	2556	2556	128	66	159	11	2	238
17776	11414s (+1.2s)	5792	5792	512	107	281	24	1	413
17777	11415s (+0.8s)	3420	3420	256	64	211	11	0	286
17778	11415s (+0.6s)	1924	1924	128	50	138	11	0	199
17779	11416s (+0.7s)	3152	3152	256	62	183	11	0	256
17780	11417s (+1.3s)	6476	6476	512	122	315	24	0	461
17781	11418s (+0.2s)	400	400	32	15	48	3	0	66
17782	11419s (+1.1s)	5400	5400	512	110	255	16	0	381
17783	11419s (+0.7s)	2744	2744	256	61	163	10	0	234
17784	11420s (+0.7s)	2980	2980	256	73	171	17	0	261
17785	11421s (+0.5s)	1828	1828	128	55	126	6	0	187
17786	11421s (+0.7s)	3044	3044	256	63	187	10	1	261
17787	11422s (+0.5s)	1936	1936	128	46	122	10	0	178
17788	11423s (+1.0s)	4156	4156	256	82	244	15	0	341
17789	11424s (+0.6s)	2244	2244	128	60	139	10	0	209
17790	11424s (+0.5s)	1680	1680	128	43	122	7	0	172
17791	11425s (+1.3s)	6820	6820	512	148	293	19	0	460
17792	11426s (+0.5s)	1512	1512	128	32	123	2	0	157
17793	11427s (+0.8s)	3128	3128	256	68	178	16	0	262
17794	11427s (+0.4s)	1288	1288	128	25	97	5	0	127
17795	11428s (+0.6s)	2240	2240	128	50	156	9	0	215
17796	11428s (+0.8s)	3292	3292	256	63	195	12	0	270
17797	11429s (+0.8s)	3224	3224	256	84	168	21	0	273
17798	11429s (+0.3s)	764	764	64	27	68	4	0	99
17799	11430s (+0.6s)	2300	2300	256	43	147	8	0	198
Episode	Time	Reward	Score	Highest	L	U	R	D	Steps
17800	11431s (+0.7s)	3068	3068	256	63	178	11	0	252
17801	11431s (+0.6s)	2376	2376	128	48	165	10	0	223
17802	11432s (+0.3s)	816	816	64	29	72	3	0	104
17803	11432s (+0.3s)	728	728	64	19	76	1	0	96
17804	11433s (+0.8s)	3184	3184	256	56	197	14	1	268
17805	11434s (+0.8s)	3564	3564	256	70	209	11	0	290
17806	11434s (+0.4s)	1492	1492	128	34	114	9	0	157
17807	11435s (+0.7s)	3084	3084	256	64	180	12	0	256
17808	11436s (+0.8s)	3216	3216	256	53	203	12	0	268
17809	11436s (+0.5s)	1760	1760	128	41	131	4	0	176
17810	11437s (+0.8s)	3228	3228	256	66	189	14	1	270
17811	11438s (+0.8s)	3640	3640	256	89	195	14	0	298
17812	11438s (+0.6s)	1936	1936	128	50	143	9	0	202
17813	11439s (+0.6s)	2144	2144	128	58	141	16	0	215
17814	11440s (+0.8s)	2968	2968	256	67	190	6	0	263
17815	11440s (+0.4s)	1492	1492	128	38	114	5	0	157
17816	11441s (+0.5s)	1740	1740	128	47	124	5	0	176
17817	11441s (+0.6s)	2424	2424	256	55	139	9	0	203
17818	11442s (+0.6s)	2192	2192	128	42	155	0	11	208
17819	11442s (+0.6s)	2708	2708	256	41	176	0	9	226
17820	11443s (+0.5s)	1844	1844	128	44	131	0	13	188
17821	11444s (+0.6s)	1912	1912	128	51	141	4	0	196
17822	11444s (+0.4s)	1244	1244	64	46	90	7	0	143
17823	11445s (+0.8s)	3212	3212	256	66	187	14	0	267
17824	11446s (+1.0s)	4260	4260	256	93	233	18	0	344
17825	11446s (+0.7s)	2732	2732	256	67	145	19	0	231
17826	11447s (+0.9s)	3944	3944	256	73	240	12	0	325
17827	11448s (+1.0s)	4200	4200	256	109	213	22	1	345
17828	11449s (+0.4s)	1212	1212	128	29	95	6	1	131
17829	11449s (+0.6s)	1908	1908	128	53	137	5	0	195
17830	11450s (+0.8s)	3456	3456	256	82	182	24	0	288
17831	11451s (+0.6s)	2180	2180	128	59	148	9	0	216
17832	11451s (+0.4s)	1240	1240	128	26	97	5	0	128
17833	11452s (+0.5s)	1716	1716	128	50	115	10	1	176
17834	11452s (+0.3s)	892	892	64	28	76	4	0	108
17835	11453s (+1.0s)	4196	4196	256	94	237	13	0	344
17836	11453s (+0.5s)	1748	1748	128	47	126	4	0	177
17837	11454s (+0.4s)	1492	1492	128	49	97	10	1	157
17838	11454s (+0.5s)	1796	1796	128	48	118	12	0	178
17839	11455s (+0.4s)	1436	1436	128	43	93	10	1	147
17840	11455s (+0.5s)	2364	2364	256	43	148	8	0	199
17841	11456s (+0.7s)	2964	2964	256	48	199	5	0	252
17842	11457s (+0.7s)	3032	3032	256	59	182	11	0	252
17843	11458s (+0.8s)	2860	2860	128	78	172	15	1	266
17844	11458s (+0.2s)	536	536	64	16	55	0	3	74
17845	11458s (+0.4s)	1340	1340	128	26	107	0	7	140
17846	11459s (+0.7s)	2908	2908	256	52	186	0	15	253
17847	11459s (+0.5s)	1688	1688	128	43	123	0	8	174
17848	11460s (+0.4s)	1180	1180	128	31	92	5	0	128
17849	11460s (+0.4s)	1436	1436	128	32	103	12	0	147
17850	11461s (+0.6s)	2468	2468	256	46	157	0	8	211
17851	11461s (+0.4s)	1500	1500	128	29	120	0	2	151
17852	11462s (+0.4s)	1024	1024	64	29	87	0	8	124
17853	11462s (+0.2s)	568	568	64	15	59	2	0	76
17854	11462s (+0.6s)	1912	1912	128	43	146	7	0	196
17855	11463s (+0.8s)	3588	3588	256	69	217	18	0	304
17856	11464s (+0.3s)	608	608	32	24	63	4	0	91
17857	11465s (+1.0s)	4152	4152	256	87	230	23	0	340
17858	11465s (+0.7s)	3288	3288	256	57	197	11	0	265
17859	11466s (+0.7s)	2772	2772	128	61	182	16	1	260
17860	11467s (+0.5s)	1796	1796	128	40	133	0	11	184
17861	11468s (+1.0s)	4060	4060	256	62	256	0	16	334
17862	11468s (+0.4s)	1148	1148	128	23	98	0	4	125
17863	11469s (+0.9s)	3812	3812	256	67	238	0	14	319
17864	11469s (+0.5s)	1684	1684	128	37	127	9	0	173
17865	11470s (+0.6s)	1868	1868	128	51	132	9	0	192
17866	11471s (+1.2s)	6016	6016	512	120	283	19	0	422
17867	11472s (+1.0s)	4972	4972	512	98	231	19	0	348
17868	11472s (+0.4s)	1172	1172	64	33	103	4	0	140
17869	11473s (+0.5s)	1708	1708	128	43	119	6	0	168
17870	11473s (+0.5s)	1576	1576	128	38	122	6	0	166
17871	11474s (+0.7s)	2956	2956	256	80	170	15	0	265
17872	11475s (+0.5s)	1604	1604	128	40	124	5	0	169
17873	11475s (+0.6s)	2388	2388	256	42	153	5	0	200
17874	11476s (+0.7s)	2772	2772	256	62	159	15	0	236
17875	11476s (+0.5s)	2052	2052	256	30	131	8	0	169
17876	11477s (+0.4s)	1412	1412	128	43	94	9	0	146
17877	11478s (+0.8s)	3480	3480	256	64	210	16	0	290
17878	11478s (+0.2s)	588	588	32	26	58	3	0	87
17879	11479s (+0.6s)	2292	2292	128	54	148	14	0	216
17880	11479s (+0.7s)	2780	2780	256	66	165	12	0	243
17881	11480s (+0.7s)	3176	3176	256	59	192	12	0	263
17882	11481s (+0.5s)	1860	1860	128	61	121	6	0	188
17883	11481s (+0.7s)	2800	2800	256	47	187	9	0	243
17884	11482s (+0.5s)	1700	1700	128	40	129	7	0	176
17885	11482s (+0.4s)	1436	1436	128	35	109	4	0	148
17886	11483s (+0.4s)	1504	1504	128	45	105	9	0	159
17887	11483s (+0.4s)	1300	1300	128	39	93	8	0	140
17888	11484s (+1.0s)	4188	4188	256	77	254	10	1	342
17889	11484s (+0.4s)	1444	1444	128	35	106	0	8	149
17890	11485s (+0.6s)	2368	2368	256	32	160	0	9	201
17891	11486s (+0.4s)	1488	1488	128	30	115	0	11	156
17892	11486s (+0.8s)	3536	3536	256	51	234	0	13	298
17893	11487s (+0.8s)	3192	3192	256	65	184	0	13	262
17894	11488s (+0.6s)	2508	2508	256	54	154	6	0	214
17895	11488s (+0.5s)	2308	2308	256	36	146	10	0	192
17896	11489s (+0.7s)	2924	2924	256	62	181	14	0	257
17897	11490s (+0.5s)	1568	1568	128	51	103	9	0	163
17898	11490s (+0.6s)	2000	2000	128	45	136	14	0	195
17899	11491s (+0.7s)	2916	2916	256	68	175	12	0	255
Episode	Time	Reward	Score	Highest	L	U	R	D	Steps
17900	11492s (+0.8s)	3368	3368	256	70	206	12	0	288
17901	11493s (+0.8s)	3356	3356	256	55	220	6	0	281
17902	11493s (+0.9s)	3648	3648	256	66	220	10	0	296
17903	11494s (+0.9s)	4040	4040	256	84	235	13	0	332
17904	11495s (+0.8s)	3560	3560	256	74	213	12	0	299
17905	11496s (+0.6s)	1908	1908	128	54	129	12	0	195
17906	11497s (+0.9s)	3916	3916	256	73	237	9	0	319
17907	11497s (+0.6s)	2460	2460	256	47	153	11	0	211
17908	11498s (+0.3s)	880	880	64	27	81	7	0	115
17909	11499s (+1.0s)	4080	4080	256	75	250	17	0	342
17910	11499s (+0.4s)	1504	1504	128	40	115	5	0	160
17911	11500s (+1.3s)	6200	6200	512	112	307	22	0	441
17912	11501s (+1.1s)	5548	5548	512	85	292	0	20	397
17913	11503s (+1.2s)	5760	5760	512	79	308	0	20	407
17914	11503s (+0.4s)	1416	1416	128	32	105	0	5	142
17915	11504s (+0.8s)	3396	3396	256	52	230	0	9	291
17916	11504s (+0.5s)	1608	1608	128	29	123	0	7	159
17917	11505s (+0.7s)	2936	2936	256	61	182	0	17	260
17918	11506s (+1.0s)	4256	4256	256	77	260	0	13	350
17919	11506s (+0.2s)	596	596	64	15	63	0	3	81
17920	11507s (+0.9s)	3900	3900	256	67	235	0	14	316
17921	11508s (+0.7s)	2948	2948	256	55	174	0	8	237
17922	11509s (+0.7s)	2952	2952	256	56	188	9	0	253
17923	11509s (+0.6s)	2612	2612	256	57	156	9	1	223
17924	11510s (+0.5s)	1884	1884	128	47	135	7	0	189
17925	11511s (+0.8s)	3236	3236	256	65	194	12	0	271
17926	11511s (+0.6s)	1960	1960	128	57	140	6	0	203
17927	11512s (+0.5s)	1588	1588	128	43	108	9	0	160
17928	11512s (+0.7s)	2892	2892	256	65	174	10	0	249
17929	11513s (+1.0s)	4244	4244	256	95	243	13	0	351
17930	11514s (+0.5s)	1792	1792	128	44	124	14	0	182
17931	11514s (+0.4s)	1296	1296	128	33	97	5	0	135
17932	11515s (+0.9s)	3844	3844	256	58	251	0	18	327
17933	11516s (+0.8s)	3268	3268	256	57	210	0	13	280
17934	11517s (+0.7s)	2872	2872	256	60	176	0	12	248
17935	11517s (+0.3s)	856	856	64	15	91	0	5	111
17936	11518s (+0.9s)	3752	3752	256	52	239	0	11	302
17937	11519s (+0.6s)	2492	2492	256	36	176	0	4	216
17938	11519s (+0.6s)	2004	2004	128	41	147	0	11	199
17939	11520s (+0.5s)	1540	1540	128	27	133	0	4	164
17940	11521s (+0.9s)	4000	4000	256	64	253	0	17	334
17941	11521s (+0.6s)	2452	2452	256	51	148	0	7	206
17942	11522s (+0.5s)	1808	1808	128	36	145	0	5	186
17943	11522s (+0.6s)	2596	2596	256	40	167	0	9	216
17944	11523s (+0.5s)	1812	1812	128	41	133	0	7	181
17945	11523s (+0.6s)	2324	2324	256	49	142	0	13	204
17946	11524s (+0.7s)	2796	2796	256	55	174	0	13	242
17947	11525s (+1.0s)	4152	4152	256	62	268	0	10	340
17948	11526s (+0.5s)	1932	1932	128	41	152	0	8	201
17949	11526s (+0.4s)	1376	1376	128	25	113	7	0	145
17950	11527s (+0.6s)	2184	2184	128	48	161	11	0	220
17951	11527s (+0.7s)	2388	2388	128	70	150	14	0	234
17952	11528s (+0.6s)	2600	2600	256	51	168	9	0	228
17953	11528s (+0.3s)	840	840	64	25	82	3	0	110
17954	11529s (+0.8s)	3600	3600	256	85	199	18	0	302
17955	11530s (+0.5s)	1712	1712	128	47	120	8	0	175
17956	11531s (+0.8s)	3600	3600	256	77	208	18	0	303
17957	11531s (+0.7s)	2832	2832	256	53	178	12	0	243
17958	11532s (+0.3s)	1112	1112	128	18	100	3	0	121
17959	11532s (+0.5s)	1760	1760	128	37	128	10	0	175
17960	11533s (+0.6s)	2368	2368	256	57	136	9	0	202
17961	11533s (+0.3s)	1116	1116	128	18	97	3	0	118
17962	11534s (+0.9s)	3588	3588	256	71	210	17	1	299
17963	11535s (+1.0s)	4176	4176	256	84	242	20	0	346
17964	11535s (+0.4s)	1584	1584	128	39	113	5	1	158
17965	11536s (+0.9s)	3964	3964	256	88	219	18	0	325
17966	11537s (+0.8s)	3276	3276	256	64	193	0	11	268
17967	11538s (+0.6s)	2700	2700	256	46	169	0	12	227
17968	11538s (+0.2s)	484	484	64	10	55	0	6	71
17969	11538s (+0.4s)	1248	1248	64	30	100	7	0	137
17970	11539s (+0.8s)	3428	3428	256	75	197	12	0	284
17971	11540s (+0.5s)	1668	1668	128	29	134	5	0	168
17972	11541s (+0.9s)	3896	3896	256	79	230	16	0	325
17973	11541s (+0.7s)	2832	2832	256	48	193	9	1	251
17974	11542s (+0.7s)	3200	3200	256	67	191	10	0	268
17975	11542s (+0.3s)	808	808	64	35	67	6	1	109
17976	11543s (+1.1s)	5612	5612	512	90	282	19	0	391
17977	11544s (+0.5s)	1800	1800	128	41	129	10	0	180
17978	11544s (+0.4s)	992	992	64	28	96	3	0	127
17979	11545s (+0.8s)	3408	3408	256	69	202	13	0	284
17980	11546s (+0.5s)	1712	1712	128	45	117	11	0	173
17981	11546s (+0.7s)	3168	3168	256	74	169	16	1	260
17982	11547s (+0.8s)	3636	3636	256	80	208	17	0	305
17983	11548s (+0.8s)	3396	3396	256	79	190	11	0	280
17984	11549s (+0.6s)	1912	1912	128	47	143	6	0	196
17985	11549s (+0.5s)	1664	1664	128	46	116	6	1	169
17986	11550s (+1.0s)	5208	5208	512	104	254	17	0	375
17987	11551s (+0.5s)	1564	1564	128	44	122	3	1	170
17988	11551s (+0.2s)	504	504	64	17	52	3	0	72
17989	11552s (+0.6s)	2144	2144	128	51	135	14	0	200
17990	11552s (+0.5s)	1812	1812	128	41	139	8	0	188
17991	11553s (+0.8s)	3292	3292	256	75	188	11	0	274
17992	11554s (+0.8s)	3328	3328	256	74	193	11	0	278
17993	11554s (+0.3s)	912	912	64	29	85	4	0	118
17994	11555s (+0.7s)	2988	2988	256	56	187	10	0	253
17995	11556s (+0.9s)	3540	3540	256	68	220	11	0	299
17996	11557s (+1.1s)	4504	4504	256	106	247	15	0	368
17997	11557s (+0.5s)	1516	1516	128	31	124	7	0	162
17998	11558s (+0.5s)	1832	1832	128	45	128	9	0	182
17999	11558s (+0.7s)	2604	2604	128	70	155	18	0	243
Episode	Time	Reward	Score	Highest	L	U	R	D	Steps
18000	11559s (+0.3s)	824	824	64	16	87	5	0	108
18001	11560s (+1.3s)	6224	6224	512	113	305	24	0	442
18002	11560s (+0.4s)	1400	1400	128	25	114	0	6	145
18003	11561s (+0.3s)	804	804	64	16	80	0	7	103
18004	11561s (+0.7s)	2888	2888	256	63	163	0	12	238
18005	11562s (+0.9s)	3552	3552	256	64	222	0	16	302
18006	11563s (+0.3s)	824	824	64	20	73	0	4	97
18007	11563s (+0.3s)	724	724	64	21	69	0	3	93
18008	11564s (+0.6s)	2664	2664	256	49	183	4	0	236
18009	11564s (+0.3s)	944	944	64	33	76	7	1	117
18010	11564s (+0.5s)	1836	1836	128	43	133	9	0	185
18011	11565s (+0.9s)	3628	3628	256	68	222	19	0	309
18012	11566s (+0.7s)	2820	2820	128	67	183	13	0	263
18013	11567s (+0.7s)	3164	3164	256	74	176	15	0	265
18014	11568s (+0.7s)	3124	3124	256	74	173	13	0	260
18015	11568s (+0.9s)	4036	4036	256	82	234	15	0	331
18016	11569s (+0.6s)	2272	2272	128	65	136	11	0	212
18017	11570s (+0.6s)	1952	1952	128	58	128	13	0	199
18018	11570s (+0.6s)	2596	2596	256	57	160	7	0	224
18019	11571s (+0.5s)	1712	1712	128	33	130	6	0	169
18020	11571s (+0.4s)	1568	1568	128	33	113	5	0	151
18021	11572s (+1.1s)	5468	5468	512	105	256	26	0	387
18022	11574s (+1.2s)	6008	6008	512	111	293	21	0	425
18023	11574s (+0.7s)	2868	2868	256	54	188	6	0	248
18024	11575s (+0.9s)	3564	3564	256	66	224	15	0	305
18025	11576s (+0.4s)	1368	1368	128	37	102	4	0	143
18026	11576s (+0.5s)	1556	1556	128	39	115	7	0	161
18027	11576s (+0.4s)	1172	1172	128	17	108	2	0	127
18028	11577s (+0.4s)	1176	1176	128	28	96	3	0	127
18029	11577s (+0.5s)	1776	1776	128	50	118	12	0	180
18030	11578s (+0.5s)	1824	1824	128	50	134	6	0	190
18031	11579s (+1.0s)	4252	4252	256	103	227	18	0	348
18032	11580s (+0.8s)	3364	3364	256	82	192	13	0	287
18033	11580s (+0.4s)	1208	1208	128	24	98	3	0	125
18034	11581s (+0.5s)	1632	1632	128	40	128	7	0	175
18035	11581s (+0.9s)	3612	3612	256	89	212	11	0	312
18036	11582s (+0.3s)	800	800	64	23	78	6	0	107
18037	11582s (+0.5s)	1640	1640	128	43	123	0	11	177
18038	11583s (+0.6s)	2528	2528	256	39	160	0	13	212
18039	11584s (+0.7s)	2740	2740	256	45	174	0	14	233
18040	11584s (+0.5s)	1804	1804	128	46	132	0	8	186
18041	11585s (+0.7s)	3136	3136	256	65	183	15	0	263
18042	11585s (+0.6s)	2684	2684	256	51	169	5	0	225
18043	11586s (+0.3s)	732	732	32	34	65	7	0	106
18044	11587s (+0.9s)	3608	3608	256	73	216	15	0	304
18045	11587s (+0.5s)	1748	1748	128	39	128	10	0	177
18046	11588s (+0.4s)	1388	1388	128	29	104	7	0	140
18047	11588s (+0.5s)	1780	1780	128	39	117	9	1	166
18048	11589s (+0.8s)	3392	3392	256	83	178	18	1	280
18049	11590s (+0.7s)	3048	3048	256	57	181	10	0	248
18050	11590s (+0.3s)	812	812	64	27	75	8	0	110
18051	11590s (+0.4s)	1176	1176	128	26	95	5	1	127
18052	11591s (+0.9s)	4788	4788	512	77	230	21	1	329
18053	11592s (+0.5s)	1628	1628	128	49	112	12	0	173
18054	11593s (+0.9s)	3808	3808	256	94	210	14	0	318
18055	11593s (+0.7s)	3004	3004	256	56	182	13	0	251
18056	11594s (+0.5s)	1860	1860	128	39	139	11	0	189
18057	11595s (+0.8s)	3548	3548	256	70	220	12	0	302
18058	11595s (+0.5s)	1800	1800	128	60	118	7	0	185
18059	11596s (+0.4s)	1452	1452	128	42	95	10	0	147
18060	11597s (+0.9s)	3968	3968	256	74	244	8	0	326
18061	11597s (+0.4s)	1164	1164	128	30	87	7	0	124
18062	11598s (+0.6s)	2736	2736	256	55	167	10	0	232
18063	11598s (+0.4s)	1280	1280	128	33	101	7	0	141
18064	11599s (+1.0s)	4244	4244	256	92	244	15	0	351
18065	11600s (+0.5s)	1928	1928	128	60	131	9	0	200
18066	11600s (+0.7s)	2576	2576	128	71	157	11	0	239
18067	11601s (+0.4s)	1176	1176	64	39	94	8	0	141
18068	11601s (+0.6s)	2648	2648	256	58	156	10	0	224
18069	11602s (+0.8s)	3520	3520	256	91	190	13	0	294
18070	11603s (+0.6s)	2128	2128	128	58	150	10	0	218
18071	11603s (+0.5s)	2164	2164	256	48	130	8	0	186
18072	11604s (+1.0s)	4100	4100	256	109	215	19	0	343
18073	11605s (+1.0s)	4448	4448	256	81	252	17	1	351
18074	11606s (+0.8s)	3360	3360	256	62	202	11	0	275
18075	11607s (+1.0s)	4156	4156	256	82	239	18	0	339
18076	11608s (+0.6s)	2220	2220	128	50	151	11	1	213
18077	11608s (+0.4s)	1300	1300	128	22	105	4	0	131
18078	11609s (+1.0s)	4056	4056	256	92	227	18	0	337
18079	11610s (+0.4s)	1448	1448	128	37	108	5	0	150
18080	11610s (+0.3s)	1124	1124	128	31	80	7	0	118
18081	11611s (+1.0s)	4248	4248	256	87	248	16	1	352
18082	11611s (+0.5s)	1808	1808	128	45	140	2	0	187
18083	11612s (+0.7s)	2916	2916	256	66	178	11	0	255
18084	11613s (+0.7s)	2940	2940	256	57	194	10	0	261
18085	11613s (+0.5s)	1568	1568	128	42	114	7	1	164
18086	11614s (+0.4s)	1348	1348	128	23	117	3	0	143
18087	11614s (+0.5s)	1520	1520	128	36	115	8	0	159
18088	11615s (+0.6s)	2516	2516	256	54	154	12	0	220
18089	11615s (+0.4s)	1304	1304	128	35	100	4	0	139
18090	11616s (+1.0s)	4256	4256	256	79	261	14	0	354
18091	11617s (+1.0s)	4120	4120	256	71	246	0	20	337
18092	11618s (+0.4s)	1528	1528	128	46	105	9	1	161
18093	11618s (+0.2s)	392	392	64	11	43	2	0	56
18094	11618s (+0.5s)	1920	1920	128	44	150	4	0	198
18095	11619s (+0.5s)	1812	1812	128	47	128	7	1	183
18096	11619s (+0.5s)	1528	1528	128	47	108	6	0	161
18097	11620s (+0.4s)	1472	1472	128	39	107	6	0	152
18098	11621s (+0.7s)	2772	2772	256	54	174	12	0	240
18099	11621s (+0.5s)	1768	1768	128	44	125	9	0	178
Episode	Time	Reward	Score	Highest	L	U	R	D	Steps
18100	11622s (+0.7s)	2504	2504	128	57	167	13	0	237
18101	11622s (+0.4s)	1212	1212	64	37	90	8	0	135
18102	11623s (+0.6s)	2548	2548	256	46	169	9	0	224
18103	11624s (+0.8s)	3292	3292	256	64	195	10	0	269
18104	11624s (+0.5s)	1612	1612	128	42	121	7	0	170
18105	11625s (+0.8s)	3180	3180	256	59	197	8	0	264
18106	11625s (+0.4s)	1172	1172	128	37	82	7	0	126
18107	11626s (+0.8s)	3296	3296	256	74	194	14	0	282
18108	11627s (+0.4s)	1436	1436	128	28	115	5	0	148
18109	11627s (+0.6s)	2160	2160	128	56	145	14	0	215
18110	11628s (+0.6s)	2124	2124	128	58	141	11	0	210
18111	11628s (+0.7s)	2892	2892	256	64	174	11	0	249
18112	11629s (+0.6s)	2240	2240	256	40	145	10	0	195
18113	11630s (+0.5s)	1804	1804	128	34	141	9	2	186
18114	11630s (+0.2s)	544	544	32	18	59	4	0	81
18115	11630s (+0.5s)	1572	1572	128	41	120	6	0	167
18116	11631s (+0.5s)	1708	1708	128	34	132	0	8	174
18117	11631s (+0.5s)	1780	1780	128	49	123	0	8	180
18118	11632s (+0.7s)	2944	2944	256	63	188	11	0	262
18119	11632s (+0.3s)	868	868	64	23	85	4	0	112
18120	11633s (+0.6s)	1924	1924	128	41	152	6	0	199
18121	11634s (+0.7s)	2800	2800	256	58	173	0	12	243
18122	11634s (+0.8s)	3132	3132	256	53	201	9	0	263
18123	11635s (+0.7s)	2852	2852	256	47	188	0	15	250
18124	11636s (+0.5s)	1804	1804	128	42	137	7	0	186
18125	11637s (+1.2s)	5780	5780	512	123	265	28	0	416
18126	11637s (+0.2s)	480	480	32	17	52	6	1	76
18127	11637s (+0.4s)	1480	1480	128	39	108	7	0	154
18128	11638s (+0.7s)	2808	2808	256	56	180	9	0	245
18129	11639s (+0.8s)	3364	3364	256	70	204	13	0	287
18130	11640s (+0.8s)	3248	3248	256	70	192	13	0	275
18131	11640s (+0.5s)	1840	1840	128	43	136	0	8	187
18132	11641s (+0.7s)	2684	2684	256	51	185	0	4	240
18133	11641s (+0.3s)	1012	1012	128	16	89	0	3	108
18134	11642s (+0.3s)	852	852	64	15	87	0	5	107
18135	11642s (+0.5s)	1752	1752	128	56	114	14	0	184
18136	11643s (+0.6s)	2460	2460	256	62	134	12	0	208
18137	11643s (+0.5s)	1720	1720	128	42	118	10	0	170
18138	11644s (+0.7s)	2988	2988	256	51	196	7	0	254
18139	11645s (+0.8s)	3360	3360	256	76	180	19	0	275
18140	11646s (+0.8s)	3508	3508	256	77	200	15	1	293
18141	11647s (+0.9s)	3748	3748	256	65	221	12	1	299
18142	11647s (+0.8s)	3452	3452	256	81	201	12	0	294
18143	11648s (+0.8s)	3356	3356	256	73	185	18	0	276
18144	11649s (+0.7s)	2912	2912	256	62	180	12	0	254
18145	11650s (+0.7s)	2940	2940	256	71	169	9	1	250
18146	11650s (+0.5s)	1632	1632	128	43	126	6	0	175
18147	11650s (+0.2s)	528	528	64	17	57	4	0	78
18148	11651s (+1.0s)	5140	5140	512	96	249	17	1	363
18149	11652s (+0.4s)	1176	1176	64	36	102	3	0	141
18150	11652s (+0.5s)	1624	1624	128	37	121	8	0	166
18151	11653s (+0.4s)	1392	1392	128	44	96	8	0	148
18152	11653s (+0.5s)	1792	1792	128	51	129	3	0	183
18153	11654s (+1.0s)	4192	4192	256	86	238	19	0	343
18154	11655s (+0.7s)	2912	2912	256	60	177	12	1	250
18155	11656s (+0.6s)	2388	2388	256	49	141	9	0	199
18156	11656s (+0.8s)	3368	3368	256	76	192	12	0	280
18157	11657s (+0.6s)	2692	2692	256	53	166	8	0	227
18158	11657s (+0.5s)	1824	1824	128	50	124	10	0	184
18159	11659s (+1.4s)	6588	6588	512	121	332	24	0	477
18160	11660s (+1.2s)	6108	6108	512	110	291	21	1	423
18161	11661s (+0.4s)	1488	1488	128	37	112	6	0	155
18162	11661s (+0.3s)	704	704	64	17	72	2	1	92
18163	11662s (+0.8s)	3316	3316	256	63	203	14	0	280
18164	11662s (+0.4s)	1392	1392	128	23	115	4	0	142
18165	11663s (+0.8s)	3248	3248	256	77	186	12	0	275
18166	11663s (+0.5s)	1680	1680	128	28	134	9	0	171
18167	11664s (+0.6s)	2456	2456	256	49	155	6	0	210
18168	11665s (+1.3s)	6480	6480	512	128	301	29	1	459
18169	11666s (+0.8s)	3496	3496	256	76	201	15	1	293
18170	11666s (+0.4s)	1516	1516	128	33	118	5	0	156
18171	11667s (+0.7s)	2524	2524	128	70	161	11	0	242
18172	11668s (+0.7s)	2752	2752	256	68	152	11	0	231
18173	11668s (+0.5s)	1608	1608	128	42	121	6	0	169
18174	11669s (+0.8s)	3504	3504	256	63	218	14	0	295
18175	11670s (+0.7s)	2836	2836	256	52	176	12	0	240
18176	11671s (+0.7s)	2488	2488	128	58	165	10	1	234
18177	11671s (+0.6s)	2420	2420	256	49	145	8	0	202
18178	11672s (+0.7s)	3000	3000	256	67	176	11	0	254
18179	11672s (+0.3s)	924	924	64	24	84	4	0	112
18180	11673s (+0.5s)	1780	1780	128	32	144	4	0	180
18181	11673s (+0.6s)	2236	2236	128	66	143	12	0	221
18182	11674s (+0.8s)	3432	3432	256	60	210	0	18	288
18183	11675s (+0.6s)	2392	2392	128	46	161	0	16	223
18184	11675s (+0.2s)	548	548	64	14	59	0	1	74
18185	11675s (+0.4s)	1408	1408	128	20	122	0	3	145
18186	11676s (+0.8s)	3332	3332	256	58	206	0	15	279
18187	11677s (+0.8s)	3552	3552	256	61	229	0	12	302
18188	11678s (+0.5s)	1812	1812	128	37	145	0	6	188
18189	11678s (+0.4s)	1428	1428	128	28	119	3	0	150
18190	11678s (+0.2s)	580	580	64	15	63	1	0	79
18191	11679s (+0.7s)	2676	2676	256	53	166	10	0	229
18192	11679s (+0.5s)	1500	1500	128	39	117	2	0	158
18193	11680s (+0.4s)	1488	1488	128	41	106	8	0	155
18194	11680s (+0.3s)	1076	1076	128	18	96	2	0	116
18195	11681s (+0.9s)	3928	3928	256	77	217	21	0	315
18196	11682s (+1.0s)	4312	4312	256	98	241	17	0	356
18197	11683s (+0.6s)	2208	2208	256	51	137	4	0	192
18198	11683s (+0.7s)	2572	2572	128	68	158	12	0	238
18199	11684s (+0.5s)	1948	1948	128	49	134	12	0	195
Episode	Time	Reward	Score	Highest	L	U	R	D	Steps
18200	11685s (+1.3s)	6356	6356	512	126	304	17	0	447
18201	11686s (+1.1s)	4636	4636	256	109	252	23	0	384
18202	11687s (+0.3s)	916	916	64	23	82	4	1	110
18203	11687s (+0.5s)	2308	2308	256	29	153	0	9	191
18204	11688s (+0.4s)	1312	1312	128	27	104	0	4	135
18205	11688s (+0.7s)	2992	2992	256	63	178	0	13	254
18206	11689s (+0.4s)	1272	1272	64	31	102	0	9	142
18207	11689s (+0.4s)	1332	1332	128	30	101	0	3	134
18208	11690s (+0.3s)	928	928	64	25	82	1	5	113
18209	11691s (+1.1s)	4868	4868	256	84	269	0	22	375
18210	11691s (+0.5s)	1776	1776	128	39	139	0	5	183
18211	11692s (+0.9s)	3620	3620	256	69	222	16	0	307
18212	11692s (+0.4s)	1268	1268	128	35	94	8	0	137
18213	11693s (+0.6s)	2252	2252	256	46	143	9	0	198
18214	11694s (+0.8s)	3112	3112	256	76	177	13	0	266
18215	11694s (+0.4s)	1280	1280	128	27	107	3	0	137
18216	11695s (+0.8s)	3284	3284	256	83	188	15	1	287
18217	11696s (+1.1s)	4568	4568	256	94	271	14	0	379
18218	11697s (+1.0s)	4212	4212	256	97	229	22	0	348
18219	11698s (+0.5s)	1856	1856	128	46	130	11	0	187
18220	11698s (+0.3s)	760	760	64	22	69	6	0	97
18221	11698s (+0.5s)	1620	1620	128	63	101	8	0	172
18222	11699s (+0.7s)	2732	2732	256	45	182	11	0	238
18223	11700s (+0.4s)	1392	1392	128	32	112	4	0	148
18224	11700s (+0.4s)	1316	1316	128	34	94	7	0	135
18225	11701s (+0.8s)	3376	3376	256	64	203	12	0	279
18226	11702s (+1.1s)	4500	4500	256	72	276	0	20	368
18227	11703s (+0.9s)	3652	3652	256	68	214	0	15	297
18228	11703s (+0.4s)	1192	1192	128	26	92	0	7	125
18229	11703s (+0.4s)	1384	1384	128	29	111	5	1	146
18230	11704s (+0.3s)	672	672	64	15	73	2	0	90
18231	11704s (+0.5s)	1900	1900	128	48	139	6	0	193
18232	11705s (+0.7s)	3044	3044	256	64	173	13	0	250
18233	11705s (+0.4s)	1464	1464	128	39	109	6	0	154
18234	11706s (+0.5s)	1768	1768	128	51	121	9	0	181
18235	11706s (+0.5s)	2040	2040	128	42	138	7	1	188
18236	11707s (+0.7s)	3060	3060	256	70	171	11	0	252
18237	11707s (+0.3s)	732	732	64	23	65	8	0	96
18238	11708s (+0.8s)	3220	3220	256	77	184	12	0	273
18239	11709s (+0.4s)	1452	1452	128	24	119	4	0	147
18240	11709s (+0.8s)	3296	3296	256	76	191	12	0	279
18241	11710s (+0.7s)	2864	2864	256	54	182	11	1	248
18242	11711s (+0.7s)	2916	2916	256	57	183	0	15	255
18243	11712s (+0.7s)	2812	2812	256	52	183	0	11	246
18244	11712s (+0.8s)	3692	3692	256	62	231	0	8	301
18245	11713s (+0.5s)	1776	1776	128	33	136	0	10	179
18246	11713s (+0.5s)	1796	1796	128	41	135	0	7	183
18247	11714s (+0.4s)	1196	1196	128	26	101	5	0	132
18248	11714s (+0.5s)	1804	1804	128	49	128	10	0	187
18249	11715s (+0.3s)	888	888	64	22	87	4	0	113
18250	11716s (+0.8s)	3368	3368	256	58	207	14	0	279
18251	11716s (+0.6s)	2424	2424	256	51	145	7	0	203
18252	11717s (+0.7s)	2932	2932	256	43	192	7	0	242
18253	11718s (+1.1s)	4460	4460	256	99	255	19	0	373
18254	11718s (+0.5s)	1752	1752	128	44	126	6	0	176
18255	11719s (+0.6s)	1868	1868	128	50	132	8	0	190
18256	11720s (+0.7s)	2864	2864	256	50	190	11	0	251
18257	11720s (+0.8s)	3280	3280	256	72	184	15	0	271
18258	11721s (+0.5s)	1756	1756	128	52	117	10	0	179
18259	11722s (+0.9s)	3968	3968	256	87	222	16	1	326
18260	11722s (+0.5s)	1616	1616	128	40	124	6	1	171
18261	11723s (+0.7s)	2896	2896	256	67	164	16	1	248
18262	11724s (+0.5s)	1756	1756	128	53	117	9	0	179
18263	11724s (+0.5s)	1756	1756	128	50	115	13	0	178
18264	11724s (+0.3s)	812	812	64	20	78	5	0	103
18265	11725s (+0.4s)	1152	1152	64	31	98	0	7	136
18266	11726s (+0.8s)	3264	3264	256	62	199	0	12	273
18267	11726s (+0.7s)	2860	2860	256	48	186	0	12	246
18268	11727s (+0.4s)	1472	1472	128	38	107	7	0	152
18269	11727s (+0.4s)	1468	1468	128	37	115	3	0	155
18270	11728s (+0.7s)	2940	2940	256	52	183	11	0	246
18271	11729s (+0.6s)	2668	2668	256	67	144	15	0	226
18272	11729s (+0.8s)	3176	3176	256	72	177	13	0	262
18273	11730s (+0.8s)	3200	3200	256	80	175	13	0	268
18274	11731s (+0.5s)	1844	1844	128	50	113	10	1	174
18275	11731s (+0.5s)	1644	1644	128	40	121	5	1	167
18276	11731s (+0.3s)	736	736	64	24	68	5	0	97
18277	11732s (+0.5s)	1660	1660	128	37	129	9	0	175
18278	11732s (+0.5s)	1656	1656	128	39	135	2	0	176
18279	11733s (+0.3s)	1112	1112	128	25	88	3	0	116
18280	11734s (+0.9s)	4724	4724	512	76	229	14	0	319
18281	11735s (+1.1s)	5148	5148	512	93	268	16	0	377
18282	11736s (+0.8s)	3380	3380	256	80	197	14	0	291
18283	11736s (+0.3s)	732	732	64	19	73	4	0	96
18284	11736s (+0.5s)	1600	1600	128	34	121	13	0	168
18285	11737s (+0.9s)	3920	3920	256	68	233	0	18	319
18286	11738s (+0.8s)	3540	3540	256	64	222	0	13	299
18287	11739s (+0.5s)	1760	1760	128	33	138	0	8	179
18288	11740s (+1.0s)	5136	5136	512	94	252	16	0	362
18289	11740s (+0.5s)	1776	1776	128	49	122	9	0	180
18290	11741s (+0.8s)	3264	3264	256	64	195	12	1	272
18291	11742s (+0.6s)	2436	2436	256	63	133	10	0	206
18292	11742s (+0.4s)	1052	1052	64	27	95	4	0	126
18293	11742s (+0.4s)	1352	1352	128	44	97	8	0	149
18294	11743s (+0.8s)	3564	3564	256	90	190	18	0	298
18295	11744s (+0.6s)	2128	2128	128	57	135	12	0	204
18296	11745s (+0.8s)	3228	3228	256	57	196	17	0	270
18297	11745s (+0.3s)	720	720	64	23	68	3	0	94
18298	11745s (+0.6s)	2232	2232	128	52	151	10	0	213
18299	11746s (+0.5s)	1680	1680	128	38	128	5	0	171
Episode	Time	Reward	Score	Highest	L	U	R	D	Steps
18300	11747s (+0.6s)	2476	2476	256	49	151	11	0	211
18301	11748s (+1.3s)	6304	6304	512	124	307	20	0	451
18302	11749s (+0.9s)	3776	3776	256	88	193	18	1	300
18303	11749s (+0.5s)	1648	1648	128	52	116	4	0	172
18304	11750s (+0.6s)	2064	2064	128	55	130	7	1	193
18305	11750s (+0.4s)	1072	1072	64	39	87	6	0	132
18306	11751s (+1.2s)	6288	6288	512	122	297	24	0	443
18307	11752s (+0.5s)	1592	1592	128	37	123	5	0	165
18308	11753s (+0.8s)	3316	3316	256	72	190	17	1	280
18309	11753s (+0.8s)	2780	2780	128	76	167	15	0	258
18310	11754s (+0.7s)	2772	2772	256	55	171	11	0	237
18311	11755s (+0.6s)	2588	2588	256	46	165	11	0	222
18312	11755s (+0.5s)	1772	1772	128	44	131	7	0	182
18313	11756s (+0.5s)	1880	1880	128	36	154	3	0	193
18314	11756s (+0.5s)	1920	1920	128	38	152	8	0	198
18315	11757s (+0.9s)	4000	4000	256	92	212	23	0	327
18316	11758s (+0.5s)	1560	1560	128	31	130	8	0	169
18317	11758s (+0.7s)	2492	2492	128	62	151	16	0	229
18318	11759s (+0.8s)	3384	3384	256	82	191	14	0	287
18319	11760s (+0.9s)	3748	3748	256	75	236	0	8	319
18320	11761s (+0.8s)	3372	3372	256	50	222	0	14	286
18321	11761s (+0.3s)	756	756	64	17	81	0	4	102
18322	11762s (+0.3s)	728	728	64	27	62	0	5	94
18323	11762s (+0.5s)	1792	1792	128	34	138	0	11	183
18324	11763s (+0.5s)	1800	1800	128	40	136	0	8	184
18325	11763s (+0.2s)	524	524	64	14	55	0	3	72
18326	11763s (+0.5s)	2132	2132	256	42	130	7	0	179
18327	11764s (+0.8s)	3472	3472	256	74	194	18	1	287
18328	11765s (+0.7s)	2620	2620	256	64	154	12	0	230
18329	11766s (+0.9s)	3620	3620	256	71	220	16	0	307
18330	11766s (+0.6s)	1924	1924	128	48	142	9	0	199
18331	11767s (+0.3s)	964	964	128	31	72	3	0	106
18332	11767s (+0.5s)	1736	1736	128	35	133	7	0	175
18333	11768s (+0.8s)	3336	3336	256	85	180	15	0	280
18334	11769s (+0.6s)	2572	2572	256	58	156	9	0	223
18335	11769s (+0.3s)	776	776	64	25	71	7	0	103
18336	11770s (+0.8s)	3424	3424	256	71	199	17	0	287
18337	11770s (+0.6s)	1872	1872	128	56	133	9	0	198
18338	11771s (+0.6s)	2508	2508	256	52	151	11	0	214
18339	11771s (+0.2s)	540	540	32	24	60	2	0	86
18340	11772s (+0.7s)	2560	2560	128	60	163	16	0	239
18341	11772s (+0.4s)	1328	1328	128	33	95	9	0	137
18342	11773s (+0.5s)	2340	2340	256	45	145	7	1	198
18343	11773s (+0.5s)	1632	1632	128	35	133	0	7	175
18344	11774s (+0.8s)	3300	3300	256	48	213	0	17	278
18345	11774s (+0.2s)	664	664	64	15	71	0	2	88
18346	11775s (+0.3s)	996	996	64	27	87	5	0	119
18347	11775s (+0.7s)	2992	2992	256	67	172	16	0	255
18348	11776s (+0.8s)	3396	3396	256	59	200	8	0	267
18349	11777s (+0.5s)	1500	1500	128	37	116	6	0	159
18350	11777s (+0.7s)	2932	2932	256	57	189	10	0	256
18351	11778s (+0.7s)	3156	3156	256	61	191	12	0	264
18352	11779s (+1.2s)	6240	6240	512	122	280	29	0	431
18353	11780s (+1.0s)	4308	4308	256	87	260	13	0	360
18354	11781s (+0.5s)	1612	1612	128	46	116	8	0	170
18355	11781s (+0.6s)	2484	2484	256	46	153	12	2	213
18356	11782s (+0.6s)	2460	2460	256	56	144	12	0	212
18357	11783s (+0.5s)	1804	1804	128	43	133	10	0	186
18358	11783s (+0.4s)	1512	1512	128	37	113	6	0	156
18359	11784s (+0.7s)	2924	2924	256	61	182	14	0	257
18360	11784s (+0.7s)	2744	2744	256	50	172	12	0	234
18361	11785s (+0.4s)	1176	1176	64	31	104	6	0	141
18362	11786s (+0.9s)	3988	3988	256	57	259	0	15	331
18363	11786s (+0.6s)	2548	2548	256	43	158	0	11	212
18364	11787s (+0.8s)	3288	3288	256	52	211	0	15	278
18365	11788s (+0.8s)	3392	3392	256	58	208	0	14	280
18366	11788s (+0.3s)	772	772	64	14	82	0	9	105
18367	11789s (+0.6s)	2316	2316	128	39	165	0	11	215
18368	11789s (+0.2s)	480	480	32	14	50	0	6	70
18369	11790s (+0.8s)	3432	3432	256	55	212	0	22	289
18370	11791s (+0.6s)	1928	1928	128	48	138	0	11	197
18371	11791s (+0.4s)	1168	1168	64	35	102	0	3	140
18372	11792s (+0.8s)	3512	3512	256	68	211	13	0	292
18373	11792s (+0.3s)	848	848	64	18	90	4	0	112
18374	11793s (+0.6s)	2392	2392	256	45	152	9	0	206
18375	11793s (+0.7s)	2964	2964	256	51	189	8	0	248
18376	11794s (+0.3s)	684	684	64	13	77	3	0	93
18377	11794s (+0.5s)	1608	1608	128	44	115	9	0	168
18378	11795s (+0.8s)	3396	3396	256	61	203	16	0	280
18379	11796s (+0.8s)	3332	3332	256	70	194	15	0	279
18380	11796s (+0.5s)	1848	1848	128	51	129	10	0	190
18381	11797s (+0.6s)	2140	2140	128	47	142	10	0	199
18382	11798s (+0.7s)	2728	2728	256	55	166	10	0	231
18383	11798s (+0.8s)	3540	3540	256	76	200	17	0	293
18384	11799s (+0.4s)	1156	1156	64	29	103	9	0	141
18385	11799s (+0.7s)	2348	2348	128	60	158	10	1	229
18386	11800s (+0.9s)	3932	3932	256	84	215	23	0	322
18387	11801s (+0.7s)	2840	2840	128	82	164	15	0	261
18388	11802s (+0.5s)	1860	1860	128	35	138	5	0	178
18389	11802s (+0.7s)	2792	2792	256	52	180	9	0	241
18390	11803s (+1.0s)	4268	4268	256	94	241	22	0	357
18391	11804s (+0.4s)	1448	1448	128	34	109	7	0	150
18392	11805s (+0.7s)	2988	2988	256	65	167	19	0	251
18393	11805s (+0.4s)	1196	1196	64	35	105	4	0	144
18394	11806s (+0.8s)	3216	3216	256	63	194	11	0	268
18395	11807s (+1.2s)	5824	5824	512	123	268	21	0	412
18396	11807s (+0.3s)	844	844	64	28	75	4	0	107
18397	11808s (+0.4s)	1316	1316	128	31	108	6	0	145
18398	11808s (+0.5s)	1804	1804	128	43	130	13	0	186
18399	11809s (+0.4s)	1200	1200	64	23	116	0	6	145
Episode	Time	Reward	Score	Highest	L	U	R	D	Steps
18400	11809s (+0.8s)	3416	3416	256	67	206	0	12	285
18401	11810s (+0.7s)	3216	3216	256	59	197	1	10	267
18402	11811s (+1.1s)	5528	5528	512	77	303	0	17	397
18403	11812s (+0.8s)	3608	3608	256	53	221	0	15	289
18404	11812s (+0.4s)	1340	1340	128	22	109	0	6	137
18405	11813s (+0.3s)	772	772	64	18	78	0	2	98
18406	11813s (+0.5s)	1940	1940	128	47	133	9	0	189
18407	11814s (+0.7s)	3092	3092	256	71	165	21	0	257
18408	11815s (+0.7s)	3228	3228	256	68	183	12	0	263
18409	11815s (+0.5s)	1720	1720	128	43	122	12	0	177
18410	11816s (+0.8s)	3496	3496	256	77	196	20	0	293
18411	11817s (+0.4s)	1400	1400	128	33	109	6	0	148
18412	11817s (+0.5s)	1796	1796	128	45	130	8	1	184
18413	11818s (+0.8s)	3532	3532	256	70	204	17	0	291
18414	11819s (+0.7s)	3104	3104	256	75	166	15	0	256
18415	11819s (+0.7s)	2780	2780	256	49	179	11	0	239
18416	11820s (+0.7s)	2556	2556	128	75	148	15	0	238
18417	11820s (+0.4s)	1408	1408	128	36	116	6	0	158
18418	11821s (+0.5s)	1596	1596	128	31	123	4	0	158
18419	11821s (+0.4s)	1452	1452	128	29	110	8	0	147
18420	11822s (+0.8s)	3488	3488	256	62	218	11	0	291
18421	11823s (+0.4s)	1028	1028	64	38	78	7	1	124
18422	11823s (+0.5s)	1740	1740	128	36	130	8	0	174
18423	11824s (+0.8s)	3608	3608	256	63	227	0	12	302
18424	11825s (+1.1s)	5288	5288	512	84	272	0	17	373
18425	11826s (+0.8s)	3376	3376	256	52	218	0	12	282
18426	11826s (+0.7s)	2800	2800	256	57	177	0	9	243
18427	11827s (+0.6s)	2768	2768	256	45	185	0	5	235
18428	11828s (+1.0s)	4144	4144	256	72	250	0	16	338
18429	11829s (+0.5s)	1844	1844	128	40	145	0	6	191
18430	11829s (+0.3s)	732	732	64	16	74	0	7	97
18431	11830s (+0.6s)	1924	1924	128	44	147	0	9	200
18432	11830s (+0.5s)	1712	1712	128	45	123	7	0	175
18433	11831s (+0.6s)	2456	2456	256	57	144	10	0	211
18434	11831s (+0.3s)	912	912	64	29	85	5	0	119
18435	11832s (+0.5s)	1692	1692	128	36	131	8	0	175
18436	11833s (+1.0s)	4260	4260	256	88	251	12	0	351
18437	11833s (+0.6s)	1924	1924	128	45	148	6	0	199
18438	11834s (+0.6s)	2264	2264	256	45	141	9	0	195
18439	11835s (+0.9s)	3988	3988	256	79	236	16	0	331
18440	11835s (+0.5s)	1632	1632	128	47	117	10	0	174
18441	11836s (+0.8s)	3596	3596	256	76	211	14	0	301
18442	11836s (+0.4s)	1412	1412	128	32	114	7	0	153
18443	11837s (+0.3s)	1160	1160	128	26	82	6	1	115
18444	11838s (+0.8s)	3520	3520	256	75	203	16	0	294
18445	11839s (+0.9s)	4108	4108	256	93	225	16	0	334
18446	11839s (+0.4s)	1184	1184	128	26	97	5	0	128
18447	11839s (+0.4s)	1400	1400	128	32	106	7	0	145
18448	11840s (+0.5s)	1812	1812	128	42	139	6	0	187
18449	11840s (+0.5s)	1568	1568	128	42	113	6	0	161
18450	11841s (+0.7s)	2756	2756	256	63	164	9	1	237
18451	11842s (+0.9s)	4732	4732	512	81	235	15	0	331
18452	11843s (+1.0s)	4264	4264	256	76	264	13	0	353
18453	11843s (+0.5s)	1700	1700	128	42	128	6	0	176
18454	11844s (+0.6s)	2304	2304	256	38	149	9	0	196
18455	11845s (+0.7s)	2776	2776	256	50	186	6	0	242
18456	11846s (+0.8s)	3548	3548	256	63	224	14	0	301
18457	11846s (+0.3s)	980	980	64	32	82	6	1	121
18458	11847s (+0.6s)	2536	2536	256	52	155	11	0	218
18459	11847s (+0.5s)	1492	1492	128	41	105	11	0	157
18460	11848s (+0.8s)	3160	3160	256	59	191	15	0	265
18461	11849s (+0.8s)	3408	3408	256	69	196	18	1	284
18462	11849s (+0.5s)	2020	2020	128	52	133	11	1	197
18463	11850s (+1.2s)	5836	5836	512	95	303	15	0	413
18464	11851s (+0.8s)	3440	3440	256	90	189	12	0	291
18465	11852s (+0.6s)	1920	1920	128	41	151	6	0	198
18466	11852s (+0.4s)	1180	1180	64	37	93	2	0	132
18467	11853s (+0.4s)	1508	1508	128	37	107	6	0	150
18468	11853s (+0.5s)	1936	1936	128	62	120	9	0	191
18469	11853s (+0.2s)	400	400	32	24	38	4	0	66
18470	11854s (+0.6s)	2488	2488	256	45	164	5	0	214
18471	11855s (+1.0s)	4472	4472	256	99	230	20	1	350
18472	11855s (+0.4s)	1032	1032	64	31	84	8	0	123
18473	11856s (+0.6s)	1944	1944	128	41	155	8	0	204
18474	11857s (+0.7s)	2896	2896	256	71	164	15	0	250
18475	11857s (+0.6s)	2456	2456	256	48	155	7	0	210
18476	11858s (+0.3s)	736	736	64	17	74	0	6	97
18477	11858s (+0.4s)	1260	1260	128	29	102	0	5	136
18478	11858s (+0.3s)	696	696	64	16	70	0	6	92
18479	11859s (+0.7s)	2876	2876	256	58	181	8	0	247
18480	11860s (+0.7s)	2932	2932	256	47	187	10	0	244
18481	11860s (+0.4s)	1236	1236	128	26	99	5	0	130
18482	11860s (+0.3s)	924	924	64	23	83	6	0	112
18483	11861s (+1.0s)	4208	4208	256	86	238	19	0	343
18484	11862s (+0.7s)	3064	3064	256	60	183	14	1	258
18485	11863s (+0.8s)	3420	3420	256	67	210	9	0	286
18486	11864s (+0.9s)	4052	4052	256	71	235	15	0	321
18487	11864s (+0.5s)	1568	1568	128	35	120	9	1	165
18488	11865s (+0.6s)	2444	2444	256	50	142	15	0	207
18489	11865s (+0.6s)	2444	2444	128	61	156	10	0	227
18490	11866s (+0.4s)	1492	1492	128	39	111	7	0	157
18491	11867s (+0.8s)	3352	3352	256	71	203	10	0	284
18492	11867s (+0.2s)	588	588	64	17	59	6	0	82
18493	11867s (+0.3s)	980	980	64	26	84	4	0	114
18494	11868s (+0.5s)	1704	1704	128	38	127	12	0	177
18495	11869s (+1.2s)	6000	6000	512	103	303	21	0	427
18496	11870s (+0.5s)	1808	1808	128	61	110	10	0	181
18497	11870s (+0.7s)	3144	3144	256	69	182	9	1	261
18498	11871s (+0.5s)	1776	1776	128	34	134	11	0	179
18499	11871s (+0.2s)	464	464	32	10	59	0	4	73
Episode	Time	Reward	Score	Highest	L	U	R	D	Steps
18500	11872s (+0.6s)	2280	2280	256	36	149	0	10	195
18501	11872s (+0.8s)	3504	3504	256	64	214	0	12	290
18502	11873s (+0.8s)	3636	3636	256	65	221	0	10	296
18503	11874s (+1.0s)	4140	4140	256	67	249	0	21	337
18504	11875s (+0.4s)	1136	1136	64	41	91	0	4	136
18505	11875s (+0.6s)	2456	2456	256	39	162	0	11	212
18506	11876s (+0.5s)	1908	1908	128	46	127	0	8	181
18507	11877s (+0.9s)	4048	4048	256	91	225	18	0	334
18508	11877s (+0.4s)	1424	1424	128	31	111	4	0	146
18509	11877s (+0.3s)	804	804	64	27	73	5	1	106
18510	11878s (+0.4s)	1480	1480	128	36	110	8	0	154
18511	11878s (+0.4s)	1244	1244	128	33	100	6	0	139
18512	11879s (+0.9s)	3928	3928	256	60	245	0	16	321
18513	11880s (+0.6s)	2552	2552	256	52	157	0	15	224
18514	11881s (+1.0s)	4456	4456	256	74	275	0	19	368
18515	11881s (+0.5s)	1696	1696	128	38	125	0	6	169
18516	11882s (+0.9s)	3716	3716	256	54	235	0	12	301
18517	11883s (+0.7s)	2808	2808	256	53	185	0	7	245
18518	11884s (+0.9s)	3620	3620	256	69	222	0	12	303
18519	11885s (+0.9s)	3572	3572	256	58	227	0	15	300
18520	11885s (+0.5s)	1792	1792	128	40	135	0	8	183
18521	11886s (+0.7s)	2520	2520	128	51	170	0	16	237
18522	11886s (+0.3s)	736	736	64	25	68	0	4	97
18523	11887s (+0.9s)	3564	3564	256	63	223	0	18	304
18524	11888s (+0.9s)	3980	3980	256	68	243	0	19	330
18525	11889s (+0.6s)	2672	2672	256	62	151	15	0	228
18526	11890s (+1.1s)	5392	5392	512	86	275	19	0	380
18527	11890s (+0.6s)	1920	1920	128	43	148	7	0	198
18528	11891s (+0.6s)	2476	2476	256	51	155	9	0	215
18529	11891s (+0.4s)	1060	1060	64	31	92	5	0	128
18530	11892s (+0.5s)	2344	2344	256	47	141	11	1	200
18531	11893s (+0.6s)	2612	2612	256	55	161	8	0	224
18532	11893s (+0.4s)	1188	1188	64	39	96	8	0	143
18533	11894s (+0.6s)	2376	2376	128	66	145	11	0	222
18534	11894s (+0.4s)	1596	1596	128	40	115	8	0	163
18535	11895s (+0.9s)	3652	3652	256	100	198	13	0	311
18536	11896s (+0.8s)	3036	3036	256	78	176	11	0	265
18537	11896s (+0.5s)	1532	1532	128	35	117	7	0	159
18538	11897s (+0.6s)	2600	2600	256	68	148	9	0	225
18539	11897s (+0.6s)	2648	2648	256	43	172	8	0	223
18540	11898s (+0.5s)	1616	1616	128	32	135	4	0	171
18541	11898s (+0.4s)	1404	1404	128	38	97	10	0	145
18542	11899s (+0.4s)	1340	1340	128	39	98	9	0	146
18543	11900s (+1.0s)	4268	4268	256	87	245	14	0	346
18544	11901s (+0.9s)	3940	3940	256	83	223	12	1	319
18545	11902s (+0.9s)	3916	3916	256	84	218	22	0	324
18546	11902s (+0.3s)	776	776	64	20	67	6	0	93
18547	11902s (+0.5s)	1676	1676	128	37	126	8	0	171
18548	11903s (+0.8s)	3500	3500	256	84	198	12	0	294
18549	11904s (+0.9s)	3868	3868	256	76	230	11	1	318
18550	11905s (+1.0s)	4244	4244	256	86	249	16	0	351
18551	11906s (+0.9s)	3956	3956	256	75	231	17	0	323
18552	11906s (+0.3s)	1056	1056	128	19	90	0	5	114
18553	11907s (+1.0s)	4296	4296	256	102	242	16	0	360
18554	11908s (+0.4s)	1236	1236	128	25	105	6	1	137
18555	11909s (+1.1s)	4448	4448	256	88	264	18	0	370
18556	11910s (+1.0s)	4268	4268	256	85	254	18	0	357
18557	11910s (+0.6s)	2324	2324	256	48	149	8	0	205
18558	11911s (+0.7s)	3080	3080	256	67	177	7	0	251
18559	11912s (+1.0s)	4184	4184	256	78	257	0	13	348
18560	11912s (+0.4s)	1212	1212	128	22	106	0	3	131
18561	11913s (+0.6s)	2328	2328	128	44	163	0	15	222
18562	11914s (+0.6s)	2248	2248	128	47	158	0	12	217
18563	11914s (+0.4s)	1208	1208	128	21	108	2	0	131
18564	11915s (+0.7s)	3076	3076	256	63	175	12	0	250
18565	11916s (+1.0s)	4224	4224	256	79	250	17	0	346
18566	11916s (+0.5s)	1532	1532	128	47	109	6	0	162
18567	11917s (+0.4s)	1488	1488	128	32	115	8	0	155
18568	11918s (+0.7s)	3124	3124	256	80	160	20	0	260
18569	11918s (+0.4s)	1436	1436	128	29	113	6	0	148
18570	11919s (+0.6s)	2500	2500	256	56	155	6	0	217
18571	11919s (+0.4s)	1312	1312	128	33	94	0	7	134
18572	11920s (+0.6s)	2572	2572	256	38	166	0	9	213
18573	11920s (+0.6s)	2436	2436	128	45	174	0	13	232
18574	11921s (+0.6s)	2652	2652	256	56	150	0	14	220
18575	11922s (+0.7s)	2904	2904	256	49	191	0	12	252
18576	11922s (+0.5s)	1764	1764	128	40	130	0	8	178
18577	11922s (+0.4s)	1188	1188	128	31	94	4	0	129
18578	11923s (+0.6s)	1928	1928	128	54	137	9	0	200
18579	11924s (+0.7s)	2872	2872	256	73	161	14	0	248
18580	11924s (+0.5s)	1624	1624	128	49	116	8	0	173
18581	11925s (+0.9s)	3852	3852	256	89	213	20	0	322
18582	11926s (+0.5s)	1792	1792	128	38	139	6	0	183
18583	11926s (+0.4s)	1140	1140	64	30	98	4	0	132
18584	11927s (+0.7s)	2572	2572	256	43	176	0	10	229
18585	11927s (+0.7s)	2808	2808	256	46	189	0	9	244
18586	11928s (+0.6s)	2192	2192	128	44	152	0	12	208
18587	11929s (+0.7s)	3072	3072	256	50	192	0	10	252
18588	11930s (+0.8s)	3380	3380	256	64	201	0	11	276
18589	11930s (+0.6s)	2448	2448	256	45	154	0	11	210
18590	11931s (+0.7s)	3112	3112	256	55	189	0	14	258
18591	11931s (+0.5s)	1740	1740	128	32	137	0	7	176
18592	11932s (+0.6s)	1948	1948	128	38	159	0	3	200
18593	11933s (+0.8s)	3276	3276	256	71	199	0	11	281
18594	11933s (+0.7s)	2804	2804	256	58	175	10	0	243
18595	11934s (+0.8s)	3488	3488	256	72	202	17	0	291
18596	11935s (+0.7s)	2812	2812	256	68	162	16	0	246
18597	11936s (+0.5s)	1864	1864	128	43	140	6	0	189
18598	11936s (+0.5s)	1696	1696	128	40	129	7	0	176
18599	11937s (+1.0s)	4204	4204	256	74	254	18	0	346
Episode	Time	Reward	Score	Highest	L	U	R	D	Steps
18600	11938s (+1.0s)	4984	4984	512	95	240	18	0	353
18601	11939s (+0.5s)	1960	1960	128	43	140	10	0	193
18602	11939s (+0.8s)	3180	3180	256	64	192	7	0	263
18603	11940s (+0.5s)	1764	1764	128	36	141	5	0	182
18604	11941s (+0.7s)	3128	3128	256	69	178	14	0	261
18605	11941s (+0.4s)	1276	1276	128	28	97	6	0	131
18606	11941s (+0.5s)	1772	1772	128	50	126	3	0	179
18607	11942s (+0.4s)	1324	1324	128	34	105	8	0	147
18608	11942s (+0.4s)	1332	1332	128	30	102	7	0	139
18609	11943s (+0.9s)	4128	4128	256	87	231	20	0	338
18610	11944s (+0.8s)	3232	3232	256	71	190	12	0	273
18611	11945s (+0.5s)	1744	1744	128	46	116	12	2	176
18612	11945s (+0.7s)	2628	2628	128	68	166	12	1	247
18613	11946s (+0.7s)	3240	3240	256	58	204	10	0	272
18614	11947s (+0.7s)	3012	3012	256	62	176	15	0	253
18615	11948s (+0.8s)	3420	3420	256	70	193	16	0	279
18616	11948s (+0.5s)	1680	1680	128	37	125	10	0	172
18617	11949s (+0.7s)	2648	2648	256	51	176	5	0	232
18618	11949s (+0.7s)	2928	2928	256	67	181	10	0	258
18619	11950s (+0.8s)	3524	3524	256	71	210	0	15	296
18620	11951s (+0.6s)	2528	2528	256	38	156	0	9	203
18621	11951s (+0.4s)	1488	1488	128	43	105	7	0	155
18622	11952s (+0.5s)	2292	2292	256	43	133	11	1	188
18623	11952s (+0.6s)	2232	2232	128	49	149	0	15	213
18624	11954s (+1.2s)	5724	5724	512	99	286	23	0	408
18625	11955s (+1.0s)	5024	5024	512	90	244	17	1	352
18626	11955s (+0.7s)	3152	3152	256	64	186	10	0	260
18627	11956s (+0.5s)	1776	1776	128	44	127	8	0	179
18628	11957s (+0.6s)	2476	2476	256	55	144	12	0	211
18629	11957s (+0.6s)	2612	2612	256	50	158	10	0	218
18630	11957s (+0.2s)	572	572	64	14	62	1	0	77
18631	11958s (+0.6s)	2520	2520	256	46	162	9	0	217
18632	11959s (+0.7s)	3104	3104	256	57	191	11	0	259
18633	11959s (+0.6s)	1940	1940	128	53	144	6	0	203
18634	11960s (+1.0s)	4296	4296	256	95	241	16	0	352
18635	11961s (+0.4s)	1524	1524	128	33	119	3	0	155
18636	11962s (+0.9s)	3968	3968	256	70	241	15	0	326
18637	11962s (+0.6s)	2444	2444	256	46	155	7	0	208
18638	11962s (+0.2s)	504	504	64	13	54	4	0	71
18639	11963s (+0.9s)	3788	3788	256	80	217	16	0	313
18640	11964s (+0.6s)	1956	1956	128	60	134	8	0	202
18641	11965s (+0.6s)	2540	2540	256	54	156	12	0	222
18642	11966s (+1.1s)	4484	4484	256	99	257	18	0	374
18643	11966s (+0.4s)	1172	1172	128	34	86	6	0	126
18644	11967s (+0.4s)	1472	1472	128	38	107	7	0	152
18645	11967s (+0.4s)	1184	1184	128	28	97	4	0	129
18646	11968s (+0.8s)	3416	3416	256	56	214	15	0	285
18647	11968s (+0.6s)	2288	2288	128	61	141	13	0	215
18648	11969s (+0.7s)	2912	2912	256	62	180	12	0	254
18649	11970s (+0.7s)	3044	3044	256	59	186	10	0	255
18650	11970s (+0.5s)	1404	1404	64	40	114	5	0	159
18651	11971s (+0.6s)	2484	2484	256	33	169	0	13	215
18652	11971s (+0.5s)	1880	1880	128	40	146	0	7	193
18653	11972s (+0.6s)	2416	2416	256	37	158	0	6	201
18654	11973s (+1.1s)	5448	5448	512	77	293	0	13	383
18655	11974s (+0.7s)	2740	2740	256	49	171	0	12	232
18656	11975s (+0.9s)	3696	3696	256	65	233	0	8	306
18657	11975s (+0.5s)	1748	1748	128	37	131	0	11	179
18658	11976s (+0.4s)	1432	1432	128	27	116	0	10	153
18659	11976s (+0.3s)	1120	1120	128	20	96	0	2	118
18660	11976s (+0.6s)	2324	2324	256	52	134	0	9	195
18661	11977s (+0.4s)	1444	1444	128	28	114	0	7	149
18662	11978s (+0.7s)	3168	3168	256	48	198	0	15	261
18663	11978s (+0.4s)	1448	1448	128	28	110	0	10	148
18664	11979s (+0.9s)	4000	4000	256	58	249	0	14	321
18665	11980s (+0.6s)	1876	1876	128	42	142	0	9	193
18666	11981s (+0.9s)	4040	4040	256	66	262	0	11	339
18667	11981s (+0.7s)	2492	2492	128	48	177	0	9	234
18668	11982s (+0.6s)	1940	1940	128	48	146	9	0	203
18669	11982s (+0.5s)	1520	1520	128	42	111	6	0	159
18670	11983s (+0.8s)	3500	3500	256	74	201	15	0	290
18671	11984s (+0.5s)	1876	1876	128	43	140	4	0	187
18672	11985s (+1.3s)	6064	6064	512	114	304	21	0	439
18673	11985s (+0.4s)	1324	1324	128	30	103	4	0	137
18674	11986s (+0.8s)	3624	3624	256	71	215	8	0	294
18675	11987s (+0.8s)	3416	3416	256	72	201	12	0	285
18676	11988s (+0.8s)	3340	3340	256	70	200	15	0	285
18677	11988s (+0.8s)	3256	3256	256	72	188	12	0	272
18678	11989s (+0.8s)	3300	3300	256	64	194	16	0	274
18679	11990s (+0.8s)	3228	3228	256	76	185	10	0	271
18680	11991s (+0.5s)	1636	1636	128	38	123	4	0	165
18681	11991s (+0.5s)	1808	1808	128	41	139	7	0	187
18682	11992s (+0.7s)	2628	2628	256	66	158	8	0	232
18683	11993s (+0.7s)	3048	3048	256	54	192	11	0	257
18684	11994s (+1.3s)	6428	6428	512	112	323	25	1	461
18685	11994s (+0.5s)	1816	1816	128	47	119	9	0	175
18686	11995s (+0.5s)	1796	1796	128	58	116	10	0	184
18687	11995s (+0.4s)	1348	1348	128	31	103	2	0	136
18688	11996s (+0.4s)	1320	1320	128	28	104	4	0	136
18689	11996s (+0.7s)	3080	3080	256	75	165	16	0	256
18690	11997s (+0.4s)	1444	1444	128	23	123	4	0	150
18691	11997s (+0.5s)	2056	2056	256	42	122	8	0	172
18692	11998s (+0.3s)	936	936	64	33	80	5	0	118
18693	11998s (+0.5s)	1656	1656	128	40	129	7	0	176
18694	11999s (+0.5s)	1732	1732	128	55	116	9	0	180
18695	11999s (+0.7s)	2692	2692	256	64	156	11	0	231
18696	12000s (+0.6s)	1920	1920	128	68	123	7	0	198
18697	12001s (+1.3s)	6504	6504	512	129	300	27	0	456
18698	12002s (+1.0s)	4060	4060	256	86	234	18	0	338
18699	12003s (+0.6s)	1876	1876	128	40	143	9	0	192
Episode	Time	Reward	Score	Highest	L	U	R	D	Steps
18700	12003s (+0.6s)	2056	2056	128	55	140	10	0	205
18701	12004s (+0.9s)	3884	3884	256	93	210	23	0	326
18702	12005s (+0.6s)	1984	1984	128	54	137	12	0	203
18703	12005s (+0.6s)	2340	2340	128	53	152	9	0	214
18704	12006s (+0.8s)	3232	3232	256	61	196	13	1	271
18705	12007s (+1.0s)	4236	4236	256	86	244	19	0	349
18706	12008s (+0.6s)	2724	2724	256	55	165	9	0	229
18707	12009s (+0.7s)	3224	3224	256	70	184	15	0	269
18708	12009s (+0.6s)	2552	2552	256	63	143	12	0	218
18709	12009s (+0.2s)	588	588	64	17	64	1	0	82
18710	12010s (+0.8s)	3340	3340	256	80	189	12	0	281
18711	12011s (+0.9s)	3868	3868	256	88	203	24	2	317
18712	12012s (+0.6s)	2680	2680	256	51	168	11	0	230
18713	12012s (+0.5s)	1696	1696	128	42	116	9	1	168
18714	12013s (+0.6s)	2632	2632	256	55	159	8	1	223
18715	12014s (+0.7s)	3036	3036	256	55	185	13	1	254
18716	12014s (+0.4s)	1472	1472	128	46	94	12	0	152
18717	12015s (+0.6s)	2404	2404	256	51	148	4	0	203
18718	12016s (+0.8s)	3552	3552	256	74	205	16	0	295
18719	12016s (+0.8s)	3460	3460	256	83	202	11	0	296
18720	12017s (+0.6s)	2584	2584	256	58	151	11	1	221
18721	12017s (+0.3s)	748	748	64	18	78	4	0	100
18722	12018s (+0.7s)	2912	2912	256	79	166	9	0	254
18723	12019s (+0.5s)	1988	1988	128	44	143	0	13	200
18724	12019s (+0.3s)	720	720	64	19	74	0	1	94
18725	12020s (+0.7s)	2476	2476	128	43	176	0	11	230
18726	12020s (+0.3s)	752	752	64	22	75	0	3	100
18727	12020s (+0.4s)	1192	1192	64	24	112	0	9	145
18728	12021s (+0.5s)	1620	1620	128	42	118	11	0	171
18729	12021s (+0.7s)	2560	2560	128	70	149	13	0	232
18730	12022s (+0.5s)	2348	2348	256	34	159	0	0	193
18731	12023s (+0.7s)	3096	3096	256	57	187	10	0	254
18732	12023s (+0.6s)	2092	2092	128	54	141	12	0	207
18733	12024s (+1.1s)	4540	4540	256	114	247	16	0	377
18734	12025s (+1.0s)	4484	4484	256	101	245	21	0	367
18735	12026s (+0.2s)	412	412	32	26	43	2	0	71
18736	12026s (+0.7s)	2780	2780	256	46	184	8	0	238
18737	12027s (+0.4s)	1648	1648	128	43	105	7	0	155
18738	12028s (+0.9s)	3896	3896	256	88	211	18	0	317
18739	12028s (+0.5s)	1616	1616	128	49	115	7	0	171
18740	12029s (+0.5s)	1848	1848	128	47	141	4	0	192
18741	12029s (+0.6s)	2692	2692	256	58	162	11	2	233
18742	12030s (+0.9s)	3612	3612	256	79	216	10	0	305
18743	12031s (+0.5s)	1912	1912	128	49	138	9	0	196
18744	12032s (+0.8s)	3588	3588	256	64	225	15	0	304
18745	12032s (+0.3s)	1008	1008	128	22	81	4	0	107
18746	12033s (+0.7s)	2476	2476	128	64	151	16	0	231
18747	12033s (+0.2s)	652	652	64	18	65	3	0	86
18748	12034s (+0.8s)	3428	3428	256	67	210	12	0	289
18749	12034s (+0.6s)	2368	2368	256	47	147	7	0	201
18750	12035s (+0.4s)	1292	1292	128	30	103	6	0	139
18751	12035s (+0.3s)	860	860	64	32	74	5	0	111
18752	12035s (+0.5s)	1720	1720	128	41	126	8	0	175
18753	12036s (+0.5s)	1720	1720	128	38	129	4	0	171
18754	12036s (+0.5s)	1508	1508	128	38	116	6	0	160
18755	12037s (+0.6s)	2464	2464	128	61	156	10	1	228
18756	12038s (+1.0s)	4372	4372	256	95	247	22	0	364
18757	12039s (+0.7s)	3112	3112	256	63	185	10	0	258
18758	12039s (+0.3s)	896	896	64	22	83	4	0	109
18759	12040s (+0.7s)	3256	3256	256	60	194	10	0	264
18760	12040s (+0.4s)	1180	1180	64	41	94	7	0	142
18761	12041s (+0.3s)	688	688	64	17	70	0	4	91
18762	12041s (+0.6s)	2740	2740	256	49	168	0	12	229
18763	12042s (+0.6s)	1932	1932	128	47	148	5	1	201
18764	12043s (+0.7s)	2816	2816	256	50	193	4	0	247
18765	12043s (+0.7s)	2696	2696	256	58	160	15	0	233
18766	12044s (+0.5s)	1600	1600	128	46	116	5	0	167
18767	12044s (+0.5s)	1840	1840	128	46	136	8	0	190
18768	12045s (+0.9s)	3744	3744	256	83	221	14	0	318
18769	12046s (+0.8s)	3240	3240	256	57	206	9	0	272
18770	12047s (+0.9s)	3792	3792	256	70	231	13	0	314
18771	12048s (+0.7s)	2800	2800	256	65	162	13	0	240
18772	12048s (+0.5s)	1576	1576	128	38	115	9	0	162
18773	12048s (+0.4s)	1516	1516	128	34	113	7	1	155
18774	12049s (+0.6s)	1892	1892	128	54	129	9	0	192
18775	12049s (+0.3s)	668	668	64	22	65	4	0	91
18776	12050s (+0.5s)	1756	1756	128	44	130	0	5	179
18777	12051s (+0.8s)	3300	3300	256	72	196	0	15	283
18778	12051s (+0.5s)	2040	2040	128	38	151	0	8	197
18779	12052s (+0.5s)	1616	1616	128	23	134	0	5	162
18780	12052s (+0.4s)	1464	1464	128	28	111	0	11	150
18781	12053s (+0.8s)	3452	3452	256	53	222	0	9	284
18782	12053s (+0.4s)	1408	1408	128	21	123	0	5	149
18783	12054s (+0.6s)	2416	2416	128	55	160	0	12	227
18784	12054s (+0.4s)	1364	1364	128	20	115	0	7	142
18785	12055s (+0.5s)	1572	1572	128	39	114	12	0	165
18786	12055s (+0.6s)	2488	2488	256	51	154	10	0	215
18787	12057s (+1.0s)	4540	4540	256	107	234	29	0	370
18788	12057s (+0.5s)	1872	1872	128	36	148	7	0	191
18789	12058s (+1.1s)	4524	4524	256	101	249	23	0	373
18790	12059s (+0.6s)	2656	2656	256	44	180	8	0	232
18791	12059s (+0.4s)	1480	1480	128	30	115	8	0	153
18792	12060s (+0.8s)	3544	3544	256	69	205	20	0	294
18793	12061s (+0.5s)	1888	1888	128	50	133	7	0	190
18794	12061s (+0.8s)	3492	3492	256	72	211	10	0	293
18795	12062s (+0.9s)	3904	3904	256	110	208	12	0	330
18796	12063s (+0.4s)	1024	1024	64	32	86	6	0	124
18797	12063s (+0.7s)	2920	2920	256	70	175	11	0	256
18798	12064s (+0.6s)	2648	2648	256	47	172	7	0	226
18799	12065s (+0.6s)	2572	2572	256	56	156	11	0	223
Episode	Time	Reward	Score	Highest	L	U	R	D	Steps
18800	12066s (+1.0s)	4260	4260	256	78	257	16	0	351
18801	12067s (+0.9s)	4004	4004	256	76	243	11	0	330
18802	12068s (+0.9s)	3820	3820	256	91	198	22	0	311
18803	12068s (+0.5s)	1556	1556	128	32	121	0	5	158
18804	12069s (+0.8s)	3084	3084	256	65	189	0	11	265
18805	12069s (+0.6s)	2532	2532	256	47	165	0	8	220
18806	12070s (+0.5s)	1772	1772	128	32	135	0	11	178
18807	12070s (+0.5s)	1636	1636	128	38	121	6	0	165
18808	12071s (+0.7s)	3184	3184	256	56	194	14	0	264
18809	12072s (+0.5s)	2024	2024	256	36	125	7	0	168
18810	12072s (+0.5s)	1804	1804	128	48	121	11	0	180
18811	12073s (+1.0s)	4084	4084	256	96	230	17	0	343
18812	12074s (+0.4s)	1380	1380	64	46	102	4	0	152
18813	12074s (+0.8s)	3484	3484	256	84	190	16	1	291
18814	12075s (+0.5s)	1692	1692	128	50	119	6	0	175
18815	12075s (+0.5s)	1680	1680	128	39	121	7	0	167
18816	12076s (+0.4s)	1176	1176	128	33	89	5	0	127
18817	12076s (+0.4s)	1468	1468	128	39	108	5	0	152
18818	12077s (+0.6s)	2676	2676	256	60	162	7	0	229
18819	12078s (+1.0s)	4220	4220	256	91	244	15	0	350
18820	12079s (+0.8s)	3020	3020	256	54	205	11	0	270
18821	12079s (+0.8s)	3516	3516	256	78	203	16	0	297
18822	12080s (+0.6s)	2556	2556	256	51	161	7	0	219
18823	12081s (+1.0s)	5132	5132	512	88	240	23	0	351
18824	12082s (+0.5s)	1920	1920	128	51	137	10	0	198
18825	12082s (+0.6s)	1932	1932	128	58	124	12	0	194
18826	12083s (+0.9s)	4072	4072	256	83	229	13	0	325
18827	12084s (+1.0s)	4188	4188	256	102	227	12	0	341
18828	12085s (+0.6s)	2348	2348	256	49	149	7	0	205
18829	12085s (+0.6s)	2528	2528	256	60	149	10	0	219
18830	12086s (+0.5s)	1852	1852	128	53	126	11	0	190
18831	12087s (+0.8s)	3204	3204	256	70	176	19	0	265
18832	12087s (+0.6s)	2452	2452	256	66	139	11	0	216
18833	12088s (+0.7s)	3028	3028	256	68	170	15	0	253
18834	12089s (+0.8s)	3232	3232	256	56	200	15	0	271
18835	12089s (+0.7s)	2556	2556	128	68	157	13	1	239
18836	12090s (+1.0s)	5204	5204	512	97	241	18	2	358
18837	12091s (+0.4s)	1208	1208	128	36	90	4	0	130
18838	12091s (+0.5s)	1684	1684	128	43	122	8	0	173
18839	12092s (+0.3s)	988	988	64	27	88	0	7	122
18840	12092s (+0.5s)	1976	1976	128	48	139	0	14	201
18841	12092s (+0.2s)	468	468	64	11	54	0	4	69
18842	12093s (+0.6s)	2648	2648	256	47	170	0	9	226
18843	12093s (+0.4s)	1240	1240	128	23	111	3	0	137
18844	12094s (+0.6s)	1932	1932	128	47	144	10	0	201
18845	12094s (+0.4s)	1488	1488	128	22	125	4	0	151
18846	12095s (+1.0s)	4288	4288	256	97	236	18	0	351
18847	12096s (+0.5s)	1516	1516	128	40	107	11	1	159
18848	12097s (+0.7s)	2892	2892	256	42	178	15	0	235
18849	12097s (+0.6s)	2384	2384	256	42	151	4	0	197
18850	12097s (+0.2s)	476	476	64	14	56	1	0	71
18851	12098s (+0.8s)	3376	3376	256	80	195	10	0	285
18852	12099s (+0.8s)	3224	3224	256	58	198	13	0	269
18853	12099s (+0.5s)	1784	1784	128	40	134	0	8	182
18854	12100s (+0.7s)	2836	2836	256	69	170	8	0	247
18855	12101s (+0.8s)	3512	3512	256	69	215	13	0	297
18856	12102s (+0.8s)	3296	3296	256	83	179	14	0	276
18857	12102s (+0.6s)	2484	2484	256	56	149	9	0	214
18858	12103s (+0.8s)	3428	3428	256	73	201	13	1	288
18859	12104s (+0.9s)	4652	4652	512	65	235	14	0	314
18860	12104s (+0.4s)	1156	1156	128	26	94	6	0	126
18861	12105s (+0.7s)	3172	3172	256	64	188	11	0	263
18862	12106s (+0.5s)	1836	1836	128	53	121	8	0	182
18863	12107s (+0.8s)	3412	3412	256	70	196	10	1	277
18864	12107s (+0.5s)	1656	1656	128	29	134	4	0	167
18865	12108s (+0.5s)	1760	1760	128	41	132	7	0	180
18866	12109s (+1.0s)	4344	4344	256	99	245	16	0	360
18867	12109s (+0.5s)	1584	1584	128	50	114	6	0	170
18868	12110s (+0.6s)	1976	1976	128	53	135	8	0	196
18869	12110s (+0.5s)	1884	1884	128	46	124	10	0	180
18870	12111s (+0.3s)	1160	1160	128	18	103	2	0	123
18871	12111s (+0.9s)	3612	3612	256	74	213	17	0	304
18872	12112s (+0.5s)	2344	2344	256	43	142	7	0	192
18873	12112s (+0.4s)	1252	1252	64	45	104	6	0	155
18874	12113s (+1.0s)	4324	4324	256	86	251	19	0	356
18875	12114s (+0.7s)	3088	3088	256	70	167	15	0	252
18876	12115s (+0.5s)	1624	1624	128	43	121	6	0	170
18877	12115s (+0.6s)	2400	2400	256	39	171	4	0	214
18878	12116s (+0.4s)	1028	1028	64	29	88	4	1	122
18879	12116s (+0.4s)	1416	1416	128	37	106	7	0	150
18880	12117s (+0.9s)	4444	4444	512	77	212	18	0	307
18881	12117s (+0.5s)	1768	1768	128	43	126	7	0	176
18882	12118s (+0.8s)	3288	3288	256	55	208	10	0	273
18883	12119s (+0.5s)	1532	1532	128	38	117	7	0	162
18884	12120s (+1.0s)	3992	3992	256	84	229	19	0	332
18885	12120s (+0.6s)	2132	2132	128	40	149	0	11	200
18886	12120s (+0.2s)	568	568	64	11	70	0	0	81
18887	12121s (+0.4s)	1256	1256	128	19	104	0	6	129
18888	12121s (+0.5s)	1792	1792	128	37	141	0	5	183
18889	12122s (+0.4s)	1440	1440	128	37	106	5	0	148
18890	12123s (+0.8s)	3568	3568	256	80	207	12	0	299
18891	12123s (+0.6s)	2468	2468	256	49	151	12	0	212
18892	12124s (+0.8s)	3200	3200	256	64	196	14	0	274
18893	12125s (+0.7s)	2904	2904	256	69	169	15	0	253
18894	12126s (+0.9s)	3788	3788	256	80	216	17	0	313
18895	12126s (+0.9s)	3772	3772	256	71	236	11	0	318
18896	12127s (+0.4s)	1172	1172	128	19	103	5	0	127
18897	12127s (+0.6s)	2636	2636	256	59	154	13	1	227
18898	12128s (+0.6s)	2648	2648	256	50	157	8	0	215
18899	12129s (+0.7s)	2712	2712	256	67	152	12	0	231
Episode	Time	Reward	Score	Highest	L	U	R	D	Steps
18900	12130s (+0.8s)	3260	3260	256	49	216	12	0	277
18901	12130s (+0.6s)	2432	2432	128	64	146	13	1	224
18902	12131s (+0.5s)	1620	1620	128	36	127	9	0	172
18903	12131s (+0.4s)	964	964	64	33	89	5	0	127
18904	12132s (+0.9s)	3760	3760	256	83	208	20	0	311
18905	12133s (+0.9s)	4008	4008	256	82	225	19	0	326
18906	12134s (+0.7s)	2828	2828	128	80	178	11	0	269
18907	12134s (+0.7s)	3220	3220	256	72	181	15	0	268
18908	12135s (+0.5s)	1740	1740	128	43	126	6	0	175
18909	12136s (+0.9s)	3908	3908	256	70	237	11	0	318
18910	12136s (+0.5s)	1596	1596	128	34	126	7	0	167
18911	12137s (+0.3s)	936	936	64	23	84	7	0	114
18912	12137s (+0.3s)	668	668	64	28	58	5	0	91
18913	12138s (+0.6s)	2716	2716	256	45	163	7	1	216
18914	12138s (+0.6s)	2216	2216	128	48	147	0	15	210
18915	12139s (+0.4s)	1464	1464	128	40	101	9	0	150
18916	12139s (+0.8s)	3620	3620	256	74	208	11	0	293
18917	12140s (+0.5s)	2008	2008	128	50	144	6	0	200
18918	12141s (+1.0s)	4348	4348	256	83	266	9	0	358
18919	12142s (+0.7s)	3132	3132	256	59	186	0	11	256
18920	12142s (+0.7s)	3092	3092	256	54	203	11	0	268
18921	12143s (+0.3s)	868	868	64	19	86	0	7	112
18922	12143s (+0.4s)	1544	1544	128	41	111	6	0	158
18923	12144s (+0.4s)	1316	1316	128	38	90	7	0	135
18924	12145s (+1.2s)	6072	6072	512	97	320	0	19	436
18925	12145s (+0.4s)	1284	1284	128	24	110	0	7	141
18926	12146s (+0.8s)	3388	3388	256	70	196	0	22	288
18927	12147s (+0.4s)	1396	1396	128	42	89	6	2	139
18928	12147s (+0.2s)	560	560	64	13	60	0	3	76
18929	12147s (+0.7s)	2840	2840	256	65	171	12	0	248
18930	12148s (+0.4s)	1448	1448	128	43	109	9	0	161
18931	12148s (+0.5s)	1752	1752	128	48	105	11	0	164
18932	12149s (+0.5s)	1616	1616	128	37	119	4	0	160
18933	12149s (+0.4s)	1536	1536	128	41	119	4	0	164
18934	12150s (+0.3s)	636	636	64	21	60	7	0	88
18935	12150s (+0.5s)	1816	1816	128	48	129	12	0	189
18936	12151s (+0.5s)	2032	2032	256	36	130	5	0	171
18937	12151s (+0.8s)	3572	3572	256	79	210	18	0	307
18938	12152s (+0.4s)	1296	1296	128	24	107	0	3	134
18939	12153s (+0.8s)	3388	3388	256	60	205	0	13	278
18940	12153s (+0.4s)	1428	1428	128	22	122	0	3	147
18941	12154s (+0.6s)	2440	2440	256	51	140	10	1	202
18942	12154s (+0.6s)	2476	2476	256	62	142	7	1	212
18943	12155s (+0.6s)	2448	2448	128	55	156	16	0	227
18944	12155s (+0.5s)	2044	2044	256	38	125	6	0	169
18945	12156s (+0.6s)	1928	1928	128	55	133	12	0	200
18946	12156s (+0.5s)	1904	1904	128	52	134	8	0	194
18947	12157s (+0.7s)	2904	2904	256	71	172	9	0	252
18948	12158s (+0.6s)	2224	2224	128	39	161	1	10	211
18949	12158s (+0.6s)	2640	2640	256	52	161	0	7	220
18950	12159s (+0.6s)	2216	2216	128	46	153	0	10	209
18951	12160s (+0.5s)	1952	1952	128	36	146	0	9	191
18952	12161s (+0.9s)	3976	3976	256	79	233	0	13	325
18953	12162s (+1.1s)	5496	5496	512	87	282	0	21	390
18954	12162s (+0.8s)	3248	3248	256	78	185	12	0	275
18955	12163s (+0.6s)	1944	1944	128	54	137	9	0	200
18956	12164s (+0.7s)	3076	3076	256	65	173	15	0	253
18957	12165s (+0.8s)	3644	3644	256	70	212	12	0	294
18958	12165s (+0.6s)	2516	2516	256	52	151	8	0	211
18959	12166s (+0.4s)	1580	1580	128	31	118	8	0	157
18960	12166s (+0.7s)	2900	2900	256	77	165	10	0	252
18961	12168s (+1.4s)	7256	7256	512	136	346	26	0	508
18962	12168s (+0.2s)	496	496	32	14	64	2	0	80
18963	12169s (+0.5s)	1508	1508	128	33	120	7	0	160
18964	12169s (+0.5s)	1800	1800	128	55	118	12	0	185
18965	12170s (+0.5s)	1692	1692	128	40	120	7	1	168
18966	12170s (+0.5s)	2116	2116	256	39	131	8	0	178
18967	12171s (+0.3s)	704	704	64	20	68	0	5	93
18968	12171s (+0.7s)	2608	2608	256	47	166	0	14	227
18969	12172s (+0.6s)	1936	1936	128	37	146	0	10	193
18970	12172s (+0.6s)	2004	2004	128	37	160	0	6	203
18971	12173s (+0.7s)	2940	2940	256	62	168	12	0	242
18972	12173s (+0.4s)	1036	1036	64	36	94	3	0	133
18973	12174s (+0.7s)	2816	2816	256	60	176	10	0	246
18974	12175s (+1.0s)	4476	4476	256	90	253	23	0	366
18975	12176s (+0.5s)	1756	1756	128	38	131	8	1	178
18976	12176s (+0.3s)	912	912	64	28	88	3	0	119
18977	12177s (+0.7s)	2828	2828	256	50	172	12	2	236
18978	12177s (+0.6s)	2396	2396	128	55	155	9	1	220
18979	12178s (+0.8s)	3360	3360	256	63	200	12	1	276
18980	12179s (+0.5s)	2192	2192	256	25	152	3	0	180
18981	12179s (+0.8s)	3304	3304	256	86	179	12	0	277
18982	12180s (+0.6s)	1980	1980	128	50	141	6	0	197
18983	12181s (+1.0s)	4324	4324	256	98	236	25	0	359
18984	12182s (+0.5s)	1848	1848	128	36	138	12	0	186
18985	12182s (+0.5s)	1804	1804	128	45	119	7	0	171
18986	12183s (+0.7s)	3168	3168	256	65	182	13	0	260
18987	12183s (+0.4s)	1444	1444	128	38	101	11	1	151
18988	12184s (+0.4s)	1216	1216	64	43	99	4	0	146
18989	12184s (+0.5s)	1812	1812	128	53	118	8	0	179
18990	12185s (+0.8s)	3328	3328	256	69	196	12	1	278
18991	12186s (+0.8s)	3400	3400	256	64	211	11	0	286
18992	12186s (+0.6s)	2584	2584	256	45	162	9	0	216
18993	12187s (+0.4s)	1416	1416	128	37	105	7	0	149
18994	12187s (+0.4s)	1480	1480	128	33	117	5	0	155
18995	12188s (+0.9s)	3764	3764	256	84	208	20	0	312
18996	12189s (+0.3s)	1144	1144	128	38	83	4	0	125
18997	12189s (+0.8s)	3464	3464	256	66	214	9	0	289
18998	12190s (+0.8s)	3388	3388	256	90	175	21	0	286
18999	12191s (+0.9s)	3796	3796	256	81	219	15	0	315
Episode	Time	Reward	Score	Highest	L	U	R	D	Steps
19000	12191s (+0.3s)	816	816	64	19	88	4	0	111
19001	12193s (+1.4s)	7172	7172	512	112	361	0	19	492
19002	12193s (+0.4s)	1440	1440	128	26	114	0	8	148
19003	12194s (+0.5s)	1700	1700	128	36	127	0	7	170
19004	12195s (+1.0s)	4056	4056	256	90	228	18	0	336
19005	12195s (+0.5s)	1868	1868	128	51	123	12	0	186
19006	12196s (+0.7s)	2928	2928	256	57	170	10	0	237
19007	12197s (+0.7s)	2756	2756	256	58	170	9	0	237
19008	12197s (+0.8s)	3344	3344	256	68	199	15	0	282
19009	12198s (+0.4s)	1280	1280	128	35	99	3	0	137
19010	12198s (+0.6s)	2392	2392	256	54	145	8	0	207
19011	12199s (+0.5s)	1712	1712	128	38	129	6	0	173
19012	12199s (+0.5s)	1888	1888	128	44	141	10	0	195
19013	12200s (+0.4s)	1348	1348	128	31	99	7	1	138
19014	12201s (+1.0s)	4380	4380	256	89	254	23	0	366
19015	12201s (+0.6s)	1880	1880	128	43	144	6	0	193
19016	12202s (+0.3s)	900	900	64	25	86	5	0	116
19017	12202s (+0.5s)	2188	2188	256	37	145	7	0	189
19018	12203s (+0.4s)	1312	1312	128	32	95	7	0	134
19019	12203s (+0.6s)	1912	1912	128	43	147	6	0	196
19020	12204s (+0.8s)	3316	3316	256	76	182	17	0	275
19021	12205s (+1.0s)	5172	5172	512	83	258	17	0	358
19022	12206s (+0.6s)	2548	2548	256	57	147	0	9	213
19023	12206s (+0.6s)	2492	2492	256	58	146	0	12	216
19024	12207s (+1.0s)	4172	4172	256	78	249	0	19	346
19025	12208s (+0.5s)	1816	1816	128	39	128	0	7	174
19026	12209s (+0.7s)	2912	2912	256	41	199	0	14	254
19027	12209s (+0.4s)	1316	1316	128	30	110	0	4	144
19028	12210s (+0.9s)	3896	3896	256	79	218	17	0	314
19029	12210s (+0.4s)	1516	1516	128	36	114	7	1	158
19030	12211s (+0.3s)	920	920	64	26	82	6	0	114
19031	12211s (+0.6s)	2292	2292	128	53	153	10	1	217
19032	12212s (+0.6s)	2524	2524	256	51	155	12	0	218
19033	12212s (+0.4s)	1056	1056	64	33	87	7	0	127
19034	12213s (+0.7s)	2840	2840	256	72	162	12	0	246
19035	12214s (+0.8s)	3068	3068	256	55	196	0	12	263
19036	12214s (+0.4s)	1176	1176	64	24	111	0	6	141
19037	12215s (+0.7s)	2780	2780	128	70	162	15	0	247
19038	12215s (+0.4s)	1440	1440	128	41	101	6	0	148
19039	12216s (+0.3s)	836	836	64	25	72	2	0	99
19040	12216s (+0.6s)	2496	2496	256	47	158	11	0	216
19041	12217s (+0.9s)	3948	3948	256	88	218	16	0	322
19042	12218s (+1.0s)	4252	4252	256	92	241	20	0	353
19043	12219s (+0.6s)	2256	2256	128	60	142	10	0	212
19044	12219s (+0.6s)	2656	2656	256	46	170	8	0	224
19045	12220s (+0.5s)	1872	1872	128	49	131	10	1	191
19046	12220s (+0.5s)	1648	1648	128	38	126	4	0	168
19047	12221s (+0.5s)	1804	1804	128	52	128	6	0	186
19048	12222s (+1.0s)	4356	4356	256	107	230	27	0	364
19049	12223s (+0.8s)	3256	3256	256	59	209	9	0	277
19050	12223s (+0.6s)	2440	2440	256	49	144	9	0	202
19051	12224s (+0.8s)	3528	3528	256	66	220	10	0	296
19052	12225s (+0.5s)	1604	1604	128	49	110	9	0	168
19053	12226s (+1.3s)	6760	6760	512	125	315	29	0	469
19054	12226s (+0.5s)	1804	1804	128	39	137	8	1	185
19055	12227s (+0.4s)	1328	1328	128	25	108	4	0	137
19056	12227s (+0.2s)	592	592	64	22	57	3	0	82
19057	12228s (+0.6s)	2212	2212	128	47	147	0	15	209
19058	12228s (+0.3s)	1016	1016	64	17	95	0	8	120
19059	12229s (+0.9s)	3884	3884	256	60	246	0	16	322
19060	12229s (+0.3s)	768	768	64	21	73	0	6	100
19061	12230s (+0.9s)	3800	3800	256	66	238	0	17	321
19062	12231s (+0.4s)	1164	1164	128	24	94	0	6	124
19063	12231s (+0.6s)	2224	2224	128	40	165	6	0	211
19064	12232s (+0.4s)	1480	1480	128	34	117	2	1	154
19065	12232s (+0.5s)	1680	1680	128	35	131	5	0	171
19066	12232s (+0.3s)	948	948	64	30	82	5	0	117
19067	12233s (+0.5s)	1644	1644	128	41	115	11	0	167
19068	12234s (+0.9s)	3996	3996	256	90	218	15	0	323
19069	12235s (+1.0s)	4228	4228	256	78	248	0	23	349
19070	12236s (+0.6s)	2568	2568	256	45	174	0	5	224
19071	12236s (+0.5s)	1896	1896	128	44	126	1	9	180
19072	12237s (+0.5s)	1648	1648	128	38	127	0	9	174
19073	12237s (+0.5s)	1504	1504	128	34	118	0	8	160
19074	12238s (+0.6s)	1972	1972	128	48	151	0	7	206
19075	12238s (+0.6s)	2060	2060	128	41	149	0	12	202
19076	12239s (+0.9s)	3992	3992	256	71	250	0	11	332
19077	12240s (+0.5s)	1592	1592	128	37	116	0	12	165
19078	12240s (+0.4s)	992	992	64	34	88	5	0	127
19079	12241s (+0.8s)	3496	3496	256	92	182	20	0	294
19080	12241s (+0.7s)	2904	2904	256	56	187	9	0	252
19081	12242s (+0.4s)	1424	1424	128	28	113	4	0	145
19082	12243s (+0.9s)	3808	3808	256	73	225	20	0	318
19083	12244s (+1.0s)	4264	4264	256	97	246	9	0	352
19084	12244s (+0.4s)	1380	1380	128	37	95	7	1	140
19085	12245s (+0.8s)	3360	3360	256	86	184	16	0	286
19086	12246s (+0.5s)	1968	1968	128	45	140	10	0	195
19087	12246s (+0.4s)	1288	1288	128	37	92	9	0	138
19088	12247s (+0.9s)	3568	3568	256	78	209	13	0	300
19089	12247s (+0.5s)	1652	1652	128	27	143	5	0	175
19090	12248s (+1.1s)	5732	5732	512	117	256	18	0	391
19091	12249s (+0.5s)	1556	1556	128	36	123	9	0	168
19092	12250s (+0.9s)	3920	3920	256	94	205	20	0	319
19093	12251s (+0.9s)	3964	3964	256	89	226	10	1	326
19094	12251s (+0.4s)	1452	1452	128	32	119	3	0	154
19095	12252s (+0.4s)	1480	1480	128	34	111	9	0	154
19096	12253s (+0.9s)	3936	3936	256	79	230	13	1	323
19097	12253s (+0.5s)	1616	1616	128	30	132	2	0	164
19098	12254s (+1.1s)	4500	4500	256	95	258	18	1	372
19099	12255s (+0.5s)	1672	1672	128	39	120	10	0	169
Episode	Time	Reward	Score	Highest	L	U	R	D	Steps
19100	12255s (+0.4s)	1516	1516	128	31	119	0	6	156
19101	12256s (+0.7s)	2736	2736	128	65	170	17	0	252
19102	12256s (+0.5s)	1732	1732	128	42	121	10	0	173
19103	12257s (+0.5s)	1824	1824	128	54	118	13	0	185
19104	12257s (+0.4s)	1180	1180	64	38	100	4	0	142
19105	12258s (+0.5s)	1764	1764	128	43	132	6	0	181
19106	12258s (+0.3s)	700	700	64	17	72	0	4	93
19107	12259s (+0.9s)	4140	4140	256	76	252	0	11	339
19108	12260s (+0.8s)	3360	3360	256	58	217	0	11	286
19109	12260s (+0.2s)	496	496	32	13	58	0	3	74
19110	12261s (+0.7s)	2476	2476	128	48	176	0	11	235
19111	12261s (+0.6s)	2328	2328	256	36	148	0	12	196
19112	12262s (+0.4s)	1340	1340	128	33	105	8	0	146
19113	12262s (+0.7s)	2760	2760	256	68	159	10	1	238
19114	12263s (+0.3s)	720	720	64	19	68	7	0	94
19115	12264s (+1.1s)	4792	4792	256	106	238	25	1	370
19116	12264s (+0.6s)	2372	2372	128	55	156	10	0	221
19117	12265s (+0.6s)	2360	2360	128	74	133	10	0	217
19118	12266s (+1.3s)	6576	6576	512	135	304	35	0	474
19119	12267s (+0.4s)	1300	1300	128	32	104	5	0	141
19120	12267s (+0.4s)	1352	1352	128	31	102	6	0	139
19121	12268s (+0.6s)	1912	1912	128	47	138	11	0	196
19122	12268s (+0.5s)	1836	1836	128	55	131	3	0	189
19123	12269s (+0.5s)	1664	1664	128	33	129	0	6	168
19124	12270s (+0.8s)	3240	3240	256	67	193	0	13	273
19125	12270s (+0.5s)	1808	1808	128	39	138	0	10	187
19126	12271s (+0.7s)	2704	2704	256	64	157	8	1	230
19127	12271s (+0.3s)	760	760	64	26	70	6	0	102
19128	12271s (+0.3s)	876	876	64	29	82	4	0	115
19129	12272s (+0.3s)	928	928	64	14	94	4	1	113
19130	12272s (+0.4s)	1216	1216	128	39	87	6	0	132
19131	12273s (+0.9s)	3528	3528	256	72	211	14	0	297
19132	12273s (+0.4s)	1204	1204	64	31	101	4	2	138
19133	12274s (+0.6s)	2084	2084	128	61	131	9	0	201
19134	12275s (+1.4s)	6580	6580	512	111	336	28	0	475
19135	12276s (+0.6s)	1928	1928	128	49	146	5	0	200
19136	12277s (+0.9s)	3976	3976	256	75	239	0	11	325
19137	12277s (+0.4s)	1288	1288	128	39	83	0	5	127
19138	12278s (+0.5s)	1616	1616	128	28	126	0	7	161
19139	12279s (+0.9s)	3936	3936	256	61	240	0	19	320
19140	12279s (+0.4s)	1508	1508	128	41	110	6	0	157
19141	12280s (+0.5s)	1840	1840	128	40	149	1	0	190
19142	12280s (+0.5s)	1788	1788	128	40	137	6	0	183
19143	12281s (+0.6s)	2452	2452	256	55	142	13	0	210
19144	12281s (+0.5s)	1636	1636	128	45	123	8	0	176
19145	12282s (+0.9s)	3548	3548	256	57	233	0	11	301
19146	12282s (+0.4s)	1176	1176	64	30	107	0	4	141
19147	12283s (+0.6s)	1944	1944	128	38	153	0	12	203
19148	12284s (+0.7s)	2832	2832	256	44	192	0	11	247
19149	12284s (+0.4s)	1388	1388	128	27	110	0	10	147
19150	12285s (+0.5s)	1828	1828	128	34	150	0	7	191
19151	12285s (+0.6s)	1916	1916	128	50	137	10	0	197
19152	12286s (+0.7s)	3112	3112	256	58	186	14	0	258
19153	12287s (+1.1s)	5172	5172	256	117	262	17	0	396
19154	12288s (+0.4s)	1232	1232	128	19	109	3	0	131
19155	12288s (+0.4s)	1400	1400	128	35	105	4	0	144
19156	12288s (+0.4s)	1436	1436	128	47	93	8	0	148
19157	12289s (+0.6s)	2256	2256	128	55	152	12	0	219
19158	12289s (+0.4s)	1068	1068	64	28	98	4	0	130
19159	12290s (+0.9s)	3656	3656	256	91	204	16	0	311
19160	12291s (+0.8s)	3244	3244	256	60	205	9	1	275
19161	12292s (+1.0s)	4260	4260	256	79	258	13	0	350
19162	12293s (+0.5s)	1680	1680	128	42	115	9	0	166
19163	12293s (+0.4s)	1180	1180	64	46	88	7	0	141
19164	12293s (+0.3s)	1156	1156	128	20	103	2	0	125
19165	12294s (+0.7s)	2836	2836	256	57	168	12	0	237
19166	12295s (+0.6s)	2812	2812	256	57	157	12	0	226
19167	12295s (+0.6s)	1920	1920	128	40	151	7	0	198
19168	12296s (+0.6s)	2504	2504	256	56	149	12	0	217
19169	12296s (+0.7s)	2684	2684	256	48	175	7	1	231
19170	12297s (+0.9s)	3660	3660	256	82	209	12	0	303
19171	12298s (+0.3s)	928	928	64	29	78	5	1	113
19172	12299s (+0.9s)	4044	4044	256	81	241	13	0	335
19173	12300s (+0.9s)	3716	3716	256	67	235	0	13	315
19174	12300s (+0.5s)	1888	1888	128	39	139	0	13	191
19175	12301s (+0.5s)	2304	2304	256	37	141	1	11	190
19176	12301s (+0.6s)	2240	2240	128	45	156	0	14	215
19177	12302s (+0.5s)	1688	1688	128	30	138	0	5	173
19178	12302s (+0.7s)	3028	3028	256	55	186	0	12	253
19179	12303s (+0.7s)	2912	2912	256	65	177	12	0	254
19180	12304s (+0.9s)	3508	3508	256	75	210	12	0	297
19181	12304s (+0.4s)	1480	1480	128	40	108	6	0	154
19182	12305s (+0.5s)	1668	1668	128	43	130	6	0	179
19183	12306s (+0.5s)	1780	1780	128	44	129	7	0	180
19184	12306s (+0.7s)	2804	2804	256	51	178	8	0	237
19185	12307s (+0.5s)	1588	1588	128	44	111	6	0	161
19186	12307s (+0.7s)	2888	2888	256	48	186	0	7	241
19187	12308s (+0.2s)	536	536	32	18	62	0	3	83
19188	12308s (+0.7s)	2796	2796	256	52	178	0	12	242
19189	12309s (+1.0s)	4140	4140	256	72	252	0	13	337
19190	12310s (+0.7s)	3044	3044	256	51	192	0	12	255
19191	12311s (+0.8s)	3220	3220	256	46	218	0	4	268
19192	12312s (+0.9s)	3552	3552	256	61	218	0	20	299
19193	12312s (+0.6s)	2536	2536	256	40	176	0	5	221
19194	12313s (+0.5s)	2028	2028	128	44	135	0	8	187
19195	12313s (+0.6s)	2604	2604	256	47	163	0	16	226
19196	12314s (+1.0s)	4112	4112	256	63	256	0	16	335
19197	12315s (+1.0s)	4864	4864	512	102	225	15	1	343
19198	12316s (+0.5s)	1780	1780	128	33	144	4	0	181
19199	12316s (+0.4s)	1400	1400	128	43	94	5	1	143
Episode	Time	Reward	Score	Highest	L	U	R	D	Steps
19200	12317s (+0.7s)	2540	2540	128	69	147	15	1	232
19201	12318s (+1.4s)	6908	6908	512	118	334	29	1	482
19202	12319s (+0.5s)	2200	2200	256	46	131	9	0	186
19203	12319s (+0.3s)	712	712	64	26	64	4	0	94
19204	12320s (+0.6s)	2608	2608	256	65	157	4	0	226
19205	12321s (+0.9s)	3788	3788	256	77	219	17	0	313
19206	12321s (+0.3s)	900	900	64	26	81	3	0	110
19207	12322s (+0.6s)	2360	2360	256	44	154	8	0	206
19208	12322s (+0.8s)	3236	3236	256	62	191	13	1	267
19209	12323s (+0.6s)	2428	2428	256	47	139	15	0	201
19210	12324s (+0.6s)	2476	2476	256	48	157	10	0	215
19211	12324s (+0.8s)	3256	3256	256	73	191	13	0	277
19212	12325s (+1.0s)	4244	4244	256	101	234	15	1	351
19213	12326s (+0.8s)	3364	3364	256	73	200	14	0	287
19214	12327s (+0.8s)	3636	3636	256	88	200	19	0	307
19215	12327s (+0.4s)	1200	1200	128	30	95	7	0	132
19216	12328s (+0.5s)	1788	1788	128	45	128	9	0	182
19217	12328s (+0.4s)	1132	1132	64	33	96	5	1	135
19218	12329s (+0.8s)	3372	3372	256	79	180	15	0	274
19219	12329s (+0.3s)	740	740	64	20	74	4	0	98
19220	12330s (+0.4s)	1380	1380	128	28	111	6	0	145
19221	12330s (+0.7s)	2812	2812	256	60	168	11	0	239
19222	12331s (+0.3s)	740	740	64	15	82	2	0	99
19223	12331s (+0.4s)	1164	1164	64	38	97	4	0	139
19224	12332s (+0.5s)	1596	1596	128	43	115	7	1	166
19225	12332s (+0.7s)	2860	2860	128	76	173	17	0	266
19226	12333s (+0.7s)	2564	2564	128	66	169	12	0	247
19227	12334s (+0.6s)	1940	1940	128	49	145	9	0	203
19228	12334s (+0.3s)	740	740	64	18	76	4	0	98
19229	12335s (+1.3s)	6348	6348	512	121	311	25	0	457
19230	12336s (+0.7s)	3032	3032	256	71	173	10	0	254
19231	12336s (+0.5s)	1708	1708	128	37	129	7	0	173
19232	12337s (+0.5s)	1808	1808	128	50	129	7	0	186
19233	12338s (+0.9s)	3912	3912	256	83	219	15	0	317
19234	12339s (+0.7s)	2900	2900	256	54	187	12	0	253
19235	12340s (+0.9s)	3620	3620	256	80	211	16	0	307
19236	12340s (+0.8s)	3208	3208	256	52	204	8	1	265
19237	12341s (+0.6s)	2452	2452	128	53	166	10	0	229
19238	12342s (+0.6s)	2512	2512	256	47	160	12	0	219
19239	12342s (+0.7s)	2976	2976	256	48	185	7	1	241
19240	12343s (+0.8s)	3288	3288	256	59	199	12	0	270
19241	12343s (+0.4s)	1288	1288	128	30	106	2	0	138
19242	12344s (+0.7s)	2828	2828	256	66	175	9	0	250
19243	12345s (+0.4s)	1188	1188	64	30	108	4	1	143
19244	12345s (+0.5s)	1972	1972	128	48	131	11	0	190
19245	12346s (+0.7s)	3208	3208	256	74	181	10	0	265
19246	12347s (+0.9s)	3836	3836	256	83	215	17	0	315
19247	12348s (+0.7s)	2948	2948	256	45	194	9	0	248
19248	12348s (+0.5s)	1756	1756	128	35	135	4	0	174
19249	12348s (+0.3s)	996	996	128	19	83	3	0	105
19250	12349s (+0.7s)	3236	3236	256	79	173	10	0	262
19251	12350s (+0.6s)	1920	1920	128	48	141	9	0	198
19252	12350s (+0.7s)	3108	3108	256	57	193	10	0	260
19253	12351s (+0.7s)	2832	2832	256	58	173	12	0	243
19254	12352s (+0.7s)	3148	3148	256	60	186	14	0	260
19255	12352s (+0.5s)	1748	1748	128	46	119	11	0	176
19256	12353s (+0.7s)	2684	2684	256	54	167	10	0	231
19257	12354s (+0.5s)	1744	1744	128	35	139	3	0	177
19258	12354s (+0.5s)	1536	1536	128	45	108	9	0	162
19259	12354s (+0.5s)	1652	1652	128	30	135	4	0	169
19260	12355s (+0.8s)	3188	3188	256	75	181	9	0	265
19261	12356s (+0.5s)	1788	1788	128	39	133	11	0	183
19262	12356s (+0.5s)	1616	1616	128	40	112	9	0	161
19263	12357s (+0.9s)	3948	3948	256	82	223	17	0	322
19264	12358s (+0.4s)	1480	1480	128	44	102	7	0	153
19265	12359s (+1.9s)	9452	9452	512	194	424	38	0	656
19266	12360s (+0.6s)	2300	2300	256	44	149	6	0	199
19267	12361s (+0.9s)	3620	3620	256	100	194	12	0	306
19268	12362s (+0.5s)	1632	1632	128	34	127	3	1	165
19269	12363s (+0.8s)	3496	3496	256	66	209	18	0	293
19270	12363s (+0.8s)	3476	3476	256	74	206	15	0	295
19271	12364s (+0.6s)	2360	2360	256	34	155	9	0	198
19272	12365s (+0.7s)	3032	3032	256	56	178	10	0	244
19273	12365s (+0.7s)	3036	3036	256	67	167	11	0	245
19274	12366s (+0.6s)	2804	2804	256	55	168	10	0	233
19275	12366s (+0.4s)	1232	1232	128	30	94	3	0	127
19276	12367s (+1.0s)	4408	4408	256	105	235	20	0	360
19277	12368s (+1.0s)	4320	4320	256	81	263	14	0	358
19278	12369s (+0.3s)	852	852	64	27	79	0	5	111
19279	12369s (+0.4s)	1448	1448	128	42	104	6	0	152
19280	12369s (+0.2s)	620	620	64	22	55	8	0	85
19281	12370s (+0.6s)	2300	2300	128	62	143	10	0	215
19282	12370s (+0.4s)	1316	1316	128	34	97	4	0	135
19283	12371s (+0.5s)	1612	1612	128	44	118	7	0	169
19284	12372s (+0.8s)	3204	3204	256	71	183	14	0	268
19285	12372s (+0.5s)	1832	1832	128	48	134	0	10	192
19286	12373s (+0.4s)	1260	1260	128	24	104	0	4	132
19287	12373s (+0.6s)	2524	2524	256	43	162	0	10	215
19288	12374s (+0.6s)	1888	1888	128	56	132	7	0	195
19289	12374s (+0.4s)	1228	1228	64	37	94	11	1	143
19290	12375s (+0.8s)	3408	3408	256	82	186	15	0	283
19291	12376s (+0.5s)	1816	1816	128	43	132	13	0	188
19292	12376s (+0.5s)	1588	1588	128	37	123	6	0	166
19293	12376s (+0.3s)	848	848	64	24	71	4	0	99
19294	12377s (+0.9s)	3972	3972	256	88	221	19	0	328
19295	12378s (+0.8s)	3452	3452	256	71	206	12	0	289
19296	12379s (+0.6s)	2500	2500	256	47	161	4	0	212
19297	12380s (+0.8s)	3648	3648	256	91	188	15	0	294
19298	12380s (+0.7s)	3164	3164	256	55	196	9	0	260
19299	12381s (+0.8s)	3276	3276	256	63	200	12	0	275
Episode	Time	Reward	Score	Highest	L	U	R	D	Steps
19300	12382s (+0.6s)	2548	2548	256	52	157	7	1	217
19301	12382s (+0.3s)	1000	1000	64	20	96	2	0	118
19302	12383s (+0.7s)	2728	2728	128	61	187	8	0	256
19303	12383s (+0.3s)	896	896	64	24	87	4	0	115
19304	12384s (+0.7s)	2824	2824	256	65	164	15	0	244
19305	12385s (+1.1s)	5540	5540	512	95	269	21	0	385
19306	12386s (+0.8s)	3384	3384	256	65	197	15	0	277
19307	12387s (+0.8s)	3472	3472	256	83	194	10	0	287
19308	12387s (+0.4s)	1240	1240	64	42	104	6	0	152
19309	12388s (+0.6s)	1916	1916	128	48	143	6	0	197
19310	12389s (+1.3s)	6308	6308	512	123	302	26	0	451
19311	12389s (+0.5s)	1632	1632	128	38	120	7	0	165
19312	12390s (+0.6s)	2708	2708	256	45	166	15	0	226
19313	12391s (+0.6s)	1848	1848	128	38	152	0	2	192
19314	12391s (+0.5s)	1704	1704	128	37	126	0	9	172
19315	12392s (+0.5s)	1792	1792	128	38	133	0	12	183
19316	12392s (+0.4s)	1448	1448	128	32	111	0	7	150
19317	12393s (+0.8s)	3576	3576	256	70	210	0	13	293
19318	12393s (+0.4s)	1484	1484	128	28	109	1	10	148
19319	12394s (+0.5s)	1688	1688	128	45	121	8	0	174
19320	12395s (+1.0s)	4224	4224	256	95	233	17	1	346
19321	12395s (+0.7s)	2944	2944	256	58	193	6	0	257
19322	12396s (+0.4s)	1280	1280	128	40	92	5	0	137
19323	12397s (+1.2s)	6056	6056	512	117	290	25	0	432
19324	12398s (+0.6s)	2272	2272	128	58	150	10	0	218
19325	12399s (+1.2s)	5800	5800	512	110	285	21	0	416
19326	12400s (+0.8s)	3384	3384	256	72	193	12	0	277
19327	12400s (+0.6s)	2548	2548	256	49	160	12	0	221
19328	12401s (+0.5s)	1780	1780	128	36	136	8	0	180
19329	12401s (+0.5s)	1676	1676	128	39	126	6	0	171
19330	12402s (+0.7s)	3108	3108	256	65	193	8	0	266
19331	12402s (+0.3s)	720	720	64	23	68	6	0	97
19332	12404s (+1.3s)	6544	6544	512	107	322	19	0	448
19333	12405s (+1.0s)	5432	5432	512	101	262	22	0	385
19334	12406s (+0.9s)	4216	4216	256	82	241	14	1	338
19335	12406s (+0.5s)	1916	1916	128	55	137	5	0	197
19336	12407s (+0.5s)	1540	1540	128	43	113	6	2	164
19337	12407s (+0.6s)	2256	2256	128	63	132	14	0	209
19338	12408s (+0.4s)	1296	1296	128	46	86	7	0	139
19339	12408s (+0.5s)	1536	1536	128	41	104	12	0	157
19340	12408s (+0.3s)	836	836	64	29	74	6	0	109
19341	12409s (+0.5s)	1844	1844	128	53	129	9	0	191
19342	12409s (+0.5s)	1552	1552	128	32	123	5	0	160
19343	12410s (+0.7s)	2772	2772	256	53	177	8	0	238
19344	12411s (+0.6s)	2472	2472	256	44	158	8	0	210
19345	12411s (+0.5s)	1688	1688	128	37	127	9	0	173
19346	12412s (+0.8s)	3188	3188	256	72	181	12	0	265
19347	12412s (+0.4s)	1164	1164	64	31	98	9	0	138
19348	12413s (+0.4s)	1160	1160	128	19	104	0	5	128
19349	12413s (+0.2s)	500	500	32	22	51	0	2	75
19350	12414s (+0.7s)	2620	2620	256	39	184	0	7	230
19351	12414s (+0.8s)	3292	3292	256	61	194	0	9	264
19352	12415s (+0.6s)	2716	2716	256	53	163	0	11	227
19353	12416s (+0.5s)	1704	1704	128	27	132	0	9	168
19354	12417s (+1.0s)	5280	5280	512	72	269	0	20	361
19355	12417s (+0.7s)	2508	2508	128	48	175	0	15	238
19356	12417s (+0.2s)	364	364	32	11	44	0	4	59
19357	12418s (+0.4s)	1312	1312	128	30	111	3	0	144
19358	12418s (+0.5s)	1868	1868	128	56	126	8	0	190
19359	12419s (+0.8s)	3556	3556	256	87	198	11	0	296
19360	12420s (+0.5s)	1628	1628	128	32	125	5	0	162
19361	12421s (+0.8s)	3340	3340	256	68	202	13	0	283
19362	12421s (+0.5s)	1772	1772	128	50	117	9	0	176
19363	12421s (+0.4s)	1504	1504	128	32	116	5	0	153
19364	12422s (+0.5s)	1484	1484	128	44	109	6	0	159
19365	12423s (+0.6s)	2040	2040	128	42	150	14	0	206
19366	12423s (+0.6s)	2600	2600	256	50	168	7	0	225
19367	12424s (+0.4s)	1240	1240	128	38	88	5	0	131
19368	12425s (+1.0s)	4180	4180	256	80	256	15	0	351
19369	12425s (+0.4s)	1068	1068	64	42	82	6	1	131
19370	12426s (+1.0s)	4000	4000	256	80	238	16	0	334
19371	12426s (+0.5s)	1600	1600	128	38	118	11	0	167
19372	12427s (+0.3s)	1180	1180	128	23	98	5	1	127
19373	12427s (+0.7s)	2732	2732	256	61	147	17	2	227
19374	12428s (+0.4s)	1484	1484	128	40	104	10	1	155
19375	12429s (+1.0s)	4224	4224	256	86	242	13	0	341
19376	12429s (+0.5s)	2296	2296	256	38	144	8	0	190
19377	12430s (+0.5s)	1748	1748	128	44	125	7	0	176
19378	12431s (+0.7s)	3180	3180	256	63	190	10	0	263
19379	12431s (+0.3s)	872	872	64	20	81	4	0	105
19380	12432s (+0.6s)	1992	1992	128	43	145	12	0	200
19381	12432s (+0.8s)	3544	3544	256	93	193	14	0	300
19382	12433s (+1.0s)	4580	4580	256	116	219	21	0	356
19383	12434s (+0.6s)	2372	2372	256	47	146	8	0	201
19384	12435s (+1.1s)	5400	5400	512	93	269	18	1	381
19385	12436s (+0.4s)	1480	1480	128	35	113	6	0	154
19386	12436s (+0.4s)	1292	1292	128	36	99	4	0	139
19387	12437s (+1.0s)	4204	4204	256	93	234	21	0	348
19388	12438s (+0.6s)	1932	1932	128	50	141	10	0	201
19389	12438s (+0.6s)	2096	2096	128	49	155	11	0	215
19390	12439s (+0.4s)	1036	1036	64	32	83	8	0	123
19391	12440s (+1.1s)	4660	4660	256	111	258	22	0	391
19392	12440s (+0.8s)	3336	3336	256	79	189	13	0	281
19393	12441s (+1.0s)	5356	5356	512	88	266	17	0	371
19394	12442s (+0.8s)	3208	3208	256	66	193	11	0	270
19395	12443s (+0.5s)	1688	1688	128	36	125	11	1	173
19396	12443s (+0.6s)	2640	2640	256	56	153	13	0	222
19397	12444s (+0.5s)	1696	1696	128	36	121	12	0	169
19398	12445s (+0.6s)	2496	2496	256	33	179	0	5	217
19399	12445s (+0.9s)	4020	4020	256	62	250	0	13	325
Episode	Time	Reward	Score	Highest	L	U	R	D	Steps
19400	12446s (+0.9s)	3608	3608	256	84	201	20	0	305
19401	12447s (+0.5s)	2200	2200	256	40	134	10	0	184
19402	12448s (+0.9s)	3684	3684	256	88	198	18	0	304
19403	12449s (+0.8s)	3480	3480	256	64	200	13	0	277
19404	12449s (+0.3s)	1104	1104	128	28	86	3	0	117
19405	12450s (+0.8s)	3328	3328	256	65	204	9	0	278
19406	12450s (+0.7s)	2860	2860	256	70	151	11	0	232
19407	12451s (+0.4s)	1252	1252	64	34	103	7	0	144
19408	12452s (+0.7s)	2840	2840	256	64	173	11	0	248
19409	12452s (+0.4s)	996	996	64	28	93	7	0	128
19410	12452s (+0.5s)	1588	1588	128	40	117	7	0	164
19411	12453s (+0.6s)	2056	2056	128	39	144	12	0	195
19412	12454s (+0.8s)	3328	3328	256	73	192	18	0	283
19413	12454s (+0.6s)	1928	1928	128	38	155	7	0	200
19414	12455s (+0.7s)	2892	2892	256	59	178	12	0	249
19415	12456s (+0.6s)	1924	1924	128	47	142	10	0	199
19416	12456s (+0.8s)	3412	3412	256	66	200	17	0	283
19417	12457s (+0.9s)	3696	3696	256	65	233	16	1	315
19418	12458s (+0.7s)	3036	3036	256	56	185	13	0	254
19419	12459s (+0.6s)	1940	1940	128	54	140	9	0	203
19420	12459s (+0.5s)	1772	1772	128	41	134	7	0	182
19421	12460s (+0.5s)	1572	1572	128	37	115	0	12	164
19422	12460s (+0.6s)	2604	2604	256	43	174	0	8	225
19423	12461s (+0.5s)	1628	1628	128	32	124	0	8	164
19424	12462s (+0.8s)	3400	3400	256	58	216	0	9	283
19425	12462s (+0.7s)	3176	3176	256	65	181	0	16	262
19426	12463s (+0.5s)	1808	1808	128	54	118	12	0	184
19427	12463s (+0.7s)	2600	2600	256	62	151	11	1	225
19428	12464s (+0.6s)	2084	2084	128	54	143	14	0	211
19429	12465s (+0.5s)	1892	1892	128	47	137	7	0	191
19430	12465s (+0.5s)	1540	1540	128	52	104	8	0	164
19431	12466s (+0.7s)	3116	3116	256	55	192	11	1	259
19432	12467s (+1.2s)	5784	5784	512	105	291	16	0	412
19433	12468s (+0.9s)	4736	4736	512	83	234	13	1	331
19434	12469s (+0.7s)	2768	2768	256	53	174	9	0	236
19435	12469s (+0.7s)	2756	2756	256	63	157	15	1	236
19436	12470s (+0.9s)	3836	3836	256	77	218	13	0	308
19437	12471s (+0.6s)	2680	2680	256	62	151	17	0	230
19438	12472s (+0.8s)	3344	3344	256	73	192	16	1	282
19439	12473s (+0.8s)	3404	3404	256	72	198	16	1	287
19440	12473s (+0.3s)	1140	1140	128	28	87	7	0	122
19441	12474s (+0.7s)	2964	2964	256	58	170	12	1	241
19442	12475s (+1.2s)	5940	5940	512	116	280	29	0	425
19443	12476s (+0.8s)	3488	3488	256	87	186	18	0	291
19444	12476s (+0.4s)	1524	1524	128	35	116	7	0	158
19445	12477s (+0.8s)	3216	3216	256	62	197	12	0	271
19446	12478s (+0.8s)	3736	3736	256	69	213	20	0	302
19447	12478s (+0.6s)	2668	2668	256	65	152	10	0	227
19448	12479s (+0.4s)	1084	1084	64	26	95	7	0	128
19449	12479s (+0.6s)	2356	2356	256	52	136	9	0	197
19450	12480s (+0.5s)	1752	1752	128	49	117	11	0	177
19451	12480s (+0.4s)	1164	1164	128	28	88	9	0	125
19452	12481s (+0.4s)	1432	1432	128	37	103	7	0	147
19453	12481s (+0.6s)	2444	2444	128	53	165	9	0	227
19454	12482s (+0.6s)	1916	1916	128	38	153	6	0	197
19455	12482s (+0.5s)	1828	1828	128	54	121	12	0	187
19456	12483s (+1.1s)	5520	5520	512	91	282	18	0	391
19457	12484s (+0.8s)	3304	3304	256	60	204	13	0	277
19458	12485s (+0.3s)	1032	1032	64	31	87	5	0	123
19459	12485s (+0.5s)	1640	1640	128	46	118	7	1	172
19460	12486s (+1.0s)	4060	4060	256	74	253	10	0	337
19461	12486s (+0.2s)	676	676	64	14	70	3	0	87
19462	12487s (+0.5s)	1500	1500	128	35	115	9	0	159
19463	12488s (+0.9s)	3804	3804	256	65	240	12	0	317
19464	12488s (+0.8s)	3256	3256	256	66	202	0	9	277
19465	12489s (+0.9s)	3668	3668	256	62	229	0	20	311
19466	12490s (+0.9s)	3968	3968	256	79	231	0	16	326
19467	12491s (+0.4s)	1436	1436	128	35	102	0	11	148
19468	12491s (+0.5s)	1752	1752	128	44	124	1	6	175
19469	12492s (+0.9s)	3680	3680	256	72	216	15	0	303
19470	12493s (+0.4s)	1196	1196	128	25	101	5	0	131
19471	12493s (+0.9s)	3652	3652	256	93	204	17	1	315
19472	12494s (+0.5s)	1488	1488	128	34	113	9	0	156
19473	12495s (+0.6s)	2620	2620	256	56	157	10	0	223
19474	12495s (+0.4s)	1464	1464	128	26	117	7	0	150
19475	12496s (+0.7s)	2560	2560	128	69	152	18	0	239
19476	12497s (+1.0s)	4056	4056	256	94	220	22	0	336
19477	12498s (+1.2s)	5876	5876	512	97	307	19	1	424
19478	12499s (+0.5s)	1608	1608	128	41	117	10	1	169
19479	12499s (+0.4s)	956	956	64	29	86	8	0	123
19480	12499s (+0.3s)	980	980	64	27	90	4	0	121
19481	12500s (+0.3s)	1104	1104	128	31	83	7	0	121
19482	12500s (+0.5s)	1620	1620	128	45	118	9	0	172
19483	12501s (+0.8s)	3240	3240	256	62	197	0	6	265
19484	12501s (+0.5s)	1508	1508	128	34	120	0	7	161
19485	12502s (+0.9s)	3700	3700	256	53	239	0	19	311
19486	12503s (+0.7s)	2916	2916	256	53	191	0	7	251
19487	12504s (+0.6s)	2800	2800	256	42	176	0	11	229
19488	12504s (+0.5s)	1752	1752	128	30	141	0	7	178
19489	12505s (+0.7s)	2644	2644	256	48	177	0	6	231
19490	12505s (+0.7s)	2924	2924	256	54	180	0	14	248
19491	12506s (+0.4s)	1336	1336	128	20	111	0	8	139
19492	12506s (+0.3s)	800	800	64	12	85	0	5	102
19493	12506s (+0.3s)	824	824	64	19	85	0	6	110
19494	12507s (+0.6s)	2444	2444	256	41	157	0	9	207
19495	12508s (+1.3s)	6408	6408	512	102	320	27	0	449
19496	12509s (+0.9s)	3512	3512	256	69	213	15	0	297
19497	12510s (+0.8s)	3244	3244	256	60	206	8	0	274
19498	12511s (+0.6s)	2448	2448	256	41	161	7	0	209
19499	12512s (+1.0s)	4032	4032	256	88	223	20	0	331
Episode	Time	Reward	Score	Highest	L	U	R	D	Steps
19500	12512s (+0.7s)	2444	2444	128	56	162	8	0	226
19501	12513s (+0.4s)	1480	1480	128	34	113	6	0	153
19502	12513s (+0.5s)	1960	1960	128	36	144	12	2	194
19503	12514s (+0.6s)	2340	2340	256	51	139	8	0	198
19504	12514s (+0.6s)	2600	2600	256	49	164	12	0	225
19505	12515s (+0.9s)	4048	4048	256	97	218	19	0	334
19506	12516s (+0.7s)	2948	2948	256	71	170	11	0	252
19507	12517s (+0.6s)	1964	1964	128	56	141	7	0	204
19508	12517s (+0.7s)	2680	2680	256	63	156	11	0	230
19509	12518s (+0.5s)	1556	1556	128	40	119	8	0	167
19510	12519s (+0.7s)	2908	2908	256	67	176	10	0	253
19511	12519s (+0.4s)	1232	1232	64	45	85	10	0	140
19512	12520s (+0.7s)	2836	2836	256	52	171	10	0	233
19513	12521s (+0.9s)	3984	3984	256	88	224	18	0	330
19514	12521s (+0.7s)	2800	2800	256	62	170	11	0	243
19515	12522s (+0.7s)	3228	3228	256	76	175	12	0	263
19516	12523s (+0.8s)	3268	3268	256	73	191	16	0	280
19517	12524s (+0.8s)	3272	3272	256	58	204	12	0	274
19518	12525s (+1.0s)	4156	4156	256	85	243	13	0	341
19519	12525s (+0.6s)	1976	1976	128	50	151	6	0	207
19520	12526s (+0.5s)	1932	1932	128	59	125	14	0	198
19521	12526s (+0.3s)	908	908	64	37	75	5	0	117
19522	12526s (+0.3s)	868	868	64	28	81	4	0	113
19523	12527s (+0.5s)	1804	1804	128	44	130	7	0	181
19524	12527s (+0.5s)	1820	1820	128	45	126	12	0	183
19525	12528s (+0.5s)	1848	1848	128	43	137	7	0	187
19526	12529s (+1.0s)	4244	4244	256	83	251	17	0	351
19527	12529s (+0.3s)	696	696	32	31	64	7	0	102
19528	12530s (+0.6s)	2508	2508	256	60	143	15	0	218
19529	12531s (+0.6s)	2628	2628	256	38	179	5	0	222
19530	12532s (+1.1s)	5520	5520	512	119	248	26	2	395
19531	12532s (+0.6s)	2528	2528	256	40	171	0	9	220
19532	12533s (+0.8s)	3352	3352	256	76	193	0	15	284
19533	12534s (+0.4s)	1352	1352	128	28	109	0	12	149
19534	12535s (+1.0s)	5012	5012	512	73	263	0	14	350
19535	12536s (+0.9s)	3940	3940	256	75	229	0	21	325
19536	12536s (+0.6s)	2496	2496	256	34	170	0	11	215
19537	12537s (+0.9s)	3984	3984	256	64	245	0	21	330
19538	12538s (+0.5s)	1624	1624	128	39	129	0	5	173
19539	12538s (+0.2s)	572	572	64	13	65	0	0	78
19540	12538s (+0.3s)	996	996	64	24	89	0	6	119
19541	12539s (+0.4s)	1524	1524	128	29	115	0	6	150
19542	12539s (+0.5s)	2108	2108	256	38	135	0	7	180
19543	12540s (+0.6s)	2464	2464	256	43	156	0	11	210
19544	12540s (+0.5s)	1620	1620	128	40	130	0	3	173
19545	12541s (+0.8s)	3616	3616	256	59	222	0	10	291
19546	12542s (+0.7s)	3188	3188	256	45	201	0	14	260
19547	12542s (+0.5s)	1792	1792	128	45	134	0	4	183
19548	12543s (+0.4s)	1044	1044	64	25	93	0	7	125
19549	12543s (+0.5s)	1824	1824	128	40	143	0	7	190
19550	12544s (+0.7s)	3204	3204	256	51	198	14	0	263
19551	12544s (+0.4s)	876	876	64	26	87	2	0	115
19552	12545s (+0.8s)	3520	3520	256	75	206	17	1	299
19553	12546s (+0.3s)	992	992	64	27	91	5	0	123
19554	12546s (+0.6s)	2576	2576	256	46	165	12	0	223
19555	12547s (+0.3s)	824	824	64	28	73	5	0	106
19556	12547s (+0.5s)	1804	1804	128	49	125	12	0	186
19557	12548s (+1.0s)	4228	4228	256	98	233	16	0	347
19558	12549s (+0.5s)	1828	1828	128	55	115	11	0	181
19559	12549s (+0.4s)	1492	1492	128	29	123	4	0	156
19560	12550s (+1.0s)	4348	4348	256	85	258	18	0	361
19561	12551s (+1.0s)	5224	5224	512	88	248	23	0	359
19562	12552s (+0.7s)	2836	2836	256	68	153	12	0	233
19563	12553s (+1.2s)	5748	5748	512	101	284	23	0	408
19564	12554s (+0.8s)	3528	3528	256	73	213	5	0	291
19565	12554s (+0.7s)	2512	2512	128	71	155	14	0	240
19566	12555s (+0.9s)	3820	3820	256	76	229	11	0	316
19567	12556s (+0.6s)	2380	2380	256	42	154	7	0	203
19568	12557s (+0.6s)	2424	2424	256	44	152	7	0	203
19569	12557s (+0.7s)	2704	2704	128	50	195	12	1	258
19570	12558s (+1.0s)	4212	4212	256	87	240	16	0	343
19571	12559s (+0.6s)	2308	2308	256	42	153	7	0	202
19572	12559s (+0.5s)	1828	1828	128	35	150	6	0	191
19573	12560s (+0.9s)	3848	3848	256	85	208	13	0	306
19574	12561s (+0.4s)	1188	1188	128	32	92	5	0	129
19575	12561s (+0.6s)	2360	2360	256	38	160	5	0	203
19576	12562s (+1.1s)	5592	5592	512	85	291	20	0	396
19577	12563s (+0.9s)	3592	3592	256	97	186	17	1	301
19578	12564s (+0.3s)	928	928	64	24	85	3	0	112
19579	12564s (+0.5s)	1768	1768	128	41	134	7	0	182
19580	12564s (+0.2s)	464	464	32	20	49	7	0	76
19581	12565s (+0.6s)	2432	2432	128	54	158	12	0	224
19582	12565s (+0.3s)	884	884	64	31	76	5	0	112
19583	12566s (+0.7s)	2676	2676	256	60	153	14	1	228
19584	12567s (+0.7s)	2856	2856	256	39	187	0	6	232
19585	12567s (+0.5s)	1776	1776	128	34	138	0	9	181
19586	12568s (+0.4s)	1312	1312	128	27	111	0	6	144
19587	12568s (+0.7s)	2784	2784	256	49	181	0	9	239
19588	12569s (+0.6s)	1908	1908	128	40	153	0	9	202
19589	12569s (+0.5s)	2024	2024	256	37	126	6	0	169
19590	12570s (+0.7s)	3108	3108	256	57	183	11	0	251
19591	12571s (+0.4s)	1276	1276	128	36	95	4	0	135
19592	12571s (+0.9s)	4084	4084	256	80	243	10	0	333
19593	12572s (+0.7s)	2940	2940	256	76	170	15	0	261
19594	12573s (+0.5s)	1504	1504	128	39	112	8	0	159
19595	12573s (+0.4s)	1356	1356	64	39	102	7	0	148
19596	12574s (+0.4s)	1448	1448	128	34	111	5	0	150
19597	12574s (+0.6s)	2508	2508	256	48	158	12	0	218
19598	12575s (+0.7s)	2936	2936	256	55	191	14	0	260
19599	12575s (+0.5s)	1868	1868	128	44	136	10	0	190
Episode	Time	Reward	Score	Highest	L	U	R	D	Steps
19600	12576s (+0.9s)	3980	3980	256	89	225	15	0	329
19601	12577s (+0.5s)	1748	1748	128	38	130	7	0	175
19602	12578s (+0.7s)	2764	2764	256	53	178	7	0	238
19603	12578s (+0.7s)	2616	2616	256	49	167	0	13	229
19604	12579s (+0.8s)	3308	3308	256	66	192	0	13	271
19605	12580s (+0.9s)	3908	3908	256	68	242	0	17	327
19606	12581s (+0.7s)	2752	2752	256	46	181	0	10	237
19607	12581s (+0.5s)	1676	1676	128	35	141	0	5	181
19608	12582s (+0.5s)	1804	1804	128	40	138	0	8	186
19609	12582s (+0.6s)	1980	1980	128	42	156	0	10	208
19610	12583s (+1.1s)	4580	4580	256	99	262	25	0	386
19611	12584s (+0.7s)	2752	2752	256	61	165	11	0	237
19612	12585s (+0.5s)	1512	1512	128	30	124	7	0	161
19613	12585s (+0.9s)	3640	3640	256	73	216	14	0	303
19614	12586s (+0.5s)	1564	1564	128	33	125	5	0	163
19615	12587s (+0.8s)	3348	3348	256	53	220	0	14	287
19616	12588s (+0.9s)	3552	3552	256	62	227	0	10	299
19617	12589s (+1.2s)	6456	6456	512	94	324	0	25	443
19618	12590s (+0.8s)	3652	3652	256	58	220	0	18	296
19619	12590s (+0.7s)	2616	2616	256	49	169	0	11	229
19620	12591s (+0.5s)	1804	1804	128	43	134	0	8	185
19621	12591s (+0.2s)	420	420	32	10	55	2	0	67
19622	12592s (+1.0s)	4812	4812	512	100	216	19	0	335
19623	12593s (+0.5s)	1728	1728	128	46	122	8	0	176
19624	12593s (+0.5s)	1700	1700	128	46	117	8	0	171
19625	12594s (+0.5s)	1564	1564	128	35	124	4	0	163
19626	12594s (+0.4s)	936	936	64	28	91	5	0	124
19627	12594s (+0.5s)	1640	1640	128	55	108	7	0	170
19628	12595s (+0.8s)	3232	3232	256	55	205	0	12	272
19629	12596s (+0.5s)	1612	1612	128	25	131	0	5	161
19630	12596s (+0.2s)	552	552	64	10	66	0	2	78
19631	12596s (+0.5s)	1548	1548	128	33	125	0	8	166
19632	12597s (+0.7s)	2772	2772	256	60	159	16	1	236
19633	12598s (+0.5s)	1900	1900	128	55	127	14	1	197
19634	12598s (+0.7s)	2840	2840	256	55	175	11	0	241
19635	12599s (+0.6s)	1912	1912	128	48	141	7	0	196
19636	12600s (+0.7s)	3188	3188	256	65	187	10	0	262
19637	12600s (+0.3s)	772	772	64	22	75	4	0	101
19638	12601s (+0.5s)	1884	1884	128	54	122	14	0	190
19639	12601s (+0.6s)	2288	2288	128	53	152	10	1	216
19640	12602s (+0.7s)	2540	2540	128	69	152	14	0	235
19641	12603s (+0.9s)	4180	4180	256	88	228	24	0	340
19642	12603s (+0.5s)	2280	2280	256	48	129	8	0	185
19643	12604s (+0.9s)	3928	3928	256	97	207	16	0	320
19644	12605s (+0.8s)	3448	3448	256	73	196	18	0	287
19645	12606s (+0.5s)	1616	1616	128	39	123	9	0	171
19646	12606s (+0.5s)	1604	1604	128	49	105	9	0	163
19647	12607s (+0.5s)	1752	1752	128	42	125	11	0	178
19648	12607s (+0.3s)	816	816	64	28	70	6	1	105
19649	12607s (+0.5s)	1876	1876	128	50	125	9	1	185
19650	12608s (+0.5s)	1576	1576	128	42	112	11	1	166
19651	12608s (+0.4s)	1520	1520	128	29	121	0	7	157
19652	12609s (+0.4s)	1488	1488	128	30	112	0	4	146
19653	12609s (+0.6s)	2360	2360	256	40	154	0	5	199
19654	12610s (+0.4s)	1156	1156	64	32	93	0	11	136
19655	12610s (+0.5s)	2068	2068	128	48	130	0	13	191
19656	12611s (+0.4s)	1172	1172	128	27	98	2	0	127
19657	12611s (+0.4s)	1328	1328	128	30	104	5	0	139
19658	12612s (+0.5s)	1760	1760	128	52	119	9	0	180
19659	12613s (+1.0s)	4240	4240	256	86	244	20	0	350
19660	12613s (+0.8s)	3152	3152	256	55	193	10	0	258
19661	12614s (+1.0s)	5396	5396	512	83	281	15	0	379
19662	12615s (+0.5s)	2328	2328	256	51	136	9	0	196
19663	12615s (+0.6s)	1872	1872	128	55	136	7	0	198
19664	12616s (+0.5s)	1764	1764	128	41	132	4	0	177
19665	12617s (+0.9s)	3612	3612	256	73	218	14	0	305
19666	12617s (+0.5s)	1512	1512	128	40	113	8	0	161
19667	12618s (+0.5s)	1816	1816	128	44	135	9	0	188
19668	12618s (+0.3s)	924	924	64	33	83	6	0	122
19669	12619s (+0.8s)	3232	3232	256	72	184	15	0	271
19670	12620s (+0.8s)	3260	3260	256	73	188	13	0	274
19671	12621s (+0.9s)	3972	3972	256	73	231	13	0	317
19672	12621s (+0.4s)	1364	1364	128	22	116	3	0	141
19673	12622s (+1.0s)	4044	4044	256	99	230	11	0	340
19674	12623s (+0.7s)	3096	3096	256	53	190	10	0	253
19675	12623s (+0.4s)	1432	1432	128	39	102	6	0	147
19676	12624s (+0.5s)	1792	1792	128	35	141	7	0	183
19677	12624s (+0.4s)	1160	1160	64	35	96	6	0	137
19678	12625s (+0.8s)	3340	3340	256	62	205	15	0	282
19679	12626s (+0.7s)	2804	2804	256	59	176	9	0	244
19680	12627s (+0.8s)	3780	3780	256	60	217	8	2	287
19681	12627s (+0.5s)	1912	1912	128	42	148	6	0	196
19682	12628s (+0.5s)	1724	1724	128	39	127	9	0	175
19683	12628s (+0.5s)	1608	1608	128	39	124	6	0	169
19684	12629s (+0.8s)	3320	3320	256	94	165	22	0	281
19685	12630s (+0.8s)	3204	3204	256	73	183	12	0	268
19686	12631s (+1.0s)	4124	4124	256	82	242	14	0	338
19687	12631s (+0.7s)	2936	2936	256	61	184	15	0	260
19688	12632s (+0.5s)	1816	1816	128	47	131	10	0	188
19689	12632s (+0.6s)	2144	2144	128	41	154	0	8	203
19690	12633s (+0.7s)	2904	2904	256	48	183	0	8	239
19691	12633s (+0.3s)	796	796	64	24	78	0	2	104
19692	12634s (+0.4s)	1264	1264	128	21	106	0	6	133
19693	12635s (+1.0s)	4160	4160	256	60	270	0	13	343
19694	12635s (+0.5s)	1728	1728	128	38	131	0	4	173
19695	12636s (+0.4s)	1136	1136	64	32	96	0	8	136
19696	12637s (+1.0s)	5084	5084	512	91	255	0	20	366
19697	12637s (+0.6s)	2136	2136	128	49	132	17	0	198
19698	12638s (+0.5s)	1572	1572	128	36	123	6	0	165
19699	12638s (+0.5s)	1880	1880	128	47	129	12	0	188
Episode	Time	Reward	Score	Highest	L	U	R	D	Steps
19700	12639s (+0.5s)	1820	1820	128	37	143	9	0	189
19701	12640s (+0.8s)	3516	3516	256	80	197	19	1	297
19702	12641s (+0.8s)	3440	3440	256	71	202	17	0	290
19703	12641s (+0.3s)	756	756	64	15	84	2	0	101
19704	12642s (+1.1s)	5504	5504	512	109	263	19	1	392
19705	12643s (+0.7s)	2676	2676	256	56	176	7	0	239
19706	12644s (+1.1s)	4524	4524	256	111	244	22	0	377
19707	12645s (+1.0s)	4032	4032	256	100	227	10	0	337
19708	12645s (+0.5s)	1800	1800	128	47	124	6	1	178
19709	12646s (+0.7s)	2788	2788	256	47	183	11	0	241
19710	12647s (+0.6s)	2596	2596	256	55	156	11	1	223
19711	12647s (+0.6s)	2272	2272	256	46	139	7	0	192
19712	12648s (+0.9s)	3984	3984	256	79	226	15	0	320
19713	12649s (+0.6s)	2512	2512	256	48	161	9	1	219
19714	12649s (+0.5s)	1556	1556	64	45	116	10	0	171
19715	12650s (+0.3s)	1112	1112	128	20	92	1	4	117
19716	12650s (+0.3s)	724	724	64	17	76	0	3	96
19717	12650s (+0.5s)	1516	1516	128	34	117	7	0	158
19718	12651s (+0.4s)	1140	1140	64	32	94	11	0	137
19719	12651s (+0.7s)	2924	2924	256	53	191	13	0	257
19720	12653s (+1.4s)	7340	7340	512	141	341	25	0	507
19721	12654s (+0.8s)	3456	3456	256	88	185	11	0	284
19722	12655s (+1.0s)	4208	4208	256	87	236	19	1	343
19723	12655s (+0.5s)	1588	1588	128	32	131	5	0	168
19724	12656s (+0.4s)	1056	1056	64	33	89	6	0	128
19725	12656s (+0.5s)	1724	1724	128	49	117	9	0	175
19726	12657s (+0.7s)	3040	3040	256	57	185	8	0	250
19727	12657s (+0.4s)	1480	1480	128	30	116	7	1	154
19728	12658s (+0.6s)	2036	2036	128	61	133	11	0	205
19729	12659s (+0.7s)	3184	3184	256	68	185	11	0	264
19730	12659s (+0.6s)	1932	1932	128	52	142	7	0	201
19731	12660s (+0.6s)	2252	2252	128	53	146	12	0	211
19732	12660s (+0.4s)	1304	1304	128	37	101	4	0	142
19733	12661s (+0.4s)	1432	1432	128	31	111	5	0	147
19734	12661s (+0.5s)	1616	1616	128	47	116	8	0	171
19735	12662s (+0.6s)	2160	2160	128	47	143	0	10	200
19736	12662s (+0.5s)	1792	1792	128	34	133	0	10	177
19737	12663s (+0.6s)	2616	2616	256	41	168	0	9	218
19738	12663s (+0.6s)	2484	2484	256	41	164	0	8	213
19739	12664s (+0.4s)	1448	1448	128	33	110	0	5	148
19740	12665s (+1.0s)	4472	4472	256	78	282	0	12	372
19741	12665s (+0.5s)	1652	1652	128	29	128	0	9	166
19742	12666s (+0.4s)	1188	1188	128	25	101	0	5	131
19743	12666s (+0.6s)	2364	2364	256	34	156	0	7	197
19744	12667s (+1.1s)	5420	5420	512	89	279	0	14	382
19745	12668s (+0.5s)	1796	1796	128	42	134	0	7	183
19746	12669s (+0.8s)	3460	3460	256	58	221	0	10	289
19747	12669s (+0.4s)	1460	1460	128	31	109	0	9	149
19748	12670s (+0.4s)	1376	1376	128	24	114	0	7	145
19749	12670s (+0.8s)	3232	3232	256	62	193	15	1	271
19750	12671s (+1.1s)	5556	5556	512	102	274	16	0	392
19751	12672s (+0.6s)	1928	1928	128	58	136	6	0	200
19752	12673s (+0.8s)	3296	3296	256	64	200	15	0	279
19753	12674s (+0.8s)	3188	3188	256	90	171	18	1	280
19754	12674s (+0.7s)	2616	2616	256	65	151	13	0	229
19755	12675s (+0.5s)	1796	1796	128	48	128	8	0	184
19756	12676s (+0.8s)	3300	3300	256	66	190	16	0	272
19757	12676s (+0.7s)	2960	2960	256	68	186	7	0	261
19758	12677s (+0.8s)	3484	3484	256	80	202	8	0	290
19759	12678s (+0.6s)	1924	1924	128	46	142	11	0	199
19760	12678s (+0.6s)	1852	1852	128	47	140	6	0	193
19761	12679s (+0.8s)	3504	3504	256	71	206	18	0	295
19762	12680s (+0.6s)	2660	2660	256	62	153	11	0	226
19763	12680s (+0.4s)	1296	1296	128	40	93	7	0	140
19764	12681s (+0.7s)	3096	3096	256	58	188	8	0	254
19765	12681s (+0.4s)	1168	1168	128	35	90	6	0	131
19766	12682s (+0.8s)	3248	3248	256	57	210	8	0	275
19767	12683s (+1.1s)	5412	5412	512	126	232	21	0	379
19768	12684s (+0.4s)	1404	1404	128	36	104	8	0	148
19769	12685s (+1.1s)	5608	5608	512	114	267	19	0	400
19770	12685s (+0.6s)	2340	2340	128	59	145	9	0	213
19771	12686s (+0.4s)	1368	1368	128	35	96	11	0	142
19772	12686s (+0.3s)	992	992	64	32	76	8	1	117
19773	12687s (+0.7s)	2952	2952	256	62	169	13	1	245
19774	12687s (+0.3s)	876	876	64	26	83	5	0	114
19775	12688s (+0.4s)	1272	1272	128	36	96	7	0	139
19776	12688s (+0.4s)	1352	1352	128	25	109	0	6	140
19777	12688s (+0.4s)	1248	1248	128	29	101	0	3	133
19778	12689s (+0.8s)	3300	3300	256	78	188	11	0	277
19779	12690s (+0.9s)	3896	3896	256	81	223	14	0	318
19780	12691s (+0.5s)	1504	1504	128	37	114	8	0	159
19781	12691s (+0.8s)	3256	3256	256	74	187	11	0	272
19782	12692s (+0.7s)	2680	2680	256	45	176	9	0	230
19783	12693s (+1.1s)	5632	5632	512	99	281	17	0	397
19784	12694s (+0.7s)	2812	2812	128	69	170	11	0	250
19785	12695s (+0.8s)	3228	3228	256	79	178	13	0	270
19786	12695s (+0.8s)	3204	3204	256	52	201	11	0	264
19787	12696s (+0.6s)	1928	1928	128	46	149	5	0	200
19788	12697s (+0.5s)	2180	2180	256	58	126	8	0	192
19789	12697s (+0.9s)	4064	4064	256	81	230	11	1	323
19790	12698s (+0.7s)	3056	3056	256	67	172	9	0	248
19791	12699s (+0.5s)	1780	1780	128	45	127	8	1	181
19792	12699s (+0.5s)	1628	1628	128	40	125	9	0	174
19793	12700s (+0.5s)	1516	1516	128	43	114	5	0	162
19794	12700s (+0.2s)	344	344	32	17	42	4	0	63
19795	12700s (+0.4s)	1476	1476	128	38	110	5	0	153
19796	12701s (+0.3s)	884	884	64	33	77	6	0	116
19797	12702s (+1.3s)	6504	6504	512	125	315	22	0	462
19798	12702s (+0.4s)	1220	1220	128	29	103	4	0	136
19799	12703s (+0.4s)	1444	1444	128	35	114	6	0	155
Episode	Time	Reward	Score	Highest	L	U	R	D	Steps
19800	12704s (+1.0s)	4204	4204	256	95	233	17	0	345
19801	12705s (+0.8s)	3224	3224	256	71	188	14	0	273
19802	12705s (+0.5s)	1748	1748	128	36	130	10	0	176
19803	12706s (+0.4s)	1436	1436	128	31	111	6	0	148
19804	12706s (+0.3s)	984	984	64	23	88	4	0	115
19805	12707s (+0.9s)	3968	3968	256	68	240	18	0	326
19806	12708s (+0.8s)	3312	3312	256	74	189	13	0	276
19807	12709s (+0.9s)	4044	4044	256	102	217	15	0	334
19808	12709s (+0.7s)	3124	3124	256	57	192	12	0	261
19809	12710s (+0.6s)	1912	1912	128	55	138	3	0	196
19810	12711s (+0.8s)	3312	3312	256	50	211	11	0	272
19811	12711s (+0.3s)	776	776	64	23	78	2	0	103
19812	12712s (+0.5s)	1896	1896	128	42	139	11	0	192
19813	12712s (+0.4s)	1180	1180	128	36	88	3	0	127
19814	12712s (+0.4s)	1512	1512	128	38	109	5	0	152
19815	12713s (+0.7s)	3044	3044	256	53	185	8	0	246
19816	12714s (+1.2s)	5856	5856	512	106	290	22	0	418
19817	12715s (+0.7s)	2692	2692	256	54	160	16	0	230
19818	12716s (+1.0s)	4284	4284	256	107	231	18	0	356
19819	12717s (+0.9s)	3836	3836	256	66	234	13	0	313
19820	12717s (+0.6s)	2424	2424	256	37	155	0	11	203
19821	12718s (+0.4s)	1344	1344	64	52	90	9	0	151
19822	12718s (+0.3s)	972	972	64	29	88	5	0	122
19823	12719s (+0.8s)	3248	3248	256	55	208	0	7	270
19824	12719s (+0.4s)	1016	1016	64	21	91	0	8	120
19825	12720s (+0.6s)	2512	2512	256	49	160	10	0	219
19826	12721s (+0.8s)	3496	3496	256	76	206	11	0	293
19827	12721s (+0.4s)	1560	1560	128	37	113	4	0	154
19828	12722s (+0.8s)	3204	3204	256	66	190	13	0	269
19829	12723s (+1.0s)	4188	4188	256	93	235	16	0	344
19830	12724s (+0.5s)	1796	1796	128	37	137	10	0	184
19831	12725s (+1.0s)	5032	5032	512	102	232	18	2	354
19832	12725s (+0.7s)	2960	2960	256	48	190	8	1	247
19833	12726s (+0.3s)	1168	1168	128	27	91	6	0	124
19834	12726s (+0.4s)	1288	1288	128	39	93	6	0	138
19835	12727s (+0.7s)	2884	2884	256	57	188	7	0	252
19836	12727s (+0.4s)	1160	1160	128	34	88	4	0	126
19837	12728s (+0.5s)	1732	1732	128	43	120	10	0	173
19838	12729s (+0.9s)	4768	4768	512	86	229	20	1	336
19839	12729s (+0.4s)	1344	1344	64	42	101	8	0	151
19840	12729s (+0.2s)	544	544	64	15	62	3	1	81
19841	12730s (+0.6s)	2576	2576	256	49	159	6	0	214
19842	12730s (+0.5s)	1888	1888	128	62	110	12	0	184
19843	12731s (+1.1s)	4648	4648	256	108	261	22	0	391
19844	12732s (+0.7s)	2408	2408	128	51	163	11	0	225
19845	12733s (+0.4s)	1360	1360	128	36	103	2	0	141
19846	12733s (+0.6s)	2568	2568	256	49	165	8	1	223
19847	12734s (+0.4s)	1360	1360	128	31	102	0	8	141
19848	12734s (+0.8s)	3520	3520	256	56	221	0	17	294
19849	12735s (+0.4s)	1480	1480	128	28	117	0	10	155
19850	12736s (+0.8s)	3252	3252	256	60	203	0	13	276
19851	12736s (+0.8s)	3280	3280	256	64	197	12	0	273
19852	12737s (+0.7s)	2644	2644	256	60	167	8	1	236
19853	12738s (+0.4s)	1160	1160	128	20	100	4	0	124
19854	12738s (+0.4s)	1384	1384	128	40	97	6	0	143
19855	12739s (+0.7s)	2496	2496	128	59	155	15	0	229
19856	12739s (+0.8s)	3152	3152	256	72	174	17	0	263
19857	12740s (+1.0s)	4388	4388	256	83	268	15	0	366
19858	12741s (+0.7s)	2716	2716	256	51	173	10	0	234
19859	12742s (+0.8s)	3428	3428	256	77	198	12	0	287
19860	12743s (+1.3s)	6456	6456	512	117	320	19	0	456
19861	12744s (+1.1s)	5668	5668	512	111	263	20	0	394
19862	12745s (+0.7s)	3172	3172	256	53	199	9	0	261
19863	12746s (+0.9s)	3820	3820	256	83	218	10	0	311
19864	12747s (+0.8s)	3440	3440	256	63	212	10	0	285
19865	12747s (+0.4s)	1292	1292	128	32	103	4	0	139
19866	12748s (+0.4s)	1484	1484	128	27	123	6	0	156
19867	12748s (+0.7s)	2804	2804	256	61	172	10	0	243
19868	12749s (+0.9s)	3668	3668	256	66	241	7	0	314
19869	12750s (+0.4s)	1212	1212	128	38	88	6	0	132
19870	12750s (+0.6s)	2300	2300	128	68	148	13	0	229
19871	12751s (+0.8s)	3616	3616	256	72	206	13	0	291
19872	12752s (+0.5s)	2084	2084	256	40	128	9	0	177
19873	12753s (+1.1s)	4620	4620	256	103	260	22	0	385
19874	12754s (+0.8s)	3284	3284	256	60	202	15	0	277
19875	12754s (+0.3s)	912	912	64	26	83	4	0	113
19876	12755s (+0.9s)	4096	4096	256	86	230	16	0	332
19877	12755s (+0.6s)	2400	2400	256	41	158	5	0	204
19878	12756s (+1.1s)	5780	5780	512	103	261	27	0	391
19879	12757s (+0.3s)	892	892	64	28	81	5	0	114
19880	12758s (+0.7s)	2964	2964	256	66	185	11	0	262
19881	12758s (+0.7s)	2768	2768	256	52	176	5	0	233
19882	12759s (+0.4s)	1400	1400	128	45	88	10	0	143
19883	12759s (+0.5s)	1804	1804	128	36	144	6	0	186
19884	12760s (+0.6s)	2448	2448	256	53	142	10	0	205
19885	12760s (+0.4s)	1292	1292	128	18	110	3	0	131
19886	12761s (+0.5s)	1912	1912	128	55	133	8	0	196
19887	12762s (+0.8s)	3380	3380	256	61	204	11	0	276
19888	12762s (+0.7s)	3144	3144	256	63	180	17	0	260
19889	12763s (+0.9s)	4060	4060	256	88	222	16	0	326
19890	12764s (+0.4s)	1052	1052	64	24	100	3	0	127
19891	12764s (+0.8s)	3448	3448	256	70	204	18	0	292
19892	12765s (+0.8s)	3492	3492	256	71	206	15	0	292
19893	12766s (+0.4s)	1336	1336	128	23	114	2	0	139
19894	12766s (+0.5s)	1564	1564	128	41	110	12	0	163
19895	12767s (+0.5s)	1804	1804	128	39	139	0	8	186
19896	12767s (+0.7s)	2768	2768	256	60	169	0	8	237
19897	12768s (+0.8s)	3268	3268	256	56	199	0	15	270
19898	12769s (+0.8s)	3176	3176	256	47	202	0	14	263
19899	12770s (+0.7s)	2596	2596	128	69	165	13	0	247
Episode	Time	Reward	Score	Highest	L	U	R	D	Steps
19900	12771s (+1.0s)	4092	4092	256	93	227	17	0	337
19901	12772s (+1.1s)	4628	4628	256	115	248	20	0	383
19902	12772s (+0.3s)	828	828	64	30	77	3	0	110
19903	12773s (+0.7s)	2804	2804	256	61	173	10	0	244
19904	12774s (+1.2s)	5652	5652	512	113	283	10	0	406
19905	12774s (+0.4s)	1460	1460	128	36	111	2	0	149
19906	12775s (+0.7s)	3176	3176	256	75	175	14	0	264
19907	12776s (+0.4s)	1276	1276	128	38	92	6	0	136
19908	12776s (+0.4s)	1416	1416	128	31	119	5	0	155
19909	12776s (+0.4s)	1348	1348	128	31	104	7	1	143
19910	12777s (+0.4s)	1220	1220	128	35	91	7	0	133
19911	12778s (+1.2s)	5836	5836	512	102	291	24	1	418
19912	12778s (+0.2s)	460	460	32	21	47	0	7	75
19913	12779s (+0.8s)	3540	3540	256	67	222	0	10	299
19914	12780s (+0.4s)	1292	1292	64	32	106	0	5	143
19915	12780s (+1.0s)	4124	4124	256	88	229	20	0	337
19916	12781s (+0.9s)	3620	3620	256	81	210	16	1	308
19917	12782s (+0.7s)	2884	2884	256	48	195	6	0	249
19918	12783s (+0.8s)	3448	3448	256	86	189	17	0	292
19919	12783s (+0.3s)	716	716	64	18	71	2	0	91
19920	12784s (+0.5s)	1608	1608	128	39	123	7	0	169
19921	12785s (+1.0s)	4064	4064	256	88	238	13	0	339
19922	12785s (+0.6s)	1928	1928	128	46	145	5	0	196
19923	12786s (+0.3s)	912	912	64	29	83	6	1	119
19924	12786s (+0.5s)	1768	1768	128	37	125	10	0	172
19925	12787s (+0.6s)	2116	2116	128	42	150	0	9	201
19926	12787s (+0.5s)	1604	1604	128	27	134	0	7	168
19927	12788s (+0.6s)	2264	2264	128	44	155	0	11	210
19928	12788s (+0.6s)	2472	2472	256	56	148	0	10	214
19929	12789s (+0.3s)	1136	1136	128	19	99	0	4	122
19930	12789s (+0.7s)	2812	2812	256	51	180	0	15	246
19931	12790s (+0.9s)	3804	3804	256	55	243	0	15	313
19932	12791s (+0.7s)	3088	3088	256	43	203	0	10	256
19933	12792s (+0.6s)	1868	1868	128	40	150	0	7	197
19934	12793s (+0.9s)	4008	4008	256	65	244	0	16	325
19935	12793s (+0.7s)	2848	2848	256	64	178	8	0	250
19936	12794s (+0.5s)	1672	1672	128	41	119	10	0	170
19937	12794s (+0.6s)	2236	2236	128	50	154	10	0	214
19938	12796s (+1.3s)	6408	6408	512	124	305	26	1	456
19939	12796s (+0.5s)	1788	1788	128	49	120	12	1	182
19940	12797s (+0.7s)	2760	2760	256	63	157	17	1	238
19941	12798s (+0.6s)	2464	2464	256	59	144	4	1	208
19942	12798s (+0.8s)	3316	3316	256	81	182	17	0	280
19943	12799s (+0.4s)	1332	1332	64	43	103	6	1	153
19944	12799s (+0.7s)	2768	2768	256	57	167	11	1	236
19945	12800s (+0.9s)	3616	3616	256	100	189	17	1	307
19946	12801s (+0.9s)	3600	3600	256	90	189	20	0	299
19947	12802s (+0.7s)	2812	2812	256	53	175	11	0	239
19948	12803s (+0.8s)	3368	3368	256	72	204	12	0	288
19949	12804s (+1.1s)	5440	5440	512	100	259	17	0	376
19950	12805s (+1.1s)	5328	5328	512	84	275	16	0	375
19951	12806s (+0.7s)	3100	3100	256	70	174	19	0	263
19952	12806s (+0.6s)	2068	2068	128	54	138	12	0	204
19953	12807s (+0.8s)	3560	3560	256	75	208	15	0	298
19954	12808s (+0.6s)	2420	2420	256	46	148	9	0	203
19955	12808s (+0.8s)	3360	3360	256	74	201	11	0	286
19956	12809s (+0.4s)	1312	1312	64	37	104	7	0	148
19957	12809s (+0.5s)	1848	1848	128	48	128	9	0	185
19958	12810s (+0.5s)	1620	1620	128	40	122	10	0	172
19959	12811s (+0.6s)	2044	2044	128	46	149	7	0	202
19960	12812s (+1.4s)	7256	7256	512	117	356	28	0	501
19961	12812s (+0.3s)	864	864	64	25	84	3	0	112
19962	12813s (+0.8s)	3512	3512	256	67	212	14	0	293
19963	12814s (+0.4s)	1348	1348	128	29	110	3	0	142
19964	12814s (+0.5s)	1820	1820	128	52	128	9	0	189
19965	12814s (+0.4s)	1360	1360	128	27	106	2	0	135
19966	12815s (+0.8s)	3192	3192	256	60	191	15	0	266
19967	12816s (+0.9s)	4624	4624	256	90	232	19	0	341
19968	12817s (+0.4s)	1160	1160	64	31	98	5	0	134
19969	12817s (+0.4s)	1432	1432	128	30	112	0	5	147
19970	12818s (+0.6s)	2472	2472	256	40	162	0	9	211
19971	12818s (+0.5s)	1668	1668	128	35	125	0	9	169
19972	12818s (+0.3s)	1060	1060	64	22	91	0	7	120
19973	12819s (+0.3s)	788	788	64	30	69	0	6	105
19974	12819s (+0.5s)	1568	1568	128	33	120	0	10	163
19975	12820s (+0.7s)	2764	2764	256	51	174	0	14	239
19976	12820s (+0.4s)	1560	1560	128	29	116	0	8	153
19977	12821s (+0.5s)	2256	2256	256	53	135	0	4	192
19978	12821s (+0.2s)	456	456	64	8	55	0	3	66
19979	12822s (+0.5s)	1680	1680	128	40	121	0	12	173
19980	12822s (+0.5s)	1604	1604	128	32	125	0	10	167
19981	12823s (+1.0s)	4240	4240	256	90	239	21	0	350
19982	12824s (+0.9s)	3972	3972	256	85	231	11	0	327
19983	12825s (+0.9s)	3788	3788	256	95	201	22	0	318
19984	12826s (+0.8s)	3232	3232	256	66	188	14	0	268
19985	12827s (+0.9s)	3744	3744	256	90	205	16	0	311
19986	12828s (+0.9s)	3984	3984	256	85	230	15	0	330
19987	12828s (+0.6s)	1916	1916	128	46	145	6	0	197
19988	12829s (+0.6s)	2384	2384	128	67	141	15	0	223
19989	12829s (+0.2s)	560	560	64	12	60	3	0	75
19990	12830s (+0.5s)	1852	1852	128	50	135	6	0	191
19991	12830s (+0.5s)	1612	1612	128	46	116	8	0	170
19992	12831s (+0.5s)	1656	1656	128	35	129	9	0	173
19993	12831s (+0.5s)	1760	1760	128	35	126	4	1	166
19994	12832s (+0.9s)	3916	3916	256	68	239	11	0	318
19995	12832s (+0.5s)	1596	1596	128	36	125	5	0	166
19996	12833s (+0.4s)	1372	1372	128	39	99	6	0	144
19997	12833s (+0.4s)	1476	1476	128	35	108	9	1	153
19998	12834s (+0.8s)	3336	3336	256	64	200	16	0	280
19999	12834s (+0.4s)	1164	1164	128	29	91	4	0	124
Episode	Time	Reward	Score	Highest	L	U	R	D	Steps
20000	12836s (+1.3s)	6324	6324	512	121	301	29	1	452
20001	12836s (+0.6s)	2444	2444	256	63	136	8	0	207
20002	12837s (+0.4s)	1024	1024	64	28	92	3	0	123
20003	12838s (+1.0s)	4356	4356	256	89	256	18	0	363
20004	12838s (+0.5s)	1504	1504	128	38	117	5	0	160
20005	12839s (+0.6s)	2484	2484	256	55	145	12	0	212
20006	12840s (+1.1s)	5432	5432	512	111	264	14	0	389
20007	12840s (+0.5s)	1824	1824	128	49	126	9	0	184
20008	12841s (+0.8s)	3212	3212	256	68	184	16	0	268
20009	12842s (+0.8s)	3240	3240	256	49	216	8	0	273
20010	12843s (+0.8s)	3400	3400	256	75	191	15	0	281
20011	12843s (+0.6s)	2540	2540	256	52	158	11	0	221
20012	12844s (+1.0s)	4292	4292	256	80	257	15	0	352
20013	12845s (+0.8s)	3512	3512	256	79	207	11	0	297
20014	12846s (+0.9s)	3548	3548	256	89	196	16	0	301
20015	12847s (+0.8s)	3524	3524	256	77	201	18	0	296
20016	12848s (+0.9s)	3772	3772	256	85	215	14	0	314
20017	12849s (+0.8s)	3640	3640	256	78	212	9	0	299
20018	12850s (+0.8s)	3604	3604	256	86	213	11	0	310
20019	12851s (+0.9s)	3968	3968	256	77	234	12	0	323
20020	12851s (+0.4s)	1236	1236	128	35	91	10	0	136
20021	12852s (+0.7s)	2832	2832	256	53	165	12	0	230
20022	12852s (+0.7s)	3168	3168	256	63	184	8	1	256
20023	12853s (+0.7s)	3172	3172	256	80	160	22	0	262
20024	12854s (+1.1s)	5604	5604	512	116	259	24	0	399
20025	12855s (+0.8s)	3216	3216	256	75	175	17	0	267
20026	12856s (+1.0s)	4764	4764	512	89	229	17	1	336
20027	12856s (+0.4s)	1304	1304	128	33	103	5	0	141
20028	12857s (+0.5s)	1656	1656	128	46	124	6	0	176
20029	12857s (+0.2s)	568	568	64	20	53	3	1	77
20030	12858s (+0.8s)	3436	3436	256	68	205	10	0	283
20031	12858s (+0.4s)	1464	1464	128	37	106	0	7	150
20032	12859s (+0.2s)	572	572	64	19	55	0	4	78
20033	12859s (+0.8s)	3728	3728	256	71	209	12	0	292
20034	12860s (+0.8s)	3448	3448	256	92	180	16	0	288
20035	12861s (+0.4s)	1416	1416	128	28	115	1	0	144
20036	12861s (+0.5s)	1872	1872	128	55	120	15	0	190
20037	12862s (+0.4s)	1304	1304	128	31	102	5	0	138
20038	12862s (+0.4s)	1336	1336	128	24	113	2	0	139
20039	12863s (+1.2s)	5796	5796	512	109	282	23	1	415
20040	12864s (+1.0s)	4956	4956	512	83	254	14	0	351
20041	12865s (+0.9s)	3872	3872	256	70	226	15	0	311
20042	12865s (+0.4s)	1228	1228	128	32	95	7	0	134
20043	12866s (+0.6s)	2528	2528	256	50	159	10	0	219
20044	12867s (+0.6s)	2640	2640	256	55	163	7	0	225
20045	12867s (+0.5s)	1596	1596	128	48	113	5	0	166
20046	12868s (+1.0s)	4040	4040	256	87	231	14	1	333
20047	12869s (+0.9s)	3552	3552	256	78	210	13	1	302
20048	12870s (+0.5s)	1636	1636	128	47	117	7	0	171
20049	12871s (+1.4s)	6668	6668	512	130	339	20	0	489
20050	12872s (+0.8s)	3528	3528	256	79	201	16	0	296
20051	12872s (+0.3s)	804	804	64	30	73	5	0	108
20052	12873s (+0.7s)	2772	2772	256	55	168	17	1	241
20053	12873s (+0.5s)	1864	1864	128	51	132	5	1	189
20054	12874s (+0.6s)	2624	2624	256	43	172	7	0	222
20055	12874s (+0.5s)	1564	1564	128	41	113	4	0	158
20056	12875s (+0.8s)	3232	3232	256	74	185	13	0	272
20057	12876s (+0.8s)	3444	3444	256	63	194	13	1	271
20058	12877s (+0.8s)	3244	3244	256	63	197	14	0	274
20059	12877s (+0.7s)	2832	2832	256	68	163	14	0	245
20060	12878s (+0.6s)	2448	2448	256	49	145	11	0	205
20061	12878s (+0.4s)	1428	1428	128	40	105	7	0	152
20062	12879s (+0.5s)	1924	1924	128	45	137	11	0	193
20063	12880s (+0.7s)	2660	2660	256	50	178	7	1	236
20064	12881s (+1.1s)	5784	5784	512	106	272	19	0	397
20065	12882s (+1.1s)	5800	5800	512	98	290	12	0	400
20066	12883s (+0.8s)	3632	3632	256	72	202	19	0	293
20067	12884s (+0.9s)	3956	3956	256	83	221	19	0	323
20068	12885s (+0.8s)	3464	3464	256	74	202	14	0	290
20069	12885s (+0.6s)	2392	2392	256	37	158	4	0	199
20070	12886s (+0.4s)	1492	1492	128	41	110	3	0	154
20071	12886s (+0.7s)	2728	2728	256	54	169	8	0	231
20072	12887s (+0.7s)	3212	3212	256	66	187	12	1	266
20073	12888s (+0.6s)	1948	1948	128	46	152	7	0	205
20074	12888s (+0.7s)	2848	2848	128	79	168	15	1	263
20075	12889s (+0.6s)	2064	2064	128	64	133	10	0	207
20076	12890s (+0.9s)	3680	3680	256	80	227	11	0	318
20077	12890s (+0.5s)	1676	1676	128	41	123	6	0	170
20078	12891s (+0.5s)	2292	2292	256	31	150	10	0	191
20079	12891s (+0.5s)	1480	1480	128	27	127	3	0	157
20080	12892s (+0.8s)	3284	3284	256	50	218	0	11	279
20081	12893s (+0.9s)	4576	4576	512	66	230	0	14	310
20082	12894s (+0.6s)	2536	2536	256	54	157	0	10	221
20083	12894s (+0.5s)	1532	1532	64	41	118	0	7	166
20084	12895s (+0.7s)	3196	3196	256	56	191	0	15	262
20085	12896s (+0.8s)	3272	3272	256	54	209	0	17	280
20086	12896s (+0.7s)	2416	2416	128	42	178	0	8	228
20087	12897s (+0.4s)	1440	1440	128	32	112	0	5	149
20088	12897s (+0.4s)	1556	1556	128	28	118	0	6	152
20089	12898s (+0.6s)	2420	2420	256	36	159	0	7	202
20090	12898s (+0.5s)	2064	2064	256	29	132	0	11	172
20091	12899s (+0.9s)	3984	3984	256	76	234	0	20	330
20092	12900s (+0.6s)	2372	2372	256	36	159	0	7	202
20093	12901s (+0.7s)	2988	2988	256	49	201	0	9	259
20094	12901s (+0.6s)	2364	2364	128	69	138	12	0	219
20095	12902s (+0.7s)	3200	3200	256	78	169	16	0	263
20096	12902s (+0.5s)	1768	1768	128	57	112	9	0	178
20097	12903s (+0.5s)	1668	1668	128	32	131	6	0	169
20098	12903s (+0.3s)	752	752	64	27	65	4	0	96
20099	12903s (+0.2s)	448	448	32	11	58	5	0	74
Episode	Time	Reward	Score	Highest	L	U	R	D	Steps
20100	12904s (+0.5s)	1588	1588	128	37	126	5	0	168
20101	12905s (+1.1s)	4684	4684	256	124	248	23	1	396
20102	12905s (+0.3s)	1040	1040	128	34	75	4	0	113
20103	12906s (+0.7s)	2920	2920	256	54	190	12	0	256
20104	12907s (+0.5s)	1792	1792	128	39	139	8	0	186
20105	12907s (+0.6s)	2448	2448	256	48	143	15	0	206
20106	12908s (+0.5s)	1788	1788	128	45	132	5	0	182
20107	12908s (+0.7s)	3208	3208	256	61	199	12	0	272
20108	12909s (+0.7s)	2604	2604	128	58	169	15	0	242
20109	12909s (+0.3s)	648	648	64	22	67	2	0	91
20110	12910s (+0.9s)	4032	4032	256	87	230	13	0	330
20111	12911s (+0.5s)	1876	1876	128	41	141	5	0	187
20112	12912s (+0.9s)	3548	3548	256	68	220	13	0	301
20113	12912s (+0.7s)	2788	2788	256	63	165	12	0	240
20114	12913s (+0.4s)	1356	1356	128	36	97	7	0	140
20115	12914s (+0.8s)	2936	2936	128	82	181	14	0	277
20116	12914s (+0.3s)	1080	1080	128	27	87	5	0	119
20117	12914s (+0.5s)	1744	1744	128	34	137	6	0	177
20118	12915s (+0.8s)	3372	3372	256	66	195	17	1	279
20119	12916s (+0.4s)	1548	1548	128	37	111	10	1	159
20120	12916s (+0.5s)	1560	1560	64	51	109	11	0	171
20121	12917s (+0.6s)	2388	2388	256	45	151	9	0	205
20122	12917s (+0.4s)	1416	1416	128	39	94	10	0	143
20123	12918s (+0.6s)	2480	2480	256	44	160	8	0	212
20124	12918s (+0.5s)	1820	1820	128	49	128	9	0	186
20125	12919s (+0.6s)	2588	2588	256	61	150	8	0	219
20126	12920s (+0.7s)	3192	3192	256	70	183	12	0	265
20127	12920s (+0.8s)	3428	3428	256	71	203	14	0	288
20128	12921s (+0.4s)	1048	1048	64	33	86	11	0	130
20129	12921s (+0.6s)	2228	2228	128	41	161	8	1	211
20130	12922s (+0.4s)	1536	1536	128	38	117	6	2	163
20131	12922s (+0.5s)	1624	1624	128	38	125	10	0	173
20132	12923s (+0.5s)	1568	1568	128	43	114	7	0	164
20133	12923s (+0.5s)	1696	1696	128	38	122	9	0	169
20134	12924s (+0.5s)	1800	1800	128	39	138	0	9	186
20135	12925s (+1.0s)	5108	5108	512	78	271	0	22	371
20136	12925s (+0.3s)	928	928	128	16	80	0	2	98
20137	12926s (+0.4s)	1248	1248	128	21	116	0	2	139
20138	12926s (+0.6s)	2512	2512	256	51	153	0	9	213
20139	12927s (+0.4s)	1360	1360	128	25	111	0	5	141
20140	12927s (+0.3s)	1100	1100	128	23	91	0	4	118
20141	12928s (+0.6s)	2540	2540	256	50	158	0	14	222
20142	12929s (+0.8s)	3528	3528	256	62	223	0	11	296
20143	12929s (+0.7s)	2956	2956	256	57	171	0	14	242
20144	12929s (+0.3s)	884	884	64	14	88	0	5	107
20145	12931s (+1.2s)	5968	5968	512	93	316	0	19	428
20146	12931s (+0.3s)	712	712	64	19	69	0	5	93
20147	12932s (+0.6s)	2680	2680	256	48	176	6	0	230
20148	12932s (+0.8s)	3692	3692	256	74	219	13	0	306
20149	12933s (+0.9s)	3680	3680	256	77	219	14	0	310
20150	12934s (+0.7s)	2884	2884	256	57	176	15	0	248
20151	12935s (+0.7s)	3092	3092	256	58	177	12	0	247
20152	12935s (+0.6s)	2536	2536	256	53	157	10	1	221
20153	12936s (+0.8s)	3492	3492	256	72	207	13	0	292
20154	12937s (+0.3s)	584	584	32	18	68	3	0	89
20155	12937s (+0.6s)	2376	2376	256	47	145	9	1	202
20156	12938s (+1.0s)	5208	5208	512	88	251	22	0	361
20157	12939s (+0.7s)	2704	2704	256	56	167	15	0	238
20158	12939s (+0.6s)	2744	2744	256	63	155	16	0	234
20159	12940s (+0.5s)	1620	1620	128	35	122	5	0	162
20160	12941s (+1.0s)	4152	4152	256	83	240	17	0	340
20161	12941s (+0.4s)	1640	1640	128	44	109	9	0	162
20162	12942s (+0.3s)	696	696	64	30	55	6	1	92
20163	12943s (+0.9s)	4496	4496	256	94	222	23	0	339
20164	12943s (+0.8s)	3312	3312	256	70	196	13	0	279
20165	12944s (+0.5s)	1788	1788	128	46	125	9	1	181
20166	12944s (+0.3s)	664	664	32	23	68	3	0	94
20167	12945s (+0.6s)	2408	2408	256	48	144	8	0	200
20168	12945s (+0.3s)	760	760	64	21	76	5	0	102
20169	12946s (+0.9s)	4028	4028	256	82	226	22	0	330
20170	12947s (+0.8s)	3240	3240	256	52	205	16	0	273
20171	12947s (+0.6s)	1980	1980	128	66	130	12	0	208
20172	12948s (+0.5s)	1532	1532	128	35	121	6	0	162
20173	12949s (+0.8s)	3424	3424	256	64	205	18	0	287
20174	12949s (+0.4s)	1328	1328	128	34	100	2	1	137
20175	12950s (+0.9s)	3792	3792	256	72	230	12	0	314
20176	12951s (+0.8s)	3580	3580	256	77	214	13	0	304
20177	12951s (+0.4s)	1328	1328	64	40	106	6	0	152
20178	12952s (+0.5s)	1788	1788	128	37	138	7	0	182
20179	12952s (+0.5s)	1576	1576	128	42	121	9	0	172
20180	12953s (+0.5s)	1544	1544	128	46	103	10	0	159
20181	12954s (+1.0s)	4312	4312	256	95	246	15	0	356
20182	12954s (+0.6s)	2432	2432	128	64	150	11	0	225
20183	12955s (+0.5s)	1844	1844	128	50	130	11	0	191
20184	12955s (+0.4s)	1372	1372	64	39	105	7	0	151
20185	12956s (+0.4s)	1176	1176	128	23	102	3	0	128
20186	12957s (+0.8s)	3412	3412	256	84	184	16	0	284
20187	12957s (+0.2s)	252	252	16	13	38	2	0	53
20188	12957s (+0.4s)	1240	1240	128	28	101	8	0	137
20189	12958s (+0.9s)	4064	4064	256	87	230	17	1	335
20190	12959s (+0.4s)	1304	1304	128	27	107	0	6	140
20191	12959s (+0.6s)	2336	2336	256	34	154	0	9	197
20192	12960s (+0.8s)	3212	3212	256	51	203	0	13	267
20193	12960s (+0.5s)	1640	1640	128	25	138	1	3	167
20194	12961s (+0.4s)	1188	1188	128	19	105	0	3	127
20195	12961s (+0.5s)	1584	1584	128	23	135	0	7	165
20196	12962s (+0.4s)	1080	1080	64	28	92	0	4	124
20197	12962s (+0.4s)	1116	1116	64	25	93	0	6	124
20198	12962s (+0.5s)	2064	2064	128	34	151	0	8	193
20199	12963s (+0.3s)	1124	1124	128	27	90	0	3	120
Episode	Time	Reward	Score	Highest	L	U	R	D	Steps
20200	12963s (+0.5s)	1800	1800	128	39	134	0	7	180
20201	12964s (+0.6s)	2512	2512	256	43	155	0	8	206
20202	12964s (+0.4s)	1196	1196	128	21	107	3	0	131
20203	12965s (+0.7s)	3108	3108	256	68	171	11	1	251
20204	12966s (+0.7s)	2924	2924	256	70	169	14	0	253
20205	12966s (+0.4s)	1396	1396	128	28	108	8	0	144
20206	12967s (+0.5s)	1800	1800	128	41	139	5	0	185
20207	12967s (+0.4s)	1420	1420	128	34	107	10	0	151
20208	12968s (+0.4s)	1344	1344	128	41	88	11	0	140
20209	12968s (+0.6s)	2064	2064	128	56	128	14	0	198
20210	12969s (+0.8s)	3544	3544	256	74	205	14	0	293
20211	12970s (+0.6s)	2464	2464	256	59	140	9	0	208
20212	12970s (+0.5s)	2072	2072	256	31	140	5	0	176
20213	12971s (+0.5s)	1688	1688	128	42	123	9	0	174
20214	12972s (+1.0s)	4264	4264	256	98	239	19	0	356
20215	12972s (+0.6s)	2476	2476	256	50	148	12	0	210
20216	12973s (+0.6s)	2576	2576	256	54	151	12	0	217
20217	12973s (+0.4s)	1480	1480	128	32	119	3	0	154
20218	12974s (+0.4s)	1204	1204	64	37	98	6	1	142
20219	12974s (+0.7s)	3252	3252	256	69	197	4	0	270
20220	12975s (+0.4s)	1384	1384	128	46	100	6	0	152
20221	12976s (+1.1s)	5716	5716	512	112	271	18	0	401
20222	12977s (+0.6s)	2164	2164	128	59	126	16	1	202
20223	12977s (+0.9s)	4416	4416	512	80	211	10	0	301
20224	12978s (+1.1s)	5384	5384	512	128	225	23	1	377
20225	12979s (+0.3s)	1004	1004	64	28	83	7	1	119
20226	12979s (+0.2s)	600	600	64	11	70	1	0	82
20227	12980s (+1.0s)	4284	4284	256	93	254	14	0	361
20228	12981s (+0.4s)	1224	1224	64	36	107	5	0	148
20229	12982s (+1.4s)	7440	7440	512	143	342	30	0	515
20230	12983s (+0.4s)	1448	1448	128	38	105	8	0	151
20231	12984s (+1.2s)	5808	5808	512	107	286	18	0	411
20232	12984s (+0.3s)	1008	1008	128	28	77	2	0	107
20233	12985s (+0.6s)	1928	1928	128	42	152	6	0	200
20234	12985s (+0.5s)	1908	1908	128	60	133	2	0	195
20235	12986s (+0.6s)	2772	2772	256	51	174	13	0	238
20236	12987s (+0.8s)	3484	3484	256	69	206	15	0	290
20237	12987s (+0.4s)	1236	1236	128	41	90	5	0	136
20238	12988s (+0.5s)	1852	1852	128	45	138	7	0	190
20239	12988s (+0.8s)	3244	3244	256	68	193	14	0	275
20240	12989s (+0.5s)	1764	1764	128	42	130	8	0	180
20241	12989s (+0.5s)	1564	1564	128	43	118	9	0	170
20242	12990s (+0.8s)	3496	3496	256	74	203	17	0	294
20243	12991s (+0.6s)	2496	2496	128	60	153	17	0	230
20244	12992s (+0.8s)	3260	3260	256	79	168	18	1	266
20245	12992s (+0.6s)	2512	2512	256	49	163	4	0	216
20246	12993s (+0.9s)	3752	3752	256	82	218	13	0	313
20247	12994s (+0.4s)	1420	1420	128	38	103	9	0	150
20248	12994s (+0.2s)	588	588	64	28	48	5	0	81
20249	12994s (+0.5s)	1604	1604	128	45	116	7	0	168
20250	12995s (+0.6s)	2028	2028	128	61	126	11	0	198
20251	12995s (+0.4s)	1252	1252	64	29	106	3	0	138
20252	12996s (+0.8s)	2844	2844	128	76	178	14	1	269
20253	12997s (+0.4s)	1512	1512	128	33	122	6	0	161
20254	12997s (+0.3s)	1080	1080	128	17	90	0	3	110
20255	12998s (+1.0s)	4244	4244	256	71	260	0	20	351
20256	12998s (+0.4s)	1232	1232	128	32	89	1	13	135
20257	12999s (+0.4s)	1272	1272	128	24	106	0	5	135
20258	12999s (+0.3s)	816	816	64	26	76	0	9	111
20259	12999s (+0.5s)	1608	1608	128	36	122	0	11	169
20260	13000s (+0.7s)	3232	3232	256	58	194	0	14	266
20261	13001s (+0.8s)	3276	3276	256	72	193	12	0	277
20262	13002s (+0.8s)	3656	3656	256	73	210	14	0	297
20263	13002s (+0.5s)	1764	1764	128	46	117	11	0	174
20264	13003s (+0.6s)	2140	2140	128	58	139	12	1	210
20265	13004s (+0.9s)	3588	3588	256	82	212	12	0	306
20266	13005s (+0.8s)	3472	3472	256	64	210	16	2	292
20267	13005s (+0.5s)	2268	2268	256	51	125	10	0	186
20268	13006s (+0.9s)	3688	3688	256	83	211	15	0	309
20269	13007s (+1.4s)	6828	6828	512	128	323	30	0	481
20270	13008s (+0.5s)	1568	1568	128	44	112	8	0	164
20271	13009s (+1.0s)	4316	4316	256	93	248	16	0	357
20272	13010s (+1.0s)	4344	4344	256	96	238	27	0	361
20273	13010s (+0.5s)	1584	1584	128	45	110	9	0	164
20274	13011s (+0.5s)	1756	1756	128	46	126	7	0	179
20275	13012s (+1.0s)	4048	4048	256	89	237	15	0	341
20276	13012s (+0.5s)	1936	1936	128	45	123	8	1	177
20277	13013s (+0.6s)	2416	2416	256	52	141	14	0	207
20278	13014s (+0.7s)	2692	2692	256	48	173	11	0	232
20279	13015s (+1.3s)	6636	6636	512	104	330	22	0	456
20280	13016s (+0.6s)	2380	2380	256	45	153	5	0	203
20281	13016s (+0.6s)	1904	1904	128	43	139	13	0	195
20282	13017s (+0.7s)	2784	2784	256	66	161	16	0	243
20283	13018s (+1.1s)	5236	5236	512	101	247	20	0	368
20284	13018s (+0.4s)	1200	1200	128	27	91	7	0	125
20285	13019s (+0.8s)	3476	3476	256	77	205	13	0	295
20286	13020s (+0.7s)	2668	2668	128	70	157	18	1	246
20287	13021s (+1.0s)	4420	4420	256	113	236	15	0	364
20288	13021s (+0.4s)	1336	1336	64	37	104	9	0	150
20289	13022s (+0.9s)	3856	3856	256	72	231	16	1	320
20290	13023s (+0.8s)	3124	3124	256	67	184	10	0	261
20291	13023s (+0.3s)	872	872	64	24	86	4	0	114
20292	13024s (+0.9s)	4120	4120	256	79	243	15	0	337
20293	13025s (+0.6s)	2332	2332	256	36	160	0	7	203
20294	13026s (+0.8s)	3308	3308	256	66	203	0	9	278
20295	13026s (+0.5s)	1812	1812	128	40	136	0	12	188
20296	13027s (+0.6s)	2128	2128	128	38	157	0	10	205
20297	13028s (+0.9s)	3992	3992	256	94	222	0	12	328
20298	13028s (+0.7s)	2916	2916	256	40	209	0	7	256
20299	13029s (+0.8s)	3236	3236	256	54	201	0	18	273
Episode	Time	Reward	Score	Highest	L	U	R	D	Steps
20300	13030s (+0.5s)	1784	1784	128	37	139	0	5	181
20301	13030s (+0.8s)	3296	3296	256	58	210	0	14	282
20302	13031s (+0.7s)	2672	2672	256	50	168	0	10	228
20303	13032s (+0.7s)	3176	3176	256	60	184	0	15	259
20304	13033s (+0.8s)	3416	3416	256	82	183	20	0	285
20305	13033s (+0.5s)	1744	1744	128	38	133	5	0	176
20306	13034s (+0.4s)	1352	1352	128	20	117	3	0	140
20307	13034s (+0.5s)	1764	1764	128	42	131	7	0	180
20308	13035s (+0.5s)	1492	1492	64	43	118	7	0	168
20309	13035s (+0.7s)	2972	2972	256	49	183	0	9	241
20310	13036s (+0.8s)	3200	3200	256	62	190	0	15	267
20311	13036s (+0.4s)	1164	1164	128	29	92	0	3	124
20312	13037s (+0.4s)	1164	1164	64	30	103	0	6	139
20313	13037s (+0.7s)	2908	2908	256	59	183	0	11	253
20314	13038s (+0.8s)	3468	3468	256	61	218	0	14	293
20315	13039s (+0.5s)	1612	1612	128	37	128	0	5	170
20316	13040s (+0.7s)	3228	3228	256	62	194	0	10	266
20317	13040s (+0.4s)	1548	1548	128	32	118	6	1	157
20318	13041s (+0.5s)	1628	1628	128	47	110	10	0	167
20319	13041s (+0.6s)	2680	2680	256	57	158	14	0	229
20320	13042s (+0.6s)	1980	1980	128	46	135	16	0	197
20321	13042s (+0.6s)	2088	2088	128	62	126	14	0	202
20322	13043s (+0.5s)	2040	2040	256	35	127	8	0	170
20323	13044s (+0.9s)	3616	3616	256	84	209	14	0	307
20324	13044s (+0.6s)	2500	2500	256	53	155	8	1	217
20325	13045s (+0.8s)	3348	3348	256	68	194	16	0	278
20326	13046s (+0.5s)	1772	1772	128	48	122	12	0	182
20327	13046s (+0.8s)	3404	3404	256	67	203	17	0	287
20328	13047s (+0.4s)	1220	1220	128	31	90	11	0	132
20329	13048s (+0.8s)	3408	3408	256	58	226	0	9	293
20330	13048s (+0.7s)	2800	2800	256	50	186	0	6	242
20331	13049s (+0.5s)	1756	1756	128	39	126	0	10	175
20332	13049s (+0.3s)	824	824	64	18	85	2	1	106
20333	13050s (+0.8s)	3532	3532	256	89	191	17	0	297
20334	13051s (+0.6s)	2776	2776	256	36	176	10	0	222
20335	13051s (+0.4s)	1452	1452	128	28	115	8	0	151
20336	13051s (+0.5s)	1656	1656	128	37	127	7	0	171
20337	13052s (+0.8s)	3484	3484	256	84	197	16	0	297
20338	13053s (+0.4s)	1296	1296	64	32	107	5	0	144
20339	13053s (+0.8s)	3280	3280	256	77	192	9	0	278
20340	13054s (+1.0s)	5032	5032	512	91	231	18	0	340
20341	13055s (+0.6s)	2608	2608	256	65	149	12	1	227
20342	13055s (+0.3s)	868	868	64	27	81	5	0	113
20343	13056s (+0.3s)	820	820	64	18	88	6	0	112
20344	13056s (+0.5s)	1788	1788	128	39	139	5	0	183
20345	13057s (+0.3s)	1260	1260	128	25	93	0	8	126
20346	13057s (+0.4s)	1200	1200	128	27	101	0	5	133
20347	13058s (+0.8s)	3568	3568	256	65	215	0	8	288
20348	13058s (+0.4s)	1324	1324	128	29	108	0	6	143
20349	13059s (+0.5s)	1816	1816	128	37	147	0	5	189
20350	13059s (+0.4s)	1508	1508	128	31	123	6	0	160
20351	13060s (+0.8s)	3540	3540	256	88	191	18	0	297
20352	13061s (+0.6s)	1952	1952	128	59	120	15	1	195
20353	13061s (+0.6s)	2616	2616	256	48	172	9	0	229
20354	13062s (+1.0s)	5332	5332	512	89	265	16	0	370
20355	13063s (+0.3s)	812	812	64	25	80	5	0	110
20356	13063s (+0.4s)	1460	1460	128	36	112	5	0	153
20357	13064s (+0.8s)	3332	3332	256	67	198	11	1	277
20358	13064s (+0.4s)	1504	1504	128	34	111	14	0	159
20359	13065s (+0.5s)	1520	1520	128	29	128	6	0	163
20360	13066s (+1.0s)	4272	4272	256	80	251	19	0	350
20361	13067s (+0.8s)	3428	3428	256	69	203	0	16	288
20362	13067s (+0.7s)	2764	2764	128	58	191	0	7	256
20363	13068s (+0.7s)	2800	2800	256	51	167	0	10	228
20364	13068s (+0.2s)	332	332	32	9	42	0	4	55
20365	13070s (+1.4s)	6672	6672	512	83	366	0	25	474
20366	13070s (+0.7s)	2972	2972	256	54	200	0	10	264
20367	13071s (+0.6s)	1960	1960	128	39	160	0	4	203
20368	13072s (+0.8s)	3356	3356	256	53	229	0	7	289
20369	13072s (+0.7s)	2864	2864	256	51	190	8	0	249
20370	13073s (+0.9s)	3872	3872	256	84	210	20	0	314
20371	13074s (+0.8s)	3636	3636	256	73	212	11	0	296
20372	13075s (+0.7s)	2612	2612	256	50	169	8	1	228
20373	13076s (+0.8s)	3460	3460	256	84	190	14	0	288
20374	13076s (+0.6s)	2176	2176	128	55	138	11	0	204
20375	13077s (+0.3s)	864	864	64	23	85	4	0	112
20376	13077s (+0.7s)	2736	2736	256	58	157	17	0	232
20377	13078s (+0.6s)	1912	1912	128	44	147	5	0	196
20378	13078s (+0.5s)	1680	1680	128	42	124	6	0	172
20379	13079s (+0.5s)	2088	2088	256	37	131	6	0	174
20380	13079s (+0.7s)	2924	2924	256	66	182	9	0	257
20381	13080s (+0.9s)	3544	3544	256	77	210	0	13	300
20382	13081s (+0.4s)	1360	1360	128	36	102	0	5	143
20383	13081s (+0.3s)	616	616	32	28	61	0	5	94
20384	13082s (+0.6s)	2304	2304	256	37	151	0	6	194
20385	13083s (+1.2s)	6468	6468	512	100	325	20	0	445
20386	13083s (+0.5s)	1660	1660	64	56	113	9	0	178
20387	13084s (+0.9s)	4116	4116	256	79	241	16	1	337
20388	13085s (+0.6s)	2460	2460	256	46	154	8	0	208
20389	13085s (+0.3s)	660	660	64	14	72	2	0	88
20390	13086s (+0.9s)	3944	3944	256	78	231	16	0	325
20391	13087s (+0.9s)	3916	3916	256	85	217	16	0	318
20392	13088s (+0.7s)	2888	2888	256	60	174	14	0	248
20393	13088s (+0.8s)	3212	3212	256	67	207	11	0	285
20394	13089s (+0.9s)	3560	3560	256	82	196	19	1	298
20395	13090s (+1.0s)	4316	4316	256	107	223	28	0	358
20396	13091s (+1.0s)	4188	4188	256	85	251	13	0	349
20397	13092s (+0.6s)	2504	2504	256	62	140	15	0	217
20398	13092s (+0.4s)	1584	1584	128	40	109	8	1	158
20399	13093s (+0.5s)	1604	1604	128	44	114	11	0	169
Episode	Time	Reward	Score	Highest	L	U	R	D	Steps
20400	13093s (+0.4s)	1348	1348	128	28	107	4	0	139
20401	13094s (+1.1s)	5620	5620	512	89	274	17	0	380
20402	13095s (+0.7s)	2748	2748	256	59	164	12	0	235
20403	13095s (+0.5s)	1696	1696	128	36	133	6	1	176
20404	13096s (+0.4s)	1400	1400	128	34	106	6	0	146
20405	13097s (+0.8s)	3608	3608	256	78	214	16	0	308
20406	13097s (+0.6s)	2376	2376	128	55	151	12	0	218
20407	13098s (+0.5s)	1764	1764	128	39	136	8	0	183
20408	13098s (+0.6s)	1952	1952	128	41	141	9	0	191
20409	13099s (+0.9s)	3828	3828	256	68	231	14	0	313
20410	13100s (+0.5s)	1792	1792	128	31	142	0	10	183
20411	13101s (+0.8s)	3388	3388	256	65	202	15	1	283
20412	13101s (+0.3s)	1104	1104	128	38	80	3	0	121
20413	13102s (+0.6s)	1912	1912	128	42	146	8	0	196
20414	13102s (+0.6s)	2620	2620	256	50	168	11	0	229
20415	13103s (+0.3s)	852	852	64	40	61	8	0	109
20416	13103s (+0.5s)	1900	1900	128	46	139	6	0	191
20417	13104s (+0.5s)	1900	1900	128	59	125	10	0	194
20418	13104s (+0.6s)	2756	2756	256	48	167	7	0	222
20419	13105s (+0.7s)	2968	2968	256	67	162	10	0	239
20420	13105s (+0.5s)	1844	1844	128	41	137	7	0	185
20421	13107s (+1.0s)	4376	4376	256	110	231	22	0	363
20422	13107s (+0.6s)	2136	2136	128	38	154	0	8	200
20423	13107s (+0.3s)	1104	1104	128	16	104	0	1	121
20424	13108s (+0.8s)	3276	3276	256	68	200	0	9	277
20425	13109s (+0.7s)	2776	2776	256	41	184	0	12	237
20426	13109s (+0.3s)	800	800	64	25	74	0	8	107
20427	13110s (+0.7s)	3188	3188	256	59	191	11	0	261
20428	13110s (+0.5s)	1584	1584	128	40	111	9	0	160
20429	13111s (+0.9s)	3840	3840	256	79	216	24	0	319
20430	13112s (+0.8s)	3504	3504	256	83	192	16	0	291
20431	13113s (+0.5s)	1788	1788	128	51	123	9	0	183
20432	13114s (+0.8s)	3420	3420	256	80	197	13	0	290
20433	13114s (+0.4s)	1228	1228	128	36	93	8	1	138
20434	13115s (+0.7s)	2816	2816	256	71	167	9	0	247
20435	13115s (+0.6s)	1944	1944	128	50	135	11	0	196
20436	13116s (+0.4s)	1456	1456	128	39	107	6	0	152
20437	13116s (+0.3s)	920	920	64	25	89	7	0	121
20438	13116s (+0.3s)	1032	1032	64	28	89	5	0	122
20439	13117s (+0.8s)	3220	3220	256	76	192	14	0	282
20440	13118s (+0.4s)	1416	1416	128	28	112	7	0	147
20441	13118s (+0.4s)	1544	1544	128	35	112	5	0	152
20442	13118s (+0.3s)	848	848	64	23	91	1	0	115
20443	13119s (+0.7s)	2488	2488	128	64	157	12	0	233
20444	13119s (+0.3s)	1068	1068	128	20	94	2	0	116
20445	13120s (+0.4s)	1268	1268	128	28	110	2	0	140
20446	13120s (+0.6s)	2028	2028	128	44	142	0	8	194
20447	13121s (+0.8s)	3616	3616	256	59	228	0	19	306
20448	13122s (+0.8s)	3280	3280	256	59	209	0	14	282
20449	13123s (+0.5s)	2340	2340	256	45	144	0	9	198
20450	13123s (+0.6s)	2220	2220	128	50	146	0	14	210
20451	13124s (+0.9s)	4044	4044	256	61	250	0	13	324
20452	13125s (+0.5s)	1884	1884	128	38	146	0	10	194
20453	13125s (+0.9s)	3740	3740	256	68	235	0	10	313
20454	13126s (+0.7s)	2676	2676	128	52	182	0	14	248
20455	13127s (+0.6s)	2588	2588	256	39	162	0	12	213
20456	13127s (+0.7s)	2760	2760	256	45	179	0	9	233
20457	13128s (+0.8s)	3328	3328	256	66	199	13	0	278
20458	13128s (+0.2s)	616	616	64	19	64	1	0	84
20459	13129s (+0.3s)	756	756	64	26	70	5	0	101
20460	13129s (+0.6s)	2232	2232	128	50	152	11	0	213
20461	13130s (+0.6s)	1904	1904	128	40	148	6	0	194
20462	13130s (+0.5s)	2036	2036	256	29	133	4	0	166
20463	13131s (+0.6s)	2564	2564	256	46	166	5	0	217
20464	13132s (+0.4s)	1512	1512	128	27	127	4	0	158
20465	13132s (+0.5s)	1848	1848	128	48	128	9	0	185
20466	13133s (+0.7s)	2740	2740	256	80	150	10	0	240
20467	13133s (+0.4s)	1488	1488	128	37	113	5	0	155
20468	13134s (+0.5s)	1776	1776	128	43	127	10	0	180
20469	13135s (+0.9s)	3588	3588	256	67	220	12	1	300
20470	13135s (+0.6s)	1924	1924	128	47	141	11	0	199
20471	13136s (+0.6s)	2424	2424	256	40	165	5	0	210
20472	13137s (+1.0s)	4332	4332	256	85	260	16	0	361
20473	13138s (+1.0s)	4212	4212	256	106	225	16	1	348
20474	13138s (+0.6s)	1920	1920	128	45	147	6	0	198
20475	13139s (+0.9s)	3964	3964	256	97	215	18	0	330
20476	13140s (+1.2s)	6076	6076	512	104	299	23	0	426
20477	13141s (+0.5s)	1800	1800	128	55	119	10	0	184
20478	13142s (+0.7s)	2924	2924	256	60	189	8	0	257
20479	13143s (+1.0s)	4432	4432	256	92	257	12	0	361
20480	13144s (+0.8s)	3364	3364	256	70	196	12	0	278
20481	13144s (+0.5s)	1664	1664	128	49	123	6	0	178
20482	13145s (+0.6s)	2512	2512	256	55	145	10	0	210
20483	13145s (+0.5s)	1756	1756	128	42	135	8	0	185
20484	13146s (+0.8s)	3452	3452	256	76	191	16	0	283
20485	13146s (+0.4s)	1268	1268	64	49	86	7	0	142
20486	13147s (+0.7s)	2800	2800	256	61	168	13	0	242
20487	13147s (+0.3s)	880	880	64	37	73	5	0	115
20488	13148s (+0.9s)	4216	4216	256	93	234	17	0	344
20489	13149s (+0.3s)	840	840	64	17	91	3	0	111
20490	13149s (+0.4s)	1288	1288	128	34	98	7	0	139
20491	13150s (+0.5s)	1880	1880	128	39	143	6	0	188
20492	13150s (+0.4s)	1496	1496	128	32	118	7	0	157
20493	13151s (+0.5s)	1652	1652	128	48	117	10	0	175
20494	13151s (+0.8s)	3192	3192	256	73	178	15	0	266
20495	13152s (+0.4s)	1068	1068	64	36	89	6	0	131
20496	13153s (+0.8s)	3564	3564	256	68	217	13	0	298
20497	13153s (+0.3s)	760	760	64	15	85	0	3	103
20498	13153s (+0.4s)	1484	1484	128	28	109	0	8	145
20499	13154s (+0.6s)	2500	2500	256	37	169	0	9	215
Episode	Time	Reward	Score	Highest	L	U	R	D	Steps
20500	13155s (+0.9s)	3964	3964	256	56	252	0	17	325
20501	13156s (+0.6s)	2672	2672	256	60	161	0	8	229
20502	13156s (+0.8s)	3140	3140	256	51	201	0	13	265
20503	13157s (+0.4s)	1064	1064	64	43	79	8	0	130
20504	13157s (+0.5s)	1748	1748	128	45	123	9	0	177
20505	13158s (+0.6s)	2144	2144	128	53	150	12	0	215
20506	13158s (+0.4s)	1312	1312	128	25	105	4	0	134
20507	13158s (+0.2s)	416	416	32	12	52	3	0	67
20508	13159s (+1.0s)	4080	4080	256	97	226	19	0	342
20509	13160s (+0.8s)	3324	3324	256	55	216	0	7	278
20510	13160s (+0.3s)	1088	1088	128	22	84	0	8	114
20511	13161s (+0.2s)	556	556	64	14	60	0	4	78
20512	13161s (+0.8s)	2996	2996	256	68	188	14	0	270
20513	13162s (+0.6s)	1864	1864	128	61	124	11	0	196
20514	13163s (+0.5s)	1808	1808	128	52	125	10	0	187
20515	13164s (+1.0s)	4216	4216	256	105	221	22	0	348
20516	13164s (+0.8s)	3492	3492	256	75	197	19	0	291
20517	13165s (+0.6s)	2700	2700	256	46	180	8	0	234
20518	13166s (+0.9s)	3616	3616	256	77	220	9	0	306
20519	13167s (+0.8s)	3272	3272	256	68	193	9	0	270
20520	13167s (+0.5s)	1604	1604	128	46	117	5	0	168
20521	13168s (+0.4s)	1268	1268	128	21	118	5	0	144
20522	13168s (+0.4s)	1372	1372	128	37	103	5	0	145
20523	13169s (+0.8s)	3200	3200	256	72	188	14	0	274
20524	13170s (+0.8s)	3380	3380	256	75	192	15	0	282
20525	13170s (+0.2s)	376	376	32	17	43	2	0	62
20526	13171s (+0.9s)	3548	3548	256	76	206	18	1	301
20527	13171s (+0.5s)	1608	1608	128	41	119	9	0	169
20528	13172s (+0.5s)	2076	2076	128	57	133	10	1	201
20529	13172s (+0.6s)	2528	2528	256	51	161	7	0	219
20530	13173s (+0.8s)	3480	3480	256	80	190	15	1	286
20531	13174s (+0.8s)	3512	3512	256	56	226	10	0	292
20532	13175s (+0.9s)	3620	3620	256	75	221	11	0	307
20533	13175s (+0.5s)	1804	1804	128	40	139	7	0	186
20534	13176s (+0.5s)	1512	1512	128	30	126	6	0	162
20535	13176s (+0.3s)	752	752	64	29	65	6	0	100
20536	13177s (+0.7s)	2464	2464	128	49	166	0	16	231
20537	13177s (+0.6s)	2496	2496	256	40	166	0	10	216
20538	13178s (+0.3s)	700	700	64	14	77	0	2	93
20539	13178s (+0.5s)	1712	1712	128	30	136	0	7	173
20540	13178s (+0.2s)	376	376	32	11	51	0	2	64
20541	13179s (+0.5s)	1892	1892	128	47	136	0	8	191
20542	13180s (+0.7s)	2808	2808	256	51	184	0	10	245
20543	13180s (+0.6s)	2388	2388	256	48	147	5	0	200
20544	13181s (+0.6s)	1904	1904	128	47	134	14	0	195
20545	13181s (+0.3s)	940	940	64	31	88	2	0	121
20546	13182s (+0.7s)	2576	2576	128	74	156	13	0	243
20547	13182s (+0.5s)	1696	1696	128	41	122	6	0	169
20548	13183s (+0.4s)	1344	1344	128	41	101	5	0	147
20549	13184s (+0.9s)	3872	3872	256	82	214	16	0	312
20550	13184s (+0.3s)	832	832	64	23	82	3	1	109
20551	13185s (+0.9s)	3884	3884	256	91	219	15	1	326
20552	13186s (+0.7s)	2948	2948	256	60	167	12	0	239
20553	13186s (+0.3s)	992	992	128	18	83	0	5	106
20554	13186s (+0.5s)	1796	1796	128	40	135	9	0	184
20555	13187s (+0.3s)	1168	1168	128	34	83	2	0	119
20556	13187s (+0.4s)	1456	1456	128	31	112	0	7	150
20557	13188s (+0.6s)	1984	1984	128	55	141	13	0	209
20558	13189s (+1.1s)	4532	4532	256	101	251	22	1	375
20559	13189s (+0.5s)	1544	1544	128	29	119	8	0	156
20560	13190s (+0.6s)	2072	2072	128	27	157	0	10	194
20561	13190s (+0.3s)	700	700	64	20	70	0	3	93
20562	13191s (+0.5s)	1848	1848	128	40	138	7	0	185
20563	13191s (+0.7s)	2920	2920	256	49	181	11	1	242
20564	13192s (+0.5s)	2336	2336	256	47	144	6	0	197
20565	13193s (+0.9s)	3788	3788	256	85	213	15	0	313
20566	13193s (+0.4s)	1324	1324	128	41	89	7	0	137
20567	13194s (+0.7s)	2812	2812	256	67	164	14	1	246
20568	13194s (+0.5s)	1704	1704	128	40	125	5	0	170
20569	13195s (+0.5s)	1524	1524	128	38	113	9	1	161
20570	13195s (+0.4s)	1348	1348	128	39	99	10	0	148
20571	13196s (+0.5s)	1840	1840	128	60	119	9	0	188
20572	13197s (+0.9s)	3936	3936	256	76	231	17	0	324
20573	13197s (+0.6s)	2560	2560	256	53	161	10	0	224
20574	13198s (+0.5s)	1816	1816	128	32	150	0	4	186
20575	13199s (+0.8s)	3224	3224	256	48	201	0	20	269
20576	13199s (+0.6s)	2220	2220	128	38	161	0	11	210
20577	13200s (+0.4s)	1328	1328	128	32	111	5	0	148
20578	13200s (+0.5s)	1852	1852	128	50	130	6	0	186
20579	13201s (+0.4s)	1268	1268	128	24	101	2	0	127
20580	13201s (+0.2s)	384	384	32	15	51	2	0	68
20581	13202s (+0.8s)	3560	3560	256	72	213	12	0	297
20582	13202s (+0.3s)	1180	1180	128	22	98	2	0	122
20583	13203s (+0.8s)	3560	3560	256	97	191	16	0	304
20584	13204s (+0.9s)	3972	3972	256	84	232	11	0	327
20585	13204s (+0.7s)	3168	3168	256	53	198	0	10	261
20586	13205s (+0.8s)	3148	3148	256	74	185	16	0	275
20587	13206s (+0.4s)	1248	1248	128	33	97	3	0	133
20588	13206s (+0.5s)	1516	1516	128	42	114	6	0	162
20589	13207s (+0.6s)	2640	2640	256	48	165	12	0	225
20590	13207s (+0.7s)	3140	3140	256	47	203	0	14	264
20591	13208s (+0.7s)	2888	2888	256	50	172	0	14	236
20592	13209s (+0.9s)	3872	3872	256	56	247	0	15	318
20593	13209s (+0.4s)	1056	1056	64	26	97	0	5	128
20594	13210s (+0.3s)	1120	1120	128	26	89	0	5	120
20595	13210s (+0.3s)	904	904	64	20	85	0	3	108
20596	13211s (+0.7s)	2436	2436	128	49	171	0	12	232
20597	13211s (+0.4s)	1336	1336	128	31	103	4	1	139
20598	13212s (+0.9s)	4044	4044	256	69	250	14	0	333
20599	13213s (+0.5s)	1740	1740	128	44	123	8	0	175
Episode	Time	Reward	Score	Highest	L	U	R	D	Steps
20600	13213s (+0.8s)	3148	3148	256	62	193	10	0	265
20601	13214s (+0.7s)	2752	2752	256	74	145	16	1	236
20602	13215s (+0.5s)	1896	1896	128	47	138	7	0	192
20603	13215s (+0.5s)	1692	1692	128	47	120	11	0	178
20604	13216s (+0.9s)	3892	3892	256	82	231	15	0	328
20605	13217s (+0.6s)	2496	2496	256	47	158	6	1	212
20606	13218s (+1.1s)	5600	5600	512	96	282	24	0	402
20607	13219s (+0.8s)	3672	3672	256	55	227	0	15	297
20608	13219s (+0.3s)	948	948	64	24	85	0	8	117
20609	13220s (+0.5s)	1552	1552	128	43	117	7	0	167
20610	13220s (+0.5s)	1920	1920	128	48	137	13	0	198
20611	13221s (+0.7s)	2708	2708	128	81	159	16	0	256
20612	13222s (+0.8s)	3392	3392	256	72	198	13	1	284
20613	13222s (+0.7s)	2560	2560	128	68	154	13	0	235
20614	13223s (+0.5s)	1612	1612	128	32	132	0	6	170
20615	13223s (+0.4s)	1444	1444	128	33	113	4	0	150
20616	13223s (+0.3s)	692	692	64	18	69	5	0	92
20617	13224s (+0.4s)	1460	1460	128	29	116	0	5	150
20618	13225s (+0.7s)	2536	2536	128	41	186	0	14	241
20619	13225s (+0.4s)	1272	1272	128	23	109	6	0	138
20620	13226s (+0.8s)	3588	3588	256	82	195	24	0	301
20621	13226s (+0.2s)	316	316	32	9	48	0	0	57
20622	13227s (+0.8s)	3332	3332	256	57	209	13	0	279
20623	13227s (+0.6s)	2776	2776	256	57	169	12	0	238
20624	13228s (+0.7s)	2976	2976	256	58	179	8	0	245
20625	13229s (+0.8s)	3476	3476	256	68	201	18	1	288
20626	13230s (+0.6s)	2360	2360	256	53	147	6	0	206
20627	13231s (+1.3s)	6588	6588	512	142	304	31	0	477
20628	13231s (+0.5s)	1772	1772	128	48	128	3	0	179
20629	13232s (+0.5s)	1624	1624	128	36	122	5	0	163
20630	13232s (+0.3s)	832	832	64	27	75	5	1	108
20631	13233s (+0.3s)	784	784	64	28	63	8	0	99
20632	13233s (+0.6s)	2448	2448	128	55	163	16	1	235
20633	13234s (+0.5s)	1768	1768	128	46	121	9	1	177
20634	13234s (+0.5s)	1820	1820	128	52	127	11	0	190
20635	13235s (+0.6s)	2752	2752	256	49	160	9	0	218
20636	13236s (+0.7s)	2620	2620	128	75	159	15	0	249
20637	13236s (+0.6s)	1932	1932	128	53	134	14	0	201
20638	13236s (+0.3s)	876	876	64	14	93	0	4	111
20639	13237s (+0.4s)	1212	1212	64	26	102	0	12	140
20640	13237s (+0.5s)	1652	1652	128	29	142	0	4	175
20641	13238s (+0.5s)	1792	1792	128	38	140	0	6	184
20642	13238s (+0.2s)	544	544	32	15	62	0	4	81
20643	13239s (+0.8s)	3480	3480	256	66	210	0	16	292
20644	13240s (+1.0s)	4024	4024	256	55	269	0	11	335
20645	13241s (+0.6s)	2340	2340	256	36	153	0	5	194
20646	13241s (+0.5s)	1788	1788	128	43	127	0	12	182
20647	13242s (+0.7s)	3184	3184	256	47	212	0	5	264
20648	13243s (+0.8s)	3700	3700	256	73	218	0	17	308
20649	13243s (+0.5s)	1744	1744	128	40	133	3	0	176
20650	13244s (+0.8s)	2900	2900	128	85	171	16	0	272
20651	13245s (+0.7s)	2836	2836	128	85	160	15	0	260
20652	13246s (+1.1s)	5588	5588	512	91	287	17	0	395
20653	13246s (+0.7s)	2600	2600	128	66	165	13	1	245
20654	13247s (+0.8s)	3576	3576	256	81	206	9	0	296
20655	13248s (+0.8s)	3380	3380	256	70	198	13	0	281
20656	13249s (+0.6s)	2252	2252	128	49	154	14	1	218
20657	13249s (+0.4s)	1248	1248	64	40	93	9	1	143
20658	13250s (+0.7s)	2680	2680	256	55	163	11	0	229
20659	13250s (+0.5s)	1524	1524	128	42	114	8	0	164
20660	13251s (+0.4s)	1396	1396	128	46	95	7	0	148
20661	13252s (+1.0s)	4168	4168	256	86	243	15	0	344
20662	13252s (+0.5s)	1352	1352	64	39	110	9	0	158
20663	13253s (+0.9s)	3808	3808	256	67	242	9	0	318
20664	13254s (+0.7s)	2764	2764	256	52	175	8	0	235
20665	13255s (+0.8s)	3364	3364	256	68	203	16	0	287
20666	13255s (+0.9s)	3588	3588	256	66	222	11	0	299
20667	13256s (+0.8s)	3360	3360	256	78	196	12	0	286
20668	13257s (+0.4s)	1068	1068	64	27	94	2	2	125
20669	13257s (+0.6s)	1952	1952	128	54	142	5	0	201
20670	13258s (+0.5s)	1540	1540	128	43	117	4	0	164
20671	13258s (+0.4s)	1488	1488	128	46	100	9	0	155
20672	13259s (+0.7s)	3028	3028	256	49	188	6	0	243
20673	13260s (+0.8s)	3304	3304	256	64	202	12	0	278
20674	13261s (+1.1s)	4616	4616	256	118	243	23	0	384
20675	13261s (+0.7s)	2760	2760	256	60	166	11	1	238
20676	13262s (+0.3s)	704	704	64	22	68	3	1	94
20677	13262s (+0.4s)	1312	1312	128	45	90	8	0	143
20678	13262s (+0.4s)	1544	1544	128	33	119	5	1	158
20679	13263s (+0.7s)	3152	3152	256	57	193	13	0	263
20680	13264s (+1.1s)	4660	4660	256	119	253	19	0	391
20681	13265s (+0.6s)	2168	2168	128	52	134	15	1	202
20682	13265s (+0.5s)	1548	1548	128	34	125	7	0	166
20683	13266s (+0.7s)	2676	2676	256	59	155	14	0	228
20684	13267s (+0.5s)	1812	1812	128	38	145	5	0	188
20685	13267s (+0.9s)	4036	4036	256	87	226	15	1	329
20686	13268s (+0.6s)	2500	2500	256	42	168	6	0	216
20687	13269s (+0.6s)	2116	2116	128	49	139	11	0	199
20688	13269s (+0.8s)	3192	3192	256	50	205	10	0	265
20689	13270s (+0.8s)	3560	3560	256	63	219	15	0	297
20690	13271s (+0.6s)	2624	2624	256	47	152	8	1	208
20691	13271s (+0.5s)	1572	1572	128	39	120	5	0	164
20692	13272s (+0.4s)	1476	1476	128	29	117	7	0	153
20693	13272s (+0.4s)	1252	1252	128	32	99	3	0	134
20694	13273s (+0.6s)	2428	2428	256	48	148	8	0	204
20695	13274s (+0.9s)	3540	3540	256	77	206	15	1	299
20696	13274s (+0.8s)	3260	3260	256	68	189	14	0	271
20697	13275s (+0.8s)	3508	3508	256	54	231	0	11	296
20698	13276s (+0.3s)	1108	1108	128	22	89	0	4	115
20699	13276s (+0.5s)	1560	1560	128	29	128	0	5	162
Episode	Time	Reward	Score	Highest	L	U	R	D	Steps
20700	13277s (+0.8s)	3424	3424	256	60	211	0	14	285
20701	13277s (+0.5s)	1620	1620	128	34	133	0	5	172
20702	13278s (+0.2s)	460	460	64	15	48	0	3	66
20703	13278s (+0.5s)	1692	1692	128	41	126	7	0	174
20704	13279s (+0.5s)	1784	1784	128	38	139	6	0	183
20705	13279s (+0.8s)	3512	3512	256	87	187	20	0	294
20706	13280s (+0.5s)	1916	1916	128	52	135	10	0	197
20707	13280s (+0.4s)	1076	1076	64	31	95	6	0	132
20708	13281s (+0.3s)	804	804	64	16	82	4	0	102
20709	13281s (+0.7s)	2896	2896	256	65	175	14	0	254
20710	13282s (+0.6s)	2036	2036	128	54	139	11	0	204
20711	13283s (+0.9s)	3756	3756	256	88	200	21	1	310
20712	13283s (+0.4s)	1456	1456	128	40	104	5	0	149
20713	13284s (+0.5s)	1764	1764	128	43	127	11	0	181
20714	13285s (+0.8s)	3284	3284	256	82	184	13	0	279
20715	13285s (+0.5s)	1796	1796	128	55	122	7	0	184
20716	13286s (+0.5s)	2372	2372	256	38	152	0	7	197
20717	13287s (+0.9s)	3900	3900	256	63	238	0	18	319
20718	13287s (+0.7s)	3108	3108	256	56	190	0	11	257
20719	13288s (+0.7s)	2892	2892	256	60	166	0	9	235
20720	13289s (+0.5s)	1812	1812	128	52	127	9	0	188
20721	13289s (+0.4s)	1480	1480	128	38	111	5	0	154
20722	13290s (+0.7s)	3248	3248	256	51	201	0	13	265
20723	13290s (+0.5s)	1728	1728	128	31	130	0	11	172
20724	13291s (+0.8s)	3456	3456	256	64	209	0	17	290
20725	13292s (+0.5s)	1588	1588	128	40	119	9	0	168
20726	13293s (+1.4s)	6888	6888	512	137	334	33	0	504
20727	13294s (+0.5s)	1792	1792	128	35	130	12	0	177
20728	13294s (+0.4s)	1464	1464	128	41	105	5	0	151
20729	13295s (+1.0s)	4260	4260	256	84	251	20	0	355
20730	13296s (+0.7s)	3152	3152	256	55	191	10	0	256
20731	13296s (+0.5s)	1752	1752	128	38	135	0	5	178
20732	13297s (+0.5s)	2260	2260	256	45	137	0	8	190
20733	13298s (+0.8s)	3336	3336	256	67	201	13	0	281
20734	13299s (+0.8s)	3556	3556	256	89	193	14	0	296
20735	13299s (+0.6s)	2708	2708	256	64	152	14	0	230
20736	13300s (+0.4s)	1036	1036	64	30	93	7	0	130
20737	13300s (+0.6s)	2432	2432	256	44	152	9	0	205
20738	13301s (+0.4s)	1520	1520	128	47	103	7	0	157
20739	13301s (+0.6s)	1928	1928	128	52	136	7	0	195
20740	13302s (+0.9s)	3948	3948	256	76	232	13	0	321
20741	13303s (+0.9s)	3940	3940	256	86	221	13	0	320
20742	13303s (+0.4s)	1156	1156	64	31	102	3	0	136
20743	13304s (+0.8s)	3392	3392	256	65	213	11	0	289
20744	13305s (+0.4s)	1456	1456	128	31	115	6	0	152
20745	13305s (+0.3s)	1112	1112	128	26	87	0	3	116
20746	13305s (+0.3s)	788	788	64	27	71	0	7	105
20747	13306s (+0.7s)	3220	3220	256	68	189	11	0	268
20748	13307s (+0.5s)	1768	1768	128	40	129	8	1	178
20749	13307s (+0.6s)	2668	2668	256	64	156	8	0	228
20750	13309s (+1.3s)	6580	6580	512	124	315	31	1	471
20751	13309s (+0.5s)	1588	1588	128	40	114	10	1	165
20752	13309s (+0.4s)	1204	1204	128	40	87	6	0	133
20753	13310s (+0.6s)	1916	1916	128	52	139	6	0	197
20754	13311s (+0.8s)	3512	3512	256	69	217	10	0	296
20755	13312s (+0.8s)	3520	3520	256	71	206	11	0	288
20756	13312s (+0.5s)	1796	1796	128	47	131	0	6	184
20757	13313s (+0.8s)	3216	3216	256	49	206	0	16	271
20758	13314s (+0.7s)	2928	2928	256	62	186	0	10	258
20759	13314s (+0.4s)	1676	1676	128	31	115	0	10	156
20760	13315s (+0.8s)	3544	3544	256	64	209	0	9	282
20761	13316s (+0.6s)	2468	2468	256	45	156	0	13	214
20762	13316s (+0.6s)	2628	2628	256	39	174	0	5	218
20763	13317s (+0.5s)	1676	1676	128	35	132	0	4	171
20764	13317s (+0.5s)	1620	1620	128	31	134	0	7	172
20765	13318s (+0.7s)	3068	3068	256	61	181	9	0	251
20766	13319s (+0.7s)	3004	3004	256	81	178	13	0	272
20767	13319s (+0.7s)	2916	2916	256	61	182	12	0	255
20768	13320s (+0.8s)	3304	3304	256	73	191	13	0	277
20769	13321s (+0.9s)	4112	4112	256	85	234	15	0	334
20770	13322s (+0.6s)	2380	2380	256	43	152	8	0	203
20771	13322s (+0.4s)	1428	1428	128	31	110	6	0	147
20772	13323s (+0.5s)	1592	1592	128	39	111	6	0	156
20773	13323s (+0.8s)	3236	3236	256	57	199	15	0	271
20774	13324s (+0.7s)	3244	3244	256	68	186	10	0	264
20775	13325s (+0.7s)	3184	3184	256	56	199	9	0	264
20776	13325s (+0.4s)	1316	1316	128	33	105	2	0	140
20777	13326s (+0.9s)	3880	3880	256	79	217	18	0	314
20778	13327s (+0.5s)	2228	2228	256	49	133	8	0	190
20779	13327s (+0.5s)	1872	1872	128	41	139	6	0	186
20780	13328s (+0.4s)	1076	1076	64	39	86	8	0	133
20781	13328s (+0.6s)	2528	2528	256	52	158	7	0	217
20782	13329s (+0.6s)	2492	2492	256	47	160	8	0	215
20783	13329s (+0.5s)	1760	1760	128	47	119	10	0	176
20784	13330s (+0.5s)	1880	1880	128	48	131	13	0	192
20785	13330s (+0.5s)	1668	1668	128	45	127	7	0	179
20786	13331s (+1.0s)	4336	4336	256	97	244	17	0	358
20787	13332s (+0.9s)	3620	3620	256	82	211	14	0	307
20788	13333s (+0.3s)	676	676	64	19	68	4	0	91
20789	13333s (+0.7s)	2820	2820	256	59	176	12	0	247
20790	13334s (+0.5s)	1628	1628	128	48	118	7	0	173
20791	13334s (+0.8s)	3160	3160	256	72	177	19	1	269
20792	13335s (+0.4s)	1488	1488	128	31	120	5	0	156
20793	13335s (+0.3s)	1116	1116	128	25	85	8	0	118
20794	13336s (+0.5s)	1920	1920	128	52	137	9	0	198
20795	13337s (+1.3s)	6188	6188	512	131	285	30	2	448
20796	13338s (+1.0s)	4264	4264	256	85	251	20	0	356
20797	13339s (+0.9s)	3752	3752	256	68	235	0	17	320
20798	13340s (+0.5s)	1820	1820	128	40	142	0	8	190
20799	13340s (+0.5s)	1788	1788	128	43	132	0	7	182
Episode	Time	Reward	Score	Highest	L	U	R	D	Steps
20800	13341s (+0.5s)	1704	1704	128	31	131	8	1	171
20801	13341s (+0.7s)	2924	2924	256	68	179	10	0	257
20802	13342s (+0.4s)	1196	1196	128	35	92	4	0	131
20803	13342s (+0.4s)	1360	1360	128	25	112	5	0	142
20804	13343s (+0.6s)	1912	1912	128	51	131	15	0	197
20805	13343s (+0.7s)	3228	3228	256	71	183	12	0	266
20806	13344s (+0.4s)	1272	1272	64	47	92	10	0	149
20807	13345s (+0.6s)	2644	2644	256	62	152	11	0	225
20808	13345s (+0.4s)	1460	1460	128	33	111	6	0	150
20809	13345s (+0.5s)	1568	1568	128	35	113	11	1	160
20810	13347s (+1.0s)	4324	4324	256	91	241	23	0	355
20811	13347s (+0.4s)	1428	1428	128	35	112	5	0	152
20812	13348s (+0.7s)	2756	2756	256	76	147	15	0	238
20813	13348s (+0.3s)	892	892	64	34	71	9	0	114
20814	13348s (+0.4s)	1176	1176	64	40	94	7	0	141
20815	13349s (+1.0s)	4104	4104	256	89	243	12	0	344
20816	13350s (+0.6s)	2600	2600	256	52	166	0	9	227
20817	13351s (+0.8s)	3204	3204	256	48	207	0	10	265
20818	13351s (+0.5s)	1600	1600	128	37	122	0	8	167
20819	13352s (+0.3s)	740	740	64	14	79	0	5	98
20820	13352s (+0.4s)	1488	1488	128	23	126	0	6	155
20821	13352s (+0.3s)	676	676	64	21	62	5	0	88
20822	13353s (+0.8s)	3520	3520	256	65	218	11	0	294
20823	13354s (+0.7s)	2608	2608	128	70	165	12	0	247
20824	13354s (+0.3s)	1036	1036	128	29	78	6	0	113
20825	13355s (+0.6s)	2540	2540	256	46	159	10	0	215
20826	13356s (+0.9s)	4028	4028	256	79	242	15	0	336
20827	13356s (+0.5s)	1768	1768	128	50	119	8	0	177
20828	13357s (+0.5s)	1612	1612	128	42	120	8	0	170
20829	13358s (+0.8s)	3568	3568	256	81	204	14	0	299
20830	13358s (+0.7s)	3080	3080	256	51	204	0	9	264
20831	13359s (+0.3s)	676	676	32	24	67	0	6	97
20832	13359s (+0.7s)	2864	2864	256	38	187	0	9	234
20833	13360s (+0.3s)	668	668	64	21	64	1	6	92
20834	13360s (+0.7s)	3036	3036	256	45	192	0	8	245
20835	13361s (+0.8s)	3500	3500	256	55	213	0	13	281
20836	13362s (+0.7s)	2816	2816	256	44	192	0	11	247
20837	13362s (+0.2s)	660	660	64	23	58	0	6	87
20838	13363s (+0.6s)	2436	2436	256	46	146	0	11	203
20839	13363s (+0.7s)	2784	2784	256	58	169	11	0	238
20840	13364s (+0.3s)	1156	1156	128	21	104	2	0	127
20841	13364s (+0.8s)	3472	3472	256	55	219	13	0	287
20842	13365s (+0.4s)	1352	1352	64	39	102	9	0	150
20843	13366s (+0.6s)	2260	2260	128	57	145	17	0	219
20844	13366s (+0.4s)	1576	1576	128	50	106	5	0	161
20845	13367s (+0.5s)	1844	1844	128	48	136	7	0	191
20846	13367s (+0.5s)	2000	2000	128	50	134	11	0	195
20847	13368s (+0.5s)	1612	1612	128	53	110	7	0	170
20848	13368s (+0.6s)	2544	2544	256	49	164	10	0	223
20849	13369s (+0.6s)	1880	1880	128	38	144	11	0	193
20850	13370s (+1.3s)	6560	6560	512	103	340	23	0	466
20851	13370s (+0.4s)	1140	1140	64	31	97	0	9	137
20852	13371s (+0.8s)	3524	3524	256	55	229	0	13	297
20853	13372s (+0.6s)	2380	2380	256	41	157	0	6	204
20854	13372s (+0.5s)	1792	1792	128	46	125	11	1	183
20855	13373s (+0.2s)	484	484	32	16	60	1	0	77
20856	13373s (+0.8s)	3416	3416	256	61	211	12	0	284
20857	13374s (+0.7s)	2892	2892	256	54	186	0	11	251
20858	13375s (+0.5s)	1840	1840	128	39	132	0	6	177
20859	13375s (+0.4s)	1368	1368	128	32	115	0	6	153
20860	13376s (+0.4s)	1172	1172	64	35	101	0	4	140
20861	13376s (+0.7s)	2652	2652	256	40	187	0	6	233
20862	13377s (+0.7s)	3112	3112	256	61	180	0	14	255
20863	13378s (+0.7s)	2728	2728	256	51	165	13	1	230
20864	13378s (+0.7s)	2984	2984	256	57	181	10	0	248
20865	13379s (+0.2s)	612	612	64	15	66	5	0	86
20866	13379s (+0.5s)	2296	2296	256	38	140	10	0	188
20867	13380s (+0.7s)	2980	2980	256	63	173	9	0	245
20868	13380s (+0.4s)	1352	1352	128	38	99	6	0	143
20869	13381s (+0.4s)	1312	1312	128	29	108	6	0	143
20870	13381s (+0.5s)	1628	1628	128	39	116	8	0	163
20871	13382s (+0.4s)	1464	1464	128	31	120	3	0	154
20872	13382s (+0.6s)	2508	2508	256	43	168	7	0	218
20873	13383s (+0.9s)	3776	3776	256	62	238	0	10	310
20874	13384s (+0.6s)	2564	2564	256	40	176	0	8	224
20875	13384s (+0.3s)	752	752	64	18	79	0	4	101
20876	13385s (+0.6s)	1932	1932	128	28	166	0	7	201
20877	13385s (+0.2s)	548	548	64	12	62	0	2	76
20878	13385s (+0.3s)	1140	1140	128	25	92	5	1	123
20879	13386s (+0.6s)	2256	2256	128	60	145	9	0	214
20880	13386s (+0.5s)	1768	1768	128	39	129	10	0	178
20881	13387s (+0.8s)	3460	3460	256	69	203	12	0	284
20882	13387s (+0.4s)	1088	1088	64	40	87	4	0	131
20883	13388s (+1.0s)	4260	4260	256	98	229	19	1	347
20884	13389s (+0.9s)	3864	3864	256	87	213	17	0	317
20885	13390s (+0.7s)	2796	2796	256	66	169	7	0	242
20886	13391s (+0.7s)	3220	3220	256	59	200	13	0	272
20887	13391s (+0.5s)	1796	1796	128	60	107	12	0	179
20888	13392s (+0.4s)	1372	1372	128	20	121	3	0	144
20889	13392s (+0.7s)	2928	2928	256	63	186	9	0	258
20890	13393s (+0.8s)	3252	3252	256	69	193	14	0	276
20891	13394s (+0.7s)	2956	2956	256	53	178	13	0	244
20892	13394s (+0.5s)	1624	1624	128	44	121	8	0	173
20893	13395s (+0.4s)	1316	1316	128	32	109	3	1	145
20894	13396s (+0.8s)	2988	2988	256	71	173	17	1	262
20895	13396s (+0.7s)	2936	2936	256	65	182	13	0	260
20896	13397s (+0.6s)	2724	2724	256	43	176	10	0	229
20897	13397s (+0.5s)	1704	1704	128	39	130	8	0	177
20898	13398s (+0.6s)	2504	2504	256	53	156	8	0	217
20899	13399s (+0.7s)	3196	3196	256	76	172	15	0	263
Episode	Time	Reward	Score	Highest	L	U	R	D	Steps
20900	13399s (+0.5s)	1720	1720	128	43	121	6	0	170
20901	13400s (+0.7s)	2448	2448	128	79	148	15	0	242
20902	13401s (+0.5s)	1624	1624	128	35	133	5	0	173
20903	13401s (+0.5s)	1784	1784	128	45	124	12	0	181
20904	13402s (+0.7s)	2708	2708	256	58	168	11	0	237
20905	13403s (+0.8s)	3496	3496	256	80	199	14	0	293
20906	13403s (+0.8s)	3296	3296	256	68	193	14	0	275
20907	13404s (+0.6s)	1880	1880	128	52	144	4	0	200
20908	13405s (+0.6s)	2448	2448	256	43	154	8	0	205
20909	13405s (+0.4s)	1628	1628	128	29	127	4	0	160
20910	13405s (+0.4s)	1540	1540	128	41	108	8	0	157
20911	13406s (+0.5s)	1904	1904	128	48	140	6	0	194
20912	13406s (+0.4s)	1424	1424	128	28	111	7	0	146
20913	13407s (+0.9s)	3896	3896	256	84	217	17	0	318
20914	13408s (+1.0s)	4340	4340	256	104	233	22	0	359
20915	13409s (+0.9s)	3700	3700	256	79	212	12	0	303
20916	13410s (+0.6s)	2468	2468	256	39	165	7	0	211
20917	13411s (+0.7s)	2748	2748	128	77	174	10	0	261
20918	13411s (+0.9s)	3720	3720	256	86	203	12	0	301
20919	13412s (+0.5s)	1500	1500	128	41	108	8	1	158
20920	13413s (+0.9s)	3840	3840	256	93	208	20	0	321
20921	13413s (+0.5s)	1768	1768	128	47	123	8	0	178
20922	13414s (+0.4s)	1328	1328	128	22	111	3	1	137
20923	13414s (+0.7s)	3112	3112	256	77	171	9	0	257
20924	13415s (+0.5s)	1792	1792	128	42	133	9	0	184
20925	13416s (+1.3s)	6300	6300	512	113	315	23	0	451
20926	13417s (+0.9s)	3636	3636	256	90	207	15	0	312
20927	13418s (+1.2s)	6448	6448	512	128	292	22	0	442
20928	13419s (+1.0s)	4348	4348	256	89	250	22	0	361
20929	13420s (+0.5s)	1656	1656	128	40	120	6	0	166
20930	13421s (+0.6s)	2376	2376	256	42	157	5	0	204
20931	13421s (+0.2s)	664	664	64	20	64	4	0	88
20932	13422s (+0.8s)	3380	3380	256	63	200	15	0	278
20933	13422s (+0.5s)	1732	1732	128	39	125	9	0	173
20934	13423s (+0.6s)	2360	2360	256	42	149	9	0	200
20935	13424s (+0.9s)	4184	4184	256	93	239	16	0	348
20936	13424s (+0.7s)	2860	2860	256	61	184	7	1	253
20937	13425s (+1.1s)	4616	4616	256	105	251	24	0	380
20938	13426s (+0.7s)	2516	2516	128	58	160	16	1	235
20939	13427s (+0.9s)	3644	3644	256	67	218	9	0	294
20940	13428s (+0.9s)	4012	4012	256	91	224	22	0	337
20941	13429s (+1.1s)	5708	5708	512	109	267	27	0	403
20942	13430s (+0.7s)	2672	2672	256	63	157	12	0	232
20943	13431s (+1.5s)	7496	7496	512	137	361	30	0	528
20944	13432s (+0.6s)	2484	2484	256	41	163	0	9	213
20945	13432s (+0.3s)	704	704	64	15	75	0	4	94
20946	13432s (+0.4s)	1200	1200	128	25	105	3	0	133
20947	13433s (+0.9s)	3760	3760	256	81	212	18	0	311
20948	13434s (+0.6s)	1956	1956	128	50	136	14	0	200
20949	13434s (+0.3s)	932	932	64	24	92	6	1	123
20950	13435s (+1.0s)	5340	5340	512	90	259	18	0	367
20951	13436s (+0.9s)	4060	4060	256	100	219	18	0	337
20952	13437s (+0.7s)	2896	2896	256	59	181	10	0	250
20953	13437s (+0.6s)	2052	2052	128	55	136	13	0	204
20954	13438s (+0.7s)	2636	2636	256	65	158	11	0	234
20955	13439s (+0.6s)	2304	2304	128	48	160	11	1	220
20956	13440s (+1.2s)	6204	6204	512	114	304	20	0	438
20957	13441s (+0.9s)	3556	3556	256	62	225	0	16	303
20958	13441s (+0.3s)	984	984	128	22	82	0	3	107
20959	13442s (+0.6s)	2220	2220	128	44	155	0	13	212
20960	13442s (+0.5s)	1784	1784	128	42	133	0	6	181
20961	13443s (+0.3s)	964	964	64	27	85	0	7	119
20962	13444s (+0.8s)	3336	3336	256	60	208	0	12	280
20963	13444s (+0.6s)	2544	2544	256	43	170	0	10	223
20964	13445s (+0.8s)	3528	3528	256	73	204	0	17	294
20965	13445s (+0.3s)	684	684	64	16	73	0	5	94
20966	13446s (+0.8s)	3024	3024	256	85	170	11	0	266
20967	13447s (+0.8s)	3204	3204	256	66	191	12	0	269
20968	13447s (+0.4s)	1488	1488	128	35	115	6	0	156
20969	13448s (+0.9s)	3596	3596	256	77	212	12	0	301
20970	13449s (+0.6s)	2632	2632	256	47	178	7	0	232
20971	13449s (+0.5s)	1520	1520	128	34	122	7	0	163
20972	13450s (+0.4s)	1516	1516	128	30	117	5	0	152
20973	13451s (+1.2s)	5792	5792	512	127	257	30	1	415
20974	13451s (+0.5s)	1628	1628	128	46	111	7	0	164
20975	13452s (+0.4s)	1160	1160	128	29	92	5	0	126
20976	13452s (+0.6s)	2476	2476	256	58	145	7	1	211
20977	13453s (+0.7s)	3164	3164	256	57	198	11	0	266
20978	13454s (+0.9s)	3736	3736	256	82	224	6	0	312
20979	13454s (+0.3s)	1024	1024	128	22	81	7	0	110
20980	13455s (+0.7s)	3032	3032	256	53	187	7	0	247
20981	13456s (+0.5s)	1684	1684	128	52	113	8	0	173
20982	13456s (+0.9s)	3836	3836	256	63	234	13	0	310
20983	13457s (+0.5s)	1620	1620	128	46	120	6	0	172
20984	13457s (+0.3s)	716	716	64	17	71	5	0	93
20985	13458s (+0.6s)	2728	2728	256	58	161	11	0	230
20986	13458s (+0.5s)	1776	1776	128	51	119	9	0	179
20987	13459s (+0.3s)	764	764	64	19	80	3	0	102
20988	13459s (+0.5s)	1632	1632	128	50	118	7	0	175
20989	13460s (+1.1s)	5780	5780	512	105	279	19	0	403
20990	13461s (+0.3s)	888	888	64	32	75	6	0	113
20991	13461s (+0.7s)	3184	3184	256	70	179	15	0	264
20992	13462s (+0.8s)	3308	3308	256	70	196	12	0	278
20993	13463s (+0.6s)	2292	2292	128	42	159	0	13	214
20994	13464s (+0.8s)	3408	3408	256	61	212	0	14	287
20995	13464s (+0.3s)	812	812	64	18	72	1	4	95
20996	13464s (+0.2s)	624	624	64	18	65	0	4	87
20997	13465s (+0.7s)	3084	3084	256	59	182	0	16	257
20998	13465s (+0.5s)	1792	1792	128	38	134	0	11	183
20999	13466s (+0.9s)	3908	3908	256	72	235	0	11	318
Episode	Time	Reward	Score	Highest	L	U	R	D	Steps
21000	13467s (+0.3s)	928	928	64	18	81	1	7	107
21001	13467s (+0.5s)	1788	1788	128	42	133	0	8	183
21002	13467s (+0.2s)	552	552	64	17	58	0	2	77
21003	13468s (+0.6s)	1940	1940	128	47	147	0	9	203
21004	13469s (+0.6s)	2548	2548	256	49	161	0	8	218
21005	13469s (+0.5s)	1836	1836	128	47	133	7	0	187
21006	13470s (+0.7s)	3124	3124	256	56	193	11	0	260
21007	13471s (+0.8s)	3312	3312	256	78	188	13	0	279
21008	13471s (+0.3s)	904	904	64	26	81	9	1	117
21009	13472s (+0.8s)	3620	3620	256	75	205	13	0	293
21010	13472s (+0.5s)	2040	2040	256	34	127	9	0	170
21011	13473s (+0.5s)	1768	1768	128	41	131	5	0	177
21012	13474s (+0.6s)	1932	1932	128	50	146	5	0	201
21013	13474s (+0.8s)	3608	3608	256	94	195	15	0	304
21014	13475s (+1.0s)	4300	4300	256	88	251	15	0	354
21015	13476s (+0.7s)	2760	2760	256	52	172	13	0	237
21016	13477s (+0.5s)	1888	1888	128	50	127	13	0	190
21017	13478s (+1.0s)	4208	4208	256	93	234	15	0	342
21018	13478s (+0.6s)	2608	2608	256	57	160	10	0	227
21019	13479s (+0.7s)	2596	2596	128	63	170	11	0	244
21020	13479s (+0.5s)	1620	1620	128	37	128	7	0	172
21021	13481s (+1.4s)	6600	6600	512	123	332	21	0	476
21022	13481s (+0.2s)	524	524	64	15	56	5	0	76
21023	13482s (+0.8s)	3372	3372	256	76	201	12	0	289
21024	13482s (+0.6s)	2580	2580	256	56	154	11	0	221
21025	13483s (+0.9s)	3848	3848	256	105	209	14	0	328
21026	13484s (+0.6s)	1952	1952	128	52	143	7	0	202
21027	13484s (+0.4s)	1580	1580	128	26	124	3	0	153
21028	13485s (+0.7s)	2836	2836	256	57	168	12	0	237
21029	13486s (+0.7s)	3124	3124	256	56	189	12	0	257
21030	13487s (+0.7s)	2552	2552	128	65	161	12	0	238
21031	13488s (+1.0s)	4316	4316	256	88	244	24	1	357
21032	13488s (+0.6s)	1924	1924	128	49	140	10	0	199
21033	13489s (+0.9s)	3852	3852	256	93	204	17	0	314
21034	13490s (+0.8s)	3556	3556	256	70	198	20	1	289
21035	13491s (+0.7s)	3160	3160	256	52	195	10	1	258
21036	13491s (+0.4s)	1396	1396	128	50	84	8	0	142
21037	13491s (+0.4s)	1376	1376	128	43	94	7	0	144
21038	13492s (+0.9s)	3704	3704	256	79	201	18	0	298
21039	13493s (+0.4s)	1172	1172	64	34	99	7	0	140
21040	13494s (+0.9s)	3984	3984	256	92	210	21	0	323
21041	13495s (+0.9s)	4012	4012	256	71	244	0	17	332
21042	13495s (+0.5s)	1808	1808	128	43	131	0	12	186
21043	13496s (+0.5s)	1840	1840	128	46	135	7	0	188
21044	13496s (+0.7s)	2772	2772	256	67	161	12	0	240
21045	13497s (+0.6s)	2300	2300	128	63	146	10	0	219
21046	13498s (+0.6s)	1928	1928	128	61	122	13	0	196
21047	13498s (+0.7s)	2564	2564	128	66	164	10	0	240
21048	13499s (+0.6s)	2296	2296	128	53	154	10	0	217
21049	13500s (+1.4s)	6620	6620	512	118	325	27	0	470
21050	13501s (+0.5s)	1464	1464	128	46	98	10	0	154
21051	13502s (+0.9s)	3612	3612	256	80	199	22	1	302
21052	13502s (+0.7s)	2936	2936	256	63	184	8	0	255
21053	13503s (+0.5s)	1780	1780	128	36	139	0	6	181
21054	13503s (+0.5s)	1676	1676	128	55	118	8	0	181
21055	13504s (+0.7s)	2712	2712	256	66	153	11	0	230
21056	13504s (+0.3s)	1028	1028	64	22	96	3	0	121
21057	13505s (+0.5s)	1920	1920	128	53	124	6	1	184
21058	13506s (+0.6s)	2516	2516	256	49	164	7	0	220
21059	13506s (+0.9s)	3972	3972	256	82	226	19	0	327
21060	13507s (+0.3s)	944	944	64	17	94	4	0	115
21061	13508s (+0.8s)	3408	3408	256	80	194	9	0	283
21062	13508s (+0.8s)	3364	3364	256	68	193	16	0	277
21063	13510s (+1.5s)	7624	7624	512	173	338	28	0	539
21064	13511s (+0.6s)	2548	2548	256	49	165	9	0	223
21065	13511s (+0.4s)	1328	1328	128	23	114	1	0	138
21066	13512s (+0.8s)	3232	3232	256	64	192	0	16	272
21067	13513s (+0.7s)	2820	2820	256	54	179	0	15	248
21068	13514s (+0.8s)	3228	3228	256	60	203	0	6	269
21069	13514s (+0.4s)	1444	1444	128	31	113	0	6	150
21070	13515s (+0.5s)	1752	1752	128	39	127	0	12	178
21071	13515s (+0.8s)	3348	3348	256	53	221	0	9	283
21072	13516s (+0.5s)	1820	1820	128	37	145	0	8	190
21073	13517s (+0.6s)	2240	2240	128	48	156	0	11	215
21074	13517s (+0.4s)	1532	1532	128	32	112	0	12	156
21075	13518s (+0.6s)	1904	1904	128	50	137	9	0	196
21076	13518s (+0.6s)	2152	2152	128	58	141	13	0	212
21077	13519s (+0.7s)	2784	2784	128	69	178	15	1	263
21078	13520s (+0.8s)	3312	3312	256	65	196	13	0	274
21079	13520s (+0.4s)	1440	1440	128	36	106	6	0	148
21080	13521s (+0.4s)	1388	1388	64	33	118	4	0	155
21081	13521s (+0.4s)	1444	1444	128	28	115	6	1	150
21082	13521s (+0.4s)	1160	1160	128	23	99	4	0	126
21083	13522s (+0.5s)	1660	1660	128	39	123	5	0	167
21084	13522s (+0.6s)	2096	2096	128	60	138	13	0	211
21085	13523s (+0.6s)	2536	2536	256	65	134	15	1	215
21086	13524s (+1.0s)	4124	4124	256	100	231	17	0	348
21087	13524s (+0.4s)	1352	1352	128	26	107	7	0	140
21088	13525s (+0.9s)	3624	3624	256	88	206	14	0	308
21089	13526s (+0.5s)	1660	1660	128	45	115	7	0	167
21090	13527s (+0.8s)	3356	3356	256	67	190	18	0	275
21091	13528s (+0.9s)	3932	3932	256	84	222	15	0	321
21092	13528s (+0.5s)	1608	1608	128	38	122	5	0	165
21093	13529s (+0.7s)	2784	2784	256	68	155	16	0	239
21094	13529s (+0.6s)	2560	2560	256	54	155	11	0	220
21095	13530s (+0.9s)	3604	3604	256	81	213	16	0	310
21096	13531s (+0.6s)	2700	2700	256	43	177	8	0	228
21097	13531s (+0.4s)	1480	1480	128	33	109	12	0	154
21098	13532s (+0.8s)	3664	3664	256	82	201	11	0	294
21099	13533s (+0.5s)	1852	1852	128	42	134	10	0	186
Episode	Time	Reward	Score	Highest	L	U	R	D	Steps
21100	13533s (+0.3s)	796	796	64	28	73	5	0	106
21101	13534s (+1.0s)	5044	5044	512	86	251	19	0	356
21102	13535s (+0.8s)	3496	3496	256	81	196	16	0	293
21103	13535s (+0.3s)	916	916	64	28	77	5	0	110
21104	13536s (+0.5s)	2104	2104	256	41	128	10	0	179
21105	13536s (+0.7s)	2888	2888	256	63	176	14	0	253
21106	13537s (+0.4s)	1364	1364	128	33	102	6	0	141
21107	13537s (+0.5s)	1640	1640	128	34	126	6	0	166
21108	13538s (+0.5s)	1672	1672	128	29	133	0	8	170
21109	13538s (+0.5s)	1552	1552	128	34	121	0	2	157
21110	13539s (+0.5s)	1764	1764	128	39	136	0	6	181
21111	13539s (+0.6s)	1944	1944	128	44	152	0	8	204
21112	13540s (+0.2s)	660	660	64	21	64	0	5	90
21113	13540s (+0.4s)	1048	1048	64	27	94	0	5	126
21114	13540s (+0.4s)	1200	1200	64	25	107	0	5	137
21115	13541s (+0.3s)	1016	1016	64	21	95	0	4	120
21116	13541s (+0.5s)	1804	1804	128	49	131	0	6	186
21117	13542s (+0.9s)	3764	3764	256	65	229	0	14	308
21118	13543s (+0.3s)	892	892	64	12	90	0	7	109
21119	13543s (+0.7s)	2840	2840	256	57	181	0	10	248
21120	13544s (+1.1s)	4644	4644	256	103	266	22	0	391
21121	13545s (+0.5s)	1692	1692	128	42	122	11	0	175
21122	13545s (+0.4s)	1164	1164	64	31	99	8	0	138
21123	13546s (+0.9s)	4116	4116	256	96	219	16	0	331
21124	13547s (+0.6s)	2244	2244	128	63	146	11	0	220
21125	13548s (+1.0s)	4332	4332	256	111	227	19	1	358
21126	13548s (+0.4s)	1456	1456	128	26	122	5	0	153
21127	13549s (+0.8s)	3256	3256	256	49	212	0	12	273
21128	13550s (+0.9s)	3796	3796	256	59	242	0	14	315
21129	13551s (+0.7s)	2932	2932	256	46	191	0	11	248
21130	13552s (+0.8s)	3348	3348	256	60	211	0	12	283
21131	13552s (+0.6s)	2420	2420	256	46	149	7	0	202
21132	13552s (+0.3s)	692	692	32	25	72	4	0	101
21133	13553s (+0.6s)	2044	2044	128	62	126	13	0	201
21134	13554s (+0.7s)	2836	2836	256	55	186	6	0	247
21135	13555s (+1.3s)	6340	6340	512	106	312	25	1	444
21136	13556s (+0.6s)	2076	2076	128	67	122	15	0	204
21137	13557s (+0.9s)	3868	3868	256	82	218	18	0	318
21138	13557s (+1.0s)	4216	4216	256	92	229	23	0	344
21139	13558s (+0.4s)	1488	1488	128	41	106	8	0	155
21140	13558s (+0.4s)	928	928	64	29	87	6	0	122
21141	13559s (+0.9s)	3880	3880	256	67	231	14	0	312
21142	13560s (+0.6s)	2028	2028	128	70	126	13	0	209
21143	13561s (+1.1s)	5348	5348	512	95	262	22	0	379
21144	13561s (+0.5s)	1904	1904	128	39	135	12	0	186
21145	13562s (+0.9s)	3904	3904	256	89	222	9	0	320
21146	13563s (+0.8s)	3356	3356	256	87	182	15	1	285
21147	13564s (+0.5s)	2144	2144	256	42	131	8	0	181
21148	13564s (+0.4s)	1220	1220	128	33	95	5	0	133
21149	13565s (+0.6s)	2236	2236	128	64	142	16	0	222
21150	13565s (+0.3s)	736	736	64	17	79	1	0	97
21151	13566s (+1.3s)	6316	6316	512	111	311	30	1	453
21152	13567s (+0.6s)	1924	1924	128	45	140	8	0	193
21153	13567s (+0.2s)	452	452	32	12	58	0	4	74
21154	13567s (+0.5s)	1600	1600	128	43	113	8	0	164
21155	13568s (+0.5s)	1572	1572	128	38	119	8	1	166
21156	13568s (+0.4s)	1388	1388	128	32	106	9	0	147
21157	13569s (+0.6s)	2476	2476	256	61	143	7	0	211
21158	13570s (+0.5s)	1896	1896	128	40	148	4	0	192
21159	13570s (+0.7s)	2736	2736	256	65	159	9	0	233
21160	13571s (+0.8s)	3488	3488	256	83	193	15	0	291
21161	13572s (+0.5s)	1812	1812	128	45	129	14	0	188
21162	13572s (+0.5s)	1744	1744	128	45	122	9	0	176
21163	13573s (+0.5s)	1712	1712	128	34	131	4	0	169
21164	13573s (+0.5s)	1756	1756	128	56	115	8	0	179
21165	13574s (+0.7s)	2748	2748	256	52	173	10	0	235
21166	13574s (+0.5s)	1804	1804	128	38	142	5	0	185
21167	13575s (+0.5s)	1668	1668	128	48	110	11	0	169
21168	13575s (+0.3s)	916	916	64	28	88	4	0	120
21169	13576s (+0.5s)	1748	1748	128	35	134	7	0	176
21170	13576s (+0.6s)	2464	2464	256	43	163	2	0	208
21171	13577s (+0.8s)	3364	3364	256	78	194	15	0	287
21172	13577s (+0.4s)	1428	1428	128	37	97	12	0	146
21173	13578s (+0.6s)	2616	2616	256	45	167	0	12	224
21174	13579s (+0.4s)	1508	1508	128	26	118	0	7	151
21175	13579s (+0.7s)	2876	2876	256	60	181	10	0	251
21176	13580s (+0.8s)	3344	3344	256	66	205	11	0	282
21177	13580s (+0.3s)	996	996	64	27	86	4	1	118
21178	13581s (+1.0s)	4212	4212	256	88	244	16	0	348
21179	13582s (+0.5s)	1680	1680	128	50	108	7	0	165
21180	13583s (+0.7s)	2760	2760	256	57	163	14	0	234
21181	13583s (+0.3s)	1064	1064	128	25	83	7	0	115
21182	13583s (+0.5s)	1648	1648	128	30	141	0	3	174
21183	13584s (+0.5s)	1760	1760	128	37	135	0	8	180
21184	13584s (+0.3s)	668	668	64	20	65	0	7	92
21185	13585s (+0.3s)	1132	1132	128	15	105	0	1	121
21186	13585s (+0.3s)	836	836	64	27	76	0	7	110
21187	13585s (+0.4s)	1268	1268	128	22	106	2	0	130
21188	13586s (+0.8s)	3536	3536	256	63	223	11	1	298
21189	13587s (+0.7s)	3120	3120	256	70	181	9	0	260
21190	13588s (+0.8s)	3416	3416	256	68	203	14	0	285
21191	13588s (+0.4s)	1256	1256	128	29	93	4	0	126
21192	13588s (+0.3s)	620	620	32	22	67	5	0	94
21193	13589s (+0.6s)	1924	1924	128	43	147	9	0	199
21194	13589s (+0.6s)	2668	2668	256	53	161	12	1	227
21195	13590s (+0.8s)	3436	3436	256	69	199	15	0	283
21196	13591s (+0.7s)	3332	3332	256	66	191	12	1	270
21197	13592s (+0.7s)	2796	2796	256	66	165	11	0	242
21198	13592s (+0.4s)	1424	1424	128	35	111	4	1	151
21199	13592s (+0.3s)	768	768	64	19	80	5	0	104
Episode	Time	Reward	Score	Highest	L	U	R	D	Steps
21200	13593s (+0.7s)	3004	3004	256	52	180	9	1	242
21201	13593s (+0.3s)	1216	1216	128	22	100	3	0	125
21202	13594s (+0.2s)	300	300	32	10	43	1	1	55
21203	13594s (+0.4s)	1300	1300	128	26	97	6	0	129
21204	13595s (+0.6s)	2352	2352	256	38	154	5	0	197
21205	13596s (+1.1s)	5452	5452	512	103	254	21	0	378
21206	13596s (+0.7s)	2636	2636	256	56	169	9	0	234
21207	13597s (+0.5s)	1696	1696	128	48	124	9	0	181
21208	13598s (+0.9s)	3968	3968	256	73	240	16	1	330
21209	13598s (+0.6s)	2768	2768	256	55	169	11	0	235
21210	13599s (+0.7s)	2796	2796	256	46	168	14	0	228
21211	13600s (+0.7s)	3020	3020	256	70	177	12	0	259
21212	13601s (+0.9s)	3936	3936	256	78	223	21	1	323
21213	13601s (+0.5s)	1772	1772	128	34	140	9	0	183
21214	13602s (+0.5s)	1824	1824	128	39	135	7	0	181
21215	13602s (+0.5s)	1624	1624	128	40	118	6	0	164
21216	13603s (+0.9s)	3992	3992	256	83	233	16	0	332
21217	13604s (+0.3s)	1092	1092	128	20	93	2	0	115
21218	13604s (+0.8s)	3464	3464	256	54	222	9	0	285
21219	13605s (+0.3s)	696	696	64	30	53	7	1	91
21220	13605s (+0.5s)	1700	1700	128	43	120	8	0	171
21221	13605s (+0.2s)	596	596	64	17	63	3	0	83
21222	13606s (+0.5s)	1720	1720	128	46	125	5	0	176
21223	13607s (+0.7s)	2968	2968	256	85	165	13	0	263
21224	13608s (+1.0s)	4292	4292	256	95	237	20	0	352
21225	13608s (+0.7s)	2956	2956	256	60	172	13	0	245
21226	13609s (+0.6s)	2556	2556	256	59	149	7	0	215
21227	13610s (+0.7s)	3120	3120	256	67	177	15	0	259
21228	13611s (+0.8s)	3644	3644	256	75	208	11	0	294
21229	13611s (+0.8s)	3496	3496	256	79	200	15	0	294
21230	13612s (+0.8s)	3328	3328	256	68	198	12	0	278
21231	13613s (+0.7s)	2816	2816	256	57	183	7	0	247
21232	13613s (+0.4s)	1404	1404	128	31	112	4	0	147
21233	13614s (+0.5s)	2260	2260	256	42	137	7	0	186
21234	13614s (+0.3s)	596	596	32	22	64	3	0	89
21235	13615s (+1.1s)	5540	5540	512	86	284	18	0	388
21236	13616s (+0.4s)	1208	1208	128	33	90	10	1	134
21237	13616s (+0.4s)	1312	1312	128	34	103	6	0	143
21238	13617s (+0.5s)	1724	1724	128	43	122	7	0	172
21239	13617s (+0.5s)	1576	1576	128	31	124	7	0	162
21240	13617s (+0.3s)	1156	1156	128	31	83	2	0	116
21241	13618s (+0.5s)	1900	1900	128	49	137	7	0	193
21242	13619s (+1.1s)	5372	5372	512	102	259	14	0	375
21243	13619s (+0.5s)	1496	1496	128	35	114	8	0	157
21244	13620s (+0.7s)	2884	2884	256	63	173	16	0	252
21245	13621s (+0.3s)	896	896	64	27	84	4	0	115
21246	13621s (+0.3s)	988	988	64	27	85	4	1	117
21247	13622s (+0.8s)	3372	3372	256	69	194	15	0	278
21248	13622s (+0.5s)	1688	1688	128	45	121	8	0	174
21249	13623s (+0.7s)	2944	2944	256	74	163	12	3	252
21250	13624s (+0.9s)	4044	4044	256	85	227	20	1	333
21251	13624s (+0.4s)	1356	1356	128	21	118	2	0	141
21252	13625s (+0.5s)	2220	2220	256	35	139	7	0	181
21253	13625s (+0.5s)	1684	1684	128	39	124	10	0	173
21254	13626s (+1.1s)	5308	5308	512	85	267	17	0	369
21255	13627s (+0.5s)	1856	1856	128	42	138	8	0	188
21256	13628s (+1.0s)	4208	4208	256	87	241	14	0	342
21257	13629s (+0.8s)	2988	2988	256	75	180	13	0	268
21258	13629s (+0.5s)	2112	2112	256	38	136	7	0	181
21259	13630s (+0.6s)	2724	2724	256	59	158	12	0	229
21260	13630s (+0.4s)	1380	1380	128	37	111	7	0	155
21261	13631s (+0.5s)	1880	1880	128	49	133	10	0	192
21262	13631s (+0.5s)	1812	1812	128	45	135	8	0	188
21263	13632s (+0.7s)	2848	2848	256	68	169	10	0	247
21264	13632s (+0.3s)	724	724	64	22	72	0	4	98
21265	13633s (+0.4s)	1356	1356	128	29	106	0	5	140
21266	13634s (+0.8s)	3224	3224	256	54	205	0	15	274
21267	13634s (+0.8s)	3276	3276	256	61	203	0	13	277
21268	13635s (+0.5s)	1668	1668	128	29	135	0	5	169
21269	13636s (+1.0s)	4016	4016	256	68	252	13	0	333
21270	13637s (+0.7s)	3084	3084	256	75	165	10	0	250
21271	13637s (+0.7s)	3220	3220	256	78	183	11	0	272
21272	13638s (+0.7s)	3092	3092	256	55	194	9	0	258
21273	13639s (+0.6s)	2572	2572	256	52	161	10	0	223
21274	13639s (+0.6s)	2068	2068	128	58	138	9	0	205
21275	13640s (+0.7s)	2876	2876	256	49	176	11	0	236
21276	13641s (+0.6s)	2428	2428	128	65	153	12	0	230
21277	13641s (+0.4s)	1436	1436	128	42	92	13	0	147
21278	13641s (+0.3s)	1128	1128	128	21	96	4	0	121
21279	13642s (+0.9s)	3916	3916	256	69	237	12	0	318
21280	13643s (+0.7s)	2516	2516	128	76	148	16	0	240
21281	13644s (+1.4s)	7272	7272	512	142	330	29	0	501
21282	13645s (+0.5s)	1724	1724	128	43	127	2	0	172
21283	13645s (+0.6s)	2324	2324	256	40	149	5	0	194
21284	13646s (+0.7s)	2764	2764	128	90	144	19	0	253
21285	13647s (+0.6s)	1884	1884	128	71	105	18	0	194
21286	13647s (+0.4s)	1232	1232	128	30	91	6	0	127
21287	13648s (+0.4s)	1152	1152	64	28	100	5	0	133
21288	13648s (+0.6s)	2548	2548	256	54	153	10	0	217
21289	13649s (+0.8s)	3396	3396	256	62	211	11	0	284
21290	13649s (+0.4s)	1448	1448	128	32	111	4	0	147
21291	13650s (+0.5s)	1696	1696	128	36	132	7	0	175
21292	13651s (+0.8s)	3232	3232	256	76	185	17	0	278
21293	13651s (+0.6s)	2408	2408	128	57	158	10	0	225
21294	13652s (+0.5s)	2260	2260	256	36	148	0	10	194
21295	13652s (+0.3s)	740	740	64	18	74	0	6	98
21296	13653s (+0.7s)	2652	2652	256	44	176	0	8	228
21297	13654s (+0.7s)	2956	2956	256	62	176	0	17	255
21298	13654s (+0.4s)	1320	1320	128	19	111	0	7	137
21299	13654s (+0.4s)	1468	1468	128	27	116	8	0	151
Episode	Time	Reward	Score	Highest	L	U	R	D	Steps
21300	13655s (+0.7s)	2820	2820	256	53	168	1	12	234
21301	13656s (+0.6s)	2608	2608	256	47	172	0	7	226
21302	13656s (+0.5s)	1800	1800	128	34	143	0	8	185
21303	13657s (+0.6s)	1964	1964	128	43	154	0	7	204
21304	13657s (+0.4s)	1160	1160	64	31	102	4	0	137
21305	13658s (+0.4s)	1296	1296	128	37	95	7	0	139
21306	13658s (+0.8s)	3448	3448	256	73	193	16	0	282
21307	13659s (+0.8s)	3224	3224	256	50	206	0	13	269
21308	13660s (+0.3s)	1028	1028	128	23	83	0	5	111
21309	13660s (+0.8s)	3188	3188	256	58	199	7	1	265
21310	13661s (+0.4s)	1432	1432	128	28	118	7	0	153
21311	13661s (+0.4s)	1168	1168	64	34	99	6	0	139
21312	13662s (+0.7s)	2516	2516	128	63	157	14	1	235
21313	13662s (+0.5s)	1856	1856	128	49	128	7	0	184
21314	13663s (+0.8s)	3404	3404	256	72	195	16	0	283
21315	13664s (+0.7s)	3172	3172	256	65	181	16	0	262
21316	13665s (+0.9s)	3944	3944	256	66	243	13	0	322
21317	13665s (+0.6s)	1884	1884	128	40	149	5	0	194
21318	13666s (+0.7s)	3004	3004	256	62	183	6	0	251
21319	13667s (+0.4s)	1336	1336	128	39	93	7	0	139
21320	13667s (+0.6s)	1996	1996	128	44	149	9	0	202
21321	13668s (+0.9s)	4036	4036	256	103	215	13	0	331
21322	13669s (+1.0s)	4348	4348	256	111	230	20	0	361
21323	13670s (+1.1s)	4484	4484	256	113	236	17	1	367
21324	13671s (+0.8s)	3468	3468	256	61	214	12	0	287
21325	13671s (+0.2s)	556	556	64	15	63	3	0	81
21326	13672s (+1.1s)	5380	5380	512	106	250	20	1	377
21327	13673s (+0.8s)	3476	3476	256	67	209	15	0	291
21328	13674s (+0.7s)	3160	3160	256	57	191	10	1	259
21329	13675s (+1.0s)	5060	5060	512	97	239	17	0	353
21330	13675s (+0.5s)	1656	1656	128	42	117	7	0	166
21331	13676s (+1.1s)	5756	5756	512	113	270	26	1	410
21332	13677s (+0.5s)	1636	1636	128	43	124	8	0	175
21333	13677s (+0.5s)	1536	1536	128	38	116	9	0	163
21334	13678s (+0.6s)	2100	2100	128	45	150	10	0	205
21335	13679s (+0.5s)	1792	1792	128	40	137	6	0	183
21336	13679s (+0.5s)	1796	1796	128	33	146	5	0	184
21337	13680s (+0.5s)	1636	1636	128	25	147	4	0	176
21338	13680s (+0.8s)	3644	3644	256	51	227	0	15	293
21339	13681s (+0.5s)	1616	1616	128	32	131	0	8	171
21340	13682s (+0.6s)	2640	2640	256	41	179	0	10	230
21341	13682s (+0.5s)	1892	1892	128	36	150	0	6	192
21342	13683s (+0.5s)	1768	1768	128	36	140	0	6	182
21343	13683s (+0.7s)	3144	3144	256	58	179	0	19	256
21344	13684s (+0.7s)	2808	2808	256	50	188	0	8	246
21345	13685s (+0.4s)	1396	1396	128	38	103	4	0	145
21346	13685s (+0.8s)	3264	3264	256	59	196	13	0	268
21347	13686s (+0.3s)	880	880	64	23	89	3	0	115
21348	13686s (+0.8s)	3448	3448	256	79	188	14	0	281
21349	13687s (+0.6s)	2392	2392	256	46	147	9	0	202
21350	13688s (+0.7s)	3220	3220	256	65	193	10	0	268
21351	13688s (+0.4s)	1356	1356	128	35	101	5	0	141
21352	13689s (+0.7s)	2928	2928	256	62	185	11	0	258
21353	13689s (+0.4s)	1188	1188	128	25	100	5	0	130
21354	13690s (+0.5s)	1800	1800	128	51	123	11	0	185
21355	13691s (+0.6s)	2220	2220	128	63	134	12	1	210
21356	13691s (+0.7s)	3120	3120	256	57	192	10	0	259
21357	13692s (+1.0s)	4100	4100	256	95	236	13	0	344
21358	13693s (+0.8s)	3480	3480	256	61	220	9	0	290
21359	13694s (+0.8s)	3528	3528	256	66	210	12	0	288
21360	13694s (+0.5s)	1648	1648	128	47	120	7	0	174
21361	13695s (+0.8s)	3476	3476	256	72	196	19	1	288
21362	13696s (+0.8s)	3216	3216	256	75	184	12	0	271
21363	13696s (+0.4s)	1388	1388	128	20	114	3	0	137
21364	13697s (+0.5s)	1840	1840	128	47	129	11	0	187
21365	13698s (+0.6s)	2108	2108	128	70	130	12	1	213
21366	13699s (+1.0s)	4376	4376	256	100	242	25	0	367
21367	13699s (+0.7s)	3148	3148	256	54	190	12	0	256
21368	13701s (+1.4s)	6920	6920	512	137	351	20	0	508
21369	13701s (+0.7s)	2936	2936	256	59	190	11	0	260
21370	13702s (+0.4s)	1380	1380	64	47	97	9	0	153
21371	13702s (+0.5s)	1868	1868	128	43	136	11	0	190
21372	13703s (+0.7s)	3188	3188	256	55	201	9	0	265
21373	13704s (+0.5s)	1724	1724	128	47	103	11	0	161
21374	13704s (+0.4s)	1476	1476	128	39	106	8	0	153
21375	13705s (+0.8s)	3508	3508	256	65	214	12	0	291
21376	13706s (+1.4s)	6832	6832	512	135	331	24	0	490
21377	13707s (+0.7s)	3024	3024	256	60	181	14	0	255
21378	13708s (+0.7s)	2612	2612	128	55	174	19	0	248
21379	13708s (+0.5s)	2036	2036	256	45	114	11	0	170
21380	13709s (+0.8s)	3456	3456	256	78	195	14	1	288
21381	13710s (+0.3s)	1024	1024	128	24	84	2	0	110
21382	13710s (+0.3s)	872	872	64	29	79	6	0	114
21383	13711s (+0.9s)	4232	4232	256	96	238	14	0	348
21384	13711s (+0.4s)	1292	1292	64	33	104	7	0	144
21385	13712s (+1.0s)	4120	4120	256	95	234	18	0	347
21386	13713s (+0.9s)	3852	3852	256	82	218	14	0	314
21387	13714s (+0.9s)	3628	3628	256	75	214	17	0	306
21388	13715s (+1.0s)	4292	4292	256	82	252	18	0	352
21389	13716s (+0.6s)	2124	2124	128	50	138	9	0	197
21390	13717s (+1.1s)	5528	5528	512	106	250	19	0	375
21391	13717s (+0.6s)	2476	2476	256	45	156	10	0	211
21392	13718s (+0.6s)	2032	2032	128	48	144	11	0	203
21393	13718s (+0.4s)	1424	1424	128	40	95	10	0	145
21394	13719s (+0.7s)	3132	3132	256	58	179	14	1	252
21395	13720s (+0.9s)	4028	4028	256	75	236	19	0	330
21396	13721s (+0.7s)	2776	2776	256	59	173	8	0	240
21397	13721s (+0.8s)	3392	3392	256	85	183	13	1	282
21398	13722s (+0.3s)	732	732	64	23	69	4	0	96
21399	13722s (+0.7s)	3092	3092	256	63	174	15	0	252
Episode	Time	Reward	Score	Highest	L	U	R	D	Steps
21400	13723s (+0.7s)	2792	2792	256	60	163	0	18	241
21401	13724s (+0.6s)	1916	1916	128	38	153	0	6	197
21402	13725s (+0.8s)	3396	3396	256	73	201	16	0	290
21403	13725s (+0.7s)	2928	2928	256	63	184	11	0	258
21404	13726s (+0.6s)	2632	2632	256	58	148	12	0	218
21405	13727s (+0.8s)	3440	3440	256	74	202	14	0	290
21406	13727s (+0.6s)	1916	1916	128	53	139	5	0	197
21407	13728s (+0.4s)	1272	1272	128	27	98	5	0	130
21408	13728s (+0.8s)	3352	3352	256	69	192	16	1	278
21409	13729s (+0.4s)	1416	1416	128	33	104	7	0	144
21410	13730s (+0.7s)	2796	2796	256	63	169	10	0	242
21411	13730s (+0.5s)	1528	1528	128	34	120	7	0	161
21412	13730s (+0.5s)	1492	1492	128	33	119	5	0	157
21413	13731s (+0.3s)	784	784	64	20	80	0	5	105
21414	13731s (+0.5s)	2292	2292	256	42	141	0	11	194
21415	13732s (+0.7s)	3164	3164	256	57	188	0	12	257
21416	13733s (+0.5s)	1628	1628	128	32	124	0	8	164
21417	13733s (+0.5s)	2304	2304	256	42	140	0	8	190
21418	13734s (+0.6s)	2844	2844	256	42	175	0	10	227
21419	13734s (+0.5s)	1556	1556	128	37	115	0	6	158
21420	13734s (+0.2s)	596	596	64	14	64	0	6	84
21421	13735s (+0.6s)	2136	2136	128	56	153	11	0	220
21422	13735s (+0.4s)	1440	1440	128	32	114	2	0	148
21423	13736s (+0.7s)	3012	3012	256	51	183	8	0	242
21424	13737s (+0.9s)	3884	3884	256	106	201	19	0	326
21425	13738s (+0.7s)	2860	2860	256	70	162	13	1	246
21426	13739s (+0.9s)	4080	4080	256	80	242	20	0	342
21427	13739s (+0.7s)	2736	2736	256	52	173	8	0	233
21428	13740s (+0.9s)	3828	3828	256	66	225	16	0	307
21429	13741s (+1.0s)	4544	4544	256	92	260	18	0	370
21430	13742s (+0.2s)	524	524	64	12	59	2	0	73
21431	13742s (+0.3s)	880	880	64	20	86	4	1	111
21432	13742s (+0.4s)	1424	1424	128	32	117	3	0	152
21433	13744s (+1.2s)	6224	6224	512	108	305	20	1	434
21434	13745s (+1.0s)	4240	4240	256	98	237	15	0	350
21435	13745s (+0.8s)	3280	3280	256	75	179	14	0	268
21436	13746s (+0.4s)	1392	1392	128	21	114	6	0	141
21437	13747s (+1.1s)	4484	4484	256	87	260	16	0	363
21438	13747s (+0.6s)	2132	2132	128	44	150	9	1	204
21439	13748s (+1.0s)	3996	3996	256	88	231	14	0	333
21440	13749s (+0.6s)	2740	2740	256	55	167	11	0	233
21441	13750s (+0.7s)	3072	3072	256	64	176	12	0	252
21442	13750s (+0.4s)	1508	1508	128	22	127	4	0	153
21443	13751s (+0.8s)	3156	3156	256	73	177	15	0	265
21444	13752s (+0.6s)	1924	1924	128	49	141	9	0	199
21445	13752s (+0.6s)	2716	2716	256	61	157	9	0	227
21446	13753s (+0.5s)	1704	1704	128	40	131	6	0	177
21447	13753s (+0.5s)	1604	1604	128	48	112	8	0	168
21448	13754s (+0.4s)	1116	1116	64	29	100	3	0	132
21449	13754s (+0.7s)	2852	2852	256	56	185	8	0	249
21450	13755s (+0.4s)	1424	1424	128	37	107	3	0	147
21451	13755s (+0.5s)	1800	1800	128	41	138	6	0	185
21452	13756s (+1.0s)	4328	4328	256	90	258	12	0	360
21453	13757s (+0.6s)	2596	2596	256	61	151	9	0	221
21454	13757s (+0.4s)	1440	1440	128	34	103	9	0	146
21455	13758s (+0.6s)	2380	2380	256	54	136	12	0	202
21456	13758s (+0.5s)	1696	1696	128	49	113	8	1	171
21457	13759s (+0.3s)	876	876	64	31	79	5	0	115
21458	13759s (+0.7s)	2928	2928	256	48	183	14	0	245
21459	13760s (+0.5s)	1500	1500	128	36	115	7	1	159
21460	13761s (+0.6s)	2756	2756	256	69	156	12	0	237
21461	13761s (+0.6s)	2292	2292	128	56	151	10	0	217
21462	13762s (+0.7s)	2796	2796	256	56	176	10	0	242
21463	13762s (+0.5s)	1872	1872	128	46	133	12	0	191
21464	13763s (+1.0s)	4288	4288	256	100	239	16	0	355
21465	13764s (+0.7s)	2840	2840	256	71	161	14	0	246
21466	13765s (+0.5s)	1728	1728	128	38	134	5	0	177
21467	13765s (+0.5s)	1632	1632	128	37	118	10	0	165
21468	13766s (+0.6s)	2636	2636	256	58	156	11	1	226
21469	13767s (+0.9s)	3948	3948	256	104	197	24	1	326
21470	13767s (+0.3s)	780	780	64	16	80	5	1	102
21471	13768s (+0.6s)	2224	2224	128	41	159	0	11	211
21472	13769s (+1.0s)	4072	4072	256	60	258	0	22	340
21473	13769s (+0.7s)	2904	2904	256	57	184	11	0	252
21474	13770s (+0.5s)	1904	1904	128	49	121	9	1	180
21475	13770s (+0.5s)	1872	1872	128	49	136	7	0	192
21476	13771s (+0.6s)	2460	2460	128	57	165	8	0	230
21477	13772s (+0.6s)	1948	1948	128	41	153	0	7	201
21478	13772s (+0.3s)	1028	1028	128	23	83	4	0	110
21479	13772s (+0.4s)	1552	1552	128	40	111	9	0	160
21480	13773s (+0.5s)	1916	1916	128	46	143	8	0	197
21481	13773s (+0.4s)	1364	1364	128	27	109	5	0	141
21482	13774s (+0.9s)	4028	4028	256	80	246	11	0	337
21483	13775s (+0.5s)	2264	2264	256	45	132	8	0	185
21484	13776s (+0.9s)	3980	3980	256	92	219	18	0	329
21485	13776s (+0.4s)	1528	1528	128	48	101	11	1	161
21486	13777s (+1.0s)	4244	4244	256	95	239	18	0	352
21487	13778s (+1.0s)	4324	4324	256	97	243	19	0	359
21488	13779s (+0.6s)	2108	2108	128	47	144	6	1	198
21489	13779s (+0.6s)	1916	1916	128	49	141	7	0	197
21490	13780s (+0.6s)	2148	2148	128	43	148	0	8	199
21491	13781s (+0.6s)	2448	2448	256	45	153	0	11	209
21492	13781s (+0.5s)	1604	1604	128	39	126	4	0	169
21493	13782s (+0.8s)	3404	3404	256	73	206	13	0	292
21494	13783s (+0.9s)	3876	3876	256	64	243	13	0	320
21495	13784s (+0.7s)	2592	2592	128	71	161	15	0	247
21496	13784s (+0.5s)	1556	1556	128	48	105	8	0	161
21497	13785s (+0.7s)	3168	3168	256	65	182	13	0	260
21498	13785s (+0.7s)	2772	2772	256	71	159	11	0	241
21499	13786s (+0.5s)	1740	1740	128	35	132	8	0	175
Episode	Time	Reward	Score	Highest	L	U	R	D	Steps
21500	13786s (+0.6s)	2404	2404	256	52	141	8	0	201
21501	13787s (+0.4s)	1308	1308	128	23	110	1	0	134
21502	13787s (+0.6s)	2156	2156	128	60	129	14	1	204
21503	13788s (+0.5s)	1552	1552	128	40	117	9	0	166
21504	13789s (+0.6s)	2696	2696	256	56	151	14	2	223
21505	13789s (+0.6s)	2740	2740	256	67	158	8	0	233
21506	13790s (+0.9s)	4156	4156	256	70	246	25	0	341
21507	13791s (+0.5s)	1504	1504	128	46	106	8	0	160
21508	13791s (+0.3s)	700	700	64	21	65	6	0	92
21509	13792s (+0.6s)	2560	2560	256	46	158	0	12	216
21510	13792s (+0.3s)	888	888	64	26	82	0	9	117
21511	13792s (+0.6s)	2060	2060	128	40	144	0	8	192
21512	13793s (+0.6s)	2516	2516	256	48	158	0	10	216
21513	13794s (+0.8s)	3316	3316	256	58	212	0	10	280
21514	13794s (+0.5s)	1668	1668	128	40	121	0	5	166
21515	13795s (+0.7s)	3204	3204	256	61	192	0	11	264
21516	13796s (+0.7s)	2892	2892	256	40	198	0	11	249
21517	13796s (+0.4s)	1224	1224	64	28	101	0	9	138
21518	13797s (+0.7s)	2724	2724	256	58	165	0	13	236
21519	13797s (+0.5s)	2236	2236	256	46	138	0	11	195
21520	13798s (+0.6s)	2532	2532	256	42	163	0	10	215
21521	13798s (+0.4s)	1420	1420	128	23	120	0	6	149
21522	13799s (+0.7s)	2788	2788	256	41	189	0	10	240
21523	13799s (+0.3s)	880	880	64	26	79	0	10	115
21524	13800s (+0.5s)	1752	1752	128	38	132	8	0	178
21525	13800s (+0.3s)	1172	1172	128	34	87	5	0	126
21526	13801s (+0.7s)	2500	2500	128	60	163	14	0	237
21527	13802s (+0.5s)	1728	1728	128	39	130	8	0	177
21528	13803s (+1.4s)	6912	6912	512	131	341	18	0	490
21529	13804s (+0.9s)	3528	3528	256	88	203	10	0	301
21530	13804s (+0.4s)	1372	1372	128	32	105	7	0	144
21531	13805s (+0.5s)	1788	1788	128	42	131	9	0	182
21532	13806s (+1.0s)	4220	4220	256	88	243	15	0	346
21533	13807s (+0.8s)	3536	3536	256	74	215	13	0	302
21534	13808s (+1.0s)	4364	4364	256	90	260	10	0	360
21535	13808s (+0.3s)	636	636	64	17	66	4	1	88
21536	13808s (+0.5s)	2196	2196	256	44	137	0	10	191
21537	13809s (+0.5s)	1792	1792	128	36	143	0	4	183
21538	13810s (+0.8s)	3496	3496	256	62	219	0	12	293
21539	13810s (+0.3s)	688	688	64	17	72	0	2	91
21540	13810s (+0.4s)	1384	1384	128	31	104	1	4	140
21541	13811s (+0.4s)	1136	1136	128	20	99	0	6	125
21542	13811s (+0.7s)	2680	2680	256	53	168	8	0	229
21543	13812s (+0.6s)	2260	2260	128	73	136	11	0	220
21544	13812s (+0.3s)	968	968	64	24	89	5	0	118
21545	13813s (+0.8s)	3300	3300	256	78	184	16	0	278
21546	13814s (+0.5s)	1920	1920	128	37	134	11	1	183
21547	13815s (+1.3s)	6260	6260	512	116	307	21	0	444
21548	13816s (+0.6s)	2128	2128	128	62	121	13	1	197
21549	13816s (+0.8s)	3156	3156	256	61	193	10	0	264
21550	13817s (+0.9s)	3772	3772	256	81	213	15	0	309
21551	13818s (+0.4s)	1412	1412	128	29	110	5	0	144
21552	13818s (+0.8s)	3208	3208	256	63	192	15	0	270
21553	13819s (+0.5s)	1860	1860	128	49	122	14	0	185
21554	13820s (+0.8s)	3256	3256	256	65	200	12	0	277
21555	13820s (+0.5s)	1640	1640	128	52	108	12	0	172
21556	13821s (+0.3s)	788	788	64	22	77	5	0	104
21557	13821s (+0.8s)	3456	3456	256	84	192	19	0	295
21558	13822s (+1.0s)	4836	4836	512	85	232	13	2	332
21559	13823s (+0.5s)	1716	1716	128	35	138	7	0	180
21560	13823s (+0.4s)	1380	1380	128	36	106	4	0	146
21561	13824s (+0.5s)	1632	1632	128	46	121	8	0	175
21562	13824s (+0.5s)	1772	1772	128	42	132	9	0	183
21563	13825s (+0.6s)	2020	2020	128	40	145	16	0	201
21564	13825s (+0.4s)	1400	1400	128	29	107	8	0	144
21565	13826s (+0.7s)	2804	2804	256	52	182	0	10	244
21566	13827s (+0.5s)	1728	1728	128	26	142	0	9	177
21567	13827s (+0.9s)	3712	3712	256	66	233	0	15	314
21568	13828s (+0.3s)	1052	1052	128	24	88	0	1	113
21569	13828s (+0.7s)	2860	2860	256	43	184	0	9	236
21570	13829s (+0.5s)	1636	1636	128	23	140	0	3	166
21571	13830s (+0.6s)	2512	2512	256	46	165	0	9	220
21572	13830s (+0.5s)	1600	1600	128	34	130	0	4	168
21573	13831s (+0.5s)	1788	1788	128	40	136	0	7	183
21574	13831s (+0.4s)	1280	1280	64	35	96	0	10	141
21575	13832s (+0.6s)	2428	2428	256	51	148	6	0	205
21576	13832s (+0.4s)	1436	1436	128	28	114	4	1	147
21577	13833s (+0.6s)	2472	2472	256	74	123	15	2	214
21578	13833s (+0.8s)	3368	3368	256	71	205	12	0	288
21579	13834s (+0.7s)	2820	2820	256	53	183	9	0	245
21580	13835s (+0.4s)	1536	1536	128	38	118	6	0	162
21581	13835s (+0.8s)	3560	3560	256	85	198	14	0	297
21582	13836s (+0.8s)	3396	3396	256	64	204	16	0	284
21583	13837s (+1.0s)	4304	4304	256	99	241	14	0	354
21584	13838s (+1.0s)	4628	4628	256	92	267	24	0	383
21585	13839s (+1.1s)	5660	5660	512	100	277	21	0	398
21586	13840s (+0.6s)	2708	2708	256	50	166	12	1	229
21587	13841s (+0.8s)	3300	3300	256	69	193	14	0	276
21588	13841s (+0.5s)	2128	2128	256	33	140	5	0	178
21589	13842s (+0.6s)	2392	2392	256	52	142	11	1	206
21590	13843s (+1.0s)	4268	4268	256	68	274	14	1	357
21591	13844s (+0.6s)	1848	1848	128	51	127	13	1	192
21592	13844s (+0.5s)	1600	1600	128	48	106	12	0	166
21593	13844s (+0.4s)	1060	1060	64	32	93	4	0	129
21594	13845s (+1.0s)	4332	4332	256	81	256	20	0	357
21595	13846s (+0.9s)	4004	4004	256	70	257	8	0	335
21596	13847s (+0.6s)	2300	2300	256	38	149	6	0	193
21597	13848s (+0.8s)	3216	3216	256	64	190	16	1	271
21598	13848s (+0.4s)	1464	1464	128	28	119	4	0	151
21599	13849s (+0.8s)	3276	3276	256	63	196	13	0	272
Episode	Time	Reward	Score	Highest	L	U	R	D	Steps
21600	13849s (+0.4s)	1456	1456	128	41	99	12	0	152
21601	13850s (+0.5s)	1688	1688	128	29	140	4	0	173
21602	13850s (+0.5s)	1688	1688	128	39	129	7	0	175
21603	13851s (+0.3s)	964	964	128	18	79	4	0	101
21604	13851s (+0.9s)	3804	3804	256	84	214	15	1	314
21605	13852s (+1.0s)	4244	4244	256	86	255	9	1	351
21606	13853s (+0.5s)	1640	1640	128	43	112	0	8	163
21607	13854s (+0.7s)	2868	2868	256	63	181	0	12	256
21608	13854s (+0.5s)	1684	1684	128	39	123	0	5	167
21609	13855s (+0.8s)	3528	3528	256	78	202	16	0	296
21610	13856s (+0.8s)	3452	3452	256	65	211	12	0	288
21611	13856s (+0.6s)	2512	2512	256	47	152	9	0	208
21612	13857s (+0.5s)	1932	1932	128	50	130	7	0	187
21613	13858s (+0.8s)	3488	3488	256	92	183	20	0	295
21614	13858s (+0.2s)	648	648	64	16	64	5	1	86
21615	13859s (+0.7s)	3116	3116	256	66	175	17	0	258
21616	13859s (+0.4s)	1516	1516	128	33	111	0	6	150
21617	13860s (+0.4s)	1480	1480	128	30	116	0	1	147
21618	13861s (+1.5s)	7312	7312	512	125	362	23	0	510
21619	13862s (+0.8s)	3220	3220	256	70	188	10	0	268
21620	13863s (+0.9s)	3776	3776	256	76	223	16	0	315
21621	13863s (+0.5s)	1892	1892	128	51	132	8	0	191
21622	13864s (+0.7s)	3068	3068	256	58	187	7	0	252
21623	13865s (+0.8s)	3204	3204	256	55	201	12	1	269
21624	13865s (+0.3s)	1004	1004	64	37	77	6	0	120
21625	13866s (+0.5s)	1620	1620	128	37	128	7	0	172
21626	13866s (+0.4s)	1452	1452	128	39	102	10	1	152
21627	13867s (+0.7s)	3188	3188	256	62	191	11	0	264
21628	13867s (+0.5s)	1612	1612	128	48	112	10	0	170
21629	13868s (+0.4s)	1348	1348	128	34	104	4	0	142
21630	13869s (+1.0s)	4168	4168	256	76	252	16	0	344
21631	13869s (+0.6s)	2724	2724	256	56	163	11	0	230
21632	13870s (+0.4s)	1464	1464	128	41	107	6	0	154
21633	13871s (+0.7s)	2576	2576	128	69	157	16	1	243
21634	13871s (+0.3s)	940	940	64	32	79	5	0	116
21635	13871s (+0.4s)	1256	1256	128	40	93	7	0	140
21636	13872s (+0.8s)	3620	3620	256	76	218	13	0	307
21637	13873s (+0.8s)	3604	3604	256	80	201	18	0	299
21638	13873s (+0.5s)	1672	1672	128	44	113	9	1	167
21639	13874s (+0.7s)	2644	2644	256	57	164	11	0	232
21640	13875s (+0.4s)	1396	1396	128	29	111	4	0	144
21641	13875s (+0.4s)	1044	1044	64	25	97	2	1	125
21642	13876s (+0.7s)	2816	2816	256	44	196	0	7	247
21643	13876s (+0.3s)	976	976	64	22	87	0	6	115
21644	13877s (+0.7s)	3124	3124	256	70	182	9	0	261
21645	13877s (+0.7s)	3144	3144	256	68	174	12	0	254
21646	13878s (+0.6s)	2236	2236	128	59	140	14	1	214
21647	13879s (+0.7s)	2916	2916	256	61	181	13	0	255
21648	13879s (+0.6s)	2440	2440	256	54	143	6	0	203
21649	13880s (+0.4s)	1524	1524	128	42	107	5	0	154
21650	13880s (+0.6s)	2260	2260	128	63	137	14	0	214
21651	13881s (+0.4s)	1384	1384	128	26	118	3	0	147
21652	13881s (+0.4s)	1020	1020	64	13	109	1	0	123
21653	13882s (+0.4s)	1452	1452	128	38	105	7	1	151
21654	13882s (+0.7s)	2944	2944	256	51	183	0	10	244
21655	13883s (+0.6s)	2572	2572	256	43	164	0	6	213
21656	13884s (+1.3s)	6712	6712	512	85	356	0	28	469
21657	13885s (+0.7s)	2784	2784	256	56	176	0	8	240
21658	13885s (+0.5s)	1692	1692	128	34	129	0	4	167
21659	13886s (+0.4s)	1048	1048	64	28	90	0	7	125
21660	13887s (+0.8s)	3468	3468	256	60	216	0	11	287
21661	13887s (+0.5s)	1776	1776	128	37	136	6	0	179
21662	13888s (+0.8s)	3492	3492	256	60	204	14	0	278
21663	13889s (+1.1s)	5348	5348	512	91	268	14	0	373
21664	13889s (+0.5s)	1704	1704	128	48	122	3	0	173
21665	13890s (+0.3s)	652	652	64	17	67	3	0	87
21666	13891s (+0.9s)	3564	3564	256	71	222	12	0	305
21667	13891s (+0.7s)	2800	2800	256	64	167	12	0	243
21668	13892s (+0.4s)	1200	1200	128	30	95	5	0	130
21669	13893s (+0.8s)	3248	3248	256	64	195	14	2	275
21670	13893s (+0.6s)	1988	1988	128	57	142	8	0	207
21671	13894s (+0.4s)	1548	1548	128	27	122	6	0	155
21672	13894s (+0.9s)	3820	3820	256	67	223	17	0	307
21673	13895s (+1.0s)	4160	4160	256	79	245	18	0	342
21674	13897s (+1.2s)	5772	5772	512	107	283	23	1	414
21675	13897s (+0.4s)	1560	1560	128	33	112	8	0	153
21676	13898s (+0.5s)	1628	1628	128	43	118	11	1	173
21677	13898s (+0.9s)	3744	3744	256	79	213	16	0	308
21678	13899s (+0.6s)	1924	1924	128	46	144	9	0	199
21679	13900s (+0.9s)	3740	3740	256	70	218	14	0	302
21680	13901s (+0.8s)	3416	3416	256	82	186	16	1	285
21681	13902s (+0.9s)	3888	3888	256	87	217	19	0	323
21682	13902s (+0.5s)	1916	1916	128	42	142	10	0	194
21683	13903s (+0.8s)	3408	3408	256	65	206	16	0	287
21684	13904s (+0.7s)	2868	2868	256	52	194	0	8	254
21685	13904s (+0.6s)	1900	1900	128	43	142	0	8	193
21686	13905s (+0.4s)	1448	1448	128	33	105	0	9	147
21687	13905s (+0.2s)	660	660	64	8	75	0	4	87
21688	13906s (+0.9s)	4044	4044	256	89	227	13	0	329
21689	13907s (+0.8s)	3288	3288	256	68	200	11	1	280
21690	13907s (+0.4s)	1440	1440	128	22	121	6	0	149
21691	13908s (+0.4s)	1384	1384	128	37	102	7	0	146
21692	13909s (+1.2s)	6432	6432	512	131	292	27	0	450
21693	13910s (+0.7s)	3020	3020	256	58	183	9	0	250
21694	13911s (+0.8s)	3596	3596	256	90	200	16	0	306
21695	13911s (+0.4s)	1324	1324	64	30	118	3	0	151
21696	13912s (+0.7s)	3044	3044	256	60	174	12	1	247
21697	13912s (+0.6s)	2488	2488	256	50	152	12	0	214
21698	13913s (+0.5s)	1864	1864	128	50	129	10	0	189
21699	13913s (+0.4s)	1152	1152	64	35	96	5	0	136
Episode	Time	Reward	Score	Highest	L	U	R	D	Steps
21700	13914s (+0.8s)	3360	3360	256	51	219	7	0	277
21701	13914s (+0.4s)	1252	1252	128	29	96	6	0	131
21702	13915s (+0.5s)	1676	1676	128	41	121	9	0	171
21703	13915s (+0.5s)	1760	1760	128	47	122	11	0	180
21704	13916s (+0.6s)	1896	1896	128	48	139	10	0	197
21705	13917s (+0.6s)	2136	2136	128	62	124	14	0	200
21706	13917s (+0.5s)	1632	1632	128	45	119	10	0	174
21707	13918s (+0.5s)	2040	2040	256	32	131	5	0	168
21708	13918s (+0.6s)	2536	2536	256	53	157	11	0	221
21709	13919s (+0.9s)	4044	4044	256	95	220	14	0	329
21710	13920s (+0.8s)	3300	3300	256	82	179	19	0	280
21711	13921s (+0.5s)	2320	2320	256	48	137	8	0	193
21712	13922s (+1.1s)	5708	5708	512	110	278	17	0	405
21713	13923s (+0.9s)	3980	3980	256	84	221	18	0	323
21714	13923s (+0.6s)	2660	2660	256	54	162	9	0	225
21715	13924s (+0.4s)	1508	1508	128	35	121	5	0	161
21716	13924s (+0.5s)	1652	1652	128	40	116	0	9	165
21717	13925s (+0.5s)	2052	2052	128	48	132	9	1	190
21718	13925s (+0.4s)	1484	1484	128	31	118	6	0	155
21719	13926s (+0.7s)	2484	2484	128	57	163	13	0	233
21720	13926s (+0.6s)	2536	2536	256	59	146	10	0	215
21721	13927s (+1.2s)	5700	5700	512	94	293	21	0	408
21722	13928s (+0.7s)	3124	3124	256	61	190	10	0	261
21723	13929s (+0.9s)	3956	3956	256	77	234	12	0	323
21724	13930s (+0.5s)	1644	1644	128	46	122	4	0	172
21725	13930s (+0.6s)	1936	1936	128	51	139	9	0	199
21726	13931s (+0.3s)	1148	1148	128	25	89	6	0	120
21727	13931s (+0.3s)	936	936	64	40	72	6	0	118
21728	13932s (+1.0s)	4268	4268	256	82	255	14	0	351
21729	13933s (+0.6s)	2524	2524	256	45	168	5	0	218
21730	13933s (+0.5s)	1916	1916	128	36	140	6	1	183
21731	13934s (+0.5s)	1660	1660	128	49	110	8	0	167
21732	13934s (+0.7s)	3216	3216	256	52	205	11	0	268
21733	13935s (+0.8s)	3184	3184	256	61	190	13	0	264
21734	13936s (+0.6s)	2668	2668	256	46	174	7	0	227
21735	13936s (+0.5s)	1776	1776	128	39	130	10	0	179
21736	13937s (+0.7s)	3216	3216	256	62	192	14	0	268
21737	13938s (+0.6s)	2736	2736	256	63	153	15	1	232
21738	13938s (+0.6s)	2684	2684	256	68	142	14	0	224
21739	13939s (+0.3s)	868	868	64	18	83	3	0	104
21740	13940s (+1.0s)	5188	5188	512	86	257	17	0	360
21741	13940s (+0.3s)	868	868	64	20	91	3	0	114
21742	13941s (+1.0s)	4992	4992	512	85	245	16	1	347
21743	13941s (+0.3s)	996	996	128	28	79	4	0	111
21744	13942s (+0.5s)	1804	1804	128	45	137	4	0	186
21745	13942s (+0.4s)	1416	1416	128	33	105	0	6	144
21746	13943s (+0.5s)	1568	1568	128	36	124	0	4	164
21747	13943s (+0.6s)	2064	2064	128	36	165	0	7	208
21748	13944s (+0.4s)	1504	1504	128	39	107	0	13	159
21749	13944s (+0.7s)	3212	3212	256	52	209	0	10	271
21750	13945s (+0.7s)	2640	2640	256	57	159	10	0	226
21751	13946s (+0.9s)	3844	3844	256	79	223	11	0	313
21752	13947s (+0.6s)	2016	2016	128	51	134	14	0	199
21753	13947s (+0.4s)	1492	1492	128	35	117	5	0	157
21754	13947s (+0.4s)	1436	1436	128	34	110	5	0	149
21755	13948s (+0.4s)	1432	1432	128	40	105	1	0	146
21756	13948s (+0.4s)	1360	1360	128	30	104	6	0	140
21757	13949s (+0.5s)	1604	1604	128	34	124	9	0	167
21758	13949s (+0.4s)	1344	1344	128	34	100	6	1	141
21759	13950s (+0.8s)	3392	3392	256	58	213	13	0	284
21760	13951s (+0.9s)	3552	3552	256	70	218	14	0	302
21761	13951s (+0.5s)	1792	1792	128	41	136	10	0	187
21762	13952s (+0.4s)	1436	1436	128	39	101	7	0	147
21763	13952s (+0.6s)	2576	2576	256	48	159	10	2	219
21764	13953s (+0.3s)	704	704	32	23	69	0	8	100
21765	13953s (+0.6s)	2300	2300	128	45	151	0	14	210
21766	13954s (+0.9s)	4000	4000	256	68	251	0	14	333
21767	13955s (+0.7s)	2784	2784	256	48	181	0	10	239
21768	13956s (+0.8s)	3224	3224	256	53	206	0	10	269
21769	13956s (+0.6s)	2536	2536	256	58	154	9	0	221
21770	13957s (+0.8s)	3324	3324	256	72	184	15	1	272
21771	13957s (+0.3s)	936	936	64	24	87	5	0	116
21772	13958s (+0.7s)	3152	3152	256	60	185	12	0	257
21773	13959s (+0.5s)	1600	1600	128	35	118	4	0	157
21774	13959s (+0.6s)	2512	2512	256	48	162	9	0	219
21775	13960s (+0.5s)	1628	1628	128	41	115	6	1	163
21776	13960s (+0.7s)	2732	2732	256	40	182	9	0	231
21777	13961s (+0.4s)	1504	1504	128	32	114	9	0	155
21778	13962s (+0.6s)	2600	2600	256	54	161	10	0	225
21779	13963s (+1.0s)	5016	5016	512	80	257	16	1	354
21780	13963s (+0.5s)	1724	1724	128	40	125	13	0	178
21781	13963s (+0.3s)	900	900	64	45	64	7	0	116
21782	13964s (+0.6s)	2248	2248	128	72	137	19	0	228
21783	13965s (+0.6s)	2404	2404	256	47	150	8	0	205
21784	13966s (+0.9s)	3612	3612	256	81	207	18	0	306
21785	13966s (+0.6s)	2492	2492	256	48	156	10	1	215
21786	13967s (+0.7s)	3076	3076	256	70	169	14	1	254
21787	13968s (+0.8s)	3336	3336	256	78	188	15	0	281
21788	13969s (+1.2s)	6300	6300	512	103	308	19	0	430
21789	13970s (+0.7s)	2908	2908	256	63	162	10	0	235
21790	13970s (+0.6s)	2612	2612	256	41	180	7	0	228
21791	13971s (+0.6s)	1984	1984	128	56	131	10	0	197
21792	13971s (+0.6s)	2616	2616	256	56	157	6	0	219
21793	13972s (+0.9s)	4076	4076	256	90	230	16	0	336
21794	13973s (+0.5s)	1776	1776	128	44	128	8	0	180
21795	13974s (+0.9s)	3880	3880	256	80	231	10	0	321
21796	13974s (+0.4s)	1120	1120	128	22	96	3	0	121
21797	13975s (+0.7s)	3072	3072	256	62	178	13	0	253
21798	13975s (+0.6s)	2196	2196	128	50	146	13	0	209
21799	13976s (+0.5s)	1724	1724	128	30	141	4	0	175
Episode	Time	Reward	Score	Highest	L	U	R	D	Steps
21800	13977s (+0.9s)	3708	3708	256	55	244	0	11	310
21801	13978s (+0.7s)	2740	2740	256	50	177	6	0	233
21802	13979s (+1.0s)	4344	4344	256	87	251	26	0	364
21803	13979s (+0.5s)	1804	1804	128	49	127	9	0	185
21804	13980s (+0.6s)	2440	2440	256	54	146	0	7	207
21805	13980s (+0.5s)	1796	1796	128	31	148	0	5	184
21806	13981s (+0.6s)	1960	1960	128	40	145	0	8	193
21807	13982s (+0.8s)	3288	3288	256	58	202	0	10	270
21808	13983s (+0.9s)	3944	3944	256	83	223	19	0	325
21809	13983s (+0.7s)	2820	2820	256	58	178	12	0	248
21810	13984s (+0.7s)	2948	2948	256	64	165	9	0	238
21811	13984s (+0.4s)	1540	1540	128	44	105	6	0	155
21812	13985s (+0.5s)	1612	1612	128	32	126	12	0	170
21813	13985s (+0.5s)	1800	1800	128	35	144	6	0	185
21814	13986s (+0.7s)	3120	3120	256	59	183	16	1	259
21815	13987s (+0.8s)	3380	3380	256	61	206	9	0	276
21816	13987s (+0.3s)	888	888	64	31	80	6	0	117
21817	13988s (+0.5s)	1596	1596	128	35	128	0	4	167
21818	13988s (+0.5s)	1836	1836	128	35	149	0	6	190
21819	13989s (+0.7s)	2800	2800	256	49	178	0	16	243
21820	13989s (+0.5s)	1848	1848	128	37	150	0	5	192
21821	13991s (+1.1s)	5200	5200	512	96	263	0	19	378
21822	13991s (+0.6s)	1920	1920	128	37	154	0	7	198
21823	13991s (+0.3s)	900	900	64	30	81	5	0	116
21824	13992s (+0.8s)	3500	3500	256	74	201	13	1	289
21825	13993s (+0.5s)	1748	1748	128	48	114	11	0	173
21826	13993s (+0.5s)	1880	1880	128	37	148	0	8	193
21827	13994s (+0.5s)	1960	1960	128	43	138	9	0	190
21828	13994s (+0.4s)	1564	1564	128	39	112	7	0	158
21829	13995s (+0.7s)	2872	2872	256	51	172	13	0	236
21830	13996s (+0.5s)	1796	1796	128	47	131	0	6	184
21831	13996s (+0.2s)	300	300	32	7	45	0	3	55
21832	13996s (+0.5s)	1724	1724	128	48	113	0	10	171
21833	13997s (+0.4s)	1464	1464	128	50	97	7	0	154
21834	13998s (+0.9s)	3792	3792	256	72	230	12	0	314
21835	13998s (+0.3s)	844	844	64	24	81	3	0	108
21836	13998s (+0.4s)	1428	1428	64	42	114	4	0	160
21837	13999s (+0.6s)	1936	1936	128	40	155	7	0	202
21838	13999s (+0.5s)	1656	1656	128	39	120	10	1	170
21839	14000s (+0.8s)	3240	3240	256	80	179	13	1	273
21840	14001s (+0.8s)	3268	3268	256	78	186	12	0	276
21841	14002s (+0.9s)	3856	3856	256	92	210	14	0	316
21842	14002s (+0.4s)	1584	1584	128	58	82	17	0	157
21843	14003s (+0.6s)	2708	2708	256	47	174	9	0	230
21844	14004s (+0.5s)	1928	1928	128	48	127	13	1	189
21845	14004s (+0.8s)	3448	3448	256	71	205	11	1	288
21846	14005s (+0.3s)	936	936	64	25	83	6	0	114
21847	14005s (+0.8s)	3240	3240	256	70	189	14	0	273
21848	14006s (+0.8s)	3292	3292	256	63	197	14	0	274
21849	14007s (+0.8s)	3212	3212	256	67	187	11	1	266
21850	14007s (+0.4s)	1448	1448	128	42	104	4	1	151
21851	14008s (+0.8s)	3184	3184	256	49	205	10	0	264
21852	14009s (+0.6s)	1904	1904	128	46	141	7	0	194
21853	14010s (+0.7s)	3132	3132	256	73	177	9	0	259
21854	14010s (+0.5s)	1596	1596	128	28	128	3	0	159
21855	14010s (+0.4s)	1636	1636	128	40	113	9	0	162
21856	14011s (+0.7s)	3068	3068	256	70	167	14	0	251
21857	14012s (+0.8s)	3320	3320	256	52	219	5	0	276
21858	14012s (+0.5s)	1844	1844	128	46	130	9	0	185
21859	14013s (+0.8s)	3412	3412	256	74	191	12	0	277
21860	14014s (+0.8s)	3472	3472	256	77	206	16	0	299
21861	14015s (+0.6s)	1920	1920	128	44	146	8	0	198
21862	14015s (+0.5s)	1712	1712	128	40	120	10	0	170
21863	14016s (+0.5s)	2296	2296	256	35	151	0	6	192
21864	14016s (+0.3s)	1124	1124	128	18	98	0	3	119
21865	14016s (+0.3s)	760	760	64	19	80	0	4	103
21866	14017s (+0.7s)	2788	2788	256	50	180	11	0	241
21867	14018s (+0.8s)	3472	3472	256	79	203	12	0	294
21868	14019s (+0.6s)	2588	2588	256	55	153	11	0	219
21869	14019s (+0.2s)	456	456	32	14	60	2	0	76
21870	14019s (+0.6s)	2664	2664	256	50	172	5	0	227
21871	14020s (+0.8s)	3192	3192	256	61	192	12	1	266
21872	14021s (+0.5s)	1496	1496	128	36	115	7	0	158
21873	14022s (+0.9s)	3932	3932	256	84	220	17	0	321
21874	14022s (+0.4s)	1380	1380	128	40	93	11	2	146
21875	14023s (+0.7s)	3148	3148	256	73	171	12	0	256
21876	14024s (+0.8s)	3496	3496	256	68	210	16	0	294
21877	14025s (+1.0s)	4260	4260	256	97	244	14	0	355
21878	14025s (+0.4s)	1192	1192	64	35	104	6	0	145
21879	14026s (+0.6s)	2148	2148	128	75	127	10	0	212
21880	14026s (+0.5s)	2300	2300	256	45	140	6	0	191
21881	14027s (+0.5s)	1560	1560	128	52	99	11	0	162
21882	14027s (+0.7s)	2860	2860	256	45	180	12	0	237
21883	14028s (+0.9s)	3736	3736	256	76	219	15	0	310
21884	14029s (+0.8s)	3224	3224	256	67	186	14	2	269
21885	14029s (+0.3s)	968	968	64	29	86	6	0	121
21886	14030s (+0.8s)	3476	3476	256	76	186	10	1	273
21887	14031s (+1.0s)	4356	4356	256	100	238	22	0	360
21888	14032s (+0.7s)	2808	2808	256	63	171	11	0	245
21889	14032s (+0.5s)	1828	1828	128	49	128	7	0	184
21890	14033s (+0.6s)	1960	1960	128	50	134	9	1	194
21891	14034s (+0.6s)	2232	2232	128	49	150	13	1	213
21892	14034s (+0.6s)	2344	2344	256	50	135	15	0	200
21893	14035s (+0.7s)	3112	3112	256	55	188	9	0	252
21894	14036s (+0.8s)	3140	3140	256	52	196	9	0	257
21895	14036s (+0.6s)	2728	2728	256	55	145	14	0	214
21896	14037s (+0.3s)	1092	1092	128	23	90	5	0	118
21897	14037s (+0.7s)	2920	2920	256	57	188	11	0	256
21898	14038s (+0.7s)	3108	3108	256	60	188	9	0	257
21899	14038s (+0.4s)	1172	1172	64	38	91	10	0	139
Episode	Time	Reward	Score	Highest	L	U	R	D	Steps
21900	14039s (+0.4s)	1384	1384	128	32	110	4	0	146
21901	14039s (+0.6s)	2156	2156	128	48	143	8	1	200
21902	14040s (+0.7s)	2840	2840	256	59	172	11	0	242
21903	14041s (+0.5s)	1548	1548	128	37	118	4	0	159
21904	14042s (+1.2s)	5908	5908	512	119	295	17	0	431
21905	14042s (+0.5s)	1516	1516	128	41	115	6	0	162
21906	14043s (+0.5s)	1672	1672	128	43	120	7	0	170
21907	14043s (+0.4s)	1176	1176	64	35	96	9	0	140
21908	14044s (+0.8s)	3180	3180	256	59	198	12	1	270
21909	14045s (+0.9s)	3812	3812	256	56	235	0	15	306
21910	14045s (+0.6s)	2384	2384	256	45	153	0	7	205
21911	14046s (+0.6s)	2864	2864	256	54	173	0	7	234
21912	14047s (+0.7s)	2864	2864	256	54	183	0	10	247
21913	14047s (+0.2s)	520	520	64	7	68	1	1	77
21914	14047s (+0.5s)	1692	1692	128	40	123	0	7	170
21915	14048s (+0.8s)	3244	3244	256	57	202	0	15	274
21916	14049s (+0.8s)	3188	3188	256	51	201	0	13	265
21917	14050s (+0.8s)	3232	3232	256	82	179	0	11	272
21918	14050s (+0.3s)	968	968	64	29	73	0	12	114
21919	14051s (+0.6s)	2444	2444	256	40	164	0	7	211
21920	14051s (+0.7s)	2992	2992	256	59	188	0	7	254
21921	14052s (+0.9s)	3760	3760	256	75	214	0	17	306
21922	14053s (+0.9s)	3424	3424	256	51	240	0	6	297
21923	14054s (+0.8s)	3448	3448	256	82	193	14	0	289
21924	14055s (+0.6s)	2592	2592	256	46	159	13	0	218
21925	14055s (+0.4s)	1320	1320	128	31	99	3	0	133
21926	14056s (+0.6s)	2684	2684	256	59	158	8	0	225
21927	14056s (+0.6s)	2468	2468	256	51	148	10	0	209
21928	14057s (+0.6s)	2324	2324	128	55	152	14	0	221
21929	14057s (+0.4s)	1484	1484	128	43	104	8	0	155
21930	14058s (+0.8s)	3524	3524	256	63	223	9	0	295
21931	14059s (+0.4s)	1456	1456	128	41	107	6	0	154
21932	14059s (+0.5s)	2192	2192	128	49	135	10	1	195
21933	14060s (+0.8s)	3324	3324	256	62	195	14	0	271
21934	14060s (+0.3s)	1080	1080	128	20	96	0	3	119
21935	14061s (+0.5s)	1712	1712	128	39	127	0	9	175
21936	14061s (+0.4s)	1444	1444	128	29	110	0	6	145
21937	14061s (+0.3s)	640	640	64	20	67	0	1	88
21938	14062s (+0.4s)	1424	1424	128	30	106	0	9	145
21939	14062s (+0.4s)	1392	1392	128	33	103	4	1	141
21940	14063s (+0.6s)	2520	2520	256	55	158	8	0	221
21941	14064s (+1.0s)	4232	4232	256	99	237	19	0	355
21942	14065s (+0.5s)	2012	2012	128	43	133	11	1	188
21943	14065s (+0.6s)	2200	2200	128	51	146	9	0	206
21944	14066s (+0.7s)	2844	2844	256	63	180	6	0	249
21945	14066s (+0.5s)	1496	1496	128	38	114	6	0	158
21946	14067s (+0.7s)	3128	3128	256	62	184	15	0	261
21947	14068s (+0.6s)	2008	2008	128	62	132	11	0	205
21948	14069s (+1.1s)	5480	5480	512	100	265	20	0	385
21949	14070s (+1.0s)	4276	4276	256	88	247	24	0	359
21950	14070s (+0.8s)	3268	3268	256	68	199	12	0	279
21951	14071s (+0.7s)	3076	3076	256	64	171	19	0	254
21952	14072s (+0.6s)	2792	2792	256	51	166	10	0	227
21953	14073s (+1.0s)	4128	4128	256	87	237	15	0	339
21954	14074s (+1.4s)	7192	7192	512	134	330	28	0	492
21955	14075s (+0.4s)	1380	1380	128	38	95	7	0	140
21956	14075s (+0.4s)	1396	1396	128	44	93	8	0	145
21957	14076s (+0.7s)	2868	2868	256	56	186	7	0	249
21958	14076s (+0.4s)	1228	1228	128	33	97	5	0	135
21959	14077s (+0.7s)	2972	2972	256	55	179	15	0	249
21960	14078s (+0.9s)	3996	3996	256	87	221	20	0	328
21961	14078s (+0.3s)	804	804	64	27	72	3	0	102
21962	14079s (+0.4s)	1516	1516	128	38	108	10	0	156
21963	14079s (+0.3s)	840	840	64	26	79	2	0	107
21964	14080s (+0.6s)	2560	2560	256	46	166	8	0	220
21965	14080s (+0.4s)	1448	1448	128	32	110	8	1	151
21966	14080s (+0.5s)	1828	1828	128	54	124	9	0	187
21967	14081s (+0.6s)	2548	2548	256	57	141	12	0	210
21968	14083s (+1.5s)	7316	7316	512	145	341	24	1	511
21969	14083s (+0.7s)	2792	2792	256	60	172	9	0	241
21970	14084s (+0.4s)	1488	1488	128	40	110	5	0	155
21971	14085s (+0.8s)	3476	3476	256	75	199	13	1	288
21972	14085s (+0.5s)	1564	1564	128	33	126	4	0	163
21973	14086s (+0.8s)	3196	3196	256	53	209	5	0	267
21974	14087s (+0.7s)	3164	3164	256	59	190	10	0	259
21975	14088s (+1.1s)	5408	5408	512	106	249	23	0	378
21976	14088s (+0.7s)	3168	3168	256	72	171	17	0	260
21977	14089s (+0.3s)	888	888	64	26	85	6	0	117
21978	14089s (+0.8s)	3196	3196	256	68	188	10	1	267
21979	14090s (+0.8s)	3332	3332	256	62	201	20	0	283
21980	14091s (+0.9s)	3628	3628	256	68	224	14	0	306
21981	14092s (+0.5s)	1824	1824	128	45	133	4	0	182
21982	14092s (+0.5s)	1584	1584	128	39	115	9	0	163
21983	14093s (+0.5s)	1624	1624	128	32	126	2	0	160
21984	14093s (+0.6s)	2612	2612	256	57	162	9	0	228
21985	14094s (+1.0s)	4232	4232	256	100	233	16	0	349
21986	14095s (+0.9s)	3544	3544	256	80	207	13	0	300
21987	14096s (+0.4s)	1320	1320	128	33	98	5	0	136
21988	14096s (+0.5s)	1724	1724	128	42	124	5	0	171
21989	14097s (+0.8s)	3384	3384	256	72	194	15	0	281
21990	14097s (+0.4s)	1464	1464	128	41	111	4	0	156
21991	14098s (+0.8s)	3416	3416	256	71	219	5	0	295
21992	14099s (+0.7s)	2848	2848	256	42	183	10	0	235
21993	14100s (+0.8s)	3564	3564	256	73	207	13	1	294
21994	14100s (+0.6s)	2580	2580	256	55	156	13	1	225
21995	14101s (+0.6s)	2656	2656	256	51	164	12	0	227
21996	14101s (+0.3s)	1012	1012	128	19	86	0	3	108
21997	14102s (+0.8s)	3348	3348	256	44	224	0	16	284
21998	14103s (+0.5s)	1608	1608	128	25	131	0	13	169
21999	14103s (+0.3s)	1052	1052	64	29	91	7	0	127
Episode	Time	Reward	Score	Highest	L	U	R	D	Steps
22000	14104s (+0.7s)	2704	2704	256	44	175	11	0	230
22001	14105s (+1.0s)	4968	4968	512	90	242	14	1	347
22002	14105s (+0.5s)	1572	1572	128	37	123	4	0	164
22003	14106s (+0.4s)	1052	1052	64	29	91	7	0	127
22004	14106s (+0.8s)	3464	3464	256	83	186	16	0	285
22005	14107s (+0.3s)	1020	1020	128	22	83	4	0	109
22006	14107s (+0.5s)	2072	2072	256	34	133	7	0	174
22007	14108s (+0.4s)	1248	1248	64	38	88	10	0	136
22008	14108s (+0.9s)	3680	3680	256	82	217	18	0	317
22009	14109s (+0.4s)	1296	1296	64	43	93	9	0	145
22010	14110s (+1.0s)	4576	4576	256	72	264	0	20	356
22011	14110s (+0.4s)	1232	1232	128	29	102	0	5	136
22012	14111s (+0.6s)	2512	2512	256	51	154	0	8	213
22013	14111s (+0.4s)	1580	1580	128	22	128	0	6	156
22014	14112s (+0.4s)	1036	1036	64	19	99	0	6	124
22015	14112s (+0.5s)	1600	1600	128	35	124	0	8	167
22016	14113s (+0.4s)	1464	1464	128	32	113	0	9	154
22017	14114s (+1.0s)	4276	4276	256	70	272	0	13	355
22018	14114s (+0.7s)	2760	2760	256	50	178	0	6	234
22019	14115s (+0.8s)	3400	3400	256	63	207	0	12	282
22020	14116s (+1.0s)	5192	5192	512	82	260	0	16	358
22021	14116s (+0.3s)	756	756	64	14	76	0	3	93
22022	14117s (+0.7s)	2736	2736	256	45	186	0	8	239
22023	14117s (+0.1s)	252	252	32	6	40	0	1	47
22024	14118s (+0.8s)	3344	3344	256	73	195	14	0	282
22025	14118s (+0.2s)	568	568	64	14	60	3	0	77
22026	14119s (+0.7s)	3164	3164	256	83	165	10	1	259
22027	14120s (+1.0s)	4204	4204	256	92	241	15	0	348
22028	14121s (+0.8s)	3448	3448	256	81	199	12	0	292
22029	14121s (+0.5s)	1728	1728	128	42	127	9	0	178
22030	14122s (+0.7s)	3176	3176	256	81	170	11	0	262
22031	14123s (+0.9s)	3768	3768	256	81	219	17	0	317
22032	14124s (+0.7s)	2744	2744	256	60	159	14	0	233
22033	14124s (+0.3s)	744	744	64	24	66	6	0	96
22034	14124s (+0.5s)	1768	1768	128	48	122	9	0	179
22035	14126s (+1.1s)	4516	4516	256	108	240	23	0	371
22036	14126s (+0.8s)	3364	3364	256	74	203	10	0	287
22037	14127s (+1.0s)	4224	4224	256	97	232	21	0	350
22038	14128s (+1.0s)	4340	4340	256	94	242	24	0	360
22039	14129s (+0.6s)	2004	2004	128	57	137	9	0	203
22040	14129s (+0.4s)	1464	1464	128	27	117	6	0	150
22041	14130s (+0.5s)	1688	1688	128	42	117	9	0	168
22042	14131s (+0.8s)	3432	3432	256	78	196	14	0	288
22043	14131s (+0.6s)	2252	2252	128	54	152	12	0	218
22044	14132s (+0.4s)	1424	1424	128	32	108	4	1	145
22045	14132s (+0.5s)	1860	1860	128	42	140	7	0	189
22046	14133s (+0.5s)	1752	1752	128	38	131	9	0	178
22047	14134s (+0.7s)	2628	2628	128	70	162	11	0	243
22048	14134s (+0.6s)	2132	2132	128	60	133	11	0	204
22049	14135s (+0.8s)	3204	3204	256	67	185	16	0	268
22050	14135s (+0.4s)	1200	1200	128	25	101	6	0	132
22051	14136s (+0.4s)	1488	1488	128	25	127	4	0	156
22052	14137s (+1.0s)	5012	5012	512	102	234	16	0	352
22053	14137s (+0.3s)	908	908	64	23	83	3	0	109
22054	14138s (+0.7s)	2820	2820	256	61	172	14	1	248
22055	14138s (+0.7s)	2708	2708	256	70	153	13	0	236
22056	14139s (+0.4s)	1064	1064	64	31	91	7	0	129
22057	14140s (+0.7s)	2760	2760	256	48	184	0	7	239
22058	14140s (+0.3s)	712	712	64	13	76	0	4	93
22059	14140s (+0.6s)	2392	2392	256	44	148	0	9	201
22060	14141s (+0.3s)	768	768	64	28	67	0	6	101
22061	14142s (+0.8s)	3508	3508	256	74	207	15	0	296
22062	14142s (+0.8s)	3620	3620	256	73	220	14	0	307
22063	14143s (+0.6s)	2116	2116	128	37	156	14	0	207
22064	14144s (+0.6s)	2676	2676	256	56	151	15	0	222
22065	14144s (+0.7s)	2888	2888	256	59	176	13	0	248
22066	14145s (+0.9s)	4008	4008	256	89	218	18	1	326
22067	14146s (+0.3s)	876	876	64	28	84	2	0	114
22068	14146s (+0.6s)	2236	2236	128	68	143	10	0	221
22069	14146s (+0.2s)	576	576	64	16	59	4	0	79
22070	14147s (+0.6s)	1988	1988	128	56	133	9	1	199
22071	14148s (+0.7s)	2924	2924	256	64	182	11	0	257
22072	14148s (+0.5s)	1624	1624	128	29	136	0	5	170
22073	14149s (+0.7s)	2992	2992	256	50	191	0	13	254
22074	14149s (+0.5s)	1588	1588	128	37	125	0	8	170
22075	14150s (+0.3s)	716	716	64	18	74	0	4	96
22076	14150s (+0.6s)	2876	2876	256	49	176	5	0	230
22077	14151s (+0.4s)	1180	1180	128	36	85	7	0	128
22078	14152s (+0.9s)	3896	3896	256	61	239	13	0	313
22079	14152s (+0.8s)	3460	3460	256	74	198	12	0	284
22080	14154s (+1.4s)	7224	7224	512	137	333	27	2	499
22081	14154s (+0.3s)	976	976	64	29	83	7	0	119
22082	14155s (+0.5s)	1792	1792	128	45	130	8	0	183
22083	14155s (+0.3s)	640	640	64	14	72	2	0	88
22084	14156s (+0.8s)	3416	3416	256	75	193	11	0	279
22085	14156s (+0.3s)	880	880	64	25	86	4	0	115
22086	14157s (+0.7s)	3104	3104	256	62	180	13	0	255
22087	14158s (+0.9s)	3944	3944	256	74	242	9	0	325
22088	14158s (+0.3s)	1168	1168	128	19	97	4	0	120
22089	14159s (+0.7s)	2548	2548	128	68	155	12	1	236
22090	14159s (+0.4s)	1216	1216	64	43	91	7	0	141
22091	14160s (+0.8s)	3308	3308	256	85	177	16	0	278
22092	14161s (+0.7s)	2464	2464	128	62	148	16	1	227
22093	14161s (+0.5s)	1632	1632	128	47	117	10	0	174
22094	14162s (+0.4s)	1304	1304	128	23	105	4	0	132
22095	14162s (+0.5s)	1588	1588	128	31	126	8	0	165
22096	14163s (+0.9s)	3940	3940	256	90	223	11	0	324
22097	14163s (+0.5s)	1656	1656	128	30	128	9	0	167
22098	14164s (+0.5s)	2296	2296	256	35	153	7	0	195
22099	14165s (+0.8s)	3516	3516	256	73	211	9	0	293
Episode	Time	Reward	Score	Highest	L	U	R	D	Steps
22100	14166s (+0.8s)	3428	3428	256	68	206	14	0	288
22101	14166s (+0.8s)	3440	3440	256	66	201	14	0	281
22102	14167s (+0.5s)	1616	1616	128	45	117	9	0	171
22103	14168s (+0.6s)	2540	2540	256	45	157	6	1	209
22104	14168s (+0.5s)	1800	1800	128	42	135	9	0	186
22105	14169s (+0.7s)	3160	3160	256	66	186	13	0	265
22106	14170s (+0.9s)	3628	3628	256	90	204	15	0	309
22107	14170s (+0.3s)	872	872	64	21	85	7	0	113
22108	14171s (+1.0s)	4292	4292	256	106	222	23	0	351
22109	14171s (+0.4s)	1316	1316	128	34	101	6	0	141
22110	14172s (+0.7s)	2820	2820	256	77	161	10	0	248
22111	14173s (+0.9s)	4040	4040	256	84	228	17	0	329
22112	14174s (+0.6s)	1928	1928	128	49	145	6	0	200
22113	14175s (+0.8s)	3900	3900	256	61	216	17	1	295
22114	14175s (+0.9s)	4164	4164	256	104	218	22	0	344
22115	14176s (+0.2s)	548	548	32	21	57	4	0	82
22116	14176s (+0.7s)	2624	2624	256	53	162	16	0	231
22117	14177s (+0.5s)	1740	1740	128	50	120	10	0	180
22118	14178s (+0.7s)	2572	2572	128	63	165	15	0	243
22119	14178s (+0.6s)	2388	2388	128	67	145	13	0	225
22120	14179s (+0.3s)	1136	1136	128	26	86	7	0	119
22121	14179s (+0.7s)	2636	2636	256	47	175	0	12	234
22122	14180s (+0.5s)	1812	1812	128	33	146	0	5	184
22123	14180s (+0.5s)	1792	1792	128	38	138	0	8	184
22124	14181s (+1.1s)	5460	5460	512	90	276	0	14	380
22125	14182s (+1.0s)	5000	5000	512	67	266	0	18	351
22126	14183s (+0.9s)	3820	3820	256	66	243	0	12	321
22127	14184s (+0.4s)	1484	1484	128	30	118	0	7	155
22128	14185s (+0.8s)	3476	3476	256	75	202	0	11	288
22129	14185s (+0.7s)	2828	2828	256	50	184	0	12	246
22130	14186s (+0.5s)	1660	1660	128	34	122	0	10	166
22131	14186s (+0.5s)	1752	1752	128	35	133	0	10	178
22132	14187s (+0.5s)	1632	1632	128	28	129	0	9	166
22133	14187s (+0.3s)	748	748	64	17	76	0	4	97
22134	14188s (+0.5s)	1900	1900	128	36	148	0	10	194
22135	14188s (+0.6s)	1900	1900	128	52	131	10	0	193
22136	14189s (+1.2s)	5856	5856	512	113	286	19	0	418
22137	14190s (+0.6s)	2620	2620	256	52	169	9	0	230
22138	14191s (+0.8s)	3388	3388	256	61	208	13	0	282
22139	14191s (+0.6s)	2112	2112	128	66	131	11	1	209
22140	14192s (+0.5s)	1780	1780	128	44	130	6	0	180
22141	14193s (+0.7s)	3280	3280	256	77	178	12	1	268
22142	14193s (+0.4s)	1480	1480	128	38	101	5	0	144
22143	14194s (+0.7s)	2920	2920	256	54	189	13	0	256
22144	14194s (+0.4s)	1068	1068	64	23	100	7	0	130
22145	14195s (+1.1s)	5960	5960	512	122	267	25	0	414
22146	14196s (+0.8s)	3496	3496	256	83	188	19	0	290
22147	14197s (+0.7s)	2760	2760	256	58	175	6	0	239
22148	14198s (+0.8s)	3456	3456	256	61	209	14	0	284
22149	14198s (+0.7s)	2868	2868	256	52	183	13	0	248
22150	14199s (+0.5s)	1768	1768	128	55	116	11	0	182
22151	14200s (+0.7s)	2728	2728	256	66	161	10	0	237
22152	14200s (+0.6s)	2192	2192	128	69	142	10	0	221
22153	14201s (+0.5s)	1684	1684	128	45	119	8	0	172
22154	14201s (+0.6s)	2248	2248	128	61	143	7	0	211
22155	14202s (+0.6s)	2276	2276	256	44	143	11	0	198
22156	14202s (+0.5s)	1772	1772	128	48	123	7	0	178
22157	14203s (+0.8s)	3428	3428	256	60	211	10	0	281
22158	14204s (+0.6s)	2836	2836	256	64	152	10	0	226
22159	14205s (+0.8s)	3248	3248	256	57	208	8	1	274
22160	14205s (+0.6s)	2532	2532	256	55	158	7	0	220
22161	14206s (+0.7s)	3252	3252	256	64	187	8	0	259
22162	14207s (+0.7s)	2696	2696	256	50	172	10	1	233
22163	14208s (+0.8s)	3064	3064	256	68	185	14	0	267
22164	14208s (+0.5s)	1760	1760	128	48	118	14	0	180
22165	14209s (+0.5s)	1540	1540	128	48	109	7	0	164
22166	14209s (+0.4s)	1496	1496	128	35	114	8	1	158
22167	14210s (+0.9s)	3820	3820	256	77	223	20	1	321
22168	14210s (+0.4s)	1348	1348	128	45	95	8	0	148
22169	14211s (+0.5s)	1900	1900	128	46	138	13	0	197
22170	14212s (+0.7s)	2812	2812	256	63	162	14	0	239
22171	14213s (+0.9s)	3880	3880	256	102	215	12	0	329
22172	14213s (+0.7s)	2944	2944	256	68	176	13	0	257
22173	14214s (+0.9s)	3980	3980	256	73	242	15	0	330
22174	14215s (+0.7s)	2828	2828	256	58	185	7	0	250
22175	14216s (+0.6s)	2016	2016	128	57	140	9	0	206
22176	14216s (+0.7s)	2768	2768	256	44	182	11	0	237
22177	14217s (+0.7s)	3168	3168	256	76	173	16	0	265
22178	14218s (+0.7s)	3192	3192	256	67	187	12	0	266
22179	14219s (+1.0s)	4328	4328	256	86	254	16	0	356
22180	14219s (+0.4s)	1284	1284	128	33	90	4	1	128
22181	14220s (+1.1s)	4620	4620	256	113	251	21	0	385
22182	14221s (+0.8s)	3448	3448	256	66	202	18	0	286
22183	14221s (+0.2s)	508	508	64	20	45	2	0	67
22184	14222s (+0.7s)	2916	2916	256	58	189	8	0	255
22185	14222s (+0.4s)	1504	1504	128	42	101	7	0	150
22186	14223s (+0.4s)	1524	1524	128	34	120	6	0	160
22187	14224s (+0.9s)	4016	4016	256	100	217	16	0	333
22188	14224s (+0.6s)	2864	2864	256	52	173	8	0	233
22189	14225s (+1.0s)	4080	4080	256	87	235	15	0	337
22190	14226s (+1.0s)	5296	5296	512	88	256	21	1	366
22191	14227s (+0.5s)	1692	1692	128	51	115	8	0	174
22192	14228s (+0.6s)	2432	2432	256	41	146	7	2	196
22193	14228s (+0.9s)	3536	3536	256	85	206	7	0	298
22194	14229s (+0.5s)	1648	1648	128	35	126	4	0	165
22195	14230s (+1.0s)	4252	4252	256	110	221	22	0	353
22196	14230s (+0.2s)	620	620	64	18	65	2	0	85
22197	14231s (+0.7s)	3056	3056	256	63	169	17	0	249
22198	14231s (+0.5s)	1784	1784	128	49	127	6	0	182
22199	14232s (+0.3s)	696	696	64	23	63	6	0	92
Episode	Time	Reward	Score	Highest	L	U	R	D	Steps
22200	14232s (+0.5s)	1752	1752	128	37	134	5	0	176
22201	14233s (+0.8s)	3492	3492	256	101	175	18	0	294
22202	14233s (+0.4s)	1072	1072	64	32	93	6	0	131
22203	14234s (+0.5s)	1604	1604	128	38	119	11	0	168
22204	14234s (+0.3s)	928	928	128	20	75	4	0	99
22205	14235s (+0.6s)	1916	1916	128	42	148	7	0	197
22206	14235s (+0.4s)	1496	1496	128	48	104	6	0	158
22207	14236s (+0.7s)	2620	2620	256	58	159	14	0	231
22208	14236s (+0.6s)	2076	2076	128	50	148	0	7	205
22209	14237s (+0.8s)	3256	3256	256	66	195	0	12	273
22210	14238s (+0.8s)	3220	3220	256	57	198	0	14	269
22211	14239s (+0.7s)	2808	2808	256	51	185	0	9	245
22212	14239s (+0.6s)	2036	2036	128	42	146	0	14	202
22213	14240s (+0.7s)	2800	2800	256	45	189	0	9	243
22214	14240s (+0.5s)	1684	1684	128	35	122	0	10	167
22215	14241s (+0.3s)	1072	1072	128	29	75	0	7	111
22216	14242s (+0.8s)	3588	3588	256	62	213	0	11	286
22217	14242s (+0.5s)	1504	1504	128	35	117	0	7	159
22218	14242s (+0.3s)	756	756	64	19	68	0	5	92
22219	14243s (+0.3s)	724	724	64	22	68	0	5	95
22220	14243s (+0.3s)	1160	1160	128	23	93	0	4	120
22221	14244s (+1.0s)	4336	4336	256	79	255	0	21	355
22222	14244s (+0.5s)	1760	1760	128	34	137	0	6	177
22223	14245s (+0.5s)	1816	1816	128	41	138	0	10	189
22224	14245s (+0.5s)	1528	1528	128	44	109	8	0	161
22225	14246s (+0.6s)	1928	1928	128	41	149	10	0	200
22226	14247s (+0.7s)	2940	2940	256	65	185	11	0	261
22227	14247s (+0.5s)	1828	1828	128	41	140	6	0	187
22228	14248s (+0.5s)	1692	1692	128	39	121	7	1	168
22229	14249s (+0.8s)	3468	3468	256	74	198	14	0	286
22230	14249s (+0.6s)	2476	2476	256	62	143	6	0	211
22231	14250s (+0.4s)	1468	1468	128	33	116	7	0	156
22232	14250s (+0.7s)	2876	2876	256	67	164	19	0	250
22233	14251s (+0.9s)	3972	3972	256	92	218	17	0	327
22234	14252s (+0.8s)	3488	3488	256	71	209	11	0	291
22235	14253s (+1.0s)	4368	4368	256	88	254	25	0	367
22236	14254s (+0.6s)	2408	2408	256	51	139	10	0	200
22237	14255s (+0.8s)	3296	3296	256	71	187	18	0	276
22238	14256s (+1.4s)	6640	6640	512	121	333	27	1	482
22239	14256s (+0.3s)	712	712	64	25	64	5	0	94
22240	14257s (+0.4s)	1176	1176	64	37	99	5	0	141
22241	14257s (+0.7s)	2804	2804	256	47	189	9	0	245
22242	14258s (+0.4s)	1288	1288	128	16	113	4	0	133
22243	14258s (+0.6s)	1920	1920	128	55	135	8	0	198
22244	14259s (+0.7s)	3000	3000	256	53	189	8	0	250
22245	14260s (+0.9s)	3568	3568	256	83	207	14	0	304
22246	14260s (+0.4s)	1512	1512	128	41	110	6	0	157
22247	14261s (+0.4s)	1468	1468	128	41	104	6	0	151
22248	14261s (+0.4s)	1480	1480	128	45	100	9	0	154
22249	14262s (+0.8s)	3584	3584	256	91	184	22	1	298
22250	14263s (+0.5s)	1516	1516	128	40	114	8	0	162
22251	14263s (+0.2s)	584	584	32	22	59	5	0	86
22252	14264s (+1.0s)	4256	4256	256	82	253	19	0	354
22253	14265s (+0.7s)	2880	2880	256	55	186	0	11	252
22254	14266s (+1.1s)	5548	5548	512	83	297	0	17	397
22255	14266s (+0.4s)	1532	1532	128	37	108	0	10	155
22256	14267s (+0.3s)	748	748	64	22	73	0	4	99
22257	14267s (+0.6s)	2180	2180	128	42	153	0	10	205
22258	14268s (+0.6s)	2388	2388	256	41	156	0	6	203
22259	14268s (+0.4s)	1296	1296	128	32	101	0	8	141
22260	14269s (+0.5s)	1632	1632	128	33	133	0	5	171
22261	14269s (+0.7s)	2692	2692	256	45	189	0	9	243
22262	14270s (+0.4s)	1432	1432	128	29	116	0	7	152
22263	14270s (+0.4s)	920	920	64	28	87	0	5	120
22264	14271s (+0.6s)	2344	2344	256	41	148	0	7	196
22265	14271s (+0.4s)	1520	1520	128	27	123	0	6	156
22266	14272s (+0.9s)	3868	3868	256	71	225	0	22	318
22267	14273s (+0.7s)	3088	3088	256	47	201	0	14	262
22268	14274s (+0.7s)	2828	2828	256	46	186	0	14	246
22269	14274s (+0.7s)	2784	2784	256	46	179	0	14	239
22270	14275s (+0.7s)	2728	2728	256	59	159	0	12	230
22271	14275s (+0.3s)	728	728	64	17	76	0	3	96
22272	14275s (+0.3s)	644	644	64	11	74	0	3	88
22273	14276s (+0.5s)	1716	1716	128	44	127	5	0	176
22274	14277s (+1.0s)	4184	4184	256	92	235	15	0	342
22275	14278s (+1.0s)	4192	4192	256	94	229	16	0	339
22276	14279s (+0.7s)	2932	2932	128	77	170	16	1	264
22277	14279s (+0.9s)	3876	3876	256	112	179	22	0	313
22278	14280s (+1.0s)	4220	4220	256	76	256	13	0	345
22279	14281s (+0.5s)	1888	1888	128	53	131	6	0	190
22280	14282s (+0.9s)	3580	3580	256	84	207	13	0	304
22281	14282s (+0.5s)	1800	1800	128	50	127	8	0	185
22282	14283s (+0.6s)	2656	2656	256	63	150	11	0	224
22283	14284s (+0.9s)	3576	3576	256	73	212	16	0	301
22284	14284s (+0.5s)	1508	1508	128	34	120	6	0	160
22285	14285s (+1.0s)	4472	4472	256	103	244	18	0	365
22286	14286s (+0.6s)	2488	2488	256	51	157	6	0	214
22287	14287s (+0.7s)	2836	2836	256	61	168	12	0	241
22288	14288s (+0.8s)	3304	3304	256	68	199	10	0	277
22289	14288s (+0.5s)	1732	1732	128	45	123	8	0	176
22290	14289s (+0.7s)	2892	2892	256	64	172	14	0	250
22291	14290s (+1.1s)	5740	5740	512	108	278	15	0	401
22292	14290s (+0.3s)	840	840	64	25	81	6	0	112
22293	14292s (+1.5s)	7412	7412	512	134	346	29	0	509
22294	14292s (+0.4s)	1440	1440	128	40	108	7	0	155
22295	14293s (+0.6s)	2120	2120	128	52	147	11	0	210
22296	14293s (+0.5s)	1672	1672	128	45	107	11	0	163
22297	14294s (+0.8s)	3240	3240	256	63	199	11	0	273
22298	14295s (+0.8s)	3092	3092	256	62	193	9	0	264
22299	14296s (+1.2s)	5896	5896	512	113	271	25	0	409
Episode	Time	Reward	Score	Highest	L	U	R	D	Steps
22300	14297s (+0.7s)	2652	2652	256	62	161	9	1	233
22301	14297s (+0.5s)	2356	2356	256	44	142	11	0	197
22302	14298s (+0.5s)	1848	1848	128	50	123	12	1	186
22303	14299s (+0.9s)	3584	3584	256	79	210	14	0	303
22304	14299s (+0.5s)	1700	1700	128	38	125	7	0	170
22305	14300s (+0.9s)	3628	3628	256	65	230	14	0	309
22306	14301s (+1.0s)	4208	4208	256	105	224	14	0	343
22307	14302s (+0.7s)	2656	2656	256	49	173	13	0	235
22308	14303s (+0.7s)	3148	3148	256	70	181	8	0	259
22309	14303s (+0.5s)	1548	1548	128	35	123	8	0	166
22310	14304s (+0.4s)	1480	1480	128	37	113	4	0	154
22311	14304s (+0.4s)	1168	1168	64	35	94	9	1	139
22312	14305s (+1.0s)	4368	4368	256	93	255	18	0	366
22313	14306s (+0.6s)	2588	2588	256	43	159	0	12	214
22314	14306s (+0.9s)	3892	3892	256	66	239	0	15	320
22315	14307s (+0.6s)	2364	2364	128	41	168	0	8	217
22316	14308s (+0.5s)	1616	1616	128	26	137	0	5	168
22317	14308s (+0.5s)	1668	1668	128	43	129	0	7	179
22318	14309s (+0.9s)	3972	3972	256	71	244	0	12	327
22319	14309s (+0.1s)	264	264	32	13	31	0	6	50
22320	14309s (+0.2s)	580	580	64	13	64	0	3	80
22321	14310s (+0.5s)	1688	1688	128	27	137	0	10	174
22322	14311s (+0.8s)	3512	3512	256	53	229	10	0	292
22323	14311s (+0.5s)	1860	1860	128	45	137	6	1	189
22324	14312s (+0.8s)	3412	3412	256	62	212	14	0	288
22325	14313s (+0.7s)	2664	2664	256	60	159	10	0	229
22326	14313s (+0.6s)	1912	1912	128	37	154	5	0	196
22327	14314s (+0.5s)	1540	1540	128	40	116	8	0	164
22328	14315s (+0.9s)	3848	3848	256	85	210	18	0	313
22329	14316s (+0.8s)	3324	3324	256	77	180	18	0	275
22330	14316s (+0.5s)	1848	1848	128	49	128	8	0	185
22331	14317s (+0.6s)	2324	2324	256	44	141	9	0	194
22332	14317s (+0.4s)	1168	1168	128	24	98	4	0	126
22333	14318s (+0.7s)	2820	2820	256	52	169	11	0	232
22334	14318s (+0.5s)	1632	1632	128	29	145	1	0	175
22335	14319s (+0.8s)	3592	3592	256	79	213	12	1	305
22336	14320s (+0.7s)	2936	2936	256	81	147	11	0	239
22337	14321s (+1.1s)	4504	4504	256	106	242	20	0	368
22338	14322s (+1.0s)	4320	4320	256	101	241	16	0	358
22339	14322s (+0.3s)	772	772	64	31	64	6	0	101
22340	14323s (+0.6s)	2184	2184	128	56	140	10	0	206
22341	14323s (+0.4s)	928	928	64	31	85	7	0	123
22342	14324s (+0.8s)	3448	3448	256	72	203	11	0	286
22343	14324s (+0.5s)	1716	1716	128	43	127	5	0	175
22344	14326s (+1.1s)	5472	5472	512	71	294	0	19	384
22345	14326s (+0.2s)	428	428	32	14	52	0	2	68
22346	14326s (+0.7s)	2628	2628	256	49	176	0	7	232
22347	14327s (+0.5s)	1772	1772	128	34	139	0	6	179
22348	14328s (+0.6s)	2236	2236	256	57	132	0	6	195
22349	14328s (+0.8s)	3108	3108	256	79	182	0	10	271
22350	14329s (+0.4s)	1392	1392	128	27	108	0	4	139
22351	14330s (+0.9s)	3916	3916	256	60	245	0	13	318
22352	14330s (+0.3s)	676	676	64	19	63	0	5	87
22353	14330s (+0.4s)	1108	1108	64	36	91	0	8	135
22354	14331s (+0.4s)	1456	1456	128	30	119	0	3	152
22355	14331s (+0.2s)	576	576	64	13	62	0	5	80
22356	14332s (+0.7s)	2636	2636	256	46	177	0	10	233
22357	14332s (+0.5s)	1712	1712	128	37	126	9	1	173
22358	14333s (+0.9s)	3712	3712	256	106	192	11	1	310
22359	14334s (+0.8s)	3400	3400	256	74	198	13	0	285
22360	14335s (+0.9s)	3544	3544	256	86	196	19	0	301
22361	14336s (+0.9s)	4100	4100	256	89	226	18	0	333
22362	14336s (+0.6s)	1924	1924	128	43	149	7	0	199
22363	14337s (+0.5s)	1832	1832	128	56	124	8	0	188
22364	14337s (+0.3s)	1144	1144	128	26	92	3	0	121
22365	14337s (+0.3s)	708	708	64	18	70	5	0	93
22366	14338s (+0.6s)	2472	2472	256	49	155	10	0	214
22367	14338s (+0.5s)	1508	1508	128	38	116	6	0	160
22368	14339s (+0.7s)	2648	2648	256	69	157	6	0	232
22369	14339s (+0.4s)	1292	1292	128	32	102	5	0	139
22370	14340s (+0.5s)	1732	1732	128	44	117	12	0	173
22371	14341s (+0.8s)	3428	3428	256	76	200	16	0	292
22372	14342s (+1.1s)	4612	4612	256	113	245	25	0	383
22373	14343s (+0.7s)	2488	2488	128	63	158	12	0	233
22374	14344s (+1.0s)	4232	4232	256	101	224	23	0	348
22375	14344s (+0.8s)	3456	3456	256	78	191	18	1	288
22376	14345s (+0.5s)	1816	1816	128	44	134	11	0	189
22377	14345s (+0.5s)	1596	1596	128	36	128	3	0	167
22378	14346s (+1.1s)	5384	5384	512	111	247	19	0	377
22379	14347s (+0.9s)	3872	3872	256	93	208	21	1	323
22380	14348s (+0.3s)	864	864	64	31	79	3	0	113
22381	14349s (+0.8s)	3560	3560	256	84	190	23	0	297
22382	14349s (+0.8s)	3208	3208	256	67	187	12	0	266
22383	14350s (+0.9s)	3604	3604	256	82	206	16	0	304
22384	14351s (+0.7s)	2812	2812	256	66	167	13	0	246
22385	14351s (+0.3s)	632	632	64	23	61	3	0	87
22386	14352s (+0.5s)	1820	1820	128	50	125	5	0	180
22387	14352s (+0.5s)	1876	1876	128	59	128	5	0	192
22388	14353s (+0.5s)	1668	1668	128	42	113	9	0	164
22389	14353s (+0.3s)	800	800	64	20	70	0	3	93
22390	14354s (+0.6s)	2608	2608	256	45	169	0	9	223
22391	14354s (+0.3s)	688	688	64	15	75	0	1	91
22392	14354s (+0.5s)	1948	1948	128	45	136	0	11	192
22393	14355s (+0.3s)	964	964	64	21	89	0	5	115
22394	14355s (+0.6s)	2528	2528	256	51	157	0	11	219
22395	14356s (+0.7s)	2892	2892	256	55	187	0	8	250
22396	14357s (+0.8s)	3448	3448	256	56	224	0	12	292
22397	14357s (+0.5s)	1824	1824	128	42	132	10	0	184
22398	14358s (+0.7s)	3000	3000	256	59	188	10	0	257
22399	14359s (+0.8s)	3200	3200	256	64	186	17	1	268
Episode	Time	Reward	Score	Highest	L	U	R	D	Steps
22400	14360s (+0.6s)	1928	1928	128	45	139	16	0	200
22401	14360s (+0.7s)	2760	2760	256	56	170	11	0	237
22402	14361s (+0.7s)	2980	2980	256	66	178	7	0	251
22403	14361s (+0.5s)	1756	1756	128	35	140	4	0	179
22404	14362s (+0.5s)	1776	1776	128	39	139	6	0	184
22405	14363s (+0.6s)	2808	2808	256	60	154	12	1	227
22406	14363s (+0.3s)	896	896	64	29	81	4	0	114
22407	14364s (+0.9s)	3956	3956	256	96	213	14	0	323
22408	14364s (+0.6s)	2476	2476	256	58	136	7	1	202
22409	14365s (+0.5s)	1884	1884	128	44	141	4	0	189
22410	14366s (+0.7s)	2784	2784	256	51	181	0	7	239
22411	14366s (+0.2s)	568	568	64	10	66	0	1	77
22412	14367s (+0.8s)	3596	3596	256	80	208	14	0	302
22413	14368s (+0.8s)	3432	3432	256	72	202	14	0	288
22414	14368s (+0.4s)	1092	1092	64	42	87	3	0	132
22415	14369s (+0.5s)	1848	1848	128	42	138	6	0	186
22416	14369s (+0.6s)	2240	2240	128	57	151	6	1	215
22417	14370s (+0.5s)	1896	1896	128	49	134	9	0	192
22418	14370s (+0.6s)	2240	2240	128	41	164	0	10	215
22419	14371s (+0.9s)	3664	3664	256	52	231	0	17	300
22420	14372s (+0.5s)	1600	1600	128	36	121	0	10	167
22421	14372s (+0.3s)	1028	1028	64	23	97	2	0	122
22422	14372s (+0.3s)	780	780	64	24	75	2	0	101
22423	14373s (+0.5s)	1628	1628	128	36	130	8	0	174
22424	14374s (+0.8s)	3160	3160	256	90	168	15	0	273
22425	14375s (+1.2s)	6240	6240	512	136	275	28	0	439
22426	14375s (+0.6s)	2452	2452	256	46	155	9	0	210
22427	14376s (+0.5s)	1860	1860	128	29	157	2	0	188
22428	14376s (+0.5s)	1516	1516	128	32	121	9	1	163
22429	14377s (+0.6s)	2356	2356	128	51	157	9	0	217
22430	14378s (+0.5s)	1732	1732	128	40	125	8	0	173
22431	14378s (+0.6s)	2488	2488	256	50	156	8	0	214
22432	14379s (+0.7s)	3068	3068	256	49	189	14	0	252
22433	14379s (+0.5s)	1788	1788	128	47	127	7	1	182
22434	14380s (+0.4s)	1408	1408	128	32	109	8	0	149
22435	14381s (+0.7s)	2756	2756	256	60	164	13	0	237
22436	14381s (+0.4s)	1328	1328	128	36	103	8	0	147
22437	14381s (+0.5s)	1576	1576	128	42	105	10	0	157
22438	14382s (+0.3s)	824	824	64	25	80	2	0	107
22439	14383s (+0.8s)	3228	3228	256	65	190	0	16	271
22440	14383s (+0.5s)	1748	1748	128	36	126	0	15	177
22441	14384s (+0.8s)	3588	3588	256	74	212	0	13	299
22442	14384s (+0.4s)	1532	1532	128	26	121	0	9	156
22443	14385s (+0.8s)	3240	3240	256	57	204	0	11	272
22444	14386s (+0.7s)	3052	3052	256	70	176	11	1	258
22445	14386s (+0.4s)	1228	1228	128	36	96	3	0	135
22446	14387s (+0.4s)	1180	1180	128	28	93	6	0	127
22447	14387s (+0.6s)	2448	2448	256	51	154	10	0	215
22448	14388s (+0.6s)	2396	2396	256	44	154	4	0	202
22449	14388s (+0.4s)	1404	1404	128	36	105	6	0	147
22450	14389s (+0.6s)	1984	1984	128	49	145	5	0	199
22451	14390s (+0.7s)	2796	2796	256	58	171	13	0	242
22452	14391s (+1.3s)	6512	6512	512	124	303	25	0	452
22453	14391s (+0.5s)	1848	1848	128	44	133	12	0	189
22454	14392s (+0.8s)	3312	3312	256	73	191	16	0	280
22455	14393s (+0.7s)	2932	2932	256	54	183	12	0	249
22456	14393s (+0.4s)	1472	1472	128	39	107	7	0	153
22457	14394s (+0.5s)	1776	1776	128	35	139	6	0	180
22458	14395s (+0.9s)	3768	3768	256	70	227	11	0	308
22459	14395s (+0.2s)	552	552	64	14	65	1	0	80
22460	14396s (+0.5s)	1640	1640	128	33	134	9	0	176
22461	14396s (+0.7s)	2872	2872	256	72	167	10	0	249
22462	14396s (+0.2s)	640	640	64	30	50	5	0	85
22463	14397s (+0.3s)	1148	1148	128	39	79	6	0	124
22464	14398s (+1.0s)	4228	4228	256	92	237	18	0	347
22465	14398s (+0.5s)	1588	1588	128	51	105	9	0	165
22466	14399s (+0.3s)	908	908	64	27	84	7	0	118
22467	14400s (+0.9s)	3796	3796	256	88	219	17	0	324
22468	14400s (+0.7s)	2808	2808	256	57	179	8	1	245
22469	14401s (+0.7s)	2796	2796	256	62	167	12	0	241
22470	14402s (+0.6s)	1892	1892	128	38	147	7	0	192
22471	14402s (+0.4s)	1608	1608	128	29	124	5	0	158
22472	14403s (+0.6s)	2624	2624	256	45	167	0	10	222
22473	14403s (+0.7s)	2640	2640	128	49	179	0	12	240
22474	14404s (+0.5s)	1812	1812	128	38	135	0	14	187
22475	14404s (+0.4s)	1512	1512	128	36	111	0	11	158
22476	14405s (+0.4s)	1340	1340	128	24	109	0	3	136
22477	14405s (+0.3s)	784	784	64	23	71	0	7	101
22478	14406s (+0.8s)	3368	3368	256	72	203	13	0	288
22479	14407s (+0.9s)	4296	4296	256	113	197	22	1	333
22480	14408s (+0.8s)	3216	3216	256	75	181	17	0	273
22481	14409s (+1.0s)	4216	4216	256	85	241	18	0	344
22482	14409s (+0.7s)	2492	2492	128	73	150	11	0	234
22483	14410s (+0.3s)	900	900	64	26	85	5	0	116
22484	14410s (+0.5s)	1836	1836	128	38	138	6	0	182
22485	14411s (+0.5s)	1812	1812	128	49	127	10	1	187
22486	14411s (+0.2s)	392	392	32	12	47	4	1	64
22487	14412s (+0.7s)	3208	3208	256	65	179	15	0	259
22488	14412s (+0.6s)	2328	2328	256	43	144	7	0	194
22489	14413s (+0.5s)	1636	1636	128	39	127	5	0	171
22490	14414s (+0.9s)	3876	3876	256	74	223	14	1	312
22491	14414s (+0.3s)	888	888	64	15	90	3	0	108
22492	14414s (+0.3s)	608	608	32	25	61	5	0	91
22493	14415s (+0.5s)	1664	1664	128	46	115	8	0	169
22494	14416s (+1.3s)	6204	6204	512	116	303	21	2	442
22495	14416s (+0.3s)	904	904	64	34	82	1	0	117
22496	14417s (+0.9s)	4612	4612	512	92	204	16	1	313
22497	14418s (+0.6s)	2568	2568	256	63	139	16	0	218
22498	14418s (+0.6s)	2740	2740	256	59	162	12	0	233
22499	14419s (+0.5s)	1820	1820	128	53	127	10	0	190
Episode	Time	Reward	Score	Highest	L	U	R	D	Steps
22500	14420s (+0.8s)	3464	3464	256	59	215	11	0	285
22501	14421s (+0.8s)	3612	3612	256	77	205	14	0	296
22502	14421s (+0.4s)	1044	1044	64	38	81	6	0	125
22503	14421s (+0.5s)	1880	1880	128	50	116	12	0	178
22504	14422s (+0.4s)	980	980	64	26	95	4	0	125
22505	14422s (+0.5s)	2084	2084	256	35	139	3	0	177
22506	14423s (+1.1s)	5544	5544	512	119	245	22	0	386
22507	14424s (+0.5s)	1744	1744	128	36	134	6	1	177
22508	14425s (+0.6s)	2048	2048	128	49	144	6	1	200
22509	14425s (+0.7s)	2632	2632	256	56	168	8	0	232
22510	14426s (+0.4s)	1460	1460	128	37	106	5	1	149
22511	14427s (+1.1s)	5524	5524	512	88	292	15	0	395
22512	14427s (+0.3s)	700	700	64	27	61	4	0	92
22513	14427s (+0.4s)	1172	1172	128	26	95	5	0	126
22514	14428s (+0.6s)	1940	1940	128	51	133	12	0	196
22515	14429s (+0.8s)	3204	3204	256	65	183	0	16	264
22516	14429s (+0.5s)	1656	1656	128	32	127	0	8	167
22517	14430s (+0.9s)	4112	4112	256	68	252	1	14	335
22518	14431s (+0.7s)	2796	2796	256	48	183	0	11	242
22519	14432s (+0.8s)	3448	3448	256	57	211	0	20	288
22520	14432s (+0.7s)	2788	2788	256	49	179	0	12	240
22521	14433s (+0.8s)	3404	3404	256	47	225	0	10	282
22522	14434s (+0.6s)	2400	2400	256	40	162	0	7	209
22523	14434s (+0.6s)	2376	2376	128	55	149	0	14	218
22524	14435s (+0.7s)	2676	2676	256	48	176	7	0	231
22525	14436s (+0.8s)	3508	3508	256	72	207	18	0	297
22526	14437s (+0.7s)	2792	2792	256	62	164	9	0	235
22527	14438s (+0.9s)	3760	3760	256	84	212	15	0	311
22528	14438s (+0.9s)	3532	3532	256	57	235	10	0	302
22529	14439s (+0.9s)	4060	4060	256	86	230	21	0	337
22530	14440s (+0.3s)	1020	1020	128	20	81	7	1	109
22531	14440s (+0.3s)	980	980	64	24	89	5	0	118
22532	14441s (+1.1s)	4488	4488	256	92	261	15	0	368
22533	14442s (+0.4s)	1496	1496	128	41	107	8	1	157
22534	14442s (+0.7s)	2556	2556	128	63	159	16	0	238
22535	14443s (+0.5s)	1844	1844	128	54	132	5	0	191
22536	14444s (+0.9s)	3844	3844	256	74	222	17	0	313
22537	14444s (+0.4s)	1396	1396	128	46	94	8	1	149
22538	14444s (+0.4s)	1032	1032	64	28	89	9	0	126
22539	14445s (+0.5s)	1796	1796	128	50	124	9	1	184
22540	14446s (+0.7s)	2924	2924	256	53	186	9	0	248
22541	14447s (+1.4s)	7176	7176	512	135	334	24	0	493
22542	14448s (+0.8s)	3368	3368	256	71	198	12	0	281
22543	14448s (+0.4s)	1032	1032	64	28	85	9	0	122
22544	14449s (+0.4s)	1576	1576	128	44	110	5	2	161
22545	14449s (+0.2s)	548	548	64	20	56	3	0	79
22546	14450s (+0.7s)	3012	3012	256	61	181	11	0	253
22547	14450s (+0.4s)	1064	1064	64	37	87	5	1	130
22548	14451s (+1.0s)	4316	4316	256	102	236	25	1	364
22549	14452s (+0.8s)	3156	3156	256	56	198	12	0	266
22550	14453s (+0.7s)	2788	2788	256	55	174	10	1	240
22551	14453s (+0.7s)	2884	2884	256	49	190	0	13	252
22552	14454s (+0.7s)	2944	2944	256	53	195	0	14	262
22553	14455s (+0.8s)	3300	3300	256	71	192	13	0	276
22554	14456s (+0.7s)	2832	2832	256	51	191	9	0	251
22555	14456s (+0.8s)	3204	3204	256	79	175	15	0	269
22556	14457s (+0.4s)	1440	1440	128	37	107	5	0	149
22557	14457s (+0.7s)	2792	2792	256	57	170	14	0	241
22558	14458s (+0.5s)	1672	1672	128	56	118	6	0	180
22559	14459s (+0.8s)	3416	3416	256	80	193	15	0	288
22560	14459s (+0.7s)	3032	3032	256	67	172	13	1	253
22561	14460s (+0.4s)	1492	1492	128	30	117	9	0	156
22562	14460s (+0.4s)	1424	1424	128	41	94	10	0	145
22563	14461s (+0.8s)	3216	3216	256	67	191	8	1	267
22564	14462s (+0.8s)	3344	3344	256	59	213	0	8	280
22565	14463s (+0.6s)	2472	2472	256	34	175	0	8	217
22566	14463s (+0.7s)	2908	2908	256	49	196	0	8	253
22567	14464s (+0.3s)	804	804	64	15	84	0	3	102
22568	14464s (+0.4s)	1312	1312	128	18	111	0	5	134
22569	14465s (+0.9s)	3672	3672	256	66	217	0	22	305
22570	14465s (+0.6s)	2632	2632	256	46	166	0	11	223
22571	14466s (+0.6s)	2192	2192	128	49	144	11	0	204
22572	14467s (+0.7s)	2392	2392	128	65	149	19	0	233
22573	14467s (+0.5s)	1744	1744	128	30	139	0	7	176
22574	14468s (+0.8s)	3496	3496	256	66	213	0	14	293
22575	14468s (+0.3s)	972	972	64	22	84	0	7	113
22576	14469s (+0.8s)	3212	3212	256	55	201	11	0	267
22577	14470s (+0.5s)	1816	1816	128	50	125	7	0	182
22578	14470s (+0.7s)	2836	2836	256	77	163	11	0	251
22579	14471s (+0.5s)	1560	1560	128	49	104	10	0	163
22580	14472s (+1.0s)	4304	4304	256	96	241	17	0	354
22581	14472s (+0.3s)	804	804	64	19	82	6	1	108
22582	14473s (+0.7s)	2796	2796	256	52	177	12	0	241
22583	14473s (+0.5s)	1676	1676	128	44	117	10	0	171
22584	14474s (+0.4s)	1300	1300	128	30	94	6	0	130
22585	14474s (+0.6s)	2440	2440	256	49	145	10	0	204
22586	14475s (+0.5s)	1648	1648	128	45	124	5	0	174
22587	14476s (+0.8s)	3392	3392	256	70	207	17	0	294
22588	14476s (+0.5s)	1524	1524	128	41	114	9	0	164
22589	14477s (+0.6s)	2480	2480	128	56	161	12	2	231
22590	14477s (+0.4s)	1336	1336	128	29	105	5	0	139
22591	14478s (+0.7s)	3032	3032	256	64	177	12	0	253
22592	14479s (+1.1s)	5684	5684	512	94	289	18	0	401
22593	14480s (+0.5s)	1588	1588	128	34	125	5	0	164
22594	14480s (+0.4s)	1152	1152	64	23	102	0	7	132
22595	14481s (+0.5s)	2140	2140	256	32	140	0	5	177
22596	14481s (+0.4s)	1484	1484	128	29	110	0	7	146
22597	14482s (+0.7s)	3060	3060	256	54	183	0	12	249
22598	14482s (+0.5s)	1960	1960	128	33	149	0	11	193
22599	14483s (+1.2s)	6072	6072	512	104	311	0	18	433
Episode	Time	Reward	Score	Highest	L	U	R	D	Steps
22600	14484s (+0.7s)	2912	2912	256	43	201	0	10	254
22601	14485s (+0.6s)	2504	2504	256	39	163	0	10	212
22602	14486s (+0.9s)	3740	3740	256	54	233	0	16	303
22603	14486s (+0.5s)	1588	1588	128	31	125	0	5	161
22604	14487s (+0.4s)	1236	1236	128	20	104	0	4	128
22605	14487s (+0.8s)	3480	3480	256	90	185	14	0	289
22606	14488s (+0.7s)	2760	2760	256	63	160	14	0	237
22607	14488s (+0.3s)	732	732	64	22	71	3	0	96
22608	14490s (+1.3s)	6420	6420	512	104	323	26	0	453
22609	14491s (+1.0s)	4240	4240	256	81	254	15	0	350
22610	14492s (+1.1s)	5320	5320	512	104	255	21	0	380
22611	14493s (+1.5s)	7448	7448	512	138	344	33	2	517
22612	14494s (+0.3s)	752	752	64	23	75	3	0	101
22613	14494s (+0.7s)	2616	2616	256	56	166	7	0	229
22614	14495s (+0.4s)	1344	1344	128	40	96	11	0	147
22615	14495s (+0.4s)	1172	1172	64	35	98	7	0	140
22616	14496s (+0.4s)	1268	1268	128	24	102	3	0	129
22617	14496s (+0.5s)	1804	1804	128	41	137	7	0	185
22618	14497s (+0.8s)	2996	2996	256	77	177	16	0	270
22619	14498s (+0.7s)	2804	2804	256	58	174	12	0	244
22620	14499s (+1.0s)	5284	5284	512	85	269	22	1	377
22621	14500s (+1.0s)	5344	5344	512	100	243	18	1	362
22622	14501s (+0.8s)	3476	3476	256	75	206	12	0	293
22623	14501s (+0.8s)	3584	3584	256	85	195	15	0	295
22624	14502s (+0.5s)	1748	1748	128	40	127	10	0	177
22625	14503s (+0.9s)	3968	3968	256	78	236	13	0	327
22626	14503s (+0.6s)	2124	2124	128	53	144	13	0	210
22627	14504s (+0.8s)	3548	3548	256	73	212	10	0	295
22628	14505s (+0.3s)	676	676	64	34	56	3	0	93
22629	14506s (+1.0s)	4060	4060	256	90	234	10	0	334
22630	14506s (+0.8s)	3672	3672	256	85	199	16	0	300
22631	14507s (+0.8s)	3484	3484	256	73	205	13	0	291
22632	14509s (+1.3s)	6368	6368	512	135	287	29	0	451
22633	14509s (+0.5s)	1684	1684	128	29	140	4	0	173
22634	14509s (+0.4s)	1280	1280	128	32	96	3	0	131
22635	14510s (+0.7s)	2816	2816	256	53	188	6	0	247
22636	14511s (+0.7s)	3100	3100	256	58	186	12	0	256
22637	14511s (+0.4s)	1480	1480	128	43	104	7	1	155
22638	14512s (+0.4s)	1452	1452	128	29	119	4	0	152
22639	14513s (+1.0s)	4900	4900	512	97	221	20	0	338
22640	14513s (+0.4s)	1336	1336	128	27	106	4	0	137
22641	14514s (+0.5s)	1556	1556	128	35	118	6	0	159
22642	14514s (+0.6s)	1916	1916	128	51	139	7	0	197
22643	14515s (+1.0s)	4236	4236	256	71	261	0	18	350
22644	14516s (+0.7s)	2940	2940	256	52	188	0	7	247
22645	14517s (+0.6s)	2652	2652	256	45	168	0	11	224
22646	14517s (+0.7s)	2476	2476	128	53	157	0	20	230
22647	14518s (+1.1s)	5384	5384	512	95	264	0	18	377
22648	14519s (+0.5s)	1792	1792	128	34	146	0	4	184
22649	14519s (+0.2s)	436	436	32	8	61	0	3	72
22650	14520s (+0.6s)	2440	2440	256	39	163	0	6	208
22651	14520s (+0.2s)	648	648	64	13	69	0	3	85
22652	14520s (+0.4s)	1532	1532	128	46	105	10	0	161
22653	14521s (+0.8s)	3584	3584	256	94	198	11	0	303
22654	14522s (+0.6s)	2572	2572	256	62	158	9	0	229
22655	14522s (+0.3s)	932	932	64	34	86	3	0	123
22656	14523s (+0.8s)	3276	3276	256	56	205	14	0	275
22657	14524s (+0.8s)	3216	3216	256	71	180	16	0	267
22658	14524s (+0.6s)	2452	2452	256	54	145	10	0	209
22659	14525s (+0.5s)	1652	1652	128	39	122	7	1	169
22660	14525s (+0.5s)	1612	1612	128	42	122	6	0	170
22661	14526s (+0.8s)	3548	3548	256	83	202	17	0	302
22662	14527s (+0.4s)	1280	1280	128	24	117	5	0	146
22663	14527s (+0.4s)	1208	1208	128	23	105	6	0	134
22664	14528s (+1.0s)	4428	4428	256	97	247	21	0	365
22665	14528s (+0.3s)	912	912	64	26	76	6	0	108
22666	14529s (+0.8s)	3356	3356	256	62	205	12	0	279
22667	14530s (+0.4s)	1308	1308	64	43	96	8	0	147
22668	14530s (+0.7s)	2816	2816	256	67	165	9	0	241
22669	14531s (+0.4s)	1308	1308	128	46	90	7	0	143
22670	14531s (+0.8s)	3328	3328	256	69	197	12	0	278
22671	14532s (+0.5s)	1828	1828	128	35	143	0	9	187
22672	14532s (+0.4s)	1224	1224	128	21	104	0	2	127
22673	14533s (+0.6s)	2392	2392	256	37	158	0	8	203
22674	14533s (+0.4s)	1404	1404	128	30	101	0	9	140
22675	14534s (+0.5s)	1624	1624	128	32	130	0	11	173
22676	14534s (+0.2s)	372	372	32	5	53	0	3	61
22677	14535s (+0.9s)	3896	3896	256	69	245	11	0	325
22678	14536s (+1.4s)	6972	6972	512	106	346	22	1	475
22679	14537s (+0.5s)	1784	1784	128	57	115	8	0	180
22680	14537s (+0.5s)	1600	1600	128	30	127	7	0	164
22681	14538s (+0.4s)	1488	1488	128	39	110	7	0	156
22682	14539s (+0.8s)	3496	3496	256	78	184	17	0	279
22683	14539s (+0.8s)	3344	3344	256	83	184	15	0	282
22684	14540s (+0.8s)	3260	3260	256	80	184	13	0	277
22685	14541s (+0.4s)	1312	1312	128	27	103	5	0	135
22686	14541s (+0.9s)	3952	3952	256	80	219	18	0	317
22687	14542s (+0.7s)	3104	3104	256	59	182	15	0	256
22688	14543s (+0.4s)	1304	1304	128	26	105	3	0	134
22689	14543s (+0.5s)	1628	1628	128	48	114	11	0	173
22690	14544s (+0.5s)	1492	1492	128	41	106	10	0	157
22691	14544s (+0.6s)	2460	2460	256	40	164	7	0	211
22692	14545s (+0.7s)	2708	2708	256	65	153	12	0	230
22693	14546s (+0.8s)	3540	3540	256	65	220	14	0	299
22694	14546s (+0.4s)	1620	1620	128	38	113	6	1	158
22695	14547s (+1.0s)	4484	4484	256	94	255	18	0	367
22696	14548s (+0.5s)	1868	1868	128	50	133	8	0	191
22697	14548s (+0.6s)	2724	2724	256	63	153	13	0	229
22698	14549s (+0.8s)	3556	3556	256	81	205	13	1	300
22699	14550s (+0.5s)	1764	1764	128	48	125	4	0	177
Episode	Time	Reward	Score	Highest	L	U	R	D	Steps
22700	14550s (+0.3s)	1000	1000	128	22	81	2	0	105
22701	14551s (+0.9s)	4036	4036	256	71	256	0	11	338
22702	14552s (+0.6s)	2412	2412	256	43	161	0	4	208
22703	14552s (+0.6s)	2036	2036	128	48	154	0	9	211
22704	14553s (+0.6s)	1912	1912	128	48	141	0	8	197
22705	14553s (+0.7s)	2636	2636	256	45	175	0	14	234
22706	14554s (+0.5s)	1804	1804	128	37	139	0	10	186
22707	14555s (+0.8s)	3364	3364	256	70	196	11	0	277
22708	14555s (+0.6s)	1908	1908	128	52	134	9	0	195
22709	14556s (+0.8s)	3256	3256	256	61	197	12	0	270
22710	14557s (+0.8s)	3460	3460	256	73	196	15	0	284
22711	14558s (+0.6s)	2480	2480	256	38	169	5	0	212
22712	14558s (+0.5s)	1680	1680	128	38	124	9	0	171
22713	14558s (+0.4s)	1228	1228	128	35	93	6	0	134
22714	14559s (+0.4s)	1232	1232	64	38	97	5	0	140
22715	14559s (+0.5s)	1876	1876	128	53	133	6	0	192
22716	14560s (+0.5s)	1888	1888	128	41	140	9	0	190
22717	14561s (+0.8s)	3452	3452	256	75	204	14	1	294
22718	14561s (+0.4s)	1340	1340	128	37	99	10	0	146
22719	14562s (+0.4s)	1404	1404	128	37	99	7	1	144
22720	14562s (+0.5s)	1896	1896	128	42	145	5	0	192
22721	14563s (+0.5s)	1860	1860	128	46	131	10	1	188
22722	14563s (+0.4s)	1188	1188	64	40	97	6	0	143
22723	14564s (+0.6s)	1908	1908	128	48	137	10	0	195
22724	14564s (+0.3s)	696	696	64	29	63	2	0	94
22725	14565s (+0.6s)	2048	2048	128	51	142	10	0	203
22726	14565s (+0.4s)	1272	1272	128	24	111	4	0	139
22727	14565s (+0.4s)	1448	1448	128	26	122	7	1	156
22728	14566s (+0.4s)	1220	1220	128	37	88	8	0	133
22729	14567s (+0.9s)	3940	3940	256	82	224	11	0	317
22730	14567s (+0.5s)	1716	1716	128	41	122	8	0	171
22731	14568s (+0.9s)	3740	3740	256	62	232	0	9	303
22732	14569s (+0.6s)	2388	2388	256	36	162	0	7	205
22733	14569s (+0.8s)	3300	3300	256	54	208	0	14	276
22734	14570s (+0.9s)	3992	3992	256	76	239	0	16	331
22735	14571s (+0.3s)	760	760	64	28	69	0	5	102
22736	14572s (+1.1s)	5240	5240	512	87	288	8	0	383
22737	14572s (+0.7s)	2864	2864	256	64	162	9	2	237
22738	14573s (+0.7s)	3180	3180	256	63	188	11	1	263
22739	14574s (+0.3s)	1156	1156	128	29	88	5	0	122
22740	14574s (+0.5s)	1752	1752	128	42	122	9	0	173
22741	14575s (+0.8s)	3440	3440	256	68	203	12	1	284
22742	14576s (+1.3s)	6448	6448	512	131	289	20	0	440
22743	14577s (+1.0s)	4212	4212	256	79	254	11	0	344
22744	14578s (+0.6s)	2004	2004	128	59	128	10	0	197
22745	14578s (+0.5s)	1784	1784	128	49	116	9	0	174
22746	14579s (+0.5s)	1668	1668	128	57	111	11	0	179
22747	14580s (+0.8s)	3384	3384	256	75	198	8	0	281
22748	14580s (+0.5s)	1624	1624	128	45	114	7	0	166
22749	14581s (+1.3s)	6452	6452	512	131	301	23	0	455
22750	14582s (+0.9s)	3528	3528	256	67	215	15	0	297
22751	14583s (+0.6s)	2348	2348	256	46	145	6	0	197
22752	14583s (+0.7s)	2944	2944	256	63	175	9	1	248
22753	14584s (+0.2s)	548	548	64	16	57	0	3	76
22754	14584s (+0.7s)	2700	2700	256	62	159	7	0	228
22755	14585s (+0.5s)	1744	1744	128	50	107	5	0	162
22756	14586s (+1.0s)	4260	4260	256	91	245	16	0	352
22757	14587s (+1.0s)	5004	5004	512	93	241	18	1	353
22758	14587s (+0.7s)	2416	2416	128	50	170	7	0	227
22759	14588s (+0.3s)	964	964	64	28	80	8	1	117
22760	14588s (+0.6s)	1960	1960	128	50	147	6	0	203
22761	14589s (+0.5s)	1596	1596	128	38	119	8	1	166
22762	14590s (+0.8s)	3464	3464	256	76	198	16	0	290
22763	14590s (+0.6s)	1924	1924	128	45	148	6	0	199
22764	14591s (+0.7s)	3048	3048	256	60	178	9	0	247
22765	14592s (+0.6s)	2492	2492	128	66	146	14	2	228
22766	14592s (+0.4s)	1068	1068	64	32	93	5	0	130
22767	14593s (+0.8s)	3160	3160	256	65	188	12	0	265
22768	14594s (+1.0s)	4160	4160	256	93	228	21	0	342
22769	14595s (+0.8s)	3592	3592	256	76	206	17	1	300
22770	14595s (+0.4s)	1544	1544	128	34	120	5	0	159
22771	14596s (+0.8s)	3500	3500	256	82	197	14	1	294
22772	14596s (+0.3s)	1168	1168	128	20	103	2	0	125
22773	14597s (+0.4s)	1504	1504	128	35	117	6	0	158
22774	14597s (+0.6s)	2424	2424	256	49	150	5	0	204
22775	14598s (+0.8s)	3464	3464	256	54	226	0	16	296
22776	14599s (+0.4s)	1472	1472	128	32	115	1	4	152
22777	14599s (+0.9s)	3884	3884	256	59	244	0	14	317
22778	14600s (+0.8s)	3460	3460	256	52	229	0	11	292
22779	14601s (+0.9s)	3880	3880	256	63	256	0	12	331
22780	14602s (+0.5s)	1604	1604	128	31	133	0	4	168
22781	14602s (+0.6s)	2604	2604	256	61	153	0	12	226
22782	14603s (+0.6s)	2384	2384	256	36	157	0	6	199
22783	14604s (+0.6s)	1940	1940	128	39	146	0	8	193
22784	14604s (+0.7s)	3056	3056	256	51	189	0	10	250
22785	14605s (+0.5s)	1848	1848	128	36	138	0	7	181
22786	14605s (+0.6s)	2664	2664	256	47	170	0	8	225
22787	14606s (+0.8s)	3612	3612	256	59	229	0	12	300
22788	14607s (+0.6s)	2532	2532	256	42	160	0	9	211
22789	14607s (+0.4s)	1464	1464	128	24	126	0	4	154
22790	14608s (+0.5s)	1788	1788	128	47	130	5	0	182
22791	14608s (+0.4s)	1352	1352	128	31	102	10	0	143
22792	14609s (+0.9s)	3616	3616	256	78	213	15	0	306
22793	14610s (+0.8s)	3328	3328	256	68	201	9	0	278
22794	14611s (+0.7s)	2788	2788	256	53	179	8	0	240
22795	14611s (+0.3s)	920	920	64	20	86	5	1	112
22796	14611s (+0.4s)	1372	1372	128	29	104	5	0	138
22797	14612s (+0.9s)	4076	4076	256	72	257	12	0	341
22798	14613s (+0.6s)	1944	1944	128	46	143	15	0	204
22799	14614s (+0.8s)	3416	3416	256	64	206	0	12	282
Episode	Time	Reward	Score	Highest	L	U	R	D	Steps
22800	14615s (+0.9s)	3708	3708	256	73	223	0	14	310
22801	14615s (+0.7s)	3052	3052	256	45	193	0	14	252
22802	14616s (+0.5s)	1680	1680	128	36	129	0	7	172
22803	14617s (+0.7s)	2976	2976	256	56	182	13	0	251
22804	14617s (+0.3s)	916	916	64	31	86	3	0	120
22805	14618s (+1.0s)	5144	5144	512	104	245	17	0	366
22806	14619s (+0.7s)	2492	2492	128	55	170	9	0	234
22807	14619s (+0.3s)	1040	1040	128	20	85	3	0	108
22808	14619s (+0.4s)	1500	1500	128	46	107	5	0	158
22809	14620s (+0.8s)	3512	3512	256	89	188	18	1	296
22810	14621s (+0.5s)	1680	1680	128	49	111	11	0	171
22811	14621s (+0.6s)	1856	1856	128	51	135	8	0	194
22812	14622s (+0.9s)	3668	3668	256	66	223	11	0	300
22813	14623s (+1.0s)	4300	4300	256	89	240	21	0	350
22814	14624s (+1.1s)	4688	4688	256	127	244	22	0	393
22815	14625s (+0.5s)	1912	1912	128	52	118	12	0	182
22816	14625s (+0.7s)	3148	3148	256	75	172	12	1	260
22817	14626s (+0.5s)	1780	1780	128	33	141	0	6	180
22818	14626s (+0.5s)	1792	1792	128	43	128	0	12	183
22819	14627s (+0.7s)	2796	2796	256	62	156	17	1	236
22820	14628s (+0.5s)	1872	1872	128	47	134	9	1	191
22821	14628s (+0.5s)	1648	1648	128	57	113	8	0	178
22822	14629s (+0.8s)	3256	3256	256	74	182	9	1	266
22823	14630s (+0.5s)	1840	1840	128	51	130	9	0	190
22824	14630s (+0.5s)	1788	1788	128	45	129	8	0	182
22825	14631s (+1.0s)	4236	4236	256	103	234	19	0	356
22826	14632s (+0.7s)	3152	3152	256	76	168	16	0	260
22827	14633s (+0.8s)	3144	3144	256	59	195	15	0	269
22828	14633s (+0.9s)	3664	3664	256	80	208	15	0	303
22829	14634s (+0.8s)	3184	3184	256	70	180	14	0	264
22830	14635s (+0.5s)	1872	1872	128	41	131	9	0	181
22831	14635s (+0.6s)	2496	2496	256	64	143	8	0	215
22832	14636s (+0.6s)	2428	2428	128	58	155	10	0	223
22833	14637s (+0.6s)	1972	1972	128	62	129	9	0	200
22834	14637s (+0.5s)	1900	1900	128	44	140	9	0	193
22835	14638s (+0.5s)	1772	1772	128	34	137	7	0	178
22836	14639s (+1.0s)	4124	4124	256	89	235	14	0	338
22837	14639s (+0.5s)	1424	1424	64	56	98	5	0	159
22838	14640s (+0.9s)	3780	3780	256	64	233	14	0	311
22839	14641s (+0.7s)	2516	2516	128	59	162	12	0	233
22840	14641s (+0.5s)	1612	1612	128	47	118	0	5	170
22841	14642s (+0.9s)	3944	3944	256	61	252	0	13	326
22842	14642s (+0.2s)	556	556	64	11	65	0	2	78
22843	14643s (+0.4s)	1368	1368	128	39	98	0	5	142
22844	14643s (+0.8s)	2980	2980	256	66	186	0	14	266
22845	14644s (+0.3s)	736	736	64	19	73	0	5	97
22846	14645s (+0.8s)	3356	3356	256	52	220	0	12	284
22847	14645s (+0.5s)	1780	1780	128	41	132	0	7	180
22848	14646s (+0.6s)	2152	2152	128	62	142	12	0	216
22849	14646s (+0.3s)	716	716	64	24	71	2	0	97
22850	14646s (+0.3s)	936	936	64	34	74	7	0	115
22851	14647s (+0.7s)	2824	2824	256	52	183	8	0	243
22852	14648s (+0.5s)	1768	1768	128	42	126	13	0	181
22853	14648s (+0.3s)	1032	1032	128	27	82	4	0	113
22854	14649s (+0.6s)	2468	2468	256	48	154	11	0	213
22855	14649s (+0.4s)	1432	1432	128	49	87	11	0	147
22856	14650s (+0.8s)	3492	3492	256	78	203	11	0	292
22857	14651s (+1.0s)	4260	4260	256	77	246	22	0	345
22858	14652s (+1.1s)	5520	5520	512	101	261	25	1	388
22859	14653s (+0.7s)	3208	3208	256	56	194	10	0	260
22860	14653s (+0.6s)	2556	2556	256	50	160	12	0	222
22861	14654s (+0.8s)	3356	3356	256	74	198	13	0	285
22862	14655s (+1.4s)	6568	6568	512	146	301	26	0	473
22863	14656s (+0.6s)	2216	2216	128	55	144	10	0	209
22864	14657s (+1.2s)	5704	5704	512	121	261	20	0	402
22865	14658s (+0.4s)	1556	1556	128	35	120	4	0	159
22866	14658s (+0.5s)	1776	1776	128	37	134	8	0	179
22867	14659s (+0.4s)	1284	1284	64	28	111	6	0	145
22868	14659s (+0.3s)	1080	1080	128	16	94	3	0	113
22869	14660s (+0.7s)	2788	2788	256	63	166	16	0	245
22870	14661s (+1.0s)	4944	4944	512	80	243	17	1	341
22871	14661s (+0.7s)	2648	2648	256	60	169	8	0	237
22872	14662s (+0.7s)	2872	2872	256	68	170	12	0	250
22873	14663s (+0.6s)	2456	2456	256	48	153	10	0	211
22874	14663s (+0.5s)	1708	1708	128	42	118	12	0	172
22875	14664s (+0.4s)	1480	1480	128	25	126	4	0	155
22876	14665s (+1.0s)	4400	4400	256	91	255	24	0	370
22877	14665s (+0.5s)	1552	1552	128	49	99	11	0	159
22878	14666s (+0.8s)	3180	3180	256	63	191	13	0	267
22879	14667s (+0.8s)	3328	3328	256	76	191	16	0	283
22880	14668s (+0.9s)	3668	3668	256	89	199	16	0	304
22881	14668s (+0.4s)	1388	1388	128	36	102	8	1	147
22882	14669s (+0.6s)	2320	2320	256	57	134	9	0	200
22883	14669s (+0.7s)	2740	2740	256	55	172	7	0	234
22884	14670s (+0.8s)	3356	3356	256	68	208	9	0	285
22885	14670s (+0.3s)	696	696	64	18	68	6	0	92
22886	14671s (+0.6s)	2500	2500	256	44	155	7	0	206
22887	14672s (+0.6s)	2416	2416	128	49	158	12	1	220
22888	14673s (+1.1s)	5500	5500	512	100	271	12	0	383
22889	14673s (+0.7s)	2904	2904	256	56	182	14	0	252
22890	14674s (+0.5s)	1712	1712	128	31	137	5	0	173
22891	14674s (+0.4s)	1432	1432	128	28	116	3	0	147
22892	14675s (+0.7s)	2904	2904	256	70	171	11	0	252
22893	14676s (+0.8s)	3556	3556	256	76	198	18	0	292
22894	14677s (+0.7s)	3160	3160	256	51	195	16	0	262
22895	14677s (+0.8s)	3488	3488	256	67	204	21	0	292
22896	14678s (+0.9s)	3984	3984	256	88	227	15	0	330
22897	14679s (+0.5s)	1472	1472	128	46	107	6	0	159
22898	14679s (+0.5s)	1800	1800	128	47	127	11	0	185
22899	14681s (+1.3s)	6772	6772	512	115	310	27	1	453
Episode	Time	Reward	Score	Highest	L	U	R	D	Steps
22900	14681s (+0.3s)	980	980	64	30	84	8	1	123
22901	14681s (+0.3s)	996	996	64	34	79	6	0	119
22902	14682s (+0.4s)	1004	1004	64	35	85	6	0	126
22903	14683s (+1.3s)	6576	6576	512	120	324	22	0	466
22904	14683s (+0.4s)	1432	1432	128	35	107	6	0	148
22905	14684s (+0.6s)	2572	2572	256	56	155	11	0	222
22906	14685s (+0.9s)	3988	3988	256	78	238	15	0	331
22907	14686s (+0.5s)	2192	2192	256	37	144	8	0	189
22908	14686s (+0.9s)	3512	3512	256	66	215	14	2	297
22909	14687s (+1.0s)	4352	4352	256	105	233	25	0	363
22910	14688s (+0.6s)	2356	2356	256	44	145	8	0	197
22911	14689s (+0.9s)	4036	4036	256	70	249	12	0	331
22912	14689s (+0.5s)	1536	1536	128	40	117	6	0	163
22913	14690s (+0.4s)	1228	1228	128	28	97	4	0	129
22914	14691s (+0.9s)	3604	3604	256	72	216	14	1	303
22915	14692s (+1.0s)	4236	4236	256	84	248	17	0	349
22916	14692s (+0.6s)	2340	2340	256	40	152	6	0	198
22917	14693s (+1.0s)	4252	4252	256	93	241	19	0	353
22918	14693s (+0.2s)	596	596	64	16	60	0	5	81
22919	14694s (+0.5s)	1916	1916	128	46	125	0	12	183
22920	14694s (+0.4s)	1348	1348	128	29	102	6	0	137
22921	14695s (+0.8s)	3484	3484	256	80	199	17	1	297
22922	14696s (+0.5s)	1600	1600	128	38	123	7	0	168
22923	14696s (+0.7s)	2868	2868	256	75	163	10	0	248
22924	14697s (+0.8s)	3264	3264	256	70	180	16	1	267
22925	14698s (+0.8s)	3368	3368	256	76	195	11	1	283
22926	14698s (+0.3s)	924	924	64	22	94	5	0	121
22927	14699s (+0.6s)	2420	2420	256	46	143	13	0	202
22928	14700s (+0.7s)	2560	2560	128	62	162	15	0	239
22929	14700s (+0.7s)	2512	2512	128	52	175	8	1	236
22930	14701s (+0.5s)	1564	1564	128	43	107	9	0	159
22931	14702s (+0.8s)	3196	3196	256	70	188	9	0	267
22932	14702s (+0.5s)	1516	1516	128	37	117	8	0	162
22933	14703s (+0.9s)	3944	3944	256	78	230	17	0	325
22934	14703s (+0.3s)	876	876	64	28	80	6	0	114
22935	14704s (+1.0s)	4128	4128	256	95	221	22	1	339
22936	14705s (+0.7s)	3084	3084	256	74	165	14	0	253
22937	14706s (+0.5s)	1868	1868	128	36	128	0	12	176
22938	14706s (+0.4s)	1100	1100	64	21	100	0	10	131
22939	14706s (+0.5s)	1836	1836	128	35	142	0	10	187
22940	14707s (+0.5s)	1648	1648	128	35	120	0	9	164
22941	14707s (+0.4s)	1196	1196	128	33	95	4	0	132
22942	14708s (+0.4s)	1512	1512	128	38	109	3	1	151
22943	14708s (+0.5s)	1544	1544	128	42	116	7	0	165
22944	14709s (+0.5s)	1668	1668	128	44	129	6	0	179
22945	14710s (+1.0s)	4616	4616	256	97	248	19	1	365
22946	14710s (+0.4s)	1236	1236	64	36	97	8	0	141
22947	14711s (+0.8s)	3116	3116	256	70	189	15	0	274
22948	14711s (+0.3s)	824	824	64	29	71	3	0	103
22949	14712s (+1.0s)	4116	4116	256	97	230	16	0	343
22950	14713s (+0.4s)	1196	1196	128	26	100	5	0	131
22951	14713s (+0.5s)	1764	1764	128	45	124	12	0	181
22952	14714s (+0.8s)	3392	3392	256	60	214	5	0	279
22953	14715s (+0.6s)	2696	2696	256	58	165	9	1	233
22954	14715s (+0.5s)	1580	1580	128	50	104	8	0	162
22955	14716s (+0.7s)	3064	3064	256	73	165	11	1	250
22956	14716s (+0.6s)	2496	2496	256	50	154	11	0	215
22957	14717s (+0.5s)	2060	2060	128	54	135	13	0	202
22958	14718s (+0.7s)	2856	2856	256	54	182	10	0	246
22959	14719s (+1.2s)	5612	5612	512	96	286	0	19	401
22960	14719s (+0.1s)	232	232	32	10	34	1	1	46
22961	14719s (+0.2s)	620	620	64	12	69	0	4	85
22962	14720s (+0.5s)	1528	1528	128	29	126	0	6	161
22963	14721s (+1.1s)	5484	5484	512	79	287	0	20	386
22964	14721s (+0.5s)	1896	1896	128	42	144	0	6	192
22965	14722s (+0.7s)	2796	2796	256	47	184	0	12	243
22966	14723s (+0.9s)	4656	4656	512	68	239	0	17	324
22967	14724s (+0.8s)	3404	3404	256	51	226	0	15	292
22968	14724s (+0.4s)	1040	1040	64	38	89	7	0	134
22969	14725s (+0.6s)	1916	1916	128	41	149	7	0	197
22970	14725s (+0.3s)	904	904	64	30	84	0	3	117
22971	14726s (+0.8s)	3712	3712	256	54	220	0	22	296
22972	14727s (+0.7s)	2772	2772	256	49	173	0	15	237
22973	14728s (+0.9s)	3672	3672	256	72	213	0	15	300
22974	14728s (+0.5s)	1540	1540	128	29	128	0	8	165
22975	14729s (+0.5s)	1752	1752	128	32	135	0	8	175
22976	14729s (+0.4s)	1168	1168	64	34	99	6	0	139
22977	14730s (+0.6s)	2136	2136	128	51	142	16	0	209
22978	14730s (+0.8s)	3196	3196	256	70	184	14	0	268
22979	14731s (+0.9s)	3828	3828	256	77	211	19	0	307
22980	14732s (+0.3s)	804	804	64	23	76	4	0	103
22981	14732s (+0.6s)	2324	2324	128	52	161	10	0	223
22982	14733s (+0.7s)	3292	3292	256	67	194	14	0	275
22983	14734s (+0.9s)	4028	4028	256	87	224	16	0	327
22984	14734s (+0.4s)	1344	1344	128	30	113	4	0	147
22985	14735s (+0.7s)	3176	3176	256	67	178	16	1	262
22986	14736s (+1.0s)	4200	4200	256	98	233	16	0	347
22987	14737s (+0.6s)	2148	2148	128	60	144	9	0	213
22988	14738s (+0.9s)	4672	4672	512	74	229	13	1	317
22989	14738s (+0.6s)	1976	1976	128	40	152	0	5	197
22990	14739s (+0.5s)	1780	1780	128	38	133	0	8	179
22991	14740s (+1.0s)	4184	4184	256	93	238	16	1	348
22992	14740s (+0.3s)	800	800	64	21	82	4	0	107
22993	14741s (+0.8s)	3232	3232	256	57	198	12	2	269
22994	14741s (+0.5s)	1616	1616	128	32	131	0	8	171
22995	14742s (+0.5s)	1592	1592	128	44	112	0	9	165
22996	14743s (+1.1s)	5516	5516	512	84	291	0	19	394
22997	14743s (+0.4s)	1548	1548	128	30	118	0	5	153
22998	14744s (+0.9s)	3668	3668	256	86	202	16	0	304
22999	14745s (+0.9s)	4052	4052	256	96	220	15	0	331
Episode	Time	Reward	Score	Highest	L	U	R	D	Steps
23000	14746s (+0.9s)	3604	3604	256	78	204	16	1	299
23001	14746s (+0.3s)	888	888	64	30	81	6	0	117
23002	14747s (+0.9s)	3852	3852	256	75	226	12	0	313
23003	14748s (+0.4s)	1492	1492	128	41	106	9	0	156
23004	14749s (+1.3s)	6420	6420	512	111	312	24	0	447
23005	14749s (+0.5s)	1504	1504	128	32	123	5	0	160
23006	14750s (+0.4s)	1364	1364	128	30	113	0	8	151
23007	14751s (+1.5s)	7532	7532	512	102	400	0	27	529
23008	14752s (+0.8s)	3400	3400	256	58	216	0	11	285
23009	14753s (+0.6s)	2264	2264	128	50	157	0	14	221
23010	14753s (+0.5s)	1740	1740	128	39	124	11	0	174
23011	14754s (+0.5s)	1744	1744	128	60	114	10	0	184
23012	14755s (+0.8s)	3504	3504	256	81	196	17	0	294
23013	14755s (+0.8s)	3264	3264	256	63	204	12	0	279
23014	14756s (+0.7s)	3068	3068	256	68	181	17	0	266
23015	14757s (+0.6s)	2068	2068	128	50	148	10	0	208
23016	14758s (+0.9s)	3856	3856	256	87	215	21	0	323
23017	14758s (+0.5s)	1672	1672	128	49	113	8	0	170
23018	14759s (+0.7s)	2892	2892	256	49	178	10	0	237
23019	14760s (+0.9s)	3848	3848	256	93	199	21	0	313
23020	14761s (+1.4s)	7556	7556	512	140	353	31	0	524
23021	14763s (+1.5s)	7528	7528	512	141	358	28	1	528
23022	14764s (+0.7s)	2736	2736	256	59	163	9	1	232
23023	14764s (+0.7s)	3084	3084	256	50	191	14	0	255
23024	14765s (+0.9s)	4644	4644	512	80	221	19	1	321
23025	14766s (+0.7s)	3040	3040	256	55	185	6	0	246
23026	14766s (+0.5s)	1580	1580	128	34	121	10	2	167
23027	14767s (+0.5s)	1892	1892	128	52	126	10	0	188
23028	14767s (+0.4s)	1368	1368	128	32	109	2	0	143
23029	14768s (+0.7s)	2772	2772	256	51	161	14	0	226
23030	14769s (+0.7s)	2520	2520	128	63	162	12	0	237
23031	14770s (+0.8s)	3552	3552	256	68	220	14	0	302
23032	14770s (+0.4s)	1228	1228	128	33	96	5	0	134
23033	14771s (+1.2s)	5828	5828	512	110	286	22	0	418
23034	14772s (+1.0s)	4224	4224	256	99	230	17	1	347
23035	14773s (+0.8s)	3316	3316	256	71	193	13	0	277
23036	14773s (+0.3s)	788	788	64	24	75	6	0	105
23037	14774s (+0.4s)	1528	1528	128	36	118	7	0	161
23038	14774s (+0.7s)	2816	2816	256	70	165	10	1	246
23039	14775s (+0.5s)	1848	1848	128	43	143	6	0	192
23040	14776s (+1.1s)	5648	5648	512	101	282	18	0	401
23041	14777s (+0.9s)	4132	4132	256	82	243	14	0	339
23042	14778s (+0.9s)	3940	3940	256	72	231	16	0	319
23043	14779s (+0.6s)	1908	1908	128	56	129	8	0	193
23044	14779s (+0.8s)	3360	3360	256	65	211	10	0	286
23045	14780s (+0.6s)	2588	2588	256	48	166	8	0	222
23046	14781s (+0.7s)	3064	3064	256	60	182	10	0	252
23047	14781s (+0.6s)	2496	2496	256	48	159	8	0	215
23048	14782s (+0.6s)	2648	2648	256	49	169	6	0	224
23049	14783s (+0.7s)	2804	2804	256	65	167	12	0	244
23050	14784s (+1.1s)	5680	5680	512	106	270	27	0	403
23051	14784s (+0.7s)	2900	2900	256	53	171	7	0	231
23052	14785s (+1.0s)	4172	4172	256	94	222	21	1	338
23053	14786s (+0.5s)	2048	2048	256	38	124	6	1	169
23054	14786s (+0.5s)	1540	1540	128	38	116	9	0	163
23055	14787s (+0.5s)	1836	1836	128	38	139	6	0	183
23056	14787s (+0.5s)	1876	1876	128	48	144	7	0	199
23057	14788s (+0.9s)	3916	3916	256	71	237	10	0	318
23058	14789s (+0.4s)	1176	1176	128	29	93	5	0	127
23059	14790s (+0.8s)	3580	3580	256	88	199	15	0	302
23060	14790s (+0.6s)	2524	2524	256	50	157	15	0	222
23061	14791s (+0.8s)	3528	3528	256	65	217	13	0	295
23062	14791s (+0.4s)	1176	1176	128	27	92	7	1	127
23063	14792s (+0.6s)	2484	2484	256	58	146	9	0	213
23064	14793s (+0.5s)	1696	1696	128	42	116	10	0	168
23065	14793s (+0.7s)	3196	3196	256	52	203	11	0	266
23066	14794s (+0.5s)	1584	1584	128	42	117	8	0	167
23067	14794s (+0.6s)	2244	2244	128	47	151	11	0	209
23068	14795s (+0.5s)	1672	1672	128	45	115	9	0	169
23069	14795s (+0.5s)	1596	1596	128	43	116	7	0	166
23070	14796s (+1.1s)	4520	4520	256	108	248	16	0	372
23071	14797s (+0.4s)	1316	1316	128	31	109	4	0	144
23072	14797s (+0.4s)	1196	1196	128	29	97	4	0	130
23073	14798s (+0.7s)	3060	3060	256	53	187	0	10	250
23074	14799s (+0.8s)	3372	3372	256	54	223	0	12	289
23075	14799s (+0.4s)	1432	1432	128	30	111	0	7	148
23076	14800s (+0.7s)	2776	2776	256	32	199	0	7	238
23077	14800s (+0.4s)	1464	1464	128	37	105	0	8	150
23078	14801s (+1.0s)	4252	4252	256	77	258	0	18	353
23079	14802s (+0.7s)	2724	2724	256	55	166	0	13	234
23080	14803s (+0.6s)	1912	1912	128	37	153	0	6	196
23081	14803s (+0.7s)	3124	3124	256	49	197	0	9	255
23082	14804s (+1.0s)	4116	4116	256	86	236	0	14	336
23083	14805s (+0.7s)	3056	3056	256	62	177	12	0	251
23084	14806s (+0.8s)	3372	3372	256	74	199	16	0	289
23085	14806s (+0.2s)	624	624	64	14	66	1	0	81
23086	14807s (+0.9s)	4212	4212	256	95	211	19	1	326
23087	14808s (+1.3s)	6296	6296	512	115	315	18	0	448
23088	14809s (+0.8s)	3148	3148	256	66	189	15	0	270
23089	14810s (+0.9s)	3876	3876	256	72	223	17	0	312
23090	14810s (+0.7s)	2704	2704	256	58	164	12	1	235
23091	14811s (+0.8s)	3408	3408	256	78	190	15	0	283
23092	14812s (+0.6s)	2520	2520	256	45	162	7	0	214
23093	14813s (+0.6s)	2448	2448	256	44	155	8	1	208
23094	14814s (+1.0s)	5172	5172	512	89	242	26	0	357
23095	14814s (+0.7s)	2412	2412	128	51	164	11	0	226
23096	14815s (+0.9s)	4044	4044	256	84	231	18	0	333
23097	14816s (+0.5s)	1740	1740	128	36	136	5	0	177
23098	14816s (+0.8s)	3324	3324	256	54	214	9	0	277
23099	14817s (+0.4s)	1392	1392	128	35	104	7	0	146
Episode	Time	Reward	Score	Highest	L	U	R	D	Steps
23100	14818s (+0.8s)	3096	3096	256	67	184	12	1	264
23101	14818s (+0.3s)	712	712	64	23	70	1	1	95
23102	14819s (+1.2s)	6264	6264	512	111	306	25	0	442
23103	14820s (+0.6s)	2476	2476	256	48	153	11	0	212
23104	14820s (+0.5s)	1780	1780	128	48	126	5	1	180
23105	14821s (+0.3s)	792	792	64	22	72	6	0	100
23106	14821s (+0.6s)	2120	2120	128	66	126	18	0	210
23107	14822s (+0.4s)	1092	1092	64	48	76	8	0	132
23108	14822s (+0.7s)	2884	2884	256	60	178	9	2	249
23109	14823s (+0.5s)	1592	1592	128	31	130	4	0	165
23110	14823s (+0.7s)	2956	2956	256	56	190	12	0	258
23111	14824s (+0.4s)	1344	1344	128	28	108	2	0	138
23112	14824s (+0.5s)	1608	1608	128	49	111	9	0	169
23113	14825s (+0.4s)	1228	1228	64	44	99	6	0	149
23114	14825s (+0.3s)	1056	1056	128	20	90	3	0	113
23115	14826s (+0.6s)	2456	2456	256	54	144	12	0	210
23116	14826s (+0.3s)	872	872	64	17	82	0	5	104
23117	14827s (+0.7s)	2896	2896	256	61	177	0	12	250
23118	14827s (+0.5s)	1896	1896	128	42	139	0	11	192
23119	14828s (+0.4s)	1516	1516	128	25	120	0	17	162
23120	14829s (+0.9s)	3768	3768	256	65	234	0	10	309
23121	14830s (+0.9s)	3980	3980	256	70	243	0	16	329
23122	14830s (+0.5s)	1716	1716	128	34	134	0	6	174
23123	14831s (+1.1s)	5684	5684	512	97	284	0	22	403
23124	14832s (+0.8s)	3280	3280	256	63	203	0	12	278
23125	14833s (+0.5s)	1608	1608	128	36	124	0	9	169
23126	14834s (+1.0s)	4424	4424	256	77	266	0	22	365
23127	14834s (+0.5s)	1924	1924	128	34	158	0	7	199
23128	14835s (+0.8s)	3416	3416	256	66	202	0	17	285
23129	14836s (+0.7s)	2832	2832	256	39	179	0	12	230
23130	14836s (+0.5s)	1672	1672	128	49	113	6	0	168
23131	14837s (+0.5s)	1880	1880	128	46	137	7	0	190
23132	14837s (+0.6s)	2076	2076	128	55	139	11	0	205
23133	14838s (+0.8s)	3552	3552	256	75	202	14	0	291
23134	14839s (+0.7s)	2780	2780	128	78	163	17	0	258
23135	14839s (+0.5s)	1576	1576	128	41	115	6	0	162
23136	14840s (+1.0s)	4148	4148	256	81	240	18	0	339
23137	14841s (+0.4s)	1492	1492	128	33	119	6	0	158
23138	14842s (+0.9s)	4680	4680	512	70	243	12	0	325
23139	14842s (+0.8s)	3380	3380	256	73	191	16	1	281
23140	14843s (+0.5s)	1716	1716	128	40	121	8	1	170
23141	14844s (+0.7s)	2760	2760	256	50	175	14	0	239
23142	14844s (+0.3s)	736	736	64	22	72	2	0	96
23143	14844s (+0.5s)	1788	1788	128	36	134	11	1	182
23144	14845s (+0.5s)	1548	1548	128	36	120	10	0	166
23145	14845s (+0.5s)	1496	1496	128	35	117	7	0	159
23146	14846s (+0.9s)	3996	3996	256	80	234	13	0	327
23147	14847s (+0.3s)	804	804	64	29	71	2	0	102
23148	14847s (+0.4s)	1360	1360	128	39	97	5	0	141
23149	14847s (+0.5s)	1624	1624	128	26	135	3	0	164
23150	14848s (+0.5s)	1516	1516	128	43	108	6	1	158
23151	14848s (+0.5s)	1820	1820	128	47	132	10	0	189
23152	14850s (+1.1s)	5336	5336	512	87	263	20	0	370
23153	14850s (+0.5s)	2160	2160	256	34	145	6	0	185
23154	14851s (+0.8s)	3368	3368	256	58	207	12	0	277
23155	14851s (+0.5s)	1812	1812	128	41	137	9	0	187
23156	14852s (+0.4s)	1408	1408	128	34	102	10	0	146
23157	14853s (+0.8s)	3440	3440	256	75	203	8	0	286
23158	14853s (+0.3s)	964	964	64	34	81	5	0	120
23159	14853s (+0.4s)	1216	1216	128	27	100	4	1	132
23160	14854s (+0.4s)	1236	1236	64	21	118	0	2	141
23161	14854s (+0.6s)	2200	2200	128	44	148	0	13	205
23162	14855s (+0.3s)	1084	1084	128	22	87	0	5	114
23163	14856s (+0.8s)	3404	3404	256	55	211	0	16	282
23164	14856s (+0.7s)	2780	2780	256	58	174	0	10	242
23165	14857s (+0.6s)	1924	1924	128	51	137	0	7	195
23166	14857s (+0.6s)	1956	1956	128	38	150	0	6	194
23167	14858s (+0.6s)	1936	1936	128	46	147	0	9	202
23168	14858s (+0.5s)	1788	1788	128	33	139	0	10	182
23169	14859s (+0.5s)	1796	1796	128	40	137	0	7	184
23170	14859s (+0.3s)	1092	1092	128	31	80	4	0	115
23171	14860s (+0.7s)	2888	2888	256	52	186	10	0	248
23172	14861s (+0.6s)	1904	1904	128	56	127	12	0	195
23173	14861s (+0.4s)	1412	1412	128	30	110	9	0	149
23174	14861s (+0.4s)	1424	1424	128	39	103	4	0	146
23175	14862s (+0.8s)	3332	3332	256	57	210	10	0	277
23176	14863s (+0.6s)	2420	2420	256	53	149	10	0	212
23177	14863s (+0.3s)	1032	1032	64	24	92	6	0	122
23178	14864s (+1.1s)	5472	5472	512	90	270	22	1	383
23179	14865s (+0.5s)	1808	1808	128	44	136	7	0	187
23180	14866s (+0.8s)	3436	3436	256	74	191	19	0	284
23181	14866s (+0.5s)	1560	1560	128	42	119	8	0	169
23182	14867s (+1.2s)	6008	6008	512	117	282	23	0	422
23183	14868s (+0.3s)	912	912	64	30	86	3	0	119
23184	14869s (+0.9s)	3944	3944	256	86	219	21	0	326
23185	14869s (+0.5s)	1684	1684	128	45	123	5	0	173
23186	14870s (+0.8s)	2832	2832	128	73	179	10	1	263
23187	14870s (+0.4s)	1404	1404	128	33	112	6	0	151
23188	14871s (+0.8s)	3560	3560	256	77	203	10	0	290
23189	14872s (+0.5s)	1492	1492	128	46	106	5	0	157
23190	14872s (+0.6s)	1928	1928	128	47	146	7	0	200
23191	14873s (+0.4s)	1288	1288	128	21	112	4	0	137
23192	14873s (+0.5s)	1692	1692	128	37	126	11	0	174
23193	14873s (+0.3s)	860	860	64	19	89	3	0	111
23194	14874s (+0.3s)	1012	1012	64	28	90	4	0	122
23195	14875s (+0.9s)	3916	3916	256	95	210	21	0	326
23196	14875s (+0.8s)	3100	3100	256	69	188	0	11	268
23197	14876s (+0.4s)	1092	1092	64	25	102	0	3	130
23198	14877s (+0.7s)	2896	2896	256	51	191	0	9	251
23199	14877s (+0.8s)	3296	3296	256	54	215	0	13	282
Episode	Time	Reward	Score	Highest	L	U	R	D	Steps
23200	14878s (+0.5s)	2108	2108	128	35	156	0	9	200
23201	14878s (+0.3s)	1044	1044	64	30	90	0	5	125
23202	14879s (+0.4s)	1336	1336	128	31	103	0	8	142
23203	14879s (+0.6s)	2656	2656	256	51	165	0	8	224
23204	14880s (+0.6s)	2604	2604	256	38	171	0	8	217
23205	14881s (+0.6s)	2504	2504	256	43	157	0	8	208
23206	14881s (+0.8s)	3240	3240	256	51	212	0	10	273
23207	14882s (+0.8s)	3380	3380	256	63	218	0	9	290
23208	14883s (+0.6s)	2396	2396	256	40	153	0	7	200
23209	14884s (+0.9s)	4096	4096	256	72	244	0	15	331
23210	14884s (+0.1s)	180	180	16	9	32	0	3	44
23211	14885s (+0.8s)	3456	3456	256	55	219	0	11	285
23212	14885s (+0.8s)	3408	3408	256	74	192	16	0	282
23213	14886s (+0.8s)	3508	3508	256	77	206	14	0	297
23214	14887s (+0.7s)	2756	2756	128	66	177	12	0	255
23215	14888s (+0.8s)	3416	3416	256	78	187	20	0	285
23216	14888s (+0.5s)	1916	1916	128	44	143	10	0	197
23217	14889s (+1.0s)	4208	4208	256	87	242	25	0	354
23218	14890s (+0.6s)	1992	1992	128	60	132	9	0	201
23219	14891s (+0.8s)	3560	3560	256	76	213	14	1	304
23220	14891s (+0.4s)	1456	1456	128	33	118	5	0	156
23221	14892s (+0.5s)	1744	1744	128	51	117	8	0	176
23222	14893s (+1.0s)	4272	4272	256	81	251	19	0	351
23223	14893s (+0.6s)	2564	2564	256	53	152	11	0	216
23224	14894s (+0.9s)	3624	3624	256	75	213	14	0	302
23225	14895s (+0.9s)	4168	4168	256	102	216	20	0	338
23226	14896s (+0.7s)	2840	2840	256	55	166	12	0	233
23227	14897s (+0.9s)	4196	4196	256	86	241	16	0	343
23228	14897s (+0.5s)	1612	1612	128	43	122	5	0	170
23229	14898s (+0.4s)	1436	1436	128	29	112	7	0	148
23230	14898s (+0.6s)	1936	1936	128	48	146	8	0	202
23231	14899s (+0.7s)	3252	3252	256	63	192	7	0	262
23232	14900s (+0.5s)	1796	1796	128	44	130	10	0	184
23233	14900s (+0.5s)	1756	1756	128	46	127	6	0	179
23234	14901s (+0.8s)	3300	3300	256	59	208	9	0	276
23235	14901s (+0.5s)	1816	1816	128	42	133	7	0	182
23236	14902s (+0.5s)	1692	1692	128	43	122	9	0	174
23237	14903s (+0.6s)	2704	2704	256	52	149	11	1	213
23238	14903s (+0.8s)	3500	3500	256	70	204	21	1	296
23239	14904s (+0.8s)	3396	3396	256	69	204	12	0	285
23240	14905s (+0.7s)	2768	2768	256	56	174	6	0	236
23241	14905s (+0.4s)	1268	1268	128	28	100	6	0	134
23242	14906s (+0.7s)	2932	2932	256	66	181	12	0	259
23243	14906s (+0.5s)	1592	1592	128	43	118	4	0	165
23244	14907s (+0.5s)	1696	1696	128	42	125	9	0	176
23245	14908s (+1.3s)	6284	6284	512	135	300	22	0	457
23246	14909s (+0.6s)	2388	2388	128	61	154	10	0	225
23247	14909s (+0.3s)	784	784	64	23	74	6	0	103
23248	14910s (+0.5s)	1628	1628	128	32	130	3	0	165
23249	14910s (+0.4s)	1104	1104	64	50	77	8	0	135
23250	14911s (+0.7s)	3076	3076	256	44	188	0	15	247
23251	14911s (+0.3s)	964	964	128	16	79	0	6	101
23252	14911s (+0.3s)	1028	1028	64	27	89	0	9	125
23253	14912s (+0.6s)	2688	2688	256	53	167	0	8	228
23254	14912s (+0.4s)	1308	1308	128	26	106	0	2	134
23255	14913s (+0.8s)	3340	3340	256	59	211	0	11	281
23256	14914s (+0.3s)	768	768	64	22	71	0	8	101
23257	14914s (+0.4s)	1004	1004	64	35	81	6	0	122
23258	14914s (+0.3s)	668	668	64	17	67	3	1	88
23259	14915s (+0.8s)	3280	3280	256	74	185	16	0	275
23260	14915s (+0.5s)	1716	1716	128	38	130	8	0	176
23261	14916s (+0.4s)	1372	1372	128	44	92	7	1	144
23262	14917s (+0.7s)	3040	3040	256	68	173	13	1	255
23263	14917s (+0.3s)	644	644	64	23	61	3	0	87
23264	14917s (+0.6s)	1920	1920	128	52	133	13	0	198
23265	14918s (+0.9s)	3776	3776	256	91	204	19	1	315
23266	14919s (+0.8s)	3320	3320	256	73	175	18	1	267
23267	14920s (+0.4s)	1528	1528	128	35	119	7	0	161
23268	14920s (+0.7s)	2824	2824	256	70	165	14	0	249
23269	14921s (+0.5s)	1568	1568	128	37	114	9	0	160
23270	14922s (+0.9s)	3976	3976	256	85	233	11	0	329
23271	14922s (+0.7s)	2776	2776	256	53	172	13	0	238
23272	14923s (+0.4s)	1408	1408	128	30	113	4	0	147
23273	14923s (+0.4s)	1388	1388	128	35	105	7	0	147
23274	14924s (+0.5s)	1728	1728	128	37	133	0	7	177
23275	14924s (+0.7s)	2828	2828	256	42	192	0	10	244
23276	14925s (+0.3s)	732	732	64	23	68	0	5	96
23277	14925s (+0.9s)	3680	3680	256	60	227	0	16	303
23278	14926s (+0.7s)	3044	3044	256	55	183	0	8	246
23279	14927s (+0.5s)	1784	1784	128	40	131	0	10	181
23280	14928s (+0.8s)	3284	3284	256	46	223	0	10	279
23281	14928s (+0.6s)	2060	2060	128	41	142	0	9	192
23282	14929s (+0.7s)	3112	3112	256	56	187	0	15	258
23283	14930s (+0.7s)	2880	2880	256	54	182	0	11	247
23284	14930s (+0.6s)	2596	2596	256	43	165	0	12	220
23285	14931s (+0.5s)	1668	1668	128	32	130	0	7	169
23286	14931s (+0.7s)	2864	2864	256	62	182	0	10	254
23287	14932s (+0.5s)	1656	1656	128	33	133	0	10	176
23288	14932s (+0.4s)	1468	1468	128	26	115	0	11	152
23289	14933s (+0.4s)	1528	1528	128	33	124	0	4	161
23290	14933s (+0.6s)	2760	2760	256	62	164	0	9	235
23291	14934s (+0.6s)	2420	2420	256	37	167	0	6	210
23292	14935s (+0.5s)	1624	1624	128	38	128	0	7	173
23293	14935s (+0.5s)	1892	1892	128	36	152	0	4	192
23294	14935s (+0.2s)	648	648	64	10	72	0	4	86
23295	14936s (+1.1s)	5508	5508	512	72	298	0	17	387
23296	14937s (+0.5s)	1540	1540	128	28	123	0	4	155
23297	14937s (+0.5s)	1708	1708	128	31	131	0	10	172
23298	14938s (+0.6s)	2532	2532	256	36	167	0	8	211
23299	14938s (+0.4s)	1312	1312	128	26	101	0	7	134
Episode	Time	Reward	Score	Highest	L	U	R	D	Steps
23300	14939s (+0.7s)	2892	2892	256	50	188	0	12	250
23301	14940s (+0.4s)	1396	1396	128	32	109	4	4	149
23302	14940s (+0.3s)	712	712	64	12	81	3	0	96
23303	14940s (+0.3s)	700	700	64	19	68	5	0	92
23304	14941s (+0.5s)	1540	1540	128	34	121	9	0	164
23305	14941s (+0.5s)	1788	1788	128	42	132	9	0	183
23306	14942s (+0.6s)	2560	2560	256	61	149	10	0	220
23307	14942s (+0.7s)	2816	2816	256	60	168	11	0	239
23308	14943s (+0.5s)	1424	1424	64	55	99	5	0	159
23309	14944s (+0.8s)	3320	3320	256	61	204	15	1	281
23310	14944s (+0.5s)	1684	1684	128	50	114	8	1	173
23311	14945s (+0.5s)	1688	1688	128	40	124	9	0	173
23312	14945s (+0.5s)	1876	1876	128	60	119	12	0	191
23313	14946s (+0.9s)	4188	4188	256	97	225	19	1	342
23314	14947s (+0.5s)	1928	1928	128	54	121	11	0	186
23315	14947s (+0.5s)	1772	1772	128	45	128	5	0	178
23316	14948s (+1.2s)	5788	5788	512	95	294	24	0	413
23317	14949s (+0.4s)	1320	1320	128	35	104	6	0	145
23318	14950s (+0.6s)	2836	2836	256	55	163	9	0	227
23319	14950s (+0.4s)	1448	1448	128	52	92	7	0	151
23320	14951s (+0.5s)	1852	1852	128	48	133	5	0	186
23321	14951s (+0.5s)	1992	1992	128	57	134	10	0	201
23322	14951s (+0.3s)	840	840	64	20	82	5	0	107
23323	14952s (+0.3s)	844	844	64	29	77	7	0	113
23324	14953s (+1.0s)	4316	4316	256	89	252	21	0	362
23325	14954s (+0.9s)	3812	3812	256	81	227	15	0	323
23326	14954s (+0.7s)	2648	2648	256	60	157	10	0	227
23327	14955s (+0.6s)	2664	2664	256	50	168	8	0	226
23328	14956s (+0.9s)	3804	3804	256	66	230	12	0	308
23329	14957s (+1.0s)	4468	4468	256	92	255	16	0	363
23330	14958s (+1.1s)	5488	5488	512	109	251	21	0	381
23331	14959s (+1.0s)	4240	4240	256	99	230	21	0	350
23332	14959s (+0.4s)	1008	1008	64	29	85	6	0	120
23333	14960s (+0.8s)	3388	3388	256	69	197	16	1	283
23334	14961s (+0.8s)	3448	3448	256	64	209	14	0	287
23335	14962s (+1.2s)	6268	6268	512	106	315	20	0	441
23336	14963s (+0.4s)	1012	1012	64	33	88	6	0	127
23337	14963s (+0.9s)	3556	3556	256	72	217	14	0	303
23338	14964s (+0.7s)	2920	2920	256	60	185	11	0	256
23339	14966s (+1.5s)	7532	7532	512	136	368	26	0	530
23340	14966s (+0.5s)	1812	1812	128	45	133	9	0	187
23341	14967s (+0.3s)	976	976	64	22	85	0	8	115
23342	14967s (+0.5s)	1848	1848	128	45	133	8	0	186
23343	14968s (+0.5s)	1588	1588	128	40	123	0	8	171
23344	14968s (+0.3s)	660	660	32	29	62	0	2	93
23345	14969s (+0.5s)	1600	1600	128	33	129	0	6	168
23346	14969s (+0.7s)	2720	2720	256	45	179	0	9	233
23347	14970s (+0.5s)	1808	1808	128	51	126	9	0	186
23348	14970s (+0.6s)	1932	1932	128	34	161	0	6	201
23349	14971s (+1.0s)	4172	4172	256	61	269	0	15	345
23350	14972s (+0.4s)	1376	1376	128	23	113	0	9	145
23351	14972s (+0.3s)	728	728	64	25	68	0	5	98
23352	14973s (+0.7s)	2928	2928	256	56	190	0	12	258
23353	14974s (+0.8s)	3572	3572	256	71	214	0	14	299
23354	14974s (+0.3s)	1056	1056	64	33	86	8	0	127
23355	14975s (+0.5s)	1812	1812	128	46	137	5	0	188
23356	14975s (+0.4s)	1204	1204	64	42	95	6	0	143
23357	14976s (+1.3s)	6560	6560	512	113	331	27	0	471
23358	14977s (+1.0s)	4196	4196	256	90	242	19	0	351
23359	14978s (+0.5s)	1848	1848	128	43	143	6	0	192
23360	14978s (+0.5s)	1740	1740	128	45	121	10	0	176
23361	14979s (+0.5s)	1576	1576	128	41	117	4	0	162
23362	14980s (+1.0s)	5180	5180	512	80	261	17	0	358
23363	14980s (+0.5s)	1668	1668	128	37	127	6	0	170
23364	14981s (+1.1s)	5504	5504	512	99	266	25	1	391
23365	14982s (+0.9s)	3568	3568	256	75	209	15	0	299
23366	14983s (+0.5s)	1564	1564	128	27	127	0	9	163
23367	14984s (+0.7s)	2920	2920	256	84	157	16	0	257
23368	14984s (+0.6s)	2224	2224	128	54	148	9	0	211
23369	14985s (+0.6s)	1904	1904	128	43	148	3	0	194
23370	14985s (+0.4s)	1292	1292	128	29	110	6	0	145
23371	14986s (+0.6s)	2452	2452	256	43	161	5	1	210
23372	14986s (+0.4s)	1216	1216	128	38	87	7	0	132
23373	14987s (+1.1s)	6104	6104	512	108	272	22	1	403
23374	14988s (+0.5s)	2172	2172	256	36	139	8	0	183
23375	14989s (+0.8s)	3384	3384	256	74	186	18	0	278
23376	14989s (+0.4s)	1476	1476	128	29	117	6	1	153
23377	14990s (+0.6s)	2620	2620	256	47	164	7	0	218
23378	14990s (+0.8s)	3520	3520	256	93	183	18	0	294
23379	14991s (+0.5s)	1896	1896	128	39	147	6	0	192
23380	14992s (+0.8s)	3192	3192	256	61	190	13	0	264
23381	14992s (+0.4s)	1088	1088	64	37	92	6	0	135
23382	14993s (+0.6s)	2532	2532	256	54	158	8	0	220
23383	14993s (+0.4s)	1320	1320	128	25	107	4	0	136
23384	14994s (+0.6s)	1964	1964	128	55	131	15	0	201
23385	14994s (+0.3s)	892	892	64	26	86	6	0	118
23386	14995s (+0.6s)	1888	1888	128	44	145	5	0	194
23387	14995s (+0.8s)	3436	3436	256	68	205	13	0	286
23388	14996s (+0.3s)	912	912	64	28	86	9	0	123
23389	14996s (+0.7s)	2616	2616	256	61	159	9	0	229
23390	14997s (+0.7s)	3188	3188	256	69	182	9	0	260
23391	14997s (+0.2s)	528	528	64	12	61	0	4	77
23392	14998s (+0.6s)	2056	2056	128	50	143	0	8	201
23393	14999s (+0.8s)	3536	3536	256	75	201	0	13	289
23394	15000s (+0.9s)	3768	3768	256	64	222	13	0	299
23395	15000s (+0.8s)	3240	3240	256	66	189	17	0	272
23396	15001s (+1.0s)	4860	4860	512	84	236	15	1	336
23397	15002s (+0.8s)	3564	3564	256	69	215	13	0	297
23398	15003s (+0.8s)	3240	3240	256	60	204	9	0	273
23399	15004s (+0.6s)	2480	2480	256	57	144	11	0	212
Episode	Time	Reward	Score	Highest	L	U	R	D	Steps
23400	15004s (+0.4s)	1068	1068	64	32	94	5	0	131
23401	15005s (+0.7s)	3112	3112	256	67	174	16	0	257
23402	15005s (+0.6s)	2540	2540	128	70	152	13	0	235
23403	15006s (+0.7s)	3244	3244	256	65	199	9	0	273
23404	15007s (+0.6s)	2376	2376	256	61	129	12	0	202
23405	15007s (+0.5s)	1864	1864	128	44	145	4	0	193
23406	15008s (+0.6s)	1968	1968	128	54	144	7	0	205
23407	15008s (+0.4s)	1556	1556	128	30	123	8	0	161
23408	15009s (+0.9s)	3644	3644	256	79	221	13	0	313
23409	15010s (+0.4s)	1500	1500	128	37	117	5	0	159
23410	15010s (+0.4s)	1380	1380	128	34	106	5	0	145
23411	15011s (+0.9s)	3764	3764	256	91	205	16	0	312
23412	15011s (+0.4s)	1504	1504	128	38	112	9	0	159
23413	15012s (+0.2s)	460	460	32	16	55	4	0	75
23414	15013s (+0.8s)	3520	3520	256	81	209	9	0	299
23415	15014s (+1.0s)	4008	4008	256	68	247	0	21	336
23416	15014s (+0.5s)	2292	2292	256	49	135	0	6	190
23417	15014s (+0.4s)	1036	1036	64	25	93	0	6	124
23418	15015s (+0.7s)	2980	2980	256	40	204	0	8	252
23419	15016s (+1.2s)	5760	5760	512	88	307	0	23	418
23420	15017s (+0.3s)	700	700	64	17	70	0	7	94
23421	15017s (+0.6s)	2480	2480	256	47	151	0	9	207
23422	15018s (+0.8s)	3472	3472	256	70	205	0	18	293
23423	15018s (+0.3s)	876	876	64	25	76	0	5	106
23424	15019s (+0.6s)	1904	1904	128	45	142	0	8	195
23425	15020s (+0.9s)	3856	3856	256	98	206	18	0	322
23426	15020s (+0.6s)	2500	2500	256	49	159	4	0	212
23427	15021s (+0.7s)	3088	3088	256	60	182	11	0	253
23428	15022s (+0.5s)	1548	1548	128	41	112	9	0	162
23429	15022s (+0.5s)	1736	1736	128	42	131	3	0	176
23430	15023s (+0.6s)	2464	2464	128	55	165	12	0	232
23431	15023s (+0.4s)	1476	1476	128	37	108	8	0	153
23432	15024s (+1.1s)	5488	5488	512	97	269	19	0	385
23433	15025s (+0.7s)	2896	2896	256	65	174	11	0	250
23434	15026s (+0.6s)	2436	2436	256	45	153	7	1	206
23435	15026s (+0.3s)	812	812	64	25	82	3	0	110
23436	15026s (+0.5s)	1492	1492	128	38	112	7	0	157
23437	15027s (+0.4s)	1056	1056	64	29	93	6	0	128
23438	15027s (+0.7s)	2744	2744	256	48	176	9	1	234
23439	15028s (+0.4s)	1452	1452	128	36	108	4	0	148
23440	15029s (+0.8s)	3260	3260	256	82	183	13	0	278
23441	15029s (+0.5s)	1896	1896	128	52	135	10	0	197
23442	15030s (+0.8s)	3220	3220	256	87	163	17	1	268
23443	15030s (+0.4s)	1032	1032	64	35	87	8	0	130
23444	15031s (+0.5s)	1700	1700	128	48	114	8	1	171
23445	15032s (+0.7s)	2880	2880	256	62	179	10	0	251
23446	15032s (+0.8s)	3248	3248	256	76	184	15	0	275
23447	15033s (+0.5s)	1928	1928	128	55	126	8	0	189
23448	15034s (+0.6s)	2576	2576	256	51	157	9	0	217
23449	15034s (+0.7s)	3148	3148	256	52	192	0	11	255
23450	15035s (+0.5s)	1620	1620	128	31	135	0	6	172
23451	15035s (+0.5s)	1620	1620	128	36	122	0	14	172
23452	15036s (+0.7s)	3192	3192	256	57	194	0	12	263
23453	15037s (+0.6s)	2248	2248	128	45	161	0	10	216
23454	15038s (+1.0s)	4260	4260	256	64	264	0	23	351
23455	15038s (+0.9s)	3488	3488	256	91	190	14	1	296
23456	15040s (+1.1s)	5556	5556	512	90	290	18	1	399
23457	15040s (+0.5s)	1752	1752	128	38	130	11	1	180
23458	15041s (+1.1s)	5352	5352	512	90	261	20	0	371
23459	15042s (+0.6s)	2552	2552	256	75	138	12	0	225
23460	15042s (+0.4s)	1472	1472	128	45	104	7	0	156
23461	15043s (+0.5s)	1672	1672	128	48	113	8	1	170
23462	15043s (+0.5s)	1856	1856	128	46	137	8	0	191
23463	15044s (+0.5s)	1588	1588	128	45	114	5	0	164
23464	15044s (+0.5s)	1800	1800	128	54	127	4	0	185
23465	15045s (+0.4s)	1500	1500	128	33	119	6	0	158
23466	15046s (+0.9s)	3808	3808	256	85	212	17	1	315
23467	15046s (+0.3s)	948	948	64	26	85	6	0	117
23468	15047s (+0.8s)	3488	3488	256	83	184	21	0	288
23469	15047s (+0.6s)	2316	2316	128	67	141	10	0	218
23470	15048s (+0.5s)	1604	1604	128	30	119	0	9	158
23471	15048s (+0.5s)	1784	1784	128	41	128	0	12	181
23472	15049s (+0.7s)	3096	3096	256	52	193	0	13	258
23473	15050s (+0.6s)	1852	1852	128	41	144	0	8	193
23474	15050s (+0.8s)	3328	3328	256	66	186	0	16	268
23475	15051s (+0.3s)	864	864	64	24	81	0	7	112
23476	15051s (+0.6s)	2716	2716	256	57	146	14	0	217
23477	15052s (+0.7s)	2824	2824	256	68	168	13	0	249
23478	15053s (+0.5s)	1884	1884	128	40	140	9	0	189
23479	15053s (+0.5s)	1516	1516	128	34	120	8	0	162
23480	15054s (+0.4s)	1472	1472	128	38	104	10	0	152
23481	15055s (+1.1s)	4592	4592	256	117	246	15	0	378
23482	15055s (+0.5s)	1668	1668	128	34	130	5	0	169
23483	15055s (+0.3s)	916	916	64	33	81	6	0	120
23484	15056s (+0.4s)	1436	1436	128	34	111	7	0	152
23485	15056s (+0.2s)	520	520	32	16	57	0	4	77
23486	15057s (+0.7s)	2656	2656	128	47	187	1	8	243
23487	15057s (+0.5s)	1792	1792	128	39	135	0	9	183
23488	15058s (+0.7s)	2996	2996	256	49	188	0	8	245
23489	15059s (+0.8s)	3224	3224	256	53	203	0	11	267
23490	15059s (+0.4s)	1164	1164	128	18	105	0	3	126
23491	15060s (+0.4s)	1236	1236	64	35	99	0	7	141
23492	15060s (+0.3s)	924	924	64	28	79	6	0	113
23493	15060s (+0.3s)	924	924	64	29	88	5	0	122
23494	15061s (+0.7s)	2924	2924	256	58	183	16	0	257
23495	15062s (+0.8s)	3516	3516	256	57	225	13	0	295
23496	15062s (+0.5s)	2016	2016	128	52	139	8	0	199
23497	15063s (+0.4s)	1412	1412	128	29	104	9	0	142
23498	15063s (+0.5s)	1632	1632	128	49	122	4	0	175
23499	15064s (+0.5s)	1800	1800	128	42	138	5	0	185
Episode	Time	Reward	Score	Highest	L	U	R	D	Steps
23500	15065s (+0.8s)	3220	3220	256	76	179	13	0	268
23501	15065s (+0.4s)	1476	1476	128	38	104	5	0	147
23502	15066s (+0.7s)	3000	3000	256	56	190	10	0	256
23503	15067s (+1.0s)	5276	5276	512	99	243	14	0	356
23504	15068s (+0.8s)	3496	3496	256	71	206	15	0	292
23505	15068s (+0.5s)	1804	1804	128	38	141	7	0	186
23506	15069s (+0.5s)	1916	1916	128	37	133	12	1	183
23507	15069s (+0.5s)	1768	1768	128	47	123	7	0	177
23508	15070s (+0.4s)	1308	1308	128	38	90	5	0	133
23509	15070s (+0.4s)	1488	1488	128	37	110	8	0	155
23510	15071s (+0.7s)	2884	2884	256	49	188	11	0	248
23511	15071s (+0.8s)	3244	3244	256	66	195	14	0	275
23512	15072s (+0.5s)	1768	1768	128	39	134	7	1	181
23513	15073s (+0.8s)	3280	3280	256	66	202	10	0	278
23514	15073s (+0.4s)	1408	1408	128	44	93	9	2	148
23515	15074s (+0.6s)	2356	2356	128	64	153	10	0	227
23516	15075s (+1.2s)	5996	5996	512	104	293	22	0	419
23517	15076s (+0.9s)	3936	3936	256	80	228	15	0	323
23518	15077s (+0.5s)	1776	1776	128	54	118	12	0	184
23519	15077s (+0.4s)	1484	1484	128	50	100	5	0	155
23520	15078s (+0.7s)	3160	3160	256	64	181	13	0	258
23521	15079s (+0.8s)	3448	3448	256	79	189	18	0	286
23522	15079s (+0.5s)	1992	1992	128	43	131	7	0	181
23523	15080s (+0.5s)	1516	1516	128	37	116	5	0	158
23524	15080s (+0.5s)	1768	1768	128	34	144	3	0	181
23525	15081s (+1.1s)	4584	4584	256	102	254	27	0	383
23526	15082s (+0.9s)	3560	3560	256	76	214	14	0	304
23527	15083s (+0.9s)	3844	3844	256	92	211	21	0	324
23528	15084s (+0.8s)	3372	3372	256	70	207	7	0	284
23529	15084s (+0.4s)	1464	1464	128	29	120	2	0	151
23530	15085s (+0.8s)	3296	3296	256	71	184	20	0	275
23531	15086s (+0.9s)	3776	3776	256	83	216	15	0	314
23532	15087s (+0.7s)	2932	2932	256	50	178	12	0	240
23533	15087s (+0.4s)	1420	1420	128	37	103	10	0	150
23534	15088s (+0.9s)	3992	3992	256	70	249	12	1	332
23535	15089s (+0.7s)	2892	2892	256	49	180	10	0	239
23536	15089s (+0.3s)	868	868	64	26	81	5	1	113
23537	15090s (+0.7s)	3008	3008	256	74	167	15	0	256
23538	15090s (+0.6s)	2648	2648	256	51	165	9	1	226
23539	15091s (+1.1s)	5296	5296	512	93	261	16	1	371
23540	15092s (+0.6s)	2448	2448	256	43	154	11	0	208
23541	15093s (+0.5s)	1724	1724	128	49	115	14	0	178
23542	15093s (+0.3s)	788	788	64	22	78	5	0	105
23543	15094s (+1.0s)	5048	5048	512	93	242	22	0	357
23544	15095s (+0.9s)	3672	3672	256	88	208	19	0	315
23545	15096s (+0.9s)	3600	3600	256	93	194	16	0	303
23546	15096s (+0.4s)	1508	1508	128	45	109	6	0	160
23547	15097s (+0.8s)	3420	3420	256	67	213	6	0	286
23548	15098s (+0.8s)	3484	3484	256	80	196	14	0	290
23549	15098s (+0.6s)	2344	2344	128	63	142	19	0	224
23550	15099s (+0.6s)	2744	2744	256	59	146	12	0	217
23551	15100s (+0.8s)	3340	3340	256	58	214	9	0	281
23552	15100s (+0.6s)	2736	2736	256	54	167	11	0	232
23553	15101s (+0.4s)	1460	1460	128	35	111	7	0	153
23554	15102s (+0.8s)	3368	3368	256	68	205	15	0	288
23555	15102s (+0.8s)	3220	3220	256	53	205	9	1	268
23556	15104s (+1.0s)	4328	4328	256	88	255	17	0	360
23557	15104s (+0.5s)	1480	1480	128	45	99	11	0	155
23558	15105s (+0.8s)	3444	3444	256	76	191	19	0	286
23559	15106s (+0.7s)	3016	3016	256	58	182	9	1	250
23560	15106s (+0.8s)	3304	3304	256	73	189	14	1	277
23561	15107s (+1.1s)	5684	5684	512	88	294	21	0	403
23562	15108s (+0.5s)	1756	1756	128	46	125	9	0	180
23563	15109s (+0.8s)	3488	3488	256	78	194	20	0	292
23564	15109s (+0.5s)	1640	1640	128	39	117	7	0	163
23565	15110s (+1.0s)	4300	4300	256	84	252	17	0	353
23566	15111s (+0.3s)	732	732	64	20	71	5	0	96
23567	15111s (+0.6s)	2624	2624	256	59	152	9	0	220
23568	15112s (+0.6s)	2684	2684	256	49	172	9	0	230
23569	15113s (+0.8s)	3520	3520	256	70	210	14	0	294
23570	15113s (+0.5s)	1628	1628	128	42	111	11	0	164
23571	15114s (+0.6s)	2232	2232	128	44	153	0	13	210
23572	15114s (+0.6s)	2524	2524	256	42	164	0	9	215
23573	15115s (+0.7s)	2832	2832	256	45	192	0	13	250
23574	15116s (+0.8s)	3220	3220	256	60	191	0	20	271
23575	15116s (+0.6s)	2008	2008	128	53	135	11	0	199
23576	15117s (+0.5s)	1732	1732	128	54	111	12	0	177
23577	15118s (+0.9s)	3804	3804	256	74	221	12	0	307
23578	15118s (+0.3s)	980	980	128	23	76	4	0	103
23579	15119s (+0.5s)	1932	1932	128	45	146	10	0	201
23580	15120s (+0.9s)	3912	3912	256	86	215	15	0	316
23581	15120s (+0.7s)	2916	2916	256	48	191	10	0	249
23582	15121s (+0.6s)	2628	2628	256	48	167	8	0	223
23583	15122s (+0.7s)	2844	2844	256	68	173	8	0	249
23584	15122s (+0.7s)	2932	2932	256	71	173	15	0	259
23585	15123s (+0.6s)	2588	2588	256	48	161	8	1	218
23586	15123s (+0.3s)	700	700	64	24	67	4	0	95
23587	15124s (+0.4s)	1500	1500	128	42	106	9	1	158
23588	15125s (+0.8s)	3360	3360	256	60	217	9	0	286
23589	15125s (+0.5s)	1684	1684	128	46	117	10	0	173
23590	15125s (+0.4s)	1304	1304	128	30	97	7	0	134
23591	15126s (+0.4s)	984	984	64	30	89	6	0	125
23592	15127s (+1.0s)	4272	4272	256	104	224	26	0	354
23593	15128s (+1.4s)	6860	6860	512	124	334	19	0	477
23594	15129s (+0.4s)	1052	1052	64	29	91	7	0	127
23595	15129s (+0.8s)	3256	3256	256	72	190	15	0	277
23596	15130s (+0.6s)	1928	1928	128	51	139	10	0	200
23597	15130s (+0.4s)	1480	1480	128	26	120	5	0	151
23598	15131s (+0.6s)	1936	1936	128	49	145	8	0	202
23599	15131s (+0.4s)	1388	1388	128	31	111	5	0	147
Episode	Time	Reward	Score	Highest	L	U	R	D	Steps
23600	15132s (+0.9s)	3884	3884	256	77	224	14	1	316
23601	15133s (+0.4s)	1264	1264	128	24	109	4	0	137
23602	15133s (+0.5s)	1844	1844	128	49	125	10	0	184
23603	15134s (+0.5s)	1796	1796	128	44	133	7	1	185
23604	15134s (+0.5s)	1688	1688	128	34	134	5	0	173
23605	15134s (+0.2s)	348	348	32	6	48	0	2	56
23606	15135s (+0.8s)	3424	3424	256	62	213	0	12	287
23607	15136s (+0.8s)	3212	3212	256	67	190	0	10	267
23608	15136s (+0.2s)	396	396	32	9	53	0	4	66
23609	15137s (+0.4s)	1496	1496	128	40	104	0	7	151
23610	15138s (+1.2s)	5700	5700	512	96	299	0	13	408
23611	15139s (+0.7s)	3076	3076	256	43	200	0	11	254
23612	15139s (+0.5s)	1556	1556	128	31	125	0	3	159
23613	15139s (+0.4s)	1196	1196	128	29	95	7	0	131
23614	15140s (+0.4s)	1448	1448	128	19	125	0	4	148
23615	15141s (+0.8s)	3472	3472	256	65	218	0	9	292
23616	15142s (+0.9s)	3716	3716	256	70	238	0	8	316
23617	15142s (+0.7s)	2672	2672	256	46	175	0	13	234
23618	15143s (+0.4s)	1456	1456	128	29	118	0	5	152
23619	15143s (+0.4s)	1392	1392	128	36	102	5	0	143
23620	15144s (+0.6s)	2568	2568	256	50	155	10	0	215
23621	15144s (+0.5s)	2132	2132	256	32	130	8	0	170
23622	15145s (+0.5s)	1708	1708	128	34	132	9	0	175
23623	15145s (+0.4s)	1240	1240	64	31	102	9	0	142
23624	15146s (+0.8s)	3300	3300	256	78	187	13	0	278
23625	15147s (+0.9s)	3732	3732	256	85	206	17	0	308
23626	15147s (+0.4s)	1032	1032	64	38	87	7	0	132
23627	15148s (+0.9s)	3940	3940	256	86	218	15	0	319
23628	15149s (+1.1s)	5508	5508	512	97	275	20	0	392
23629	15150s (+0.4s)	1072	1072	64	24	98	3	0	125
23630	15150s (+0.5s)	2012	2012	128	44	138	8	0	190
23631	15151s (+0.5s)	1636	1636	128	34	123	6	0	163
23632	15151s (+0.6s)	2372	2372	256	47	147	6	0	200
23633	15152s (+0.9s)	3632	3632	256	76	214	17	0	307
23634	15152s (+0.5s)	1716	1716	128	49	118	7	0	174
23635	15153s (+0.7s)	3452	3452	256	76	183	11	0	270
23636	15154s (+0.8s)	3272	3272	256	62	205	9	0	276
23637	15154s (+0.4s)	1144	1144	128	33	84	6	1	124
23638	15155s (+0.2s)	312	312	32	7	49	1	0	57
23639	15155s (+0.5s)	1792	1792	128	50	128	5	0	183
23640	15156s (+1.0s)	4152	4152	256	85	243	12	0	340
23641	15157s (+0.7s)	3068	3068	256	55	184	11	1	251
23642	15158s (+0.8s)	3284	3284	256	80	176	13	0	269
23643	15158s (+0.4s)	1544	1544	128	35	106	7	0	148
23644	15158s (+0.4s)	1172	1172	64	44	87	9	0	140
23645	15159s (+0.4s)	1500	1500	128	32	117	10	0	159
23646	15160s (+1.1s)	5852	5852	512	112	265	23	0	400
23647	15161s (+0.8s)	3236	3236	256	70	191	11	0	272
23648	15161s (+0.3s)	1016	1016	64	36	78	8	0	122
23649	15162s (+0.5s)	1560	1560	128	38	119	5	0	162
23650	15162s (+0.4s)	1480	1480	128	42	105	5	2	154
23651	15163s (+1.0s)	4304	4304	256	89	243	23	0	355
23652	15164s (+0.8s)	3304	3304	256	68	195	11	0	274
23653	15164s (+0.4s)	1252	1252	128	34	100	5	0	139
23654	15165s (+0.5s)	1656	1656	128	41	118	7	0	166
23655	15165s (+0.6s)	1952	1952	128	45	140	9	1	195
23656	15166s (+0.7s)	3008	3008	256	63	176	0	10	249
23657	15166s (+0.5s)	1800	1800	128	37	142	0	6	185
23658	15167s (+0.6s)	1936	1936	128	41	153	0	8	202
23659	15168s (+0.8s)	3252	3252	256	48	214	0	12	274
23660	15169s (+0.7s)	2968	2968	256	48	194	0	7	249
23661	15169s (+0.9s)	4028	4028	256	79	242	0	15	336
23662	15170s (+0.4s)	1544	1544	128	23	127	0	5	155
23663	15170s (+0.5s)	1596	1596	128	37	124	0	9	170
23664	15171s (+0.6s)	2600	2600	256	47	161	0	12	220
23665	15172s (+0.6s)	1928	1928	128	53	141	6	0	200
23666	15172s (+0.8s)	3344	3344	256	79	187	13	0	279
23667	15174s (+1.2s)	5932	5932	512	109	294	20	0	423
23668	15175s (+0.9s)	3620	3620	256	77	216	15	0	308
23669	15175s (+0.7s)	2964	2964	256	55	180	6	0	241
23670	15176s (+0.5s)	1904	1904	128	53	134	7	0	194
23671	15176s (+0.6s)	2176	2176	128	47	149	8	0	204
23672	15177s (+0.8s)	3116	3116	256	87	168	18	0	273
23673	15178s (+0.4s)	1432	1432	128	46	93	8	0	147
23674	15178s (+0.8s)	3372	3372	256	73	196	10	0	279
23675	15179s (+0.9s)	3840	3840	256	78	218	15	0	311
23676	15180s (+0.4s)	988	988	64	34	87	5	0	126
23677	15180s (+0.5s)	1848	1848	128	45	138	7	0	190
23678	15181s (+0.7s)	2500	2500	128	81	145	10	0	236
23679	15182s (+0.8s)	3588	3588	256	81	207	11	1	300
23680	15182s (+0.7s)	3088	3088	256	64	187	9	2	262
23681	15183s (+0.8s)	3372	3372	256	69	211	9	0	289
23682	15184s (+0.4s)	1192	1192	128	27	97	6	0	130
23683	15184s (+0.4s)	1356	1356	128	35	100	9	0	144
23684	15184s (+0.3s)	624	624	64	19	62	4	0	85
23685	15185s (+0.7s)	2872	2872	256	71	163	15	0	249
23686	15185s (+0.4s)	1232	1232	64	28	108	4	0	140
23687	15186s (+0.9s)	3832	3832	256	78	213	18	0	309
23688	15187s (+0.9s)	3840	3840	256	77	220	13	1	311
23689	15188s (+0.9s)	3668	3668	256	80	207	13	0	300
23690	15188s (+0.4s)	1508	1508	128	45	102	6	1	154
23691	15189s (+0.5s)	1816	1816	128	59	116	9	0	184
23692	15190s (+0.7s)	2932	2932	256	53	175	8	0	236
23693	15190s (+0.6s)	2596	2596	256	61	157	6	0	224
23694	15191s (+0.7s)	2620	2620	256	62	157	11	0	230
23695	15192s (+0.7s)	2712	2712	256	61	167	9	0	237
23696	15193s (+1.0s)	4324	4324	256	101	227	27	0	355
23697	15193s (+0.8s)	2976	2976	256	82	171	12	0	265
23698	15194s (+0.8s)	3300	3300	256	66	199	12	0	277
23699	15195s (+0.5s)	1380	1380	64	42	102	9	0	153
Episode	Time	Reward	Score	Highest	L	U	R	D	Steps
23700	15195s (+0.7s)	2896	2896	256	49	172	15	1	237
23701	15196s (+1.0s)	4176	4176	256	102	217	27	0	346
23702	15197s (+0.9s)	4272	4272	256	62	281	8	0	351
23703	15198s (+0.7s)	2832	2832	256	54	183	13	0	250
23704	15199s (+0.7s)	3060	3060	256	63	178	9	0	250
23705	15199s (+0.5s)	1800	1800	128	59	114	12	0	185
23706	15200s (+0.7s)	2440	2440	128	74	145	21	1	241
23707	15201s (+0.5s)	1896	1896	128	47	139	6	0	192
23708	15201s (+0.5s)	1752	1752	128	39	131	8	0	178
23709	15202s (+0.6s)	2588	2588	256	60	157	10	0	227
23710	15202s (+0.7s)	2668	2668	128	65	181	10	0	256
23711	15203s (+0.7s)	2988	2988	256	73	178	10	1	262
23712	15204s (+0.5s)	2080	2080	128	41	140	9	2	192
23713	15204s (+0.4s)	1244	1244	128	32	97	6	0	135
23714	15205s (+0.4s)	1424	1424	128	36	110	5	0	151
23715	15205s (+0.9s)	3844	3844	256	77	226	9	0	312
23716	15206s (+0.4s)	1472	1472	128	37	106	8	1	152
23717	15207s (+1.0s)	5180	5180	512	84	273	16	0	373
23718	15208s (+1.2s)	5756	5756	512	102	285	23	0	410
23719	15209s (+0.9s)	3976	3976	256	82	228	18	0	328
23720	15210s (+0.8s)	3508	3508	256	86	193	18	0	297
23721	15210s (+0.3s)	1128	1128	128	23	92	4	0	119
23722	15211s (+0.5s)	1836	1836	128	42	138	6	0	186
23723	15211s (+0.5s)	1836	1836	128	46	133	10	0	189
23724	15212s (+0.5s)	1616	1616	128	40	123	8	0	171
23725	15212s (+0.4s)	1216	1216	128	29	102	5	0	136
23726	15213s (+0.4s)	1284	1284	128	26	103	10	0	139
23727	15213s (+0.7s)	3084	3084	256	65	179	12	0	256
23728	15214s (+0.5s)	1628	1628	128	54	109	10	0	173
23729	15214s (+0.6s)	2536	2536	256	50	156	9	0	215
23730	15215s (+0.6s)	2504	2504	256	44	164	9	0	217
23731	15216s (+0.8s)	3240	3240	256	83	177	13	0	273
23732	15216s (+0.5s)	1656	1656	128	44	117	8	1	170
23733	15217s (+0.9s)	3888	3888	256	90	208	25	0	323
23734	15218s (+0.3s)	908	908	64	27	86	5	0	118
23735	15218s (+0.4s)	1380	1380	128	29	112	4	0	145
23736	15218s (+0.4s)	1396	1396	128	26	114	0	2	142
23737	15219s (+0.1s)	256	256	32	4	43	0	2	49
23738	15219s (+0.5s)	1812	1812	128	49	133	0	6	188
23739	15220s (+0.7s)	3060	3060	256	43	205	0	12	260
23740	15221s (+0.7s)	2688	2688	256	58	175	0	9	242
23741	15221s (+0.6s)	2492	2492	256	39	169	0	6	214
23742	15222s (+0.7s)	2756	2756	256	46	180	0	11	237
23743	15223s (+0.7s)	3056	3056	256	66	183	0	10	259
23744	15223s (+0.5s)	1776	1776	128	35	134	0	11	180
23745	15224s (+0.6s)	2480	2480	256	58	149	5	0	212
23746	15224s (+0.7s)	2740	2740	256	43	187	4	0	234
23747	15225s (+0.5s)	1688	1688	128	40	127	6	0	173
23748	15225s (+0.4s)	1520	1520	128	45	107	7	0	159
23749	15226s (+0.4s)	1144	1144	64	29	100	8	1	138
23750	15226s (+0.6s)	2516	2516	256	57	154	9	0	220
23751	15228s (+1.1s)	4644	4644	256	125	257	16	0	398
23752	15228s (+0.6s)	2640	2640	256	49	162	11	0	222
23753	15229s (+0.8s)	3496	3496	256	88	186	19	0	293
23754	15230s (+1.0s)	4220	4220	256	100	226	19	0	345
23755	15230s (+0.4s)	1208	1208	64	43	95	6	0	144
23756	15231s (+0.3s)	904	904	64	25	82	5	0	112
23757	15231s (+0.5s)	1732	1732	128	29	140	5	0	174
23758	15232s (+0.8s)	3604	3604	256	74	217	12	0	303
23759	15233s (+0.9s)	3952	3952	256	85	223	19	0	327
23760	15235s (+1.4s)	7204	7204	512	133	341	21	0	495
23761	15235s (+0.9s)	4072	4072	256	75	239	11	0	325
23762	15236s (+0.4s)	1100	1100	64	27	104	3	0	134
23763	15236s (+0.6s)	2448	2448	128	63	152	8	1	224
23764	15238s (+1.4s)	7136	7136	512	148	305	30	0	483
23765	15239s (+0.9s)	4208	4208	256	92	231	19	0	342
23766	15240s (+1.3s)	6088	6088	512	117	295	28	0	440
23767	15241s (+0.5s)	1760	1760	128	39	127	10	0	176
23768	15241s (+0.7s)	2732	2732	256	65	163	10	0	238
23769	15242s (+0.7s)	2892	2892	256	52	177	7	0	236
23770	15243s (+1.3s)	6232	6232	512	116	311	17	0	444
23771	15244s (+1.0s)	4148	4148	256	85	240	16	0	341
23772	15245s (+1.0s)	4196	4196	256	104	218	21	0	343
23773	15246s (+0.7s)	2800	2800	256	63	174	6	0	243
23774	15247s (+0.7s)	2920	2920	256	64	158	13	0	235
23775	15247s (+0.5s)	1716	1716	128	29	137	5	0	171
23776	15247s (+0.3s)	752	752	64	20	72	6	0	98
23777	15248s (+0.4s)	1056	1056	64	29	94	5	0	128
23778	15249s (+0.7s)	3168	3168	256	76	173	12	0	261
23779	15249s (+0.6s)	2500	2500	256	46	164	7	0	217
23780	15250s (+0.7s)	2816	2816	256	52	185	10	0	247
23781	15251s (+0.7s)	2820	2820	256	64	170	13	0	247
23782	15251s (+0.8s)	3276	3276	256	60	208	9	0	277
23783	15252s (+0.8s)	3476	3476	256	64	209	15	0	288
23784	15253s (+1.0s)	4204	4204	256	83	247	15	0	345
23785	15253s (+0.3s)	1000	1000	128	19	82	4	0	105
23786	15254s (+0.5s)	1652	1652	128	31	127	8	1	167
23787	15255s (+0.5s)	2040	2040	128	46	140	7	0	193
23788	15256s (+1.0s)	4072	4072	256	86	234	20	0	340
23789	15256s (+0.6s)	2068	2068	128	48	150	10	0	208
23790	15257s (+0.6s)	1996	1996	128	46	149	11	0	206
23791	15257s (+0.4s)	1512	1512	128	31	119	7	0	157
23792	15258s (+0.6s)	1904	1904	128	36	148	0	10	194
23793	15258s (+0.4s)	1508	1508	128	30	112	0	8	150
23794	15259s (+0.7s)	3016	3016	256	41	192	0	10	243
23795	15260s (+0.8s)	3368	3368	256	51	223	0	14	288
23796	15260s (+0.7s)	2812	2812	256	63	173	0	10	246
23797	15261s (+0.4s)	1324	1324	128	27	106	0	4	137
23798	15261s (+0.8s)	3376	3376	256	63	217	0	9	289
23799	15262s (+0.6s)	2724	2724	256	46	174	0	10	230
Episode	Time	Reward	Score	Highest	L	U	R	D	Steps
23800	15263s (+0.4s)	1432	1432	128	43	99	6	0	148
23801	15263s (+0.6s)	1988	1988	128	50	144	6	0	200
23802	15264s (+0.5s)	1808	1808	128	52	121	7	1	181
23803	15264s (+0.7s)	2708	2708	256	75	149	8	0	232
23804	15265s (+0.7s)	3212	3212	256	65	189	13	0	267
23805	15266s (+0.4s)	1480	1480	128	34	117	3	0	154
23806	15266s (+0.6s)	2388	2388	128	65	150	11	0	226
23807	15267s (+0.5s)	1744	1744	128	48	121	6	0	175
23808	15268s (+1.0s)	4316	4316	256	100	235	22	0	357
23809	15268s (+0.5s)	1776	1776	128	40	134	6	0	180
23810	15269s (+0.6s)	2332	2332	128	60	156	10	0	226
23811	15269s (+0.3s)	764	764	64	26	77	1	0	104
23812	15270s (+0.6s)	2564	2564	256	48	164	9	0	221
23813	15270s (+0.5s)	1656	1656	128	32	132	0	9	173
23814	15271s (+0.4s)	1436	1436	128	24	121	0	3	148
23815	15272s (+0.9s)	3684	3684	256	55	237	0	15	307
23816	15272s (+0.5s)	1544	1544	128	36	121	0	7	164
23817	15273s (+0.5s)	2288	2288	256	52	136	0	9	197
23818	15273s (+0.6s)	2644	2644	256	49	167	0	8	224
23819	15274s (+0.7s)	2620	2620	256	55	165	10	0	230
23820	15275s (+0.9s)	3880	3880	256	72	232	11	0	315
23821	15275s (+0.5s)	1520	1520	128	31	122	6	0	159
23822	15276s (+0.6s)	2548	2548	256	52	162	8	0	222
23823	15277s (+0.8s)	3268	3268	256	66	191	14	1	272
23824	15277s (+0.3s)	784	784	64	20	82	3	0	105
23825	15278s (+0.5s)	1816	1816	128	47	135	7	0	189
23826	15278s (+0.8s)	3512	3512	256	91	190	15	0	296
23827	15280s (+1.2s)	6048	6048	512	109	299	22	0	430
23828	15280s (+0.4s)	1520	1520	128	42	107	7	0	156
23829	15281s (+0.6s)	2552	2552	256	44	170	10	0	224
23830	15281s (+0.5s)	1832	1832	128	47	125	10	1	183
23831	15282s (+0.8s)	3364	3364	256	69	207	11	0	287
23832	15283s (+0.8s)	3316	3316	256	56	208	12	0	276
23833	15284s (+1.0s)	5092	5092	512	96	245	20	0	361
23834	15284s (+0.4s)	1436	1436	128	32	112	0	5	149
23835	15285s (+0.4s)	1400	1400	128	32	107	3	0	142
23836	15286s (+1.2s)	5840	5840	512	94	303	18	0	415
23837	15287s (+0.7s)	2744	2744	256	61	156	17	0	234
23838	15288s (+1.3s)	6592	6592	512	123	300	30	1	454
23839	15289s (+0.8s)	3212	3212	256	91	161	15	0	267
23840	15290s (+0.7s)	2688	2688	256	55	162	9	0	226
23841	15291s (+1.2s)	6108	6108	512	113	295	22	0	430
23842	15292s (+0.8s)	3204	3204	256	75	183	11	0	269
23843	15292s (+0.6s)	2140	2140	128	61	131	8	0	200
23844	15293s (+0.7s)	2956	2956	256	61	188	11	0	260
23845	15293s (+0.4s)	1176	1176	128	29	93	5	0	127
23846	15294s (+0.2s)	344	344	32	12	46	4	0	62
23847	15294s (+0.3s)	764	764	64	16	85	0	3	104
23848	15295s (+0.8s)	3248	3248	256	61	197	0	9	267
23849	15295s (+0.7s)	3156	3156	256	59	185	0	14	258
23850	15296s (+0.5s)	1744	1744	128	29	142	0	5	176
23851	15297s (+0.8s)	3240	3240	256	70	191	11	0	272
23852	15297s (+0.6s)	2624	2624	256	50	169	11	1	231
23853	15298s (+0.6s)	2604	2604	256	56	153	8	0	217
23854	15299s (+0.7s)	3156	3156	256	62	181	14	0	257
23855	15300s (+1.0s)	4388	4388	256	93	255	19	0	367
23856	15301s (+1.0s)	4168	4168	256	107	214	23	0	344
23857	15301s (+0.7s)	2736	2736	256	48	183	5	0	236
23858	15302s (+0.7s)	3128	3128	256	66	170	14	1	251
23859	15303s (+0.7s)	2764	2764	256	68	153	18	0	239
23860	15303s (+0.5s)	1720	1720	128	63	110	7	2	182
23861	15304s (+0.5s)	1736	1736	128	37	133	5	0	175
23862	15304s (+0.4s)	1548	1548	128	35	115	5	0	155
23863	15305s (+0.8s)	3340	3340	256	68	203	10	0	281
23864	15306s (+0.5s)	1768	1768	128	37	133	6	1	177
23865	15306s (+0.7s)	2900	2900	256	76	157	13	0	246
23866	15307s (+1.0s)	4072	4072	256	80	246	14	0	340
23867	15308s (+0.5s)	1736	1736	128	45	122	7	0	174
23868	15308s (+0.6s)	1932	1932	128	44	148	9	0	201
23869	15309s (+0.6s)	2096	2096	128	62	135	13	0	210
23870	15309s (+0.4s)	1176	1176	128	26	92	8	0	126
23871	15310s (+0.9s)	4028	4028	256	77	238	17	0	332
23872	15311s (+0.2s)	600	600	64	15	69	0	0	84
23873	15311s (+0.7s)	2924	2924	256	59	175	9	0	243
23874	15312s (+0.7s)	2732	2732	256	61	164	13	0	238
23875	15312s (+0.5s)	1788	1788	128	32	145	4	1	182
23876	15314s (+1.2s)	5780	5780	512	120	268	23	0	411
23877	15314s (+0.9s)	3576	3576	256	76	210	15	0	301
23878	15315s (+0.4s)	968	968	64	30	87	5	0	122
23879	15315s (+0.6s)	2332	2332	256	35	154	8	0	197
23880	15316s (+0.3s)	680	680	64	15	75	1	0	91
23881	15316s (+0.6s)	1900	1900	128	57	125	12	0	194
23882	15317s (+0.8s)	3556	3556	256	89	194	13	0	296
23883	15318s (+0.5s)	1604	1604	128	45	112	11	0	168
23884	15319s (+1.2s)	5788	5788	512	91	303	19	0	413
23885	15319s (+0.5s)	1748	1748	128	39	125	11	0	175
23886	15320s (+0.3s)	672	672	64	21	70	2	0	93
23887	15320s (+0.2s)	608	608	64	15	65	2	0	82
23888	15321s (+0.8s)	3240	3240	256	65	195	13	0	273
23889	15321s (+0.4s)	1140	1140	64	42	91	3	0	136
23890	15321s (+0.5s)	1812	1812	128	44	134	9	1	188
23891	15322s (+0.4s)	1308	1308	128	36	102	5	0	143
23892	15322s (+0.6s)	2304	2304	256	39	148	0	13	200
23893	15323s (+0.7s)	3156	3156	256	58	188	0	11	257
23894	15324s (+0.6s)	2376	2376	256	51	141	0	11	203
23895	15324s (+0.4s)	1036	1036	64	32	82	0	9	123
23896	15325s (+0.4s)	1492	1492	128	38	111	7	0	156
23897	15325s (+0.5s)	2292	2292	256	33	152	6	0	191
23898	15326s (+0.8s)	3232	3232	256	60	199	12	0	271
23899	15327s (+0.6s)	2020	2020	128	58	126	17	0	201
Episode	Time	Reward	Score	Highest	L	U	R	D	Steps
23900	15327s (+0.5s)	1860	1860	128	46	125	7	0	178
23901	15328s (+0.5s)	1800	1800	128	33	149	3	0	185
23902	15328s (+0.5s)	1748	1748	128	41	127	9	0	177
23903	15329s (+0.6s)	2380	2380	128	65	151	11	0	227
23904	15329s (+0.7s)	2860	2860	256	53	179	11	0	243
23905	15330s (+0.8s)	3256	3256	256	62	194	10	0	266
23906	15331s (+0.5s)	1900	1900	128	59	122	7	0	188
23907	15332s (+1.0s)	4872	4872	512	80	251	14	0	345
23908	15332s (+0.3s)	920	920	64	24	76	6	0	106
23909	15333s (+1.0s)	4224	4224	256	85	244	17	0	346
23910	15334s (+0.9s)	3760	3760	256	98	196	21	0	315
23911	15335s (+0.8s)	3356	3356	256	59	217	9	0	285
23912	15335s (+0.6s)	2296	2296	128	63	146	12	0	221
23913	15336s (+0.4s)	1332	1332	128	35	96	8	0	139
23914	15336s (+0.5s)	1728	1728	128	31	136	6	0	173
23915	15337s (+1.1s)	4452	4452	256	89	262	20	0	371
23916	15338s (+0.4s)	1180	1180	64	40	95	7	0	142
23917	15338s (+0.5s)	1600	1600	128	38	124	5	0	167
23918	15339s (+1.0s)	4200	4200	256	99	225	23	0	347
23919	15340s (+0.7s)	2908	2908	256	52	189	12	0	253
23920	15341s (+0.8s)	3300	3300	256	71	189	15	1	276
23921	15342s (+1.0s)	3988	3988	256	99	228	20	0	347
23922	15343s (+0.7s)	3060	3060	256	68	170	13	0	251
23923	15343s (+1.0s)	4196	4196	256	89	237	14	0	340
23924	15344s (+0.8s)	3416	3416	256	70	203	12	0	285
23925	15345s (+0.6s)	2444	2444	256	52	150	7	0	209
23926	15345s (+0.5s)	1836	1836	128	52	124	13	0	189
23927	15346s (+0.7s)	2672	2672	128	70	175	13	0	258
23928	15347s (+0.9s)	3740	3740	256	86	210	10	0	306
23929	15348s (+0.5s)	1620	1620	128	37	119	7	0	163
23930	15348s (+0.9s)	3672	3672	256	85	200	15	1	301
23931	15349s (+0.3s)	1004	1004	128	18	85	3	0	106
23932	15350s (+1.3s)	6864	6864	512	124	319	20	0	463
23933	15351s (+0.5s)	1804	1804	128	39	141	6	0	186
23934	15351s (+0.3s)	764	764	64	25	73	5	0	103
23935	15352s (+0.6s)	2652	2652	256	54	163	10	0	227
23936	15352s (+0.9s)	3884	3884	256	69	236	12	0	317
23937	15353s (+0.7s)	2732	2732	128	82	153	15	1	251
23938	15354s (+0.4s)	1136	1136	64	42	88	6	0	136
23939	15354s (+0.3s)	1048	1048	128	26	81	2	0	109
23940	15355s (+0.7s)	3016	3016	256	61	180	9	0	250
23941	15355s (+0.3s)	1104	1104	128	24	91	4	0	119
23942	15356s (+1.0s)	4148	4148	256	105	212	20	0	337
23943	15357s (+0.7s)	3224	3224	256	74	184	11	0	269
23944	15358s (+1.2s)	6080	6080	512	120	297	21	0	438
23945	15359s (+0.9s)	3856	3856	256	85	217	13	0	315
23946	15359s (+0.5s)	1540	1540	128	32	124	8	0	164
23947	15360s (+0.6s)	2472	2472	256	66	124	14	0	204
23948	15361s (+0.7s)	2812	2812	256	55	184	7	0	246
23949	15361s (+0.8s)	3240	3240	256	71	186	9	0	266
23950	15362s (+0.8s)	3188	3188	256	71	179	15	0	265
23951	15363s (+0.5s)	1944	1944	128	42	133	15	0	190
23952	15363s (+0.4s)	1452	1452	128	50	93	9	0	152
23953	15364s (+0.6s)	2556	2556	256	40	169	8	1	218
23954	15364s (+0.5s)	1676	1676	128	46	115	10	0	171
23955	15365s (+0.4s)	1224	1224	64	50	90	8	0	148
23956	15365s (+0.6s)	2632	2632	256	39	179	0	5	223
23957	15366s (+0.7s)	2532	2532	128	44	185	0	11	240
23958	15366s (+0.4s)	1224	1224	64	32	114	0	2	148
23959	15367s (+0.8s)	3264	3264	256	55	207	0	12	274
23960	15368s (+0.9s)	3828	3828	256	66	230	0	13	309
23961	15369s (+0.8s)	3252	3252	256	49	210	0	17	276
23962	15369s (+0.5s)	1608	1608	128	36	127	0	6	169
23963	15370s (+0.5s)	1644	1644	128	43	123	0	12	178
23964	15370s (+0.5s)	1848	1848	128	45	142	0	5	192
23965	15371s (+0.8s)	3456	3456	256	65	210	0	12	287
23966	15372s (+0.5s)	1676	1676	128	30	133	0	7	170
23967	15373s (+0.8s)	3452	3452	256	67	210	0	12	289
23968	15373s (+0.2s)	624	624	64	14	69	0	3	86
23969	15373s (+0.4s)	1392	1392	128	37	99	0	6	142
23970	15374s (+0.8s)	3184	3184	256	55	203	10	0	268
23971	15375s (+1.1s)	5500	5500	512	92	283	15	0	390
23972	15376s (+0.9s)	4468	4468	512	74	217	15	0	306
23973	15377s (+0.5s)	1812	1812	128	41	138	9	0	188
23974	15377s (+0.5s)	2344	2344	256	60	124	10	1	195
23975	15377s (+0.4s)	1188	1188	128	37	84	8	0	129
23976	15378s (+0.8s)	3484	3484	256	110	159	18	0	287
23977	15379s (+0.4s)	1256	1256	128	18	109	7	0	134
23978	15379s (+0.3s)	1008	1008	64	29	85	7	0	121
23979	15380s (+0.5s)	1908	1908	128	43	146	6	0	195
23980	15380s (+0.5s)	1572	1572	128	39	119	7	0	165
23981	15381s (+0.9s)	4128	4128	256	89	221	20	1	331
23982	15381s (+0.4s)	1196	1196	128	39	87	6	0	132
23983	15382s (+0.6s)	2756	2756	256	45	163	9	0	217
23984	15382s (+0.4s)	1324	1324	128	26	103	7	0	136
23985	15383s (+0.5s)	1804	1804	128	41	137	8	0	186
23986	15384s (+1.0s)	5460	5460	512	78	280	22	0	380
23987	15385s (+0.7s)	2660	2660	256	47	180	0	8	235
23988	15385s (+0.3s)	804	804	64	20	82	1	5	108
23989	15386s (+0.6s)	2796	2796	256	44	171	0	10	225
23990	15386s (+0.4s)	1572	1572	128	29	125	0	9	163
23991	15386s (+0.4s)	1408	1408	128	24	119	0	5	148
23992	15387s (+0.4s)	1024	1024	64	19	100	0	6	125
23993	15388s (+1.0s)	4052	4052	256	75	246	14	0	335
23994	15389s (+0.9s)	3772	3772	256	85	213	11	0	309
23995	15389s (+0.7s)	2928	2928	256	57	194	7	0	258
23996	15390s (+1.0s)	4248	4248	256	81	255	16	0	352
23997	15391s (+0.5s)	2052	2052	128	46	130	10	0	186
23998	15392s (+0.8s)	3224	3224	256	78	180	12	0	270
23999	15393s (+0.8s)	2948	2948	256	50	206	7	0	263
Episode	Time	Reward	Score	Highest	L	U	R	D	Steps
24000	15393s (+0.6s)	2272	2272	128	49	156	11	0	216
24001	15394s (+0.5s)	1784	1784	128	40	136	6	0	182
24002	15394s (+0.4s)	1232	1232	64	37	104	9	0	150
24003	15395s (+0.7s)	3176	3176	256	60	190	12	0	262
24004	15395s (+0.5s)	1900	1900	128	47	131	6	0	184
24005	15396s (+0.9s)	3856	3856	256	87	214	18	0	319
24006	15397s (+0.4s)	1260	1260	128	34	95	3	0	132
24007	15397s (+0.2s)	656	656	64	26	53	7	0	86
24008	15398s (+0.7s)	3156	3156	256	61	184	12	0	257
24009	15398s (+0.5s)	1860	1860	128	42	143	5	0	190
24010	15399s (+0.7s)	2828	2828	256	60	175	8	0	243
24011	15399s (+0.3s)	972	972	64	25	93	4	0	122
24012	15401s (+1.3s)	6488	6488	512	123	314	27	0	464
24013	15401s (+0.7s)	2744	2744	256	64	156	14	0	234
24014	15402s (+0.4s)	1492	1492	128	32	118	6	1	157
24015	15403s (+0.7s)	3084	3084	256	62	179	13	1	255
24016	15403s (+0.6s)	2476	2476	256	62	144	12	0	218
24017	15404s (+0.9s)	3736	3736	256	74	225	11	0	310
24018	15405s (+0.5s)	1604	1604	128	40	119	3	0	162
24019	15405s (+0.5s)	1736	1736	128	39	129	10	0	178
24020	15406s (+0.5s)	1828	1828	128	36	143	0	6	185
24021	15406s (+0.7s)	2796	2796	256	46	187	0	9	242
24022	15407s (+0.5s)	1788	1788	128	42	133	6	1	182
24023	15408s (+0.8s)	3436	3436	256	84	186	13	0	283
24024	15408s (+0.5s)	1632	1632	128	51	108	5	0	164
24025	15409s (+0.7s)	3084	3084	256	52	195	8	0	255
24026	15410s (+0.8s)	3180	3180	256	60	190	15	0	265
24027	15410s (+0.5s)	1720	1720	128	53	114	10	0	177
24028	15411s (+0.4s)	1268	1268	64	34	100	8	0	142
24029	15411s (+0.7s)	3216	3216	256	61	193	0	17	271
24030	15412s (+1.0s)	4172	4172	256	95	234	0	16	345
24031	15413s (+0.5s)	1668	1668	128	36	125	0	8	169
24032	15414s (+0.7s)	2732	2732	256	54	169	0	8	231
24033	15414s (+0.7s)	2800	2800	256	46	184	0	13	243
24034	15415s (+1.2s)	5980	5980	512	98	308	0	19	425
24035	15416s (+0.6s)	2452	2452	256	47	156	0	8	211
24036	15417s (+0.7s)	2624	2624	256	44	179	0	5	228
24037	15417s (+0.5s)	2316	2316	256	50	136	0	10	196
24038	15418s (+0.6s)	2136	2136	128	47	156	0	11	214
24039	15419s (+0.7s)	3120	3120	256	50	193	0	17	260
24040	15419s (+0.4s)	1456	1456	128	32	114	0	6	152
24041	15420s (+0.8s)	2948	2948	256	64	180	19	0	263
24042	15420s (+0.5s)	2008	2008	128	45	127	12	0	184
24043	15421s (+0.7s)	2552	2552	128	49	177	11	0	237
24044	15422s (+0.5s)	1624	1624	128	43	122	3	0	168
24045	15422s (+0.8s)	3440	3440	256	67	204	13	0	284
24046	15423s (+0.4s)	1312	1312	64	47	94	6	1	148
24047	15424s (+0.9s)	3620	3620	256	67	223	13	0	303
24048	15424s (+0.5s)	1528	1528	128	48	108	6	1	163
24049	15425s (+0.4s)	1480	1480	128	36	109	8	0	153
24050	15425s (+0.8s)	3464	3464	256	52	227	10	0	289
24051	15426s (+0.5s)	1648	1648	128	47	109	11	1	168
24052	15427s (+0.8s)	3192	3192	256	63	190	12	0	265
24053	15427s (+0.7s)	3132	3132	256	60	187	10	0	257
24054	15428s (+0.8s)	3328	3328	256	80	188	15	0	283
24055	15429s (+1.0s)	4136	4136	256	80	247	14	0	341
24056	15430s (+0.4s)	1260	1260	64	41	96	8	1	146
24057	15430s (+0.6s)	2128	2128	128	42	156	5	0	203
24058	15431s (+0.6s)	1904	1904	128	48	141	6	0	195
24059	15432s (+0.8s)	3212	3212	256	62	193	11	0	266
24060	15432s (+0.5s)	1532	1532	128	33	124	5	0	162
24061	15432s (+0.4s)	1180	1180	128	41	81	5	0	127
24062	15433s (+0.4s)	1292	1292	128	37	86	6	1	130
24063	15433s (+0.5s)	1716	1716	128	37	137	3	0	177
24064	15434s (+0.9s)	3888	3888	256	95	215	20	0	330
24065	15435s (+0.5s)	1868	1868	128	46	137	8	0	191
24066	15435s (+0.2s)	520	520	64	14	59	3	0	76
24067	15436s (+0.9s)	4112	4112	256	99	212	24	0	335
24068	15436s (+0.5s)	1736	1736	128	51	122	8	0	181
24069	15437s (+0.5s)	1728	1728	128	44	118	9	1	172
24070	15438s (+1.1s)	5560	5560	512	96	290	18	0	404
24071	15439s (+1.0s)	4296	4296	256	97	239	16	0	352
24072	15440s (+0.4s)	1180	1180	64	37	100	5	0	142
24073	15440s (+0.4s)	1316	1316	128	29	99	0	6	134
24074	15441s (+0.7s)	2856	2856	256	55	187	0	9	251
24075	15441s (+0.6s)	2484	2484	256	40	169	0	6	215
24076	15442s (+0.8s)	3164	3164	256	47	211	0	5	263
24077	15443s (+0.7s)	2920	2920	256	63	182	0	11	256
24078	15444s (+0.8s)	3260	3260	256	55	213	0	10	278
24079	15444s (+0.2s)	668	668	64	20	62	0	3	85
24080	15444s (+0.5s)	2036	2036	128	49	133	0	9	191
24081	15445s (+0.8s)	3580	3580	256	67	216	15	1	299
24082	15446s (+0.4s)	1500	1500	128	43	105	7	1	156
24083	15447s (+0.8s)	3460	3460	256	79	197	12	1	289
24084	15447s (+0.7s)	2792	2792	256	70	161	10	0	241
24085	15448s (+0.5s)	1528	1528	128	49	101	11	0	161
24086	15448s (+0.8s)	3336	3336	256	78	186	14	0	278
24087	15449s (+0.8s)	3504	3504	256	76	203	16	0	295
24088	15450s (+0.8s)	3096	3096	256	76	177	10	0	263
24089	15451s (+0.6s)	2652	2652	256	51	163	9	0	223
24090	15451s (+0.6s)	1908	1908	128	41	149	5	0	195
24091	15452s (+0.6s)	2616	2616	256	55	156	8	0	219
24092	15452s (+0.3s)	1060	1060	128	23	93	2	0	118
24093	15453s (+0.4s)	1416	1416	128	29	109	5	0	143
24094	15453s (+0.5s)	1520	1520	128	51	103	5	0	159
24095	15453s (+0.3s)	908	908	64	26	88	4	0	118
24096	15454s (+0.3s)	1156	1156	128	21	96	6	0	123
24097	15454s (+0.3s)	860	860	64	33	71	7	0	111
24098	15455s (+1.0s)	4132	4132	256	76	255	9	0	340
24099	15456s (+0.7s)	2752	2752	256	48	175	10	0	233
Episode	Time	Reward	Score	Highest	L	U	R	D	Steps
24100	15457s (+1.1s)	5856	5856	512	99	278	26	1	404
24101	15457s (+0.5s)	1784	1784	128	38	134	9	0	181
24102	15458s (+0.5s)	1608	1608	128	44	118	7	0	169
24103	15459s (+0.8s)	3428	3428	256	62	207	12	0	281
24104	15460s (+1.0s)	4060	4060	256	86	238	13	0	337
24105	15461s (+0.8s)	3548	3548	256	83	198	13	0	294
24106	15461s (+0.6s)	2576	2576	256	46	166	8	0	220
24107	15462s (+0.3s)	1056	1056	128	27	84	3	0	114
24108	15462s (+0.5s)	2240	2240	256	44	143	9	1	197
24109	15463s (+0.5s)	1660	1660	128	49	123	5	0	177
24110	15463s (+0.6s)	2420	2420	256	37	167	5	0	209
24111	15464s (+0.5s)	1644	1644	128	37	125	5	0	167
24112	15465s (+0.9s)	3960	3960	256	77	232	14	1	324
24113	15465s (+0.7s)	3300	3300	256	75	180	12	0	267
24114	15466s (+0.6s)	2436	2436	256	50	154	8	0	212
24115	15466s (+0.4s)	1396	1396	128	34	106	6	0	146
24116	15468s (+1.5s)	7652	7652	512	158	355	29	0	542
24117	15469s (+0.4s)	1164	1164	64	26	107	4	1	138
24118	15469s (+0.4s)	1548	1548	128	36	117	6	0	159
24119	15470s (+0.5s)	1860	1860	128	41	137	5	0	183
24120	15470s (+0.9s)	3780	3780	256	109	181	19	0	309
24121	15471s (+0.8s)	3340	3340	256	67	198	16	0	281
24122	15472s (+1.0s)	4296	4296	256	95	239	18	0	352
24123	15473s (+0.7s)	3168	3168	256	79	174	14	0	267
24124	15474s (+1.0s)	4264	4264	256	91	255	10	0	356
24125	15474s (+0.3s)	1080	1080	128	19	97	1	0	117
24126	15475s (+0.7s)	2712	2712	128	75	167	15	0	257
24127	15476s (+0.8s)	3128	3128	256	68	183	11	0	262
24128	15476s (+0.6s)	1900	1900	128	46	139	9	0	194
24129	15477s (+0.6s)	2152	2152	128	60	135	10	0	205
24130	15478s (+0.6s)	1880	1880	128	45	133	14	0	192
24131	15479s (+1.0s)	4060	4060	256	86	236	15	0	337
24132	15479s (+0.9s)	3716	3716	256	90	205	12	0	307
24133	15480s (+0.6s)	2536	2536	256	54	157	10	0	221
24134	15481s (+0.8s)	3508	3508	256	68	220	8	0	296
24135	15481s (+0.3s)	1092	1092	128	29	82	4	0	115
24136	15482s (+0.4s)	1308	1308	128	26	110	7	0	143
24137	15482s (+0.3s)	1024	1024	128	17	92	1	0	110
24138	15483s (+0.9s)	3828	3828	256	98	203	16	1	318
24139	15484s (+0.8s)	3516	3516	256	75	202	16	1	294
24140	15484s (+0.7s)	2916	2916	256	59	166	16	0	241
24141	15486s (+1.1s)	5580	5580	512	84	296	13	0	393
24142	15486s (+0.8s)	3448	3448	256	69	213	10	0	292
24143	15487s (+0.7s)	2788	2788	256	51	183	6	0	240
24144	15487s (+0.3s)	876	876	64	35	76	3	0	114
24145	15488s (+0.3s)	872	872	64	18	91	5	0	114
24146	15488s (+0.7s)	2916	2916	256	50	175	7	0	232
24147	15489s (+0.7s)	3104	3104	256	60	191	10	0	261
24148	15490s (+0.5s)	1740	1740	128	42	124	9	0	175
24149	15490s (+0.5s)	1856	1856	128	60	118	9	0	187
24150	15491s (+0.7s)	2928	2928	256	62	187	9	0	258
24151	15492s (+0.7s)	2804	2804	256	47	190	8	0	245
24152	15492s (+0.4s)	1460	1460	128	38	107	8	0	153
24153	15493s (+0.8s)	3300	3300	256	76	191	16	0	283
24154	15494s (+0.6s)	2220	2220	128	64	138	8	0	210
24155	15495s (+0.9s)	3988	3988	256	83	226	16	0	325
24156	15495s (+0.8s)	3436	3436	256	67	202	15	0	284
24157	15496s (+0.5s)	1776	1776	128	35	137	7	0	179
24158	15496s (+0.6s)	2692	2692	256	41	172	4	0	217
24159	15497s (+0.8s)	3236	3236	256	68	195	9	0	272
24160	15498s (+0.5s)	1840	1840	128	49	131	10	0	190
24161	15498s (+0.5s)	1620	1620	128	40	122	10	0	172
24162	15499s (+0.8s)	3328	3328	256	83	186	14	0	283
24163	15500s (+0.7s)	2780	2780	256	46	184	7	1	238
24164	15501s (+0.9s)	4208	4208	256	98	228	20	0	346
24165	15501s (+0.5s)	1760	1760	128	42	125	12	0	179
24166	15502s (+0.4s)	1508	1508	128	38	108	8	0	154
24167	15503s (+1.0s)	4396	4396	256	92	256	20	0	368
24168	15504s (+0.7s)	3128	3128	256	54	201	6	1	262
24169	15504s (+0.6s)	2660	2660	256	67	150	8	0	225
24170	15506s (+1.3s)	6648	6648	512	132	315	25	0	472
24171	15506s (+0.9s)	3428	3428	256	73	218	7	0	298
24172	15507s (+0.3s)	912	912	64	27	86	6	0	119
24173	15507s (+0.6s)	2376	2376	256	42	155	4	0	201
24174	15508s (+0.4s)	1204	1204	128	32	91	6	0	129
24175	15508s (+0.5s)	1608	1608	128	42	111	6	0	159
24176	15509s (+0.8s)	3392	3392	256	67	218	9	0	294
24177	15509s (+0.5s)	1524	1524	128	46	108	6	0	160
24178	15510s (+0.4s)	1068	1068	64	24	94	0	7	125
24179	15511s (+0.7s)	2896	2896	256	49	190	0	16	255
24180	15511s (+0.8s)	3152	3152	256	54	195	0	14	263
24181	15512s (+0.6s)	2520	2520	256	42	163	0	10	215
24182	15513s (+0.5s)	1788	1788	128	47	126	9	0	182
24183	15513s (+0.5s)	2248	2248	256	38	138	9	0	185
24184	15514s (+0.8s)	3480	3480	256	67	208	14	0	289
24185	15515s (+1.0s)	4336	4336	256	96	246	16	0	358
24186	15515s (+0.2s)	560	560	32	20	61	3	0	84
24187	15516s (+0.4s)	1212	1212	128	33	87	11	0	131
24188	15516s (+0.5s)	1716	1716	128	33	132	6	0	171
24189	15517s (+0.5s)	1856	1856	128	36	155	3	0	194
24190	15517s (+0.3s)	760	760	64	22	78	2	0	102
24191	15517s (+0.5s)	1724	1724	128	51	121	9	0	181
24192	15519s (+1.1s)	5728	5728	512	111	269	20	1	401
24193	15519s (+0.7s)	2708	2708	256	45	176	10	0	231
24194	15520s (+0.6s)	1916	1916	128	43	149	6	0	198
24195	15520s (+0.6s)	2376	2376	128	60	150	11	1	222
24196	15521s (+0.7s)	2908	2908	256	55	181	17	0	253
24197	15522s (+1.0s)	4112	4112	256	74	240	0	22	336
24198	15523s (+0.8s)	3332	3332	256	68	198	13	0	279
24199	15523s (+0.3s)	800	800	64	29	66	6	0	101
Episode	Time	Reward	Score	Highest	L	U	R	D	Steps
24200	15524s (+0.6s)	2492	2492	128	48	173	12	1	234
24201	15525s (+0.7s)	2924	2924	256	64	179	14	0	257
24202	15525s (+0.5s)	1892	1892	128	65	121	5	0	191
24203	15526s (+1.0s)	4264	4264	256	109	223	24	0	356
24204	15527s (+0.6s)	1972	1972	128	50	141	12	0	203
24205	15527s (+0.6s)	2392	2392	256	44	147	9	0	200
24206	15528s (+0.3s)	868	868	64	25	84	4	0	113
24207	15528s (+0.4s)	1480	1480	128	32	120	2	0	154
24208	15529s (+0.8s)	3228	3228	256	66	198	7	0	271
24209	15530s (+0.8s)	3532	3532	256	82	197	19	0	298
24210	15531s (+0.9s)	3868	3868	256	81	223	14	0	318
24211	15531s (+0.3s)	1132	1132	128	29	90	2	0	121
24212	15532s (+0.9s)	4008	4008	256	72	247	12	0	331
24213	15533s (+0.5s)	1856	1856	128	54	121	13	0	188
24214	15533s (+0.5s)	1908	1908	128	51	138	6	0	195
24215	15534s (+0.5s)	1640	1640	128	51	116	5	0	172
24216	15535s (+1.0s)	4224	4224	256	104	222	18	0	344
24217	15536s (+1.0s)	4172	4172	256	75	248	16	0	339
24218	15536s (+0.5s)	1880	1880	128	44	137	8	0	189
24219	15537s (+0.5s)	1424	1424	128	29	113	6	0	148
24220	15537s (+0.6s)	2436	2436	256	36	160	0	6	202
24221	15538s (+0.5s)	1900	1900	128	39	138	0	10	187
24222	15538s (+0.4s)	1480	1480	128	33	113	0	8	154
24223	15538s (+0.3s)	980	980	64	25	91	0	5	121
24224	15539s (+0.8s)	3332	3332	256	59	211	0	9	279
24225	15540s (+0.7s)	2676	2676	256	54	168	0	7	229
24226	15540s (+0.5s)	1784	1784	128	31	144	0	7	182
24227	15541s (+0.4s)	1284	1284	128	31	103	0	4	138
24228	15542s (+0.6s)	2600	2600	256	46	170	0	9	225
24229	15542s (+0.7s)	2828	2828	256	38	200	0	11	249
24230	15543s (+0.5s)	1828	1828	128	40	139	0	8	187
24231	15543s (+0.4s)	1388	1388	128	29	113	0	6	148
24232	15544s (+0.8s)	3532	3532	256	69	199	0	15	283
24233	15545s (+0.5s)	1732	1732	128	40	125	7	0	172
24234	15546s (+1.0s)	4188	4188	256	92	229	18	0	339
24235	15546s (+0.7s)	2756	2756	256	69	157	10	1	237
24236	15547s (+0.4s)	1144	1144	128	24	97	3	0	124
24237	15547s (+0.7s)	2676	2676	256	57	164	8	0	229
24238	15548s (+0.9s)	4168	4168	256	87	241	16	0	344
24239	15549s (+0.5s)	1504	1504	128	29	123	7	0	159
24240	15549s (+0.4s)	1464	1464	128	30	110	8	0	148
24241	15550s (+0.5s)	1812	1812	128	49	133	6	0	188
24242	15550s (+0.5s)	1536	1536	128	42	111	8	1	162
24243	15551s (+1.3s)	7016	7016	512	119	332	20	0	471
24244	15552s (+0.4s)	1144	1144	64	41	85	8	0	134
24245	15553s (+0.9s)	3912	3912	256	71	234	13	0	318
24246	15553s (+0.5s)	1544	1544	128	45	113	6	0	164
24247	15554s (+0.5s)	1680	1680	128	48	112	11	0	171
24248	15554s (+0.5s)	1508	1508	128	32	122	6	0	160
24249	15555s (+0.6s)	2568	2568	256	43	170	8	1	222
24250	15556s (+1.0s)	5264	5264	512	89	247	26	1	363
24251	15557s (+0.7s)	3016	3016	256	53	178	9	0	240
24252	15557s (+0.6s)	2112	2112	128	51	145	12	0	208
24253	15558s (+0.5s)	1848	1848	128	44	128	17	0	189
24254	15558s (+0.4s)	1192	1192	128	21	106	3	0	130
24255	15558s (+0.4s)	1180	1180	128	29	93	6	0	128
24256	15559s (+0.7s)	2920	2920	256	66	168	7	1	242
24257	15560s (+0.4s)	1432	1432	128	22	122	3	1	148
24258	15560s (+0.6s)	1908	1908	128	33	155	7	0	195
24259	15561s (+1.2s)	5728	5728	512	109	275	19	0	403
24260	15562s (+0.5s)	1560	1560	128	47	101	0	11	159
24261	15562s (+0.4s)	1320	1320	128	20	111	0	6	137
24262	15563s (+0.9s)	4024	4024	256	67	250	0	18	335
24263	15564s (+0.8s)	3244	3244	256	56	200	0	14	270
24264	15564s (+0.4s)	1320	1320	128	27	107	0	5	139
24265	15565s (+0.6s)	2396	2396	256	45	152	0	6	203
24266	15566s (+0.9s)	3576	3576	256	85	199	13	1	298
24267	15566s (+0.7s)	2500	2500	128	61	163	12	0	236
24268	15567s (+0.5s)	1588	1588	128	40	115	8	0	163
24269	15567s (+0.4s)	1336	1336	128	32	102	5	0	139
24270	15568s (+0.6s)	2164	2164	128	57	148	0	11	216
24271	15569s (+0.8s)	3528	3528	256	62	218	0	16	296
24272	15569s (+0.3s)	692	692	64	22	68	2	0	92
24273	15570s (+0.8s)	3188	3188	256	51	205	9	0	265
24274	15570s (+0.3s)	856	856	64	33	80	3	0	116
24275	15571s (+0.4s)	1456	1456	128	22	126	0	5	153
24276	15572s (+1.0s)	4276	4276	256	92	247	15	1	355
24277	15572s (+0.8s)	3232	3232	256	68	189	14	0	271
24278	15573s (+0.6s)	2396	2396	256	42	146	9	0	197
24279	15574s (+0.6s)	1984	1984	128	43	144	11	0	198
24280	15574s (+0.3s)	864	864	64	36	71	4	0	111
24281	15575s (+1.0s)	4068	4068	256	84	239	16	0	339
24282	15575s (+0.4s)	1240	1240	128	33	96	9	0	138
24283	15576s (+0.8s)	3352	3352	256	43	228	0	8	279
24284	15577s (+0.7s)	3264	3264	256	56	199	0	14	269
24285	15577s (+0.5s)	1604	1604	128	33	132	0	3	168
24286	15578s (+0.8s)	3252	3252	256	52	209	0	15	276
24287	15579s (+0.5s)	1848	1848	128	33	147	0	6	186
24288	15579s (+0.6s)	2628	2628	256	50	167	5	0	222
24289	15580s (+0.7s)	2824	2824	256	57	177	15	0	249
24290	15581s (+0.6s)	2716	2716	256	53	169	6	0	228
24291	15581s (+0.8s)	3404	3404	256	50	223	9	0	282
24292	15582s (+0.7s)	2476	2476	128	61	169	7	0	237
24293	15583s (+0.7s)	2744	2744	128	80	160	13	0	253
24294	15583s (+0.5s)	1576	1576	128	40	117	5	0	162
24295	15584s (+0.8s)	3464	3464	256	75	200	15	0	290
24296	15584s (+0.3s)	932	932	64	29	74	5	0	108
24297	15585s (+0.6s)	2612	2612	256	45	162	8	0	215
24298	15586s (+0.5s)	1788	1788	128	37	139	7	0	183
24299	15586s (+0.4s)	1444	1444	128	33	122	5	0	160
Episode	Time	Reward	Score	Highest	L	U	R	D	Steps
24300	15587s (+0.7s)	2280	2280	128	62	153	14	0	229
24301	15587s (+0.8s)	3244	3244	256	59	207	8	0	274
24302	15588s (+0.5s)	1476	1476	128	39	115	5	0	159
24303	15588s (+0.4s)	1384	1384	128	28	113	5	0	146
24304	15589s (+0.6s)	2544	2544	256	44	158	10	0	212
24305	15589s (+0.6s)	2336	2336	256	38	151	9	0	198
24306	15590s (+0.8s)	3640	3640	256	75	205	14	0	294
24307	15591s (+0.3s)	840	840	64	30	71	6	0	107
24308	15591s (+0.5s)	1668	1668	128	40	124	9	0	173
24309	15592s (+0.5s)	1892	1892	128	50	133	9	0	192
24310	15592s (+0.5s)	1656	1656	128	32	124	9	1	166
24311	15593s (+0.5s)	1632	1632	128	36	124	10	0	170
24312	15593s (+0.7s)	2812	2812	256	57	178	11	0	246
24313	15594s (+0.9s)	3816	3816	256	65	242	13	0	320
24314	15595s (+0.7s)	2800	2800	256	64	168	11	0	243
24315	15596s (+0.5s)	1904	1904	128	40	149	5	0	194
24316	15596s (+0.8s)	3396	3396	256	66	216	13	0	295
24317	15597s (+0.4s)	1388	1388	128	41	93	7	0	141
24318	15598s (+0.7s)	2780	2780	256	55	176	7	0	238
24319	15598s (+0.8s)	3532	3532	256	79	202	15	1	297
24320	15599s (+0.6s)	2468	2468	256	54	145	9	0	208
24321	15600s (+0.6s)	2488	2488	256	47	144	13	0	204
24322	15600s (+0.6s)	1924	1924	128	39	155	5	0	199
24323	15601s (+0.7s)	2904	2904	256	54	177	7	1	239
24324	15601s (+0.7s)	2804	2804	256	58	173	13	0	244
24325	15602s (+0.5s)	1688	1688	128	31	132	7	0	170
24326	15603s (+0.6s)	1936	1936	128	49	129	16	0	194
24327	15603s (+0.8s)	3196	3196	256	51	208	0	8	267
24328	15604s (+0.6s)	2460	2460	256	42	157	0	9	208
24329	15605s (+1.2s)	5600	5600	512	84	295	0	19	398
24330	15606s (+0.6s)	1892	1892	128	34	155	0	9	198
24331	15606s (+0.6s)	2284	2284	128	36	173	0	12	221
24332	15607s (+0.7s)	2516	2516	128	77	145	14	0	236
24333	15608s (+0.6s)	2412	2412	256	39	151	10	1	201
24334	15608s (+0.8s)	3468	3468	256	59	222	13	0	294
24335	15609s (+0.3s)	860	860	64	24	80	6	0	110
24336	15610s (+0.9s)	4160	4160	256	96	224	15	0	335
24337	15611s (+1.2s)	6048	6048	512	122	281	23	0	426
24338	15611s (+0.4s)	1180	1180	64	35	101	6	0	142
24339	15612s (+0.9s)	3664	3664	256	73	225	15	1	314
24340	15613s (+0.8s)	3412	3412	256	68	200	16	0	284
24341	15614s (+0.9s)	4140	4140	256	83	239	16	0	338
24342	15614s (+0.3s)	852	852	64	20	78	0	5	103
24343	15615s (+0.4s)	1496	1496	128	28	123	6	0	157
24344	15615s (+0.5s)	1912	1912	128	41	148	7	0	196
24345	15616s (+0.6s)	2628	2628	256	62	162	8	0	232
24346	15616s (+0.4s)	1068	1068	64	22	102	0	3	127
24347	15617s (+1.0s)	4408	4408	256	111	244	16	0	371
24348	15618s (+0.8s)	3308	3308	256	84	174	15	0	273
24349	15619s (+0.5s)	1736	1736	128	40	127	7	0	174
24350	15619s (+0.4s)	1484	1484	128	34	118	3	0	155
24351	15620s (+0.7s)	2672	2672	256	59	156	13	0	228
24352	15620s (+0.4s)	1144	1144	128	22	95	0	7	124
24353	15621s (+0.8s)	3248	3248	256	54	208	0	11	273
24354	15622s (+0.7s)	2628	2628	256	60	164	8	0	232
24355	15622s (+0.5s)	1620	1620	128	40	124	8	0	172
24356	15623s (+0.5s)	1812	1812	128	42	131	8	0	181
24357	15623s (+0.5s)	2004	2004	128	40	138	10	1	189
24358	15623s (+0.3s)	900	900	64	36	74	6	0	116
24359	15624s (+0.2s)	620	620	64	16	61	6	0	83
24360	15625s (+1.4s)	7280	7280	512	143	333	28	0	504
24361	15626s (+0.6s)	2376	2376	128	47	162	0	13	222
24362	15626s (+0.7s)	2600	2600	256	40	180	0	6	226
24363	15627s (+0.7s)	2780	2780	256	53	177	0	9	239
24364	15628s (+0.7s)	2876	2876	256	67	163	0	17	247
24365	15628s (+0.6s)	2508	2508	256	41	169	0	8	218
24366	15629s (+0.7s)	3160	3160	256	57	192	0	9	258
24367	15630s (+0.8s)	3344	3344	256	71	190	0	11	272
24368	15630s (+0.4s)	1308	1308	128	26	108	0	3	137
24369	15631s (+0.7s)	3084	3084	256	65	189	0	12	266
24370	15632s (+0.7s)	2792	2792	256	46	188	0	7	241
24371	15633s (+0.8s)	3236	3236	256	72	178	10	1	261
24372	15633s (+0.9s)	3592	3592	256	86	208	10	1	305
24373	15634s (+0.3s)	1020	1020	128	26	80	4	0	110
24374	15634s (+0.5s)	1844	1844	128	51	122	11	0	184
24375	15635s (+0.6s)	2444	2444	256	48	152	8	0	208
24376	15636s (+0.8s)	3428	3428	256	94	169	25	0	288
24377	15637s (+0.8s)	3496	3496	256	90	187	16	0	293
24378	15637s (+0.8s)	3252	3252	256	86	175	16	0	277
24379	15638s (+0.6s)	2596	2596	256	49	166	9	0	224
24380	15639s (+0.5s)	1820	1820	128	54	121	8	0	183
24381	15639s (+0.6s)	1972	1972	128	60	127	9	0	196
24382	15640s (+0.7s)	3100	3100	256	68	164	16	1	249
24383	15641s (+1.0s)	4144	4144	256	97	227	14	0	338
24384	15641s (+0.5s)	1636	1636	128	53	111	12	0	176
24385	15642s (+0.7s)	2832	2832	256	60	168	5	0	233
24386	15643s (+1.3s)	6276	6276	512	117	313	20	0	450
24387	15644s (+0.6s)	1904	1904	128	48	141	9	0	198
24388	15644s (+0.4s)	1500	1500	128	38	111	9	0	158
24389	15645s (+0.4s)	1328	1328	128	39	103	5	0	147
24390	15645s (+0.5s)	1796	1796	128	48	127	10	0	185
24391	15646s (+0.3s)	944	944	64	24	86	0	7	117
24392	15646s (+0.3s)	1036	1036	128	22	82	0	3	107
24393	15647s (+0.6s)	2632	2632	256	48	158	0	17	223
24394	15647s (+0.8s)	3676	3676	256	62	229	0	14	305
24395	15648s (+0.8s)	3600	3600	256	65	210	0	14	289
24396	15649s (+0.4s)	1172	1172	64	38	92	10	0	140
24397	15649s (+0.8s)	3216	3216	256	64	193	10	0	267
24398	15650s (+0.6s)	2516	2516	256	56	153	12	0	221
24399	15651s (+0.8s)	3256	3256	256	52	213	11	0	276
Episode	Time	Reward	Score	Highest	L	U	R	D	Steps
24400	15651s (+0.3s)	856	856	64	30	73	7	0	110
24401	15652s (+0.8s)	3552	3552	256	81	194	20	0	295
24402	15653s (+0.6s)	2512	2512	256	45	160	8	0	213
24403	15654s (+0.8s)	3444	3444	256	75	202	11	0	288
24404	15654s (+0.3s)	756	756	64	25	74	2	0	101
24405	15654s (+0.7s)	2800	2800	256	55	180	9	0	244
24406	15655s (+0.4s)	1428	1428	128	45	95	7	0	147
24407	15656s (+1.1s)	5624	5624	512	107	264	18	1	390
24408	15657s (+0.6s)	2376	2376	128	47	161	0	11	219
24409	15658s (+1.4s)	6776	6776	512	111	345	17	0	473
24410	15659s (+0.8s)	2952	2952	256	65	188	11	0	264
24411	15659s (+0.4s)	1532	1532	128	32	118	5	0	155
24412	15660s (+0.7s)	2920	2920	256	62	182	12	0	256
24413	15661s (+0.9s)	3848	3848	256	74	217	16	0	307
24414	15661s (+0.5s)	1476	1476	128	41	116	6	0	163
24415	15662s (+0.4s)	1500	1500	128	34	117	7	0	158
24416	15662s (+0.6s)	2560	2560	256	53	157	6	0	216
24417	15663s (+0.5s)	1892	1892	128	48	124	5	0	177
24418	15664s (+0.9s)	3584	3584	256	74	216	15	0	305
24419	15664s (+0.5s)	1856	1856	128	41	138	8	0	187
24420	15665s (+0.6s)	2092	2092	128	54	131	10	1	196
24421	15666s (+1.1s)	5452	5452	512	101	258	19	1	379
24422	15667s (+0.7s)	3096	3096	256	60	193	6	0	259
24423	15667s (+0.4s)	1456	1456	128	45	96	8	0	149
24424	15668s (+0.7s)	3328	3328	256	58	201	11	0	270
24425	15669s (+0.7s)	2788	2788	256	72	156	12	0	240
24426	15669s (+0.5s)	1896	1896	128	51	132	9	0	192
24427	15670s (+0.7s)	3032	3032	256	67	171	15	0	253
24428	15671s (+0.7s)	2752	2752	256	58	176	8	0	242
24429	15671s (+0.5s)	1496	1496	128	30	121	6	0	157
24430	15672s (+1.0s)	4084	4084	256	83	243	17	0	343
24431	15673s (+0.5s)	1808	1808	128	52	125	9	0	186
24432	15673s (+0.8s)	3388	3388	256	88	179	16	0	283
24433	15674s (+1.0s)	4212	4212	256	70	262	12	0	344
24434	15675s (+0.8s)	3276	3276	256	62	199	10	0	271
24435	15675s (+0.3s)	1016	1016	128	27	77	6	0	110
24436	15676s (+0.8s)	3272	3272	256	64	192	10	0	266
24437	15677s (+0.6s)	2112	2112	128	51	138	10	0	199
24438	15678s (+0.8s)	3448	3448	256	63	204	19	0	286
24439	15678s (+0.4s)	1420	1420	128	44	99	8	0	151
24440	15679s (+0.6s)	2404	2404	256	36	162	7	0	205
24441	15679s (+0.6s)	1924	1924	128	51	140	8	0	199
24442	15680s (+0.7s)	2812	2812	256	61	167	10	2	240
24443	15681s (+0.8s)	3484	3484	256	69	204	17	0	290
24444	15682s (+0.7s)	3156	3156	256	68	179	11	0	258
24445	15682s (+0.5s)	1540	1540	128	53	99	9	0	161
24446	15683s (+0.8s)	4468	4468	512	78	217	15	0	310
24447	15683s (+0.5s)	1488	1488	128	37	114	6	0	157
24448	15684s (+0.4s)	1476	1476	128	21	120	2	0	143
24449	15684s (+0.5s)	1844	1844	128	55	121	7	1	184
24450	15685s (+0.9s)	3928	3928	256	89	215	14	0	318
24451	15686s (+0.5s)	1584	1584	128	42	112	7	0	161
24452	15686s (+0.5s)	1608	1608	128	44	117	7	1	169
24453	15687s (+0.6s)	2024	2024	128	42	149	10	0	201
24454	15687s (+0.8s)	3392	3392	256	72	188	19	0	279
24455	15688s (+0.5s)	1580	1580	128	34	129	4	0	167
24456	15688s (+0.4s)	1340	1340	128	28	106	6	0	140
24457	15689s (+0.5s)	1788	1788	128	50	124	8	0	182
24458	15689s (+0.5s)	1776	1776	128	36	138	5	0	179
24459	15690s (+0.8s)	3304	3304	256	74	192	12	0	278
24460	15691s (+0.6s)	2492	2492	256	41	165	9	0	215
24461	15692s (+0.7s)	2572	2572	128	62	164	14	1	241
24462	15692s (+0.6s)	2452	2452	128	55	157	14	2	228
24463	15693s (+0.4s)	1152	1152	128	22	98	5	0	125
24464	15693s (+0.4s)	1056	1056	64	33	88	7	0	128
24465	15694s (+0.7s)	2812	2812	256	56	178	12	0	246
24466	15694s (+0.5s)	1712	1712	128	50	117	8	0	175
24467	15695s (+0.4s)	1476	1476	128	41	101	10	0	152
24468	15695s (+0.7s)	3092	3092	256	64	176	12	1	253
24469	15696s (+0.8s)	3528	3528	256	69	207	10	0	286
24470	15697s (+0.7s)	2700	2700	256	78	142	14	0	234
24471	15698s (+0.7s)	2636	2636	256	53	173	7	0	233
24472	15698s (+0.6s)	2596	2596	256	49	153	10	1	213
24473	15699s (+0.4s)	1436	1436	128	32	118	4	0	154
24474	15699s (+0.7s)	3196	3196	256	55	203	9	0	267
24475	15700s (+0.3s)	728	728	64	26	66	3	0	95
24476	15700s (+0.8s)	3560	3560	256	79	197	14	0	290
24477	15701s (+1.0s)	5020	5020	512	91	243	20	1	355
24478	15702s (+0.5s)	1432	1432	64	38	109	11	0	158
24479	15703s (+0.7s)	2688	2688	256	57	168	7	0	232
24480	15703s (+0.4s)	1420	1420	128	25	112	5	2	144
24481	15703s (+0.4s)	1432	1432	128	39	110	8	0	157
24482	15704s (+0.6s)	2544	2544	256	49	165	9	1	224
24483	15705s (+0.9s)	3724	3724	256	73	227	0	14	314
24484	15706s (+0.6s)	2520	2520	256	44	162	0	10	216
24485	15706s (+0.6s)	2772	2772	256	48	180	0	8	236
24486	15707s (+0.5s)	2000	2000	128	42	135	0	12	189
24487	15707s (+0.6s)	2112	2112	128	47	162	0	5	214
24488	15708s (+0.5s)	1560	1560	128	28	131	0	4	163
24489	15708s (+0.4s)	1412	1412	128	32	114	0	7	153
24490	15710s (+1.3s)	6472	6472	512	97	326	0	19	442
24491	15710s (+0.8s)	3244	3244	256	53	208	0	12	273
24492	15711s (+0.5s)	1800	1800	128	46	131	8	0	185
24493	15711s (+0.5s)	1648	1648	128	38	122	9	0	169
24494	15712s (+0.7s)	2508	2508	128	68	155	14	0	237
24495	15713s (+0.9s)	3880	3880	256	85	212	18	0	315
24496	15714s (+1.0s)	4304	4304	256	100	231	23	0	354
24497	15714s (+0.3s)	908	908	64	31	83	4	0	118
24498	15715s (+0.5s)	1612	1612	128	42	111	5	1	159
24499	15716s (+1.1s)	5544	5544	512	96	278	18	0	392
Episode	Time	Reward	Score	Highest	L	U	R	D	Steps
24500	15716s (+0.4s)	1284	1284	128	25	103	2	0	130
24501	15717s (+0.7s)	2956	2956	256	65	187	13	0	265
24502	15718s (+0.7s)	2836	2836	256	64	165	11	2	242
24503	15718s (+0.3s)	1020	1020	128	27	80	3	0	110
24504	15719s (+0.9s)	4268	4268	256	88	242	15	0	345
24505	15720s (+1.1s)	5608	5608	512	75	305	0	21	401
24506	15721s (+0.4s)	1176	1176	64	33	102	6	0	141
24507	15721s (+0.5s)	2296	2296	256	34	152	0	2	188
24508	15722s (+0.6s)	2468	2468	256	31	178	0	5	214
24509	15722s (+0.6s)	1952	1952	128	44	150	0	8	202
24510	15723s (+0.3s)	984	984	64	21	93	0	6	120
24511	15723s (+0.5s)	1748	1748	128	32	135	0	11	178
24512	15724s (+0.5s)	1752	1752	128	42	128	9	0	179
24513	15724s (+0.5s)	1784	1784	128	38	135	8	0	181
24514	15725s (+1.0s)	4248	4248	256	96	238	18	0	352
24515	15726s (+0.5s)	1708	1708	128	41	121	9	0	171
24516	15726s (+0.5s)	1888	1888	128	50	130	10	0	190
24517	15727s (+0.6s)	2656	2656	256	60	155	10	0	225
24518	15728s (+0.6s)	2460	2460	256	60	136	11	0	207
24519	15729s (+1.0s)	4064	4064	256	100	217	18	0	335
24520	15729s (+0.9s)	4640	4640	512	83	221	16	0	320
24521	15730s (+0.9s)	3868	3868	256	82	212	18	0	312
24522	15731s (+0.4s)	1300	1300	128	35	100	6	0	141
24523	15732s (+0.8s)	3320	3320	256	74	202	12	0	288
24524	15733s (+0.9s)	3872	3872	256	98	223	12	0	333
24525	15733s (+0.8s)	3348	3348	256	68	200	14	1	283
24526	15734s (+0.9s)	3860	3860	256	84	220	12	0	316
24527	15735s (+0.8s)	3184	3184	256	55	195	13	0	263
24528	15736s (+0.6s)	1900	1900	128	46	140	9	0	195
24529	15737s (+1.1s)	5708	5708	512	106	275	28	0	409
24530	15737s (+0.4s)	1192	1192	64	45	96	4	0	145
24531	15738s (+0.4s)	1452	1452	128	35	108	8	0	151
24532	15738s (+0.6s)	1952	1952	128	52	145	4	0	201
24533	15739s (+0.5s)	1624	1624	128	36	123	4	0	163
24534	15739s (+0.4s)	1488	1488	128	39	110	7	0	156
24535	15740s (+0.9s)	3872	3872	256	62	243	7	0	312
24536	15740s (+0.4s)	1432	1432	128	34	106	7	1	148
24537	15741s (+0.5s)	1624	1624	128	46	117	10	0	173
24538	15742s (+0.9s)	4028	4028	256	96	214	19	0	329
24539	15743s (+0.8s)	3132	3132	256	82	181	14	0	277
24540	15743s (+0.5s)	1640	1640	128	36	125	5	0	166
24541	15744s (+0.5s)	1548	1548	128	40	114	8	0	162
24542	15744s (+1.0s)	4048	4048	256	85	235	13	1	334
24543	15745s (+0.9s)	3976	3976	256	75	240	13	0	328
24544	15746s (+0.9s)	3864	3864	256	67	234	15	1	317
24545	15747s (+0.4s)	1248	1248	128	32	95	5	0	132
24546	15747s (+0.7s)	2792	2792	256	57	174	10	0	241
24547	15748s (+0.3s)	1048	1048	128	21	88	4	0	113
24548	15748s (+0.7s)	3116	3116	256	76	169	13	0	258
24549	15749s (+0.4s)	1368	1368	64	36	105	9	0	150
24550	15750s (+1.3s)	6316	6316	512	120	308	21	1	450
24551	15751s (+0.6s)	2184	2184	128	47	144	9	0	200
24552	15752s (+0.9s)	3736	3736	256	84	213	12	0	309
24553	15752s (+0.6s)	1976	1976	128	55	131	11	0	197
24554	15753s (+0.5s)	1528	1528	64	42	121	6	0	169
24555	15754s (+0.8s)	3496	3496	256	55	225	13	0	293
24556	15754s (+0.6s)	2140	2140	128	54	145	7	1	207
24557	15755s (+1.1s)	4620	4620	256	105	255	25	0	385
24558	15756s (+0.7s)	2840	2840	256	58	173	11	0	242
24559	15756s (+0.4s)	1488	1488	128	32	119	5	0	156
24560	15757s (+0.4s)	1544	1544	128	37	112	6	0	155
24561	15757s (+0.3s)	760	760	64	24	72	6	0	102
24562	15758s (+0.8s)	3548	3548	256	83	202	16	0	301
24563	15758s (+0.4s)	1180	1180	128	28	96	0	5	129
24564	15759s (+0.4s)	1060	1060	64	32	82	0	8	122
24565	15760s (+1.0s)	4224	4224	256	72	253	0	21	346
24566	15760s (+0.4s)	1580	1580	128	35	112	0	10	157
24567	15761s (+0.7s)	2740	2740	256	56	163	12	1	232
24568	15761s (+0.5s)	1684	1684	128	41	124	12	0	177
24569	15762s (+0.6s)	2072	2072	128	43	152	8	1	204
24570	15762s (+0.3s)	980	980	128	34	66	6	0	106
24571	15763s (+1.2s)	5900	5900	512	108	293	27	1	429
24572	15764s (+0.8s)	3384	3384	256	72	211	9	0	292
24573	15765s (+0.6s)	1960	1960	128	57	135	11	0	203
24574	15766s (+1.1s)	5352	5352	512	86	273	15	1	375
24575	15767s (+0.7s)	3168	3168	256	72	177	15	0	264
24576	15767s (+0.7s)	3208	3208	256	70	183	12	1	266
24577	15768s (+0.5s)	1520	1520	128	39	113	7	0	159
24578	15768s (+0.4s)	1120	1120	128	32	84	7	1	124
24579	15769s (+1.0s)	4124	4124	256	93	238	17	0	348
24580	15770s (+0.5s)	1592	1592	128	49	106	9	1	165
24581	15770s (+0.5s)	1748	1748	128	40	132	5	0	177
24582	15771s (+0.9s)	3828	3828	256	69	232	11	0	312
24583	15772s (+0.5s)	1592	1592	128	38	118	9	0	165
24584	15773s (+1.1s)	4664	4664	256	117	254	21	0	392
24585	15773s (+0.5s)	1784	1784	128	47	126	8	0	181
24586	15774s (+0.7s)	2920	2920	256	50	200	6	0	256
24587	15774s (+0.5s)	1668	1668	128	36	125	6	1	168
24588	15775s (+0.3s)	864	864	64	26	81	5	0	112
24589	15775s (+0.6s)	1912	1912	128	42	147	7	0	196
24590	15776s (+0.5s)	2140	2140	256	46	129	6	0	181
24591	15777s (+0.9s)	3992	3992	256	98	206	20	1	325
24592	15777s (+0.5s)	1664	1664	128	35	128	6	0	169
24593	15778s (+0.6s)	2664	2664	256	61	153	7	0	221
24594	15779s (+0.8s)	3592	3592	256	70	214	15	1	300
24595	15779s (+0.5s)	1776	1776	128	45	128	6	0	179
24596	15780s (+0.7s)	2888	2888	256	63	166	11	0	240
24597	15781s (+0.7s)	3148	3148	256	59	190	11	0	260
24598	15781s (+0.4s)	1468	1468	128	34	116	5	0	155
24599	15782s (+0.8s)	3616	3616	256	66	219	13	0	298
Episode	Time	Reward	Score	Highest	L	U	R	D	Steps
24600	15782s (+0.4s)	1496	1496	128	35	114	8	0	157
24601	15784s (+1.4s)	6600	6600	512	137	305	33	0	475
24602	15784s (+0.4s)	1456	1456	128	26	121	4	0	151
24603	15785s (+0.6s)	2668	2668	256	48	171	9	0	228
24604	15786s (+0.6s)	2568	2568	256	60	147	11	0	218
24605	15786s (+0.8s)	3508	3508	256	73	211	12	0	296
24606	15787s (+0.3s)	868	868	64	35	71	6	0	112
24607	15788s (+0.8s)	3548	3548	256	72	213	16	0	301
24608	15788s (+0.7s)	2788	2788	256	68	160	12	0	240
24609	15789s (+0.8s)	3304	3304	256	62	201	9	0	272
24610	15790s (+0.5s)	1588	1588	128	34	121	4	0	159
24611	15790s (+0.6s)	2632	2632	256	50	166	0	11	227
24612	15791s (+0.4s)	1268	1268	128	22	98	0	8	128
24613	15791s (+0.6s)	1964	1964	128	55	141	8	0	204
24614	15792s (+0.5s)	1648	1648	128	39	115	10	1	165
24615	15792s (+0.8s)	3944	3944	256	75	227	9	0	311
24616	15793s (+0.6s)	2488	2488	256	51	156	7	0	214
24617	15793s (+0.3s)	976	976	64	21	90	4	0	115
24618	15794s (+0.5s)	1848	1848	128	41	135	9	0	185
24619	15795s (+1.1s)	5616	5616	512	95	289	18	0	402
24620	15796s (+0.5s)	1748	1748	128	42	123	8	1	174
24621	15796s (+0.8s)	3552	3552	256	80	204	10	1	295
24622	15797s (+0.4s)	1052	1052	64	43	78	6	0	127
24623	15797s (+0.4s)	1232	1232	128	34	98	4	0	136
24624	15798s (+0.4s)	1176	1176	128	27	90	0	9	126
24625	15798s (+0.2s)	588	588	64	16	62	4	0	82
24626	15799s (+1.0s)	4204	4204	256	86	241	18	0	345
24627	15799s (+0.6s)	2180	2180	128	60	149	11	0	220
24628	15800s (+0.8s)	3540	3540	256	92	192	15	0	299
24629	15801s (+1.0s)	4236	4236	256	93	241	15	0	349
24630	15802s (+0.4s)	1152	1152	128	34	82	6	0	122
24631	15802s (+0.5s)	1616	1616	128	31	136	4	0	171
24632	15802s (+0.2s)	572	572	64	23	57	4	0	84
24633	15803s (+0.4s)	1072	1072	64	34	89	4	0	127
24634	15803s (+0.7s)	2840	2840	256	52	182	7	0	241
24635	15804s (+0.3s)	820	820	64	21	84	7	0	112
24636	15804s (+0.6s)	2484	2484	256	52	151	10	0	213
24637	15805s (+0.4s)	1440	1440	128	35	106	7	0	148
24638	15805s (+0.4s)	1200	1200	64	36	94	6	0	136
24639	15806s (+1.0s)	4272	4272	256	84	256	17	1	358
24640	15807s (+0.7s)	2804	2804	256	65	171	8	0	244
24641	15807s (+0.6s)	1940	1940	128	41	157	5	0	203
24642	15808s (+0.6s)	2504	2504	256	58	155	5	0	218
24643	15808s (+0.3s)	840	840	64	30	78	4	0	112
24644	15809s (+0.8s)	3352	3352	256	57	217	10	0	284
24645	15810s (+0.6s)	2456	2456	256	42	152	11	1	206
24646	15810s (+0.6s)	1928	1928	128	51	134	9	0	194
24647	15811s (+0.7s)	3148	3148	256	54	198	9	0	261
24648	15812s (+0.5s)	1808	1808	128	53	119	9	0	181
24649	15812s (+0.5s)	1696	1696	128	50	110	9	0	169
24650	15813s (+0.6s)	2420	2420	128	42	174	0	12	228
24651	15813s (+0.3s)	660	660	64	18	67	0	6	91
24652	15814s (+0.6s)	2516	2516	256	51	158	7	0	216
24653	15815s (+0.9s)	3764	3764	256	76	212	15	0	303
24654	15816s (+0.9s)	4172	4172	256	86	236	16	0	338
24655	15816s (+0.4s)	1324	1324	128	31	97	9	0	137
24656	15817s (+0.6s)	1928	1928	128	50	140	10	0	200
24657	15817s (+0.8s)	3456	3456	256	67	203	13	0	283
24658	15818s (+0.6s)	2488	2488	256	36	169	9	0	214
24659	15818s (+0.4s)	1060	1060	64	32	86	6	0	124
24660	15819s (+0.7s)	2864	2864	256	63	180	5	0	248
24661	15820s (+1.4s)	7228	7228	512	118	359	24	0	501
24662	15821s (+0.5s)	1568	1568	128	40	112	7	0	159
24663	15821s (+0.5s)	1708	1708	128	40	128	4	0	172
24664	15822s (+0.8s)	3392	3392	256	73	197	12	1	283
24665	15823s (+0.9s)	3828	3828	256	78	221	13	0	312
24666	15824s (+1.0s)	4316	4316	256	92	246	20	0	358
24667	15825s (+0.5s)	1628	1628	128	38	131	5	0	174
24668	15825s (+0.4s)	1304	1304	128	27	102	3	0	132
24669	15826s (+0.7s)	3056	3056	256	56	177	12	0	245
24670	15827s (+1.2s)	5944	5944	512	117	280	19	0	416
24671	15828s (+0.9s)	3516	3516	256	104	180	14	0	298
24672	15829s (+1.1s)	4564	4564	256	120	243	19	0	382
24673	15829s (+0.5s)	2064	2064	128	42	139	11	0	192
24674	15830s (+0.5s)	1808	1808	128	49	127	11	0	187
24675	15830s (+0.4s)	1560	1560	128	36	117	5	1	159
24676	15831s (+0.9s)	3796	3796	256	82	219	14	0	315
24677	15832s (+0.5s)	1828	1828	128	46	137	8	0	191
24678	15832s (+0.6s)	2336	2336	256	47	139	7	0	193
24679	15833s (+0.4s)	1356	1356	128	35	99	5	0	139
24680	15833s (+0.4s)	1164	1164	64	40	93	5	0	138
24681	15834s (+0.8s)	3244	3244	256	78	182	14	0	274
24682	15835s (+0.7s)	2804	2804	128	82	168	13	0	263
24683	15836s (+0.8s)	3444	3444	256	70	210	12	0	292
24684	15836s (+0.7s)	2788	2788	256	57	171	12	0	240
24685	15837s (+0.5s)	1536	1536	128	42	116	9	0	167
24686	15837s (+0.7s)	2864	2864	256	57	173	18	0	248
24687	15838s (+0.7s)	2904	2904	256	65	167	12	0	244
24688	15839s (+0.5s)	1524	1524	128	35	120	5	0	160
24689	15839s (+0.4s)	1196	1196	128	27	95	9	0	131
24690	15839s (+0.3s)	888	888	64	25	85	7	0	117
24691	15840s (+0.9s)	3980	3980	256	83	228	19	0	330
24692	15841s (+0.9s)	3680	3680	256	62	229	0	16	307
24693	15842s (+0.5s)	1764	1764	128	36	136	0	9	181
24694	15842s (+0.8s)	3636	3636	256	64	221	0	13	298
24695	15843s (+0.4s)	1608	1608	128	24	133	0	6	163
24696	15843s (+0.3s)	1128	1128	128	22	96	0	3	121
24697	15844s (+0.6s)	2072	2072	128	42	152	0	11	205
24698	15844s (+0.4s)	1516	1516	128	33	113	0	7	153
24699	15845s (+0.4s)	1100	1100	64	29	98	0	5	132
Episode	Time	Reward	Score	Highest	L	U	R	D	Steps
24700	15845s (+0.7s)	2848	2848	256	55	177	0	11	243
24701	15846s (+0.9s)	3976	3976	256	77	234	17	0	328
24702	15847s (+0.8s)	3236	3236	256	71	185	15	0	271
24703	15848s (+0.7s)	2908	2908	256	64	178	11	0	253
24704	15848s (+0.7s)	2640	2640	256	53	171	6	0	230
24705	15849s (+1.0s)	4312	4312	256	95	242	19	0	356
24706	15850s (+0.9s)	3896	3896	256	80	227	17	0	324
24707	15851s (+0.8s)	2944	2944	256	68	180	14	0	262
24708	15852s (+0.6s)	2304	2304	128	61	146	9	0	216
24709	15852s (+0.4s)	1332	1332	128	27	105	3	0	135
24710	15853s (+0.5s)	1564	1564	128	46	112	7	0	165
24711	15853s (+0.5s)	1656	1656	128	48	111	8	0	167
24712	15853s (+0.4s)	1180	1180	128	29	97	1	0	127
24713	15855s (+1.4s)	6864	6864	512	119	328	32	0	479
24714	15855s (+0.5s)	1600	1600	128	36	121	10	0	167
24715	15856s (+0.6s)	2224	2224	128	64	135	12	0	211
24716	15856s (+0.4s)	1104	1104	64	32	96	7	0	135
24717	15857s (+0.9s)	3724	3724	256	84	205	14	0	303
24718	15858s (+0.7s)	3196	3196	256	53	193	15	1	262
24719	15859s (+1.1s)	5604	5604	512	96	274	18	0	388
24720	15860s (+0.7s)	3180	3180	256	62	191	10	0	263
24721	15860s (+0.7s)	3200	3200	256	59	200	9	0	268
24722	15861s (+0.7s)	2844	2844	256	59	180	10	0	249
24723	15862s (+0.6s)	2156	2156	128	53	149	14	1	217
24724	15862s (+0.5s)	1812	1812	128	46	124	11	0	181
24725	15863s (+0.6s)	2376	2376	256	38	156	9	0	203
24726	15863s (+0.4s)	1184	1184	128	34	90	5	0	129
24727	15864s (+0.5s)	2244	2244	256	36	155	5	0	196
24728	15865s (+0.7s)	2816	2816	256	70	159	13	0	242
24729	15866s (+0.9s)	4040	4040	256	67	251	14	0	332
24730	15866s (+0.9s)	4160	4160	256	78	245	0	19	342
24731	15867s (+0.7s)	2800	2800	256	58	176	9	0	243
24732	15868s (+0.7s)	2824	2824	256	71	162	15	1	249
24733	15869s (+0.7s)	2820	2820	128	74	170	16	0	260
24734	15869s (+0.6s)	1932	1932	128	45	149	7	0	201
24735	15870s (+0.5s)	1740	1740	128	48	116	10	0	174
24736	15870s (+0.6s)	2188	2188	128	38	163	0	7	208
24737	15871s (+0.6s)	2356	2356	128	42	164	0	11	217
24738	15872s (+0.6s)	2460	2460	256	51	146	10	0	207
24739	15872s (+0.8s)	3292	3292	256	66	194	14	0	274
24740	15873s (+0.9s)	4004	4004	256	81	237	17	0	335
24741	15874s (+0.5s)	1800	1800	128	45	134	6	0	185
24742	15875s (+0.7s)	2788	2788	128	77	170	13	0	260
24743	15875s (+0.7s)	3196	3196	256	67	190	9	0	266
24744	15876s (+0.6s)	1996	1996	128	39	158	8	0	205
24745	15876s (+0.5s)	1856	1856	128	39	142	8	0	189
24746	15877s (+0.6s)	2140	2140	128	53	140	14	0	207
24747	15878s (+0.7s)	2668	2668	256	58	162	7	0	227
24748	15878s (+0.8s)	3560	3560	256	90	191	16	0	297
24749	15879s (+0.5s)	1796	1796	128	51	123	10	0	184
24750	15880s (+0.5s)	1828	1828	128	51	130	6	0	187
24751	15880s (+0.8s)	3348	3348	256	60	199	19	0	278
24752	15881s (+0.6s)	2180	2180	128	60	140	16	0	216
24753	15882s (+1.4s)	6708	6708	512	91	372	0	20	483
24754	15883s (+0.5s)	1856	1856	128	40	146	0	8	194
24755	15884s (+1.0s)	5288	5288	512	80	259	0	20	359
24756	15885s (+0.9s)	4012	4012	256	66	251	0	15	332
24757	15885s (+0.5s)	1756	1756	128	32	141	0	7	180
24758	15886s (+1.0s)	4440	4440	256	65	279	0	20	364
24759	15887s (+0.5s)	1620	1620	128	26	137	0	9	172
24760	15887s (+0.4s)	1448	1448	128	35	108	6	1	150
24761	15888s (+0.7s)	3196	3196	256	68	181	14	0	263
24762	15889s (+0.6s)	2400	2400	128	50	163	9	1	223
24763	15889s (+0.7s)	2572	2572	256	54	165	13	1	233
24764	15890s (+0.5s)	1724	1724	128	60	109	8	1	178
24765	15891s (+0.8s)	3428	3428	256	74	189	18	0	281
24766	15891s (+0.4s)	1236	1236	128	31	100	5	0	136
24767	15892s (+0.5s)	1748	1748	128	32	139	5	0	176
24768	15892s (+0.4s)	1440	1440	128	36	103	10	0	149
24769	15893s (+0.9s)	4420	4420	256	106	210	21	0	337
24770	15893s (+0.5s)	1572	1572	128	31	128	2	0	161
24771	15894s (+0.9s)	3664	3664	256	81	209	24	0	314
24772	15895s (+0.8s)	3540	3540	256	73	212	14	0	299
24773	15896s (+0.8s)	3436	3436	256	57	218	8	0	283
24774	15897s (+0.6s)	1964	1964	128	52	149	3	0	204
24775	15897s (+0.3s)	636	636	64	22	61	4	0	87
24776	15897s (+0.6s)	1936	1936	128	54	139	9	0	202
24777	15898s (+1.0s)	4464	4464	256	98	245	19	0	362
24778	15899s (+0.5s)	1708	1708	128	41	130	7	0	178
24779	15899s (+0.4s)	1288	1288	128	24	100	0	6	130
24780	15900s (+0.3s)	852	852	64	23	82	0	6	111
24781	15900s (+0.7s)	3260	3260	256	52	206	0	9	267
24782	15901s (+0.4s)	1124	1124	128	43	78	0	4	125
24783	15901s (+0.5s)	1760	1760	128	30	147	0	4	181
24784	15902s (+0.5s)	1648	1648	128	39	120	0	6	165
24785	15902s (+0.8s)	3192	3192	256	54	195	0	14	263
24786	15903s (+0.5s)	1660	1660	128	29	131	0	7	167
24787	15904s (+0.7s)	2872	2872	256	65	172	13	0	250
24788	15904s (+0.6s)	2180	2180	128	63	129	13	0	205
24789	15905s (+0.5s)	1868	1868	128	58	117	11	0	186
24790	15905s (+0.4s)	1372	1372	128	27	108	8	0	143
24791	15906s (+0.8s)	3396	3396	256	81	183	18	0	282
24792	15906s (+0.3s)	696	696	64	20	69	3	0	92
24793	15907s (+0.5s)	1784	1784	128	41	130	10	1	182
24794	15908s (+0.9s)	3620	3620	256	62	228	17	0	307
24795	15909s (+0.8s)	3480	3480	256	75	200	14	0	289
24796	15909s (+0.5s)	1876	1876	128	48	138	5	1	192
24797	15910s (+0.6s)	2208	2208	128	48	156	8	0	212
24798	15910s (+0.6s)	2252	2252	128	50	150	0	13	213
24799	15911s (+0.6s)	2628	2628	256	47	162	0	12	221
Episode	Time	Reward	Score	Highest	L	U	R	D	Steps
24800	15912s (+0.7s)	3140	3140	256	61	183	0	13	257
24801	15912s (+0.5s)	2272	2272	256	32	147	0	7	186
24802	15912s (+0.3s)	920	920	64	23	82	0	6	111
24803	15913s (+0.9s)	3692	3692	256	48	243	0	14	305
24804	15914s (+0.5s)	1540	1540	128	32	124	0	7	163
24805	15915s (+0.7s)	2864	2864	256	43	195	0	7	245
24806	15915s (+0.7s)	2996	2996	256	48	187	0	9	244
24807	15916s (+0.5s)	1508	1508	128	26	127	5	1	159
24808	15916s (+0.5s)	1796	1796	128	46	124	11	0	181
24809	15917s (+0.8s)	3548	3548	256	75	204	17	0	296
24810	15917s (+0.4s)	1252	1252	128	22	107	2	0	131
24811	15918s (+0.5s)	1660	1660	128	52	115	10	0	177
24812	15918s (+0.3s)	1128	1128	128	17	99	0	3	119
24813	15919s (+0.4s)	1172	1172	128	32	92	2	1	127
24814	15919s (+0.3s)	1120	1120	128	31	83	4	0	118
24815	15919s (+0.4s)	1248	1248	128	40	93	4	0	137
24816	15920s (+0.9s)	4084	4084	256	79	233	16	0	328
24817	15921s (+0.8s)	3496	3496	256	67	189	16	1	273
24818	15922s (+0.7s)	2916	2916	256	54	194	7	0	255
24819	15922s (+0.6s)	2036	2036	128	56	128	15	2	201
24820	15923s (+1.0s)	4144	4144	256	83	235	20	0	338
24821	15924s (+0.6s)	1916	1916	128	44	143	10	0	197
24822	15925s (+0.8s)	3316	3316	256	76	187	14	0	277
24823	15925s (+0.7s)	2748	2748	256	59	167	8	1	235
24824	15926s (+0.4s)	1488	1488	128	35	110	8	0	153
24825	15926s (+0.3s)	728	728	64	17	76	4	0	97
24826	15927s (+0.5s)	1772	1772	128	49	122	7	0	178
24827	15928s (+0.9s)	4044	4044	256	86	229	19	0	334
24828	15929s (+1.4s)	6880	6880	512	138	332	27	1	498
24829	15930s (+0.9s)	3732	3732	256	86	209	19	1	315
24830	15931s (+0.7s)	2628	2628	256	67	152	10	0	229
24831	15931s (+0.2s)	540	540	32	25	55	4	0	84
24832	15931s (+0.3s)	904	904	64	26	80	2	0	108
24833	15932s (+0.5s)	1524	1524	128	34	125	5	0	164
24834	15932s (+0.8s)	3228	3228	256	46	216	7	1	270
24835	15933s (+0.6s)	2184	2184	128	49	161	11	0	221
24836	15934s (+0.8s)	3300	3300	256	67	191	13	0	271
24837	15934s (+0.5s)	1608	1608	128	30	126	4	0	160
24838	15935s (+0.8s)	3308	3308	256	59	208	8	0	275
24839	15936s (+0.6s)	2220	2220	128	47	158	8	1	214
24840	15936s (+0.4s)	1460	1460	128	38	111	7	0	156
24841	15937s (+0.6s)	2504	2504	256	63	148	6	0	217
24842	15937s (+0.3s)	964	964	64	26	86	8	0	120
24843	15938s (+0.8s)	3284	3284	256	67	189	16	0	272
24844	15939s (+0.8s)	3612	3612	256	82	211	12	0	305
24845	15939s (+0.3s)	716	716	64	25	66	7	0	98
24846	15940s (+0.8s)	3600	3600	256	74	215	13	0	302
24847	15940s (+0.4s)	1172	1172	64	38	95	7	0	140
24848	15941s (+0.6s)	2552	2552	256	47	157	7	1	212
24849	15942s (+0.7s)	2912	2912	256	51	195	0	8	254
24850	15943s (+1.0s)	4464	4464	256	74	278	0	17	369
24851	15943s (+0.8s)	3492	3492	256	64	215	0	10	289
24852	15944s (+0.5s)	1668	1668	128	41	116	0	11	168
24853	15944s (+0.5s)	2312	2312	256	52	131	9	0	192
24854	15946s (+1.1s)	5640	5640	512	106	273	21	0	400
24855	15946s (+0.5s)	1740	1740	128	47	124	4	0	175
24856	15947s (+0.4s)	1516	1516	128	53	96	7	0	156
24857	15947s (+0.9s)	3564	3564	256	81	208	16	0	305
24858	15948s (+0.6s)	2372	2372	256	51	148	5	0	204
24859	15949s (+0.7s)	2724	2724	256	53	172	11	0	236
24860	15949s (+0.5s)	1788	1788	128	35	141	6	0	182
24861	15950s (+0.6s)	1868	1868	128	43	149	4	0	196
24862	15951s (+0.9s)	3992	3992	256	89	227	16	0	332
24863	15951s (+0.6s)	2048	2048	128	60	135	12	0	207
24864	15952s (+0.2s)	632	632	64	17	66	4	0	87
24865	15952s (+0.5s)	2024	2024	256	45	114	10	0	169
24866	15953s (+0.4s)	1480	1480	128	40	108	6	0	154
24867	15953s (+0.4s)	1396	1396	128	36	97	8	1	142
24868	15954s (+0.7s)	2900	2900	256	61	178	11	1	251
24869	15954s (+0.8s)	3280	3280	256	65	189	13	0	267
24870	15955s (+0.7s)	3100	3100	256	79	161	15	0	255
24871	15956s (+0.9s)	4292	4292	256	92	233	22	0	347
24872	15957s (+1.0s)	4304	4304	256	95	240	19	0	354
24873	15958s (+0.5s)	1740	1740	128	36	138	2	0	176
24874	15958s (+0.4s)	1488	1488	128	34	112	7	0	153
24875	15959s (+0.5s)	1624	1624	128	41	116	5	0	162
24876	15959s (+0.6s)	1960	1960	128	52	137	11	0	200
24877	15960s (+1.0s)	5256	5256	512	90	257	10	0	357
24878	15962s (+1.3s)	6452	6452	512	115	321	22	1	459
24879	15962s (+0.6s)	2604	2604	256	53	161	0	11	225
24880	15963s (+0.7s)	2784	2784	256	57	170	0	12	239
24881	15963s (+0.5s)	1760	1760	128	38	135	0	7	180
24882	15964s (+0.4s)	1360	1360	128	38	95	0	10	143
24883	15965s (+0.9s)	3720	3720	256	82	208	22	0	312
24884	15965s (+0.4s)	1264	1264	128	19	112	2	0	133
24885	15965s (+0.4s)	1496	1496	128	41	109	8	0	158
24886	15966s (+0.7s)	2864	2864	256	58	175	10	0	243
24887	15967s (+0.5s)	1584	1584	128	48	108	7	0	163
24888	15967s (+0.4s)	1440	1440	128	28	111	0	11	150
24889	15968s (+0.9s)	3564	3564	256	62	231	12	0	305
24890	15969s (+0.6s)	2108	2108	128	54	131	13	0	198
24891	15969s (+0.3s)	812	812	64	23	76	5	0	104
24892	15969s (+0.4s)	1232	1232	64	44	104	2	0	150
24893	15970s (+0.7s)	2936	2936	256	63	182	11	0	256
24894	15971s (+0.9s)	3672	3672	256	76	213	12	0	301
24895	15972s (+0.8s)	3448	3448	256	75	200	11	0	286
24896	15972s (+0.5s)	1752	1752	128	40	131	0	6	177
24897	15972s (+0.3s)	744	744	64	26	69	4	0	99
24898	15973s (+0.5s)	1632	1632	128	38	121	5	0	164
24899	15974s (+0.9s)	3828	3828	256	105	204	18	0	327
Episode	Time	Reward	Score	Highest	L	U	R	D	Steps
24900	15974s (+0.5s)	1800	1800	128	45	127	13	0	185
24901	15975s (+0.8s)	3472	3472	256	77	210	11	0	298
24902	15976s (+0.6s)	2008	2008	128	49	153	7	0	209
24903	15976s (+0.4s)	1492	1492	128	44	103	10	0	157
24904	15977s (+0.8s)	3524	3524	256	66	216	13	0	295
24905	15978s (+0.4s)	1136	1136	64	37	88	10	1	136
24906	15978s (+0.5s)	1996	1996	128	37	144	0	11	192
24907	15979s (+0.5s)	2204	2204	256	42	130	1	9	182
24908	15979s (+0.4s)	1328	1328	128	29	105	0	4	138
24909	15980s (+0.7s)	3168	3168	256	60	186	0	14	260
24910	15980s (+0.3s)	1016	1016	128	19	85	5	0	109
24911	15981s (+0.5s)	1928	1928	128	38	159	3	0	200
24912	15982s (+1.1s)	4496	4496	256	113	241	23	0	377
24913	15983s (+0.8s)	3488	3488	256	76	197	18	0	291
24914	15983s (+0.4s)	1152	1152	64	41	88	6	0	135
24915	15984s (+0.7s)	3200	3200	256	64	188	10	1	263
24916	15984s (+0.5s)	1804	1804	128	33	148	5	0	186
24917	15985s (+0.4s)	1244	1244	128	35	88	6	0	129
24918	15985s (+0.5s)	2236	2236	256	41	135	0	6	182
24919	15985s (+0.3s)	1044	1044	64	23	95	0	7	125
24920	15986s (+0.6s)	2500	2500	256	49	158	0	10	217
24921	15986s (+0.3s)	748	748	64	21	74	0	4	99
24922	15987s (+0.3s)	1120	1120	128	24	87	0	6	117
24923	15987s (+0.7s)	2952	2952	256	67	159	17	0	243
24924	15988s (+0.7s)	2880	2880	256	63	169	18	1	251
24925	15989s (+0.8s)	3500	3500	256	63	214	12	0	289
24926	15990s (+0.6s)	2272	2272	128	64	137	11	0	212
24927	15990s (+0.5s)	1644	1644	128	40	123	14	0	177
24928	15991s (+0.5s)	1808	1808	128	59	117	10	0	186
24929	15991s (+0.5s)	1676	1676	128	32	129	4	0	165
24930	15992s (+0.9s)	3940	3940	256	78	230	15	0	323
24931	15993s (+0.8s)	3140	3140	256	57	198	9	0	264
24932	15993s (+0.2s)	588	588	64	15	59	2	0	76
24933	15994s (+0.7s)	2656	2656	128	74	169	11	0	254
24934	15995s (+0.9s)	4044	4044	256	91	216	22	0	329
24935	15995s (+0.6s)	1912	1912	128	49	138	5	0	192
24936	15996s (+0.5s)	1804	1804	128	40	137	9	0	186
24937	15997s (+1.0s)	5112	5112	512	77	264	14	1	356
24938	15997s (+0.5s)	1980	1980	128	45	130	13	0	188
24939	15998s (+0.7s)	2940	2940	256	72	178	11	0	261
24940	15999s (+0.5s)	1664	1664	128	40	115	13	0	168
24941	15999s (+0.8s)	3532	3532	256	78	208	11	0	297
24942	16000s (+1.0s)	5216	5216	512	91	255	17	0	363
24943	16001s (+0.3s)	788	788	64	24	74	7	0	105
24944	16001s (+0.8s)	3288	3288	256	74	190	13	0	277
24945	16002s (+0.7s)	2848	2848	256	66	165	12	0	243
24946	16003s (+0.7s)	2696	2696	128	76	161	16	0	253
24947	16003s (+0.5s)	1812	1812	128	38	142	7	0	187
24948	16004s (+0.6s)	2332	2332	256	37	151	0	8	196
24949	16004s (+0.5s)	1604	1604	128	38	126	0	5	169
24950	16005s (+0.6s)	2164	2164	128	43	154	0	14	211
24951	16006s (+0.8s)	3224	3224	256	65	198	0	10	273
24952	16006s (+0.4s)	1500	1500	128	26	121	0	7	154
24953	16007s (+0.2s)	644	644	64	16	64	3	0	83
24954	16007s (+0.6s)	2492	2492	256	47	159	8	0	214
24955	16008s (+0.9s)	3760	3760	256	68	220	12	1	301
24956	16009s (+0.8s)	3340	3340	256	71	197	13	0	281
24957	16009s (+0.6s)	2580	2580	256	51	160	9	1	221
24958	16010s (+0.7s)	2488	2488	128	68	164	17	0	249
24959	16011s (+0.9s)	4180	4180	256	77	244	20	0	341
24960	16012s (+0.6s)	1988	1988	128	45	140	12	0	197
24961	16012s (+0.5s)	1952	1952	128	48	131	12	1	192
24962	16013s (+0.7s)	3196	3196	256	61	195	11	0	267
24963	16014s (+0.5s)	1688	1688	128	48	113	11	1	173
24964	16014s (+0.7s)	2796	2796	256	65	165	12	0	242
24965	16015s (+1.0s)	4260	4260	256	95	232	20	1	348
24966	16016s (+0.8s)	3448	3448	256	85	187	19	0	291
24967	16017s (+0.7s)	3120	3120	256	68	184	7	0	259
24968	16017s (+0.4s)	1228	1228	128	22	109	5	0	136
24969	16017s (+0.3s)	668	668	32	29	63	3	0	95
24970	16018s (+0.6s)	2080	2080	128	39	143	11	0	193
24971	16019s (+0.7s)	2884	2884	256	54	179	12	1	246
24972	16020s (+0.8s)	3372	3372	256	73	205	11	0	289
24973	16021s (+1.0s)	5024	5024	512	80	257	0	15	352
24974	16021s (+0.3s)	716	716	64	23	71	0	1	95
24975	16021s (+0.7s)	2700	2700	256	51	166	0	10	227
24976	16022s (+0.5s)	1908	1908	128	36	140	0	9	185
24977	16022s (+0.4s)	1440	1440	128	37	104	0	8	149
24978	16023s (+0.5s)	1768	1768	128	45	127	0	10	182
24979	16024s (+1.2s)	5924	5924	512	85	322	0	20	427
24980	16025s (+0.7s)	3096	3096	256	54	189	0	13	256
24981	16025s (+0.4s)	1016	1016	64	21	97	0	5	123
24982	16026s (+0.4s)	1296	1296	128	28	99	0	3	130
24983	16026s (+0.4s)	1044	1044	64	26	92	0	8	126
24984	16027s (+0.7s)	2720	2720	256	37	184	0	7	228
24985	16027s (+0.4s)	1352	1352	128	29	105	0	6	140
24986	16028s (+0.5s)	1748	1748	128	38	131	0	8	177
24987	16028s (+0.6s)	2604	2604	256	40	175	0	12	227
24988	16029s (+1.0s)	5220	5220	512	66	274	0	15	355
24989	16030s (+0.7s)	3196	3196	256	63	192	7	0	262
24990	16031s (+0.6s)	2396	2396	256	48	144	12	0	204
24991	16031s (+0.7s)	2840	2840	256	56	185	7	1	249
24992	16032s (+0.7s)	3072	3072	256	63	178	11	0	252
24993	16033s (+0.5s)	1652	1652	128	40	119	6	0	165
24994	16033s (+0.2s)	480	480	32	20	51	6	0	77
24995	16034s (+1.3s)	6520	6520	512	142	304	26	0	472
24996	16035s (+0.8s)	3236	3236	256	43	219	10	0	272
24997	16035s (+0.4s)	1316	1316	64	33	109	7	0	149
24998	16036s (+0.8s)	3444	3444	256	62	212	12	0	286
24999	16037s (+0.6s)	2560	2560	256	40	172	8	0	220
Episode	Time	Reward	Score	Highest	L	U	R	D	Steps
25000	16038s (+0.8s)	3820	3820	256	76	216	15	0	307
25001	16038s (+0.3s)	968	968	128	24	73	7	0	104
25002	16039s (+0.9s)	4112	4112	256	84	236	16	0	336
25003	16039s (+0.5s)	1756	1756	128	44	128	7	0	179
25004	16040s (+0.7s)	3256	3256	256	58	196	16	1	271
25005	16042s (+1.3s)	6752	6752	512	133	309	26	0	468
25006	16042s (+0.6s)	1892	1892	128	59	123	9	0	191
25007	16042s (+0.4s)	1332	1332	128	27	106	3	1	137
25008	16043s (+0.5s)	1772	1772	128	45	127	6	0	178
25009	16044s (+0.8s)	3492	3492	256	72	205	15	1	293
25010	16045s (+1.0s)	4232	4232	256	96	236	16	0	348
25011	16045s (+0.4s)	1116	1116	64	37	89	5	0	131
25012	16046s (+0.8s)	3256	3256	256	68	193	15	0	276
25013	16047s (+0.6s)	2160	2160	128	49	147	10	1	207
25014	16047s (+0.6s)	2560	2560	256	48	162	6	0	216
25015	16048s (+0.8s)	3688	3688	256	73	206	14	1	294
25016	16049s (+0.7s)	3268	3268	256	57	208	8	1	274
25017	16049s (+0.3s)	900	900	64	29	72	5	0	106
25018	16050s (+0.5s)	1556	1556	128	35	126	7	0	168
25019	16051s (+1.3s)	6556	6556	512	114	322	29	0	465
25020	16052s (+0.7s)	3020	3020	256	63	185	14	0	262
25021	16052s (+0.4s)	1276	1276	128	40	94	6	0	140
25022	16053s (+1.4s)	7048	7048	512	125	325	26	1	477
25023	16054s (+0.6s)	2184	2184	128	48	146	11	0	205
25024	16055s (+0.6s)	2468	2468	256	57	138	14	0	209
25025	16055s (+0.4s)	1528	1528	128	43	111	8	0	162
25026	16056s (+0.6s)	2308	2308	256	45	151	1	0	197
25027	16057s (+0.9s)	3820	3820	256	68	238	10	0	316
25028	16057s (+0.8s)	3348	3348	256	71	197	15	0	283
25029	16058s (+1.0s)	5044	5044	512	107	231	18	0	356
25030	16059s (+1.0s)	4232	4232	256	90	237	21	0	348
25031	16060s (+0.3s)	944	944	64	26	92	8	0	126
25032	16060s (+0.4s)	1192	1192	128	26	99	4	0	129
25033	16061s (+0.5s)	1672	1672	128	35	126	7	1	169
25034	16061s (+0.5s)	1780	1780	128	41	133	6	0	180
25035	16062s (+0.6s)	2728	2728	256	69	143	14	1	227
25036	16062s (+0.5s)	1920	1920	128	48	120	6	0	174
25037	16063s (+0.6s)	2620	2620	256	55	157	9	1	222
25038	16063s (+0.6s)	1916	1916	128	43	143	11	0	197
25039	16064s (+0.3s)	828	828	64	27	72	5	0	104
25040	16064s (+0.6s)	2380	2380	256	44	153	5	0	202
25041	16065s (+0.7s)	2892	2892	256	55	168	12	0	235
25042	16066s (+0.6s)	2536	2536	256	58	148	15	0	221
25043	16066s (+0.3s)	808	808	64	23	80	6	0	109
25044	16066s (+0.3s)	1152	1152	128	24	91	7	0	122
25045	16067s (+0.7s)	2876	2876	256	59	170	6	1	236
25046	16068s (+0.8s)	3348	3348	256	63	210	10	0	283
25047	16068s (+0.5s)	1740	1740	128	47	122	6	0	175
25048	16070s (+1.3s)	6288	6288	512	123	306	22	0	451
25049	16070s (+0.7s)	2624	2624	256	51	169	11	0	231
25050	16071s (+0.7s)	2940	2940	256	62	186	13	0	261
25051	16071s (+0.4s)	1320	1320	128	27	114	5	0	146
25052	16072s (+1.0s)	5104	5104	512	105	241	18	0	364
25053	16073s (+0.8s)	3184	3184	256	64	189	12	0	265
25054	16075s (+1.3s)	6424	6424	512	119	316	25	0	460
25055	16076s (+1.0s)	4172	4172	256	84	246	13	0	343
25056	16076s (+0.7s)	2924	2924	256	51	179	10	0	240
25057	16077s (+0.8s)	3536	3536	256	71	213	14	0	298
25058	16078s (+0.9s)	4084	4084	256	84	227	19	0	330
25059	16079s (+0.7s)	2680	2680	256	60	158	11	0	229
25060	16080s (+1.4s)	6900	6900	512	160	312	30	0	502
25061	16081s (+0.9s)	4592	4592	512	68	225	19	1	313
25062	16082s (+0.5s)	1788	1788	128	48	121	12	0	181
25063	16082s (+0.5s)	2132	2132	256	49	122	8	0	179
25064	16083s (+0.8s)	3216	3216	256	56	198	14	0	268
25065	16084s (+0.7s)	2584	2584	128	67	166	12	0	245
25066	16084s (+0.4s)	1400	1400	128	28	110	4	2	144
25067	16085s (+0.7s)	2552	2552	128	64	154	17	2	237
25068	16085s (+0.2s)	444	444	64	15	47	1	0	63
25069	16086s (+0.7s)	2724	2724	256	60	170	6	0	236
25070	16086s (+0.3s)	932	932	64	30	81	2	0	113
25071	16087s (+0.9s)	4020	4020	256	85	231	11	0	327
25072	16087s (+0.5s)	1644	1644	128	42	117	11	0	170
25073	16088s (+0.4s)	1344	1344	128	31	104	5	1	141
25074	16089s (+1.0s)	4252	4252	256	90	247	16	0	353
25075	16090s (+1.0s)	4212	4212	256	107	217	20	0	344
25076	16090s (+0.6s)	2656	2656	256	49	165	11	0	225
25077	16091s (+0.4s)	1308	1308	128	30	107	2	0	139
25078	16091s (+0.6s)	2216	2216	128	61	142	9	0	212
25079	16092s (+0.2s)	616	616	64	18	62	3	0	83
25080	16093s (+1.0s)	5184	5184	512	93	246	20	0	359
25081	16093s (+0.6s)	2540	2540	256	45	166	6	0	217
25082	16094s (+0.3s)	908	908	64	27	87	4	0	118
25083	16095s (+1.0s)	4232	4232	256	87	248	12	1	348
25084	16095s (+0.7s)	3240	3240	256	67	176	17	0	260
25085	16096s (+0.6s)	2332	2332	256	28	164	4	0	196
25086	16097s (+0.7s)	2996	2996	256	51	182	7	0	240
25087	16097s (+0.5s)	1724	1724	128	47	116	9	0	172
25088	16098s (+0.8s)	3556	3556	256	81	203	19	0	303
25089	16099s (+0.8s)	3348	3348	256	60	209	11	0	280
25090	16099s (+0.3s)	884	884	64	22	89	5	0	116
25091	16100s (+0.5s)	1824	1824	128	47	126	10	1	184
25092	16100s (+0.8s)	3468	3468	256	74	197	15	0	286
25093	16101s (+0.4s)	1128	1128	128	20	104	3	0	127
25094	16101s (+0.5s)	1808	1808	128	47	132	7	0	186
25095	16102s (+0.4s)	1468	1468	128	38	108	6	0	152
25096	16102s (+0.6s)	2740	2740	256	55	163	11	0	229
25097	16103s (+0.5s)	1588	1588	128	33	129	5	1	168
25098	16103s (+0.5s)	1708	1708	128	45	114	13	1	173
25099	16104s (+0.8s)	3596	3596	256	63	223	5	0	291
Episode	Time	Reward	Score	Highest	L	U	R	D	Steps
25100	16105s (+1.0s)	4300	4300	256	75	261	17	0	353
25101	16106s (+0.9s)	3976	3976	256	65	249	0	15	329
25102	16107s (+0.3s)	1100	1100	128	24	88	0	5	117
25103	16107s (+0.5s)	1664	1664	128	30	130	0	7	167
25104	16108s (+0.5s)	1772	1772	128	34	147	0	2	183
25105	16108s (+0.5s)	2216	2216	256	32	148	0	4	184
25106	16109s (+0.8s)	3200	3200	256	53	193	0	21	267
25107	16110s (+0.8s)	3492	3492	256	43	231	0	13	287
25108	16110s (+0.4s)	1336	1336	64	37	101	0	12	150
25109	16111s (+0.8s)	3564	3564	256	75	219	11	0	305
25110	16111s (+0.4s)	1524	1524	128	32	116	7	0	155
25111	16112s (+0.4s)	1384	1384	128	22	120	5	0	147
25112	16112s (+0.7s)	2768	2768	256	74	148	17	0	239
25113	16114s (+1.1s)	4536	4536	256	105	247	23	0	375
25114	16114s (+0.4s)	1348	1348	128	36	106	3	0	145
25115	16115s (+0.8s)	3212	3212	256	65	207	9	0	281
25116	16115s (+0.4s)	1472	1472	128	28	113	8	1	150
25117	16116s (+1.1s)	5272	5272	512	104	254	22	0	380
25118	16117s (+0.8s)	3176	3176	256	93	168	13	0	274
25119	16118s (+0.6s)	2276	2276	256	65	117	12	0	194
25120	16118s (+0.4s)	1180	1180	64	33	101	8	0	142
25121	16119s (+0.7s)	2884	2884	256	70	169	14	0	253
25122	16120s (+0.7s)	2804	2804	256	42	182	7	0	231
25123	16120s (+0.3s)	848	848	64	23	81	5	0	109
25124	16120s (+0.6s)	2596	2596	256	51	163	9	0	223
25125	16121s (+0.6s)	2680	2680	256	58	158	14	0	230
25126	16122s (+0.4s)	1156	1156	64	40	90	7	0	137
25127	16122s (+0.5s)	1540	1540	128	42	113	8	0	163
25128	16123s (+0.8s)	3236	3236	256	75	176	15	0	266
25129	16123s (+0.4s)	1168	1168	64	36	94	6	0	136
25130	16124s (+0.4s)	1536	1536	128	41	111	8	0	160
25131	16124s (+0.8s)	3204	3204	256	75	177	17	0	269
25132	16125s (+0.8s)	3212	3212	256	74	186	10	0	270
25133	16126s (+0.7s)	3216	3216	256	68	183	10	0	261
25134	16127s (+0.9s)	4008	4008	256	75	235	14	0	324
25135	16127s (+0.6s)	2200	2200	128	64	133	13	0	210
25136	16129s (+1.2s)	6128	6128	512	107	292	24	0	423
25137	16129s (+0.6s)	2260	2260	128	62	142	8	1	213
25138	16130s (+0.7s)	2912	2912	256	65	176	13	0	254
25139	16131s (+0.5s)	1880	1880	128	51	138	4	0	193
25140	16131s (+0.6s)	2180	2180	128	56	135	12	0	203
25141	16131s (+0.3s)	1092	1092	128	28	86	4	0	118
25142	16132s (+0.4s)	1428	1428	128	41	108	7	0	156
25143	16133s (+0.6s)	2432	2432	128	66	148	10	0	224
25144	16133s (+0.6s)	2160	2160	128	65	145	9	0	219
25145	16134s (+0.5s)	1892	1892	128	45	140	6	0	191
25146	16134s (+0.4s)	1232	1232	128	33	90	0	5	128
25147	16135s (+0.9s)	4156	4156	256	76	248	0	17	341
25148	16136s (+0.4s)	1396	1396	128	22	121	0	4	147
25149	16136s (+0.5s)	1848	1848	128	29	151	0	10	190
25150	16137s (+0.7s)	3176	3176	256	58	194	0	10	262
25151	16137s (+0.6s)	2664	2664	256	50	163	0	13	226
25152	16139s (+1.3s)	6272	6272	512	126	290	27	0	443
25153	16139s (+0.5s)	1732	1732	128	35	116	7	1	159
25154	16140s (+0.8s)	3620	3620	256	85	211	11	0	307
25155	16141s (+0.7s)	2800	2800	256	68	163	11	0	242
25156	16141s (+0.7s)	2752	2752	256	64	164	8	0	236
25157	16142s (+0.6s)	2632	2632	256	54	160	12	0	226
25158	16143s (+0.9s)	4612	4612	512	77	221	15	1	314
25159	16144s (+0.6s)	2584	2584	256	45	160	13	0	218
25160	16144s (+0.5s)	1784	1784	128	39	133	9	0	181
25161	16145s (+1.2s)	6296	6296	512	117	304	27	0	448
25162	16146s (+0.4s)	1376	1376	128	30	102	5	0	137
25163	16147s (+1.0s)	4388	4388	256	93	243	19	0	355
25164	16147s (+0.7s)	3112	3112	256	72	170	17	0	259
25165	16148s (+0.8s)	3216	3216	256	70	188	13	0	271
25166	16149s (+0.8s)	3508	3508	256	71	210	11	1	293
25167	16150s (+0.5s)	1620	1620	128	48	117	7	0	172
25168	16150s (+0.7s)	2792	2792	256	62	167	12	0	241
25169	16151s (+0.6s)	1924	1924	128	53	138	8	0	199
25170	16151s (+0.5s)	1620	1620	128	37	116	10	0	163
25171	16152s (+0.6s)	1912	1912	128	48	141	7	0	196
25172	16153s (+0.8s)	3588	3588	256	78	209	17	0	304
25173	16153s (+0.3s)	1012	1012	64	24	90	0	7	121
25174	16154s (+0.9s)	3856	3856	256	61	237	0	13	311
25175	16155s (+0.6s)	2192	2192	128	37	159	0	12	208
25176	16156s (+0.9s)	4096	4096	256	65	260	0	7	332
25177	16156s (+0.5s)	1724	1724	128	32	140	0	10	182
25178	16157s (+0.8s)	3208	3208	256	63	197	0	10	270
25179	16157s (+0.4s)	1308	1308	128	23	106	0	4	133
25180	16158s (+0.8s)	3228	3228	256	63	195	0	12	270
25181	16159s (+0.6s)	2708	2708	256	59	158	9	0	226
25182	16159s (+0.5s)	1812	1812	128	38	140	9	0	187
25183	16160s (+0.9s)	4140	4140	256	91	222	19	0	332
25184	16161s (+0.9s)	3972	3972	256	71	242	14	0	327
25185	16162s (+1.1s)	4500	4500	256	97	252	22	0	371
25186	16164s (+1.6s)	7812	7812	512	159	368	27	0	554
25187	16165s (+1.0s)	4284	4284	256	104	227	22	0	353
25188	16166s (+0.6s)	2548	2548	256	57	153	13	0	223
25189	16166s (+0.5s)	1516	1516	128	33	123	6	0	162
25190	16167s (+1.0s)	4292	4292	256	108	229	15	0	352
25191	16168s (+0.7s)	2596	2596	128	84	148	11	0	243
25192	16168s (+0.3s)	796	796	64	19	70	2	0	91
25193	16168s (+0.5s)	1528	1528	128	42	111	8	0	161
25194	16169s (+0.5s)	1808	1808	128	42	135	10	0	187
25195	16170s (+0.7s)	3136	3136	256	47	200	10	0	257
25196	16170s (+0.6s)	2296	2296	256	42	149	7	0	198
25197	16171s (+0.6s)	2564	2564	128	63	160	13	0	236
25198	16172s (+0.6s)	2528	2528	256	44	174	5	0	223
25199	16172s (+0.6s)	2536	2536	128	76	141	16	1	234
Episode	Time	Reward	Score	Highest	L	U	R	D	Steps
25200	16173s (+0.4s)	1508	1508	128	36	117	7	0	160
25201	16173s (+0.3s)	872	872	64	24	80	5	0	109
25202	16174s (+1.2s)	6064	6064	512	126	286	22	0	434
25203	16175s (+0.4s)	1392	1392	128	22	124	3	0	149
25204	16176s (+0.7s)	2980	2980	256	57	192	0	8	257
25205	16176s (+0.5s)	1944	1944	128	48	129	0	12	189
25206	16177s (+0.5s)	1500	1500	128	31	124	0	4	159
25207	16177s (+0.6s)	2540	2540	256	46	164	12	0	222
25208	16177s (+0.3s)	720	720	64	25	66	5	0	96
25209	16178s (+0.7s)	2632	2632	256	57	168	7	0	232
25210	16178s (+0.3s)	616	616	64	8	76	0	3	87
25211	16179s (+0.7s)	2484	2484	128	62	158	12	0	232
25212	16180s (+0.9s)	3884	3884	256	83	227	12	0	322
25213	16181s (+0.7s)	2728	2728	256	46	182	7	0	235
25214	16181s (+0.2s)	576	576	64	17	57	3	0	77
25215	16181s (+0.5s)	1864	1864	128	40	139	9	0	188
25216	16182s (+0.5s)	1708	1708	128	49	110	13	0	172
25217	16182s (+0.4s)	1216	1216	64	49	92	5	0	146
25218	16183s (+0.4s)	1464	1464	128	45	104	5	0	154
25219	16183s (+0.5s)	1796	1796	128	39	138	7	0	184
25220	16184s (+0.4s)	1532	1532	128	36	109	11	0	156
25221	16184s (+0.5s)	1704	1704	128	42	128	8	0	178
25222	16185s (+0.5s)	1724	1724	128	38	129	0	4	171
25223	16185s (+0.2s)	604	604	64	15	57	0	6	78
25224	16185s (+0.3s)	828	828	64	17	74	0	7	98
25225	16186s (+0.6s)	2444	2444	256	51	147	9	0	207
25226	16186s (+0.5s)	1516	1516	128	27	125	10	0	162
25227	16187s (+0.6s)	2264	2264	128	65	137	12	0	214
25228	16188s (+0.7s)	3048	3048	256	81	165	11	0	257
25229	16188s (+0.5s)	2012	2012	128	57	127	14	0	198
25230	16189s (+0.6s)	2544	2544	256	56	158	9	0	223
25231	16190s (+0.8s)	3360	3360	256	67	204	14	1	286
25232	16190s (+0.6s)	2512	2512	256	55	150	14	0	219
25233	16191s (+0.8s)	3476	3476	256	65	214	9	0	288
25234	16192s (+0.6s)	2332	2332	256	41	146	9	0	196
25235	16192s (+0.5s)	1596	1596	128	45	107	9	1	162
25236	16193s (+0.8s)	3340	3340	256	81	184	16	0	281
25237	16194s (+0.5s)	1764	1764	128	44	127	10	0	181
25238	16194s (+0.3s)	672	672	64	22	66	4	0	92
25239	16195s (+0.7s)	2844	2844	256	76	156	13	1	246
25240	16196s (+1.1s)	4488	4488	256	90	261	19	0	370
25241	16197s (+1.0s)	4216	4216	256	93	233	20	0	346
25242	16197s (+0.7s)	2936	2936	256	67	181	7	0	255
25243	16198s (+0.7s)	2760	2760	256	55	168	14	0	237
25244	16199s (+0.5s)	2144	2144	256	41	130	9	0	180
25245	16199s (+0.5s)	1736	1736	128	43	126	9	0	178
25246	16200s (+0.5s)	1892	1892	128	45	135	12	0	192
25247	16200s (+0.6s)	1908	1908	128	50	135	10	0	195
25248	16201s (+0.6s)	2400	2400	128	60	162	6	0	228
25249	16202s (+0.8s)	3208	3208	256	59	200	7	0	266
25250	16202s (+0.3s)	876	876	64	34	73	7	0	114
25251	16202s (+0.3s)	1164	1164	128	27	92	4	0	123
25252	16203s (+0.8s)	3372	3372	256	66	210	13	0	289
25253	16204s (+0.7s)	2756	2756	256	54	171	8	0	233
25254	16204s (+0.5s)	1748	1748	128	42	126	3	1	172
25255	16204s (+0.2s)	476	476	32	16	57	3	0	76
25256	16206s (+1.0s)	4376	4376	256	91	256	16	0	363
25257	16206s (+0.9s)	3856	3856	256	83	212	10	0	305
25258	16207s (+0.6s)	1912	1912	128	40	151	5	0	196
25259	16208s (+0.8s)	3336	3336	256	81	185	14	0	280
25260	16208s (+0.7s)	2696	2696	256	56	170	7	0	233
25261	16209s (+0.3s)	1184	1184	128	21	98	1	0	120
25262	16209s (+0.3s)	940	940	64	34	79	6	0	119
25263	16210s (+1.0s)	4828	4828	512	79	240	18	2	339
25264	16211s (+0.5s)	1732	1732	128	33	143	0	4	180
25265	16211s (+0.8s)	3232	3232	256	49	214	1	8	272
25266	16212s (+0.2s)	484	484	32	14	54	0	4	72
25267	16212s (+0.6s)	2208	2208	128	52	136	13	0	201
25268	16213s (+0.9s)	3596	3596	256	85	204	14	0	303
25269	16214s (+0.7s)	2624	2624	256	59	159	13	0	231
25270	16214s (+0.4s)	1476	1476	128	36	107	8	1	152
25271	16215s (+0.8s)	3540	3540	256	76	215	8	0	299
25272	16215s (+0.3s)	1168	1168	128	32	88	4	0	124
25273	16216s (+0.3s)	696	696	64	17	74	2	0	93
25274	16217s (+1.0s)	4496	4496	256	98	256	16	0	370
25275	16217s (+0.7s)	2616	2616	128	68	161	16	0	245
25276	16219s (+1.2s)	6332	6332	512	105	300	22	0	427
25277	16219s (+0.7s)	2824	2824	256	62	168	12	0	242
25278	16220s (+0.5s)	1604	1604	128	44	114	10	0	168
25279	16220s (+0.4s)	1316	1316	128	23	108	4	0	135
25280	16221s (+1.0s)	4228	4228	256	91	242	14	0	347
25281	16222s (+0.6s)	2484	2484	256	51	154	7	0	212
25282	16222s (+0.4s)	1256	1256	128	37	101	4	0	142
25283	16223s (+0.4s)	1424	1424	128	46	96	8	1	151
25284	16223s (+0.5s)	1704	1704	128	39	123	9	0	171
25285	16223s (+0.4s)	960	960	64	31	92	3	0	126
25286	16225s (+1.0s)	4464	4464	256	104	245	20	0	369
25287	16225s (+1.0s)	4120	4120	256	72	252	12	1	337
25288	16226s (+0.5s)	1996	1996	128	48	131	9	0	188
25289	16227s (+0.7s)	2700	2700	256	57	169	9	0	235
25290	16227s (+0.5s)	1780	1780	128	45	130	10	0	185
25291	16228s (+1.1s)	4504	4504	256	92	265	15	0	372
25292	16229s (+0.7s)	2828	2828	256	47	184	0	14	245
25293	16230s (+1.1s)	5480	5480	512	90	286	0	14	390
25294	16231s (+0.7s)	2800	2800	256	56	179	0	8	243
25295	16231s (+0.3s)	1032	1032	128	17	83	0	9	109
25296	16232s (+0.5s)	1824	1824	128	32	145	0	7	184
25297	16232s (+0.4s)	1208	1208	128	21	99	0	5	125
25298	16233s (+0.8s)	3456	3456	256	67	205	0	15	287
25299	16234s (+0.9s)	3932	3932	256	64	244	0	10	318
Episode	Time	Reward	Score	Highest	L	U	R	D	Steps
25300	16235s (+1.0s)	4316	4316	256	91	246	20	0	357
25301	16235s (+0.3s)	1120	1120	128	26	86	6	0	118
25302	16236s (+0.7s)	3084	3084	256	79	160	15	1	255
25303	16237s (+0.9s)	4056	4056	256	77	228	22	0	327
25304	16237s (+0.5s)	1780	1780	128	42	133	6	0	181
25305	16238s (+0.5s)	1608	1608	128	39	111	8	1	159
25306	16239s (+1.4s)	7036	7036	512	122	337	20	1	480
25307	16240s (+0.7s)	2932	2932	256	50	186	9	1	246
25308	16241s (+0.6s)	2528	2528	256	65	139	7	1	212
25309	16241s (+0.6s)	2424	2424	256	56	135	12	0	203
25310	16242s (+0.7s)	2836	2836	256	64	164	13	0	241
25311	16243s (+0.7s)	3028	3028	256	69	170	13	0	252
25312	16243s (+0.3s)	860	860	64	14	93	3	0	110
25313	16244s (+0.7s)	2880	2880	256	52	169	11	0	232
25314	16244s (+0.6s)	2064	2064	128	42	158	7	0	207
25315	16245s (+0.5s)	1948	1948	128	46	145	7	0	198
25316	16245s (+0.2s)	584	584	32	20	65	1	0	86
25317	16246s (+0.8s)	3468	3468	256	60	204	12	1	277
25318	16246s (+0.6s)	2740	2740	256	49	163	8	0	220
25319	16247s (+0.5s)	1892	1892	128	49	140	2	0	191
25320	16247s (+0.4s)	1180	1180	64	33	105	4	0	142
25321	16248s (+1.1s)	4576	4576	256	128	227	26	0	381
25322	16249s (+0.5s)	1848	1848	128	45	135	10	0	190
25323	16250s (+0.7s)	2892	2892	256	62	169	8	0	239
25324	16251s (+0.9s)	3816	3816	256	86	210	21	0	317
25325	16251s (+0.9s)	3624	3624	256	82	207	12	0	301
25326	16252s (+0.7s)	2952	2952	256	72	163	14	0	249
25327	16253s (+0.7s)	2780	2780	256	53	173	13	0	239
25328	16254s (+1.3s)	6672	6672	512	127	314	28	0	469
25329	16255s (+0.8s)	3176	3176	256	76	174	12	0	262
25330	16256s (+0.9s)	3584	3584	256	78	206	14	1	299
25331	16256s (+0.5s)	1804	1804	128	44	135	6	0	185
25332	16257s (+0.4s)	1284	1284	128	28	97	5	0	130
25333	16257s (+0.7s)	2920	2920	256	69	163	10	0	242
25334	16258s (+0.4s)	1512	1512	128	36	110	5	0	151
25335	16258s (+0.5s)	1596	1596	128	39	113	8	0	160
25336	16259s (+1.0s)	4248	4248	256	103	226	16	0	345
25337	16260s (+0.5s)	1956	1956	128	54	127	9	0	190
25338	16260s (+0.4s)	1488	1488	128	33	115	8	0	156
25339	16261s (+0.8s)	3328	3328	256	67	201	11	0	279
25340	16262s (+0.5s)	1884	1884	128	40	130	13	1	184
25341	16262s (+0.4s)	1444	1444	128	31	111	8	0	150
25342	16263s (+0.7s)	2912	2912	256	53	192	9	0	254
25343	16263s (+0.5s)	1592	1592	128	38	123	6	0	167
25344	16264s (+0.7s)	3112	3112	256	62	189	11	0	262
25345	16265s (+0.7s)	2724	2724	256	61	164	11	0	236
25346	16265s (+0.7s)	3032	3032	256	59	179	5	0	243
25347	16266s (+0.7s)	2912	2912	256	37	214	3	0	254
25348	16266s (+0.3s)	860	860	64	30	77	4	0	111
25349	16267s (+0.8s)	3252	3252	256	58	199	12	0	269
25350	16268s (+0.5s)	1672	1672	128	36	128	6	1	171
25351	16268s (+0.4s)	1496	1496	128	27	127	3	0	157
25352	16269s (+0.5s)	1852	1852	128	40	148	5	0	193
25353	16269s (+0.7s)	2892	2892	256	76	163	14	0	253
25354	16270s (+0.5s)	1564	1564	128	27	131	5	0	163
25355	16271s (+0.6s)	2580	2580	256	56	155	9	0	220
25356	16271s (+0.5s)	1700	1700	128	35	142	0	5	182
25357	16272s (+0.5s)	1616	1616	128	32	123	0	6	161
25358	16272s (+0.9s)	3688	3688	256	67	226	0	12	305
25359	16273s (+0.6s)	2568	2568	256	43	174	0	7	224
25360	16274s (+0.8s)	3396	3396	256	52	226	0	12	290
25361	16274s (+0.4s)	1060	1060	64	26	97	0	6	129
25362	16275s (+0.7s)	2872	2872	256	62	171	0	12	245
25363	16275s (+0.2s)	548	548	64	10	64	0	2	76
25364	16276s (+0.5s)	1552	1552	128	35	115	1	5	156
25365	16276s (+0.5s)	1712	1712	128	38	128	1	5	172
25366	16277s (+0.5s)	1628	1628	128	28	129	0	7	164
25367	16278s (+1.4s)	6824	6824	512	139	322	31	0	492
25368	16279s (+0.6s)	2076	2076	128	49	154	7	0	210
25369	16279s (+0.5s)	1640	1640	128	42	123	12	0	177
25370	16280s (+0.5s)	1812	1812	128	43	135	9	0	187
25371	16281s (+1.0s)	5264	5264	512	127	212	27	1	367
25372	16281s (+0.7s)	2904	2904	256	68	170	14	0	252
25373	16283s (+1.1s)	5676	5676	512	104	276	21	1	402
25374	16283s (+0.7s)	2784	2784	256	59	170	10	0	239
25375	16284s (+0.8s)	3216	3216	256	81	171	16	0	268
25376	16285s (+0.7s)	2792	2792	256	60	170	11	0	241
25377	16285s (+0.5s)	1744	1744	128	43	122	11	0	176
25378	16286s (+0.7s)	3092	3092	256	52	195	6	0	253
25379	16287s (+0.6s)	1912	1912	128	43	145	8	0	196
25380	16287s (+0.8s)	3428	3428	256	76	186	19	1	282
25381	16288s (+0.5s)	1856	1856	128	44	137	6	0	187
25382	16289s (+0.8s)	3184	3184	256	53	203	8	0	264
25383	16289s (+0.3s)	1032	1032	64	23	97	3	0	123
25384	16290s (+0.7s)	3196	3196	256	68	186	13	0	267
25385	16290s (+0.7s)	2988	2988	256	71	160	15	2	248
25386	16291s (+0.8s)	3556	3556	256	62	225	10	0	297
25387	16292s (+0.3s)	796	796	64	27	76	4	0	107
25388	16292s (+0.5s)	1552	1552	128	36	126	4	0	166
25389	16293s (+0.8s)	3164	3164	256	75	182	13	0	270
25390	16293s (+0.4s)	1332	1332	128	32	106	1	0	139
25391	16294s (+0.5s)	1712	1712	128	43	113	12	0	168
25392	16294s (+0.7s)	2888	2888	256	72	170	10	0	252
25393	16295s (+0.4s)	1004	1004	64	28	88	6	1	123
25394	16295s (+0.5s)	2232	2232	256	45	134	8	1	188
25395	16296s (+0.4s)	1116	1116	128	26	93	5	0	124
25396	16296s (+0.4s)	1488	1488	128	38	113	5	0	156
25397	16297s (+0.4s)	1000	1000	64	35	84	6	0	125
25398	16297s (+0.9s)	3916	3916	256	64	243	13	0	320
25399	16298s (+0.8s)	3332	3332	256	64	200	15	0	279
Episode	Time	Reward	Score	Highest	L	U	R	D	Steps
25400	16299s (+0.5s)	1784	1784	128	48	126	7	0	181
25401	16299s (+0.4s)	1172	1172	128	30	90	6	0	126
25402	16300s (+0.8s)	3212	3212	256	76	167	21	1	265
25403	16300s (+0.4s)	1456	1456	128	35	109	0	4	148
25404	16301s (+0.9s)	4500	4500	512	68	222	0	16	306
25405	16302s (+0.5s)	2236	2236	256	41	133	0	7	181
25406	16302s (+0.7s)	2804	2804	256	51	179	0	9	239
25407	16303s (+0.4s)	1308	1308	128	27	102	0	4	133
25408	16304s (+0.7s)	3044	3044	256	47	188	0	13	248
25409	16304s (+0.8s)	3348	3348	256	73	198	0	12	283
25410	16305s (+0.9s)	3724	3724	256	58	229	0	16	303
25411	16306s (+1.0s)	4876	4876	512	68	253	0	16	337
25412	16307s (+0.4s)	1220	1220	64	29	99	0	9	137
25413	16307s (+0.8s)	3364	3364	256	60	213	0	14	287
25414	16308s (+0.4s)	1148	1148	128	18	102	4	0	124
25415	16308s (+0.4s)	1040	1040	64	25	92	7	0	124
25416	16309s (+0.6s)	1964	1964	128	55	129	10	0	194
25417	16309s (+0.2s)	456	456	32	16	53	5	0	74
25418	16310s (+0.9s)	4096	4096	256	84	233	14	0	331
25419	16310s (+0.4s)	1292	1292	128	22	107	7	0	136
25420	16311s (+0.4s)	1452	1452	128	38	108	8	0	154
25421	16311s (+0.7s)	2748	2748	256	54	171	10	0	235
25422	16312s (+0.8s)	3244	3244	256	62	200	12	0	274
25423	16313s (+0.4s)	1380	1380	128	39	93	7	0	139
25424	16314s (+1.0s)	4444	4444	256	87	269	13	0	369
25425	16314s (+0.5s)	1640	1640	128	42	110	11	0	163
25426	16315s (+0.5s)	1700	1700	128	44	113	8	0	165
25427	16315s (+0.3s)	1000	1000	64	24	86	0	8	118
25428	16315s (+0.4s)	1180	1180	128	31	90	0	6	127
25429	16316s (+0.8s)	3220	3220	256	53	206	0	9	268
25430	16317s (+0.6s)	2560	2560	256	43	173	0	5	221
25431	16317s (+0.6s)	2604	2604	256	35	186	0	6	227
25432	16318s (+0.2s)	640	640	64	11	73	0	0	84
25433	16318s (+0.6s)	2204	2204	128	38	157	0	11	206
25434	16319s (+0.6s)	2548	2548	256	38	179	0	6	223
25435	16319s (+0.3s)	1076	1076	128	22	92	4	0	118
25436	16320s (+0.4s)	1288	1288	128	44	93	7	0	144
25437	16320s (+0.4s)	1160	1160	64	38	92	7	0	137
25438	16321s (+0.8s)	3340	3340	256	82	186	18	0	286
25439	16322s (+0.7s)	2800	2800	256	53	181	8	0	242
25440	16322s (+0.3s)	1080	1080	128	24	87	0	3	114
25441	16322s (+0.5s)	1588	1588	128	39	117	0	8	164
25442	16323s (+0.9s)	3712	3712	256	91	205	19	0	315
25443	16324s (+0.8s)	3576	3576	256	73	219	16	0	308
25444	16325s (+0.5s)	1740	1740	128	34	139	2	0	175
25445	16326s (+1.0s)	4316	4316	256	97	247	18	0	362
25446	16326s (+0.8s)	3096	3096	256	80	171	13	0	264
25447	16327s (+0.8s)	3632	3632	256	64	222	10	0	296
25448	16328s (+0.6s)	2140	2140	128	55	146	13	0	214
25449	16329s (+0.9s)	3780	3780	256	88	207	17	0	312
25450	16329s (+0.5s)	1760	1760	128	44	117	14	0	175
25451	16330s (+0.7s)	2760	2760	256	67	158	13	0	238
25452	16331s (+0.7s)	3220	3220	256	54	195	10	0	259
25453	16331s (+0.8s)	3492	3492	256	72	201	19	0	292
25454	16332s (+0.3s)	864	864	64	33	73	6	1	113
25455	16332s (+0.5s)	1636	1636	128	35	123	8	0	166
25456	16333s (+0.4s)	1516	1516	128	38	112	0	5	155
25457	16333s (+0.5s)	1820	1820	128	51	131	0	8	190
25458	16334s (+0.5s)	2320	2320	256	32	151	0	11	194
25459	16334s (+0.4s)	1044	1044	64	28	90	0	7	125
25460	16335s (+0.6s)	2224	2224	128	38	164	0	10	212
25461	16335s (+0.3s)	908	908	64	29	86	3	0	118
25462	16336s (+0.8s)	3476	3476	256	66	210	13	0	289
25463	16336s (+0.3s)	776	776	64	26	68	7	0	101
25464	16337s (+0.6s)	2648	2648	256	61	150	15	0	226
25465	16337s (+0.5s)	1532	1532	128	35	118	8	0	161
25466	16338s (+0.3s)	828	828	64	28	78	4	0	110
25467	16338s (+0.5s)	1740	1740	128	43	118	14	0	175
25468	16339s (+0.7s)	3000	3000	256	60	178	12	0	250
25469	16339s (+0.6s)	2064	2064	128	43	154	10	0	207
25470	16340s (+0.6s)	2128	2128	128	49	144	0	11	204
25471	16341s (+0.6s)	2308	2308	128	45	157	0	15	217
25472	16341s (+0.8s)	3328	3328	256	59	209	0	9	277
25473	16342s (+0.7s)	2792	2792	256	49	186	0	6	241
25474	16343s (+0.5s)	1792	1792	128	45	128	0	10	183
25475	16343s (+0.3s)	872	872	64	24	75	0	8	107
25476	16343s (+0.4s)	1248	1248	128	29	91	0	4	124
25477	16344s (+0.2s)	568	568	32	21	60	5	0	86
25478	16344s (+0.8s)	3564	3564	256	65	220	12	0	297
25479	16345s (+0.6s)	2196	2196	128	54	152	13	0	219
25480	16346s (+0.4s)	1212	1212	64	29	103	7	0	139
25481	16346s (+0.5s)	1716	1716	128	32	136	3	0	171
25482	16347s (+0.8s)	3600	3600	256	71	227	6	0	304
25483	16348s (+0.7s)	2912	2912	256	74	170	7	3	254
25484	16348s (+0.3s)	752	752	64	22	74	4	0	100
25485	16348s (+0.4s)	1304	1304	128	31	94	7	0	132
25486	16349s (+0.8s)	3264	3264	256	56	209	13	0	278
25487	16350s (+0.9s)	3676	3676	256	83	203	19	1	306
25488	16350s (+0.6s)	1964	1964	128	50	149	5	0	204
25489	16351s (+0.4s)	1912	1912	256	39	113	5	0	157
25490	16352s (+0.9s)	4200	4200	256	89	239	13	1	342
25491	16353s (+1.1s)	5552	5552	512	100	274	17	0	391
25492	16353s (+0.5s)	1564	1564	128	42	124	3	0	169
25493	16354s (+0.8s)	3564	3564	256	70	213	15	0	298
25494	16355s (+0.6s)	2504	2504	256	58	149	10	0	217
25495	16356s (+1.0s)	4328	4328	256	89	258	13	0	360
25496	16356s (+0.4s)	1284	1284	128	28	102	7	0	137
25497	16357s (+0.5s)	1804	1804	128	49	129	8	0	186
25498	16357s (+0.4s)	1556	1556	128	37	116	8	0	161
25499	16358s (+0.8s)	3424	3424	256	77	197	12	0	286
Episode	Time	Reward	Score	Highest	L	U	R	D	Steps
25500	16359s (+1.4s)	6604	6604	512	147	295	34	1	477
25501	16360s (+0.9s)	4100	4100	256	71	245	15	1	332
25502	16361s (+0.6s)	2100	2100	128	55	144	12	0	211
25503	16362s (+0.6s)	1932	1932	128	57	128	9	1	195
25504	16362s (+0.8s)	3268	3268	256	67	197	15	0	279
25505	16363s (+0.8s)	3408	3408	256	73	200	10	0	283
25506	16364s (+0.8s)	3204	3204	256	67	192	10	0	269
25507	16365s (+0.6s)	2508	2508	256	50	158	10	0	218
25508	16366s (+0.9s)	4012	4012	256	101	214	15	0	330
25509	16366s (+0.7s)	2816	2816	256	75	154	11	0	240
25510	16367s (+1.0s)	4308	4308	256	85	258	12	0	355
25511	16368s (+0.9s)	3892	3892	256	90	210	17	0	317
25512	16369s (+0.6s)	1920	1920	128	43	140	12	0	195
25513	16370s (+1.0s)	4084	4084	256	86	235	18	0	339
25514	16370s (+0.6s)	2324	2324	128	44	172	8	0	224
25515	16371s (+0.9s)	3980	3980	256	77	238	14	0	329
25516	16372s (+1.0s)	4176	4176	256	88	242	16	0	346
25517	16373s (+0.8s)	2784	2784	128	66	183	13	1	263
25518	16374s (+0.9s)	3796	3796	256	82	220	13	0	315
25519	16374s (+0.4s)	1448	1448	128	35	107	8	0	150
25520	16375s (+0.8s)	3584	3584	256	79	206	13	0	298
25521	16376s (+0.8s)	3432	3432	256	88	193	12	0	293
25522	16377s (+0.4s)	1492	1492	128	25	125	4	0	154
25523	16377s (+0.5s)	1912	1912	128	54	134	8	0	196
25524	16378s (+0.6s)	1920	1920	128	45	148	5	0	198
25525	16378s (+0.8s)	3496	3496	256	84	195	15	0	294
25526	16379s (+0.7s)	3088	3088	256	51	195	6	0	252
25527	16380s (+0.3s)	816	816	64	30	77	3	0	110
25528	16380s (+0.9s)	4224	4224	256	85	236	21	0	342
25529	16381s (+0.7s)	2240	2240	128	63	152	12	0	227
25530	16382s (+0.7s)	2824	2824	256	63	171	9	0	243
25531	16382s (+0.5s)	1616	1616	128	39	125	6	1	171
25532	16383s (+0.5s)	1772	1772	128	49	129	8	0	186
25533	16383s (+0.5s)	1616	1616	128	42	123	6	0	171
25534	16384s (+0.7s)	2956	2956	256	57	181	11	1	250
25535	16385s (+0.9s)	3648	3648	256	83	214	16	1	314
25536	16386s (+0.8s)	3340	3340	256	63	198	20	0	281
25537	16386s (+0.5s)	1836	1836	128	44	135	7	0	186
25538	16387s (+0.5s)	1624	1624	128	52	108	10	0	170
25539	16387s (+0.6s)	2052	2052	128	55	136	14	0	205
25540	16388s (+0.6s)	2592	2592	256	51	160	12	0	223
25541	16389s (+0.9s)	4012	4012	256	79	231	10	0	320
25542	16390s (+0.7s)	2876	2876	256	51	189	10	0	250
25543	16390s (+0.7s)	3160	3160	256	64	188	14	0	266
25544	16391s (+0.8s)	3476	3476	256	63	214	11	1	289
25545	16392s (+0.5s)	1892	1892	128	41	143	7	0	191
25546	16392s (+0.5s)	1796	1796	128	53	118	13	0	184
25547	16393s (+0.9s)	3784	3784	256	89	213	19	0	321
25548	16394s (+1.0s)	4116	4116	256	94	224	18	0	336
25549	16395s (+1.1s)	4536	4536	256	112	246	22	0	380
25550	16396s (+0.8s)	3352	3352	256	66	194	15	0	275
25551	16397s (+1.2s)	6100	6100	512	118	293	22	0	433
25552	16398s (+0.8s)	3464	3464	256	72	203	10	1	286
25553	16399s (+0.5s)	1608	1608	128	36	116	9	0	161
25554	16399s (+0.7s)	2752	2752	256	58	164	10	0	232
25555	16400s (+0.7s)	2924	2924	256	64	183	11	0	258
25556	16401s (+0.9s)	4008	4008	256	94	215	20	0	329
25557	16401s (+0.5s)	1804	1804	128	56	119	11	0	186
25558	16402s (+0.7s)	3120	3120	256	60	180	13	0	253
25559	16403s (+0.3s)	816	816	64	19	88	4	0	111
25560	16403s (+0.6s)	2184	2184	128	75	135	10	0	220
25561	16404s (+0.7s)	3068	3068	256	61	172	13	1	247
25562	16404s (+0.5s)	1612	1612	64	53	112	9	0	174
25563	16405s (+0.7s)	2784	2784	256	55	173	11	0	239
25564	16406s (+0.8s)	3344	3344	256	80	189	13	0	282
25565	16406s (+0.6s)	2076	2076	128	61	127	15	0	203
25566	16407s (+0.4s)	1528	1528	128	37	120	4	0	161
25567	16407s (+0.4s)	1084	1084	64	40	86	3	1	130
25568	16408s (+0.4s)	1432	1432	64	39	103	11	1	154
25569	16408s (+0.3s)	928	928	64	31	77	5	0	113
25570	16409s (+0.8s)	4284	4284	512	68	203	16	0	287
25571	16409s (+0.6s)	2428	2428	128	52	160	11	0	223
25572	16410s (+0.6s)	2512	2512	256	69	136	8	0	213
25573	16411s (+0.5s)	2208	2208	256	60	121	7	0	188
25574	16411s (+0.5s)	1508	1508	128	47	105	9	0	161
25575	16412s (+1.1s)	5388	5388	512	84	277	18	0	379
25576	16413s (+0.9s)	3920	3920	256	86	216	17	0	319
25577	16414s (+0.5s)	1756	1756	128	60	102	14	0	176
25578	16414s (+0.8s)	3232	3232	256	64	194	12	0	270
25579	16415s (+0.3s)	692	692	64	21	69	2	0	92
25580	16415s (+0.5s)	1736	1736	128	37	130	6	0	173
25581	16415s (+0.2s)	440	440	32	27	43	4	0	74
25582	16416s (+0.4s)	1420	1420	128	32	105	7	0	144
25583	16417s (+1.0s)	4384	4384	256	86	258	21	0	365
25584	16418s (+1.0s)	4068	4068	256	78	237	19	0	334
25585	16418s (+0.4s)	1072	1072	64	22	102	6	1	131
25586	16419s (+0.6s)	2612	2612	128	65	153	16	1	235
25587	16420s (+1.1s)	5840	5840	512	106	297	16	0	419
25588	16420s (+0.4s)	1348	1348	128	15	122	0	3	140
25589	16421s (+0.5s)	1768	1768	128	40	127	10	0	177
25590	16422s (+0.6s)	2056	2056	128	58	131	12	0	201
25591	16422s (+0.8s)	3252	3252	256	55	212	8	0	275
25592	16423s (+0.5s)	1516	1516	128	33	117	8	1	159
25593	16423s (+0.4s)	1472	1472	128	32	113	0	7	152
25594	16424s (+0.8s)	3464	3464	256	67	212	0	13	292
25595	16425s (+0.6s)	2508	2508	256	53	159	0	7	219
25596	16425s (+0.3s)	924	924	64	20	96	0	5	121
25597	16426s (+0.4s)	1328	1328	128	23	118	0	5	146
25598	16426s (+0.2s)	384	384	32	8	51	0	3	62
25599	16426s (+0.5s)	1632	1632	128	39	129	7	0	175
Episode	Time	Reward	Score	Highest	L	U	R	D	Steps
25600	16427s (+0.7s)	2680	2680	256	56	164	10	0	230
25601	16428s (+0.7s)	3276	3276	256	74	180	16	0	270
25602	16428s (+0.4s)	1480	1480	128	37	105	11	0	153
25603	16429s (+0.5s)	1564	1564	128	40	115	8	0	163
25604	16429s (+0.4s)	1172	1172	64	43	90	7	0	140
25605	16429s (+0.5s)	1576	1576	128	38	117	7	0	162
25606	16430s (+0.9s)	4276	4276	256	86	245	16	0	347
25607	16431s (+0.8s)	3244	3244	256	54	205	14	2	275
25608	16431s (+0.3s)	876	876	64	38	70	7	0	115
25609	16432s (+0.8s)	3360	3360	256	59	217	10	0	286
25610	16433s (+0.5s)	1844	1844	128	49	129	11	0	189
25611	16433s (+0.4s)	1416	1416	128	23	120	3	0	146
25612	16434s (+0.6s)	1956	1956	128	60	126	11	0	197
25613	16434s (+0.6s)	2012	2012	128	50	137	11	0	198
25614	16435s (+0.5s)	1676	1676	128	40	124	7	0	171
25615	16436s (+0.6s)	2472	2472	256	51	152	7	0	210
25616	16436s (+0.4s)	1184	1184	128	28	92	8	0	128
25617	16437s (+0.6s)	2692	2692	256	37	187	0	6	230
25618	16437s (+0.3s)	804	804	64	24	77	0	8	109
25619	16438s (+0.8s)	3176	3176	256	55	205	0	8	268
25620	16438s (+0.6s)	2276	2276	128	45	166	0	8	219
25621	16439s (+0.8s)	3316	3316	256	58	197	0	21	276
25622	16440s (+0.5s)	1788	1788	128	47	129	6	0	182
25623	16440s (+0.2s)	568	568	64	19	56	3	0	78
25624	16440s (+0.4s)	1068	1068	64	42	77	9	0	128
25625	16441s (+0.4s)	1020	1020	64	29	87	7	0	123
25626	16441s (+0.8s)	3360	3360	256	73	189	14	0	276
25627	16442s (+0.5s)	1960	1960	128	45	143	9	0	197
25628	16442s (+0.6s)	2028	2028	128	61	130	12	0	203
25629	16443s (+0.6s)	2376	2376	256	45	146	11	0	202
25630	16444s (+0.6s)	2416	2416	128	64	151	12	0	227
25631	16444s (+0.7s)	2780	2780	256	57	170	12	0	239
25632	16445s (+0.6s)	1916	1916	128	40	147	7	0	194
25633	16446s (+0.6s)	1916	1916	128	42	142	12	1	197
25634	16446s (+0.9s)	3728	3728	256	79	205	15	0	299
25635	16447s (+0.8s)	3600	3600	256	66	221	7	0	294
25636	16448s (+0.7s)	2416	2416	128	65	150	12	0	227
25637	16448s (+0.5s)	1928	1928	128	48	141	11	0	200
25638	16449s (+0.9s)	3968	3968	256	61	247	0	18	326
25639	16450s (+0.6s)	2224	2224	128	46	151	0	14	211
25640	16451s (+0.8s)	3480	3480	256	77	196	16	0	289
25641	16452s (+1.1s)	5500	5500	512	101	272	17	0	390
25642	16453s (+1.0s)	4268	4268	256	98	235	17	0	350
25643	16454s (+0.8s)	3288	3288	256	67	190	12	0	269
25644	16454s (+0.6s)	2160	2160	128	57	145	13	0	215
25645	16455s (+0.6s)	2456	2456	256	56	139	12	0	207
25646	16456s (+0.6s)	2468	2468	256	49	155	6	0	210
25647	16456s (+0.6s)	2480	2480	256	44	157	12	0	213
25648	16457s (+0.5s)	1804	1804	128	41	137	7	1	186
25649	16457s (+0.4s)	1432	1432	128	33	106	7	0	146
25650	16458s (+0.7s)	2972	2972	256	60	181	8	1	250
25651	16459s (+0.9s)	3528	3528	256	66	213	16	1	296
25652	16459s (+0.4s)	1464	1464	128	29	122	4	0	155
25653	16460s (+0.5s)	1728	1728	128	36	132	5	0	173
25654	16460s (+0.5s)	1776	1776	128	39	130	10	0	179
25655	16461s (+0.4s)	1160	1160	64	36	95	6	0	137
25656	16461s (+0.6s)	2768	2768	256	52	173	11	0	236
25657	16462s (+0.9s)	3932	3932	256	79	216	20	0	315
25658	16463s (+0.7s)	2884	2884	256	67	167	15	0	249
25659	16463s (+0.7s)	2876	2876	256	68	162	11	1	242
25660	16464s (+0.7s)	2704	2704	256	58	162	15	0	235
25661	16465s (+0.7s)	2728	2728	128	67	170	16	0	253
25662	16466s (+0.9s)	3568	3568	256	70	216	13	1	300
25663	16466s (+0.4s)	1272	1272	64	35	101	12	1	149
25664	16467s (+0.6s)	2368	2368	128	58	153	9	0	220
25665	16467s (+0.6s)	2052	2052	128	48	142	9	0	199
25666	16468s (+0.8s)	3180	3180	256	53	202	9	0	264
25667	16469s (+0.5s)	1776	1776	128	46	127	10	1	184
25668	16469s (+0.4s)	1376	1376	128	22	119	3	0	144
25669	16470s (+0.4s)	1396	1396	128	34	105	6	0	145
25670	16470s (+0.7s)	2868	2868	256	75	162	11	0	248
25671	16471s (+0.5s)	1912	1912	128	57	133	6	0	196
25672	16472s (+0.9s)	3584	3584	256	95	187	21	1	304
25673	16472s (+0.6s)	1960	1960	128	45	154	4	0	203
25674	16473s (+1.0s)	4096	4096	256	84	229	20	0	333
25675	16474s (+0.5s)	1868	1868	128	47	135	7	1	190
25676	16474s (+0.2s)	596	596	32	29	54	6	0	89
25677	16475s (+0.8s)	3288	3288	256	58	213	0	13	284
25678	16475s (+0.4s)	1556	1556	128	36	114	0	12	162
25679	16476s (+0.6s)	2712	2712	256	49	170	0	8	227
25680	16476s (+0.3s)	1112	1112	128	34	84	0	4	122
25681	16477s (+0.5s)	1856	1856	128	44	135	0	8	187
25682	16478s (+0.7s)	3196	3196	256	68	180	14	0	262
25683	16478s (+0.9s)	3544	3544	256	88	194	17	1	300
25684	16479s (+0.5s)	1596	1596	128	45	113	8	0	166
25685	16480s (+0.6s)	2504	2504	256	65	142	10	0	217
25686	16480s (+0.6s)	2708	2708	256	56	157	13	0	226
25687	16481s (+0.6s)	2620	2620	256	53	157	8	0	218
25688	16482s (+0.8s)	3248	3248	256	72	188	11	1	272
25689	16482s (+0.7s)	2912	2912	256	61	182	11	0	254
25690	16483s (+0.2s)	372	372	32	17	46	2	0	65
25691	16483s (+0.8s)	3152	3152	256	59	198	14	0	271
25692	16484s (+0.9s)	3772	3772	256	85	203	21	0	309
25693	16485s (+0.5s)	1812	1812	128	42	139	7	0	188
25694	16485s (+0.5s)	1764	1764	128	51	122	4	0	177
25695	16486s (+0.7s)	2548	2548	128	65	161	10	1	237
25696	16486s (+0.4s)	1560	1560	128	44	99	10	0	153
25697	16487s (+0.5s)	1588	1588	128	41	111	13	0	165
25698	16487s (+0.6s)	2224	2224	128	49	152	10	0	211
25699	16488s (+0.8s)	3232	3232	256	60	197	9	0	266
Episode	Time	Reward	Score	Highest	L	U	R	D	Steps
25700	16489s (+1.0s)	4480	4480	256	86	258	18	0	362
25701	16490s (+0.6s)	1920	1920	128	35	154	9	0	198
25702	16490s (+0.6s)	2484	2484	256	49	158	10	0	217
25703	16491s (+0.8s)	3772	3772	256	67	221	11	1	300
25704	16492s (+0.9s)	3956	3956	256	90	218	14	1	323
25705	16493s (+1.1s)	4968	4968	256	110	253	25	0	388
25706	16494s (+0.4s)	1148	1148	64	36	94	7	0	137
25707	16494s (+0.4s)	1488	1488	128	34	114	0	8	156
25708	16495s (+0.6s)	2468	2468	256	41	159	0	13	213
25709	16495s (+0.6s)	2184	2184	128	47	146	0	13	206
25710	16496s (+0.6s)	2528	2528	256	46	166	0	7	219
25711	16497s (+0.9s)	3568	3568	256	70	221	0	15	306
25712	16497s (+0.4s)	1124	1124	64	31	94	0	8	133
25713	16498s (+0.4s)	1468	1468	128	38	102	0	14	154
25714	16498s (+0.7s)	2748	2748	256	50	177	0	8	235
25715	16499s (+0.3s)	720	720	64	12	81	0	4	97
25716	16499s (+0.8s)	3252	3252	256	82	174	15	0	271
25717	16500s (+0.9s)	3904	3904	256	59	237	19	0	315
25718	16501s (+0.8s)	3432	3432	256	60	218	11	0	289
25719	16502s (+0.5s)	1676	1676	128	41	126	5	0	172
25720	16502s (+0.8s)	3748	3748	256	71	219	13	1	304
25721	16503s (+0.4s)	1152	1152	64	42	87	6	0	135
25722	16503s (+0.6s)	1904	1904	128	43	146	5	0	194
25723	16504s (+0.5s)	2088	2088	128	56	126	12	0	194
25724	16505s (+0.6s)	2372	2372	256	42	152	7	0	201
25725	16505s (+0.5s)	1592	1592	128	43	116	6	0	165
25726	16505s (+0.4s)	1456	1456	128	29	116	6	1	152
25727	16506s (+0.8s)	3244	3244	256	68	193	13	0	274
25728	16507s (+0.5s)	1668	1668	128	49	111	9	0	169
25729	16507s (+0.5s)	1684	1684	128	47	119	7	0	173
25730	16508s (+0.5s)	1760	1760	128	46	123	11	0	180
25731	16509s (+0.8s)	3316	3316	256	70	194	11	0	275
25732	16509s (+0.6s)	1924	1924	128	49	144	6	0	199
25733	16510s (+0.8s)	3188	3188	256	72	180	13	0	265
25734	16510s (+0.5s)	1748	1748	128	35	135	7	0	177
25735	16511s (+0.5s)	1836	1836	128	42	134	8	0	184
25736	16511s (+0.4s)	1320	1320	64	39	104	8	0	151
25737	16512s (+0.8s)	3364	3364	256	85	192	11	0	288
25738	16513s (+0.8s)	3264	3264	256	69	191	19	0	279
25739	16514s (+0.9s)	3988	3988	256	85	233	13	0	331
25740	16515s (+0.8s)	3444	3444	256	58	221	13	0	292
25741	16516s (+0.8s)	3500	3500	256	83	189	18	0	290
25742	16516s (+0.7s)	2768	2768	256	65	164	10	0	239
25743	16517s (+0.8s)	3652	3652	256	71	221	8	0	300
25744	16518s (+1.1s)	5424	5424	512	99	266	18	0	383
25745	16520s (+1.4s)	7228	7228	512	130	341	30	0	501
25746	16520s (+0.4s)	1416	1416	128	35	106	8	1	150
25747	16520s (+0.4s)	1076	1076	64	35	92	5	0	132
25748	16521s (+0.7s)	2556	2556	128	57	166	16	0	239
25749	16522s (+0.5s)	1752	1752	128	45	123	10	0	178
25750	16522s (+0.7s)	2740	2740	256	58	159	12	0	229
25751	16523s (+0.5s)	1860	1860	128	42	130	9	0	181
25752	16523s (+0.6s)	2544	2544	256	48	162	12	1	223
25753	16525s (+1.2s)	5952	5952	512	115	290	21	1	427
25754	16525s (+0.6s)	1940	1940	128	54	138	10	1	203
25755	16526s (+0.6s)	2064	2064	128	49	143	15	0	207
25756	16527s (+0.8s)	3360	3360	256	77	183	13	0	273
25757	16527s (+0.5s)	1616	1616	128	38	126	7	0	171
25758	16528s (+0.6s)	1912	1912	128	40	151	5	0	196
25759	16528s (+0.6s)	2432	2432	256	47	150	8	0	205
25760	16529s (+0.8s)	3568	3568	256	80	196	19	0	295
25761	16530s (+0.9s)	3588	3588	256	100	181	22	1	304
25762	16531s (+0.7s)	2696	2696	256	57	165	10	0	232
25763	16531s (+0.5s)	1872	1872	128	47	134	10	0	191
25764	16532s (+0.7s)	3056	3056	256	52	196	10	1	259
25765	16532s (+0.4s)	1364	1364	128	37	99	5	1	142
25766	16533s (+0.5s)	1580	1580	128	49	112	5	0	166
25767	16534s (+1.1s)	5648	5648	512	91	286	22	1	400
25768	16535s (+0.7s)	3028	3028	256	56	178	11	1	246
25769	16535s (+0.6s)	2456	2456	256	42	155	10	0	207
25770	16536s (+0.8s)	3188	3188	256	50	201	14	0	265
25771	16537s (+0.6s)	2444	2444	256	41	164	6	0	211
25772	16537s (+0.4s)	1056	1056	64	28	93	6	1	128
25773	16538s (+0.8s)	3228	3228	256	67	190	13	0	270
25774	16538s (+0.6s)	2616	2616	256	49	173	7	0	229
25775	16539s (+0.2s)	476	476	64	17	52	1	0	70
25776	16540s (+0.9s)	3856	3856	256	86	210	19	0	315
25777	16540s (+0.7s)	2620	2620	256	56	167	0	7	230
25778	16541s (+0.6s)	2060	2060	128	40	148	0	14	202
25779	16542s (+0.7s)	3136	3136	256	48	196	0	14	258
25780	16542s (+0.6s)	2020	2020	128	37	162	0	8	207
25781	16543s (+0.6s)	1928	1928	128	44	147	0	9	200
25782	16543s (+0.4s)	1452	1452	128	32	111	9	0	152
25783	16544s (+0.8s)	3484	3484	256	69	207	14	0	290
25784	16545s (+0.6s)	2516	2516	256	37	170	0	12	219
25785	16545s (+0.5s)	2340	2340	256	40	147	0	8	195
25786	16546s (+0.9s)	3668	3668	256	93	206	15	0	314
25787	16547s (+0.6s)	2412	2412	256	59	141	4	0	204
25788	16547s (+0.8s)	3396	3396	256	57	213	13	1	284
25789	16548s (+0.4s)	1184	1184	128	32	90	5	1	128
25790	16548s (+0.4s)	1136	1136	64	28	98	7	0	133
25791	16548s (+0.3s)	760	760	64	30	60	6	0	96
25792	16549s (+0.5s)	1756	1756	128	45	126	8	0	179
25793	16550s (+0.5s)	2328	2328	256	38	148	9	0	195
25794	16550s (+0.7s)	2928	2928	256	58	193	7	0	258
25795	16551s (+1.0s)	4072	4072	256	63	261	0	13	337
25796	16552s (+0.5s)	1648	1648	128	28	128	0	9	165
25797	16552s (+0.5s)	1720	1720	128	38	124	0	9	171
25798	16553s (+0.3s)	972	972	64	30	79	0	10	119
25799	16553s (+0.7s)	3224	3224	256	70	184	9	0	263
Episode	Time	Reward	Score	Highest	L	U	R	D	Steps
25800	16554s (+0.6s)	2036	2036	128	51	139	10	0	200
25801	16554s (+0.5s)	1808	1808	128	46	136	5	0	187
25802	16555s (+0.3s)	788	788	64	29	67	8	0	104
25803	16556s (+0.7s)	3184	3184	256	66	186	11	0	263
25804	16556s (+0.8s)	3388	3388	256	74	204	15	0	293
25805	16557s (+0.8s)	3508	3508	256	72	209	10	0	291
25806	16558s (+0.9s)	3612	3612	256	82	205	18	1	306
25807	16559s (+0.6s)	1988	1988	128	39	148	7	0	194
25808	16559s (+0.6s)	1904	1904	128	42	145	7	0	194
25809	16560s (+0.7s)	3200	3200	256	68	181	14	0	263
25810	16560s (+0.5s)	1616	1616	128	38	119	5	0	162
25811	16561s (+0.7s)	3192	3192	256	64	178	20	0	262
25812	16561s (+0.3s)	1068	1068	128	29	81	3	0	113
25813	16562s (+0.9s)	4064	4064	256	72	248	0	14	334
25814	16563s (+0.9s)	3896	3896	256	61	237	0	11	309
25815	16564s (+0.4s)	1052	1052	64	26	93	0	8	127
25816	16564s (+0.3s)	836	836	64	24	82	0	3	109
25817	16565s (+1.0s)	4340	4340	256	75	267	13	0	355
25818	16566s (+0.5s)	1580	1580	128	35	119	8	1	163
25819	16566s (+0.7s)	2740	2740	256	46	177	10	0	233
25820	16567s (+1.0s)	4180	4180	256	99	220	17	0	336
25821	16568s (+0.5s)	1788	1788	128	44	127	11	0	182
25822	16569s (+0.8s)	3536	3536	256	82	200	16	0	298
25823	16569s (+0.7s)	3156	3156	256	74	171	13	0	258
25824	16570s (+0.8s)	3224	3224	256	63	193	12	0	268
25825	16571s (+0.8s)	3436	3436	256	77	194	8	0	279
25826	16572s (+0.8s)	3216	3216	256	80	171	16	0	267
25827	16573s (+0.9s)	4752	4752	512	93	218	21	0	332
25828	16573s (+0.5s)	1648	1648	128	46	121	7	0	174
25829	16574s (+0.9s)	4056	4056	256	88	222	26	0	336
25830	16574s (+0.4s)	1480	1480	128	42	103	8	0	153
25831	16575s (+0.6s)	2152	2152	128	41	153	9	0	203
25832	16576s (+0.5s)	1696	1696	128	38	131	6	0	175
25833	16576s (+0.6s)	2192	2192	128	39	155	7	1	202
25834	16577s (+0.8s)	3196	3196	256	73	176	12	1	262
25835	16578s (+1.1s)	5464	5464	512	96	265	20	0	381
25836	16579s (+0.6s)	1932	1932	128	57	135	9	0	201
25837	16579s (+0.2s)	468	468	32	19	55	1	0	75
25838	16579s (+0.5s)	1764	1764	128	47	124	10	0	181
25839	16580s (+0.3s)	1160	1160	128	22	97	0	5	124
25840	16580s (+0.6s)	2348	2348	128	46	165	0	11	222
25841	16581s (+0.4s)	1172	1172	64	36	95	9	0	140
25842	16582s (+1.0s)	4204	4204	256	69	268	0	11	348
25843	16582s (+0.2s)	584	584	64	13	66	0	2	81
25844	16583s (+0.8s)	3420	3420	256	66	208	0	12	286
25845	16583s (+0.5s)	1616	1616	128	40	121	9	1	171
25846	16584s (+0.5s)	1684	1684	128	42	122	9	0	173
25847	16584s (+0.6s)	2596	2596	256	52	161	11	0	224
25848	16585s (+0.5s)	2056	2056	256	35	123	6	0	164
25849	16586s (+0.8s)	3400	3400	256	58	211	11	0	280
25850	16586s (+0.7s)	2756	2756	256	56	167	9	0	232
25851	16587s (+0.7s)	2744	2744	128	73	163	16	1	253
25852	16588s (+0.6s)	2524	2524	256	55	158	6	0	219
25853	16589s (+0.9s)	3924	3924	256	85	220	17	0	322
25854	16590s (+1.2s)	5836	5836	512	113	288	19	0	420
25855	16591s (+1.6s)	8544	8544	512	163	379	40	0	582
25856	16592s (+0.4s)	1496	1496	128	28	125	5	0	158
25857	16593s (+0.8s)	3380	3380	256	75	193	13	0	281
25858	16593s (+0.5s)	1904	1904	128	47	137	10	0	194
25859	16594s (+0.5s)	1624	1624	128	47	106	9	1	163
25860	16595s (+0.7s)	2600	2600	256	47	175	7	0	229
25861	16595s (+0.8s)	3444	3444	256	71	207	10	0	288
25862	16596s (+0.8s)	3480	3480	256	77	198	14	0	289
25863	16597s (+0.6s)	2540	2540	256	49	160	13	0	222
25864	16597s (+0.4s)	1136	1136	64	35	88	8	0	131
25865	16598s (+0.5s)	1604	1604	128	36	126	6	0	168
25866	16598s (+0.4s)	1332	1332	128	26	110	3	0	139
25867	16599s (+0.9s)	3680	3680	256	77	210	15	1	303
25868	16600s (+0.8s)	3248	3248	256	70	187	11	0	268
25869	16600s (+0.6s)	1824	1824	128	57	124	9	0	190
25870	16601s (+0.5s)	1764	1764	128	48	122	8	0	178
25871	16601s (+0.4s)	1268	1268	128	36	100	2	0	138
25872	16602s (+0.7s)	2932	2932	256	52	173	9	0	234
25873	16602s (+0.5s)	1620	1620	128	32	120	10	0	162
25874	16603s (+0.3s)	1012	1012	128	22	84	2	0	108
25875	16603s (+0.6s)	2376	2376	128	62	146	13	1	222
25876	16604s (+0.5s)	1532	1532	128	39	115	3	0	157
25877	16605s (+1.0s)	4288	4288	256	99	236	19	0	354
25878	16605s (+0.5s)	1516	1516	128	47	105	10	0	162
25879	16606s (+0.4s)	1212	1212	128	40	82	7	0	129
25880	16606s (+0.5s)	1912	1912	128	46	132	9	0	187
25881	16607s (+0.3s)	916	916	64	28	76	6	0	110
25882	16607s (+0.7s)	2952	2952	256	48	188	0	13	249
25883	16608s (+0.7s)	2904	2904	256	51	190	0	12	253
25884	16608s (+0.5s)	1776	1776	128	42	131	0	6	179
25885	16609s (+0.7s)	3060	3060	256	48	189	13	0	250
25886	16610s (+0.6s)	2624	2624	256	53	170	8	0	231
25887	16610s (+0.6s)	2668	2668	256	73	143	11	0	227
25888	16611s (+0.5s)	1564	1564	128	35	120	5	0	160
25889	16612s (+1.3s)	6440	6440	512	124	310	18	1	453
25890	16613s (+0.5s)	1804	1804	128	51	117	11	0	179
25891	16613s (+0.7s)	2744	2744	256	71	150	13	0	234
25892	16614s (+1.0s)	3988	3988	256	63	252	16	0	331
25893	16615s (+0.5s)	1732	1732	128	38	124	10	0	172
25894	16615s (+0.3s)	964	964	64	26	83	8	0	117
25895	16616s (+1.0s)	4168	4168	256	73	255	16	0	344
25896	16617s (+0.5s)	1640	1640	128	53	108	11	0	172
25897	16618s (+0.8s)	3440	3440	256	80	185	15	0	280
25898	16618s (+0.9s)	3644	3644	256	91	207	16	0	314
25899	16619s (+0.6s)	2476	2476	256	50	150	11	0	211
Episode	Time	Reward	Score	Highest	L	U	R	D	Steps
25900	16620s (+0.6s)	2224	2224	128	60	140	11	0	211
25901	16620s (+0.6s)	2408	2408	256	45	155	6	0	206
25902	16621s (+0.6s)	2616	2616	256	48	169	6	0	223
25903	16621s (+0.5s)	1524	1524	128	37	118	5	0	160
25904	16622s (+0.8s)	3456	3456	256	81	192	14	0	287
25905	16623s (+0.4s)	1324	1324	128	31	102	9	0	142
25906	16623s (+0.6s)	1924	1924	128	36	151	0	12	199
25907	16623s (+0.3s)	1060	1060	128	20	90	0	5	115
25908	16624s (+0.7s)	3188	3188	256	80	165	16	0	261
25909	16625s (+0.6s)	1940	1940	128	44	154	5	0	203
25910	16625s (+0.7s)	2932	2932	256	67	163	11	0	241
25911	16626s (+0.9s)	3704	3704	256	88	199	15	0	302
25912	16627s (+0.5s)	1768	1768	128	40	130	7	0	177
25913	16627s (+0.3s)	976	976	128	29	72	3	0	104
25914	16628s (+0.4s)	1356	1356	128	37	106	6	0	149
25915	16628s (+0.7s)	2628	2628	256	51	171	9	0	231
25916	16629s (+0.5s)	1856	1856	128	42	135	10	0	187
25917	16629s (+0.4s)	1500	1500	128	42	110	6	1	159
25918	16630s (+0.7s)	2792	2792	256	56	178	7	0	241
25919	16630s (+0.5s)	1804	1804	128	46	132	7	0	185
25920	16631s (+0.5s)	1928	1928	128	29	144	0	13	186
25921	16632s (+0.6s)	2644	2644	256	36	172	0	14	222
25922	16632s (+0.6s)	2572	2572	256	44	180	0	5	229
25923	16633s (+0.7s)	2656	2656	256	47	180	0	7	234
25924	16634s (+0.6s)	2520	2520	256	35	176	0	10	221
25925	16634s (+0.8s)	3268	3268	256	51	211	0	13	275
25926	16635s (+0.3s)	828	828	64	24	83	0	3	110
25927	16635s (+0.4s)	1220	1220	128	34	94	0	5	133
25928	16636s (+0.6s)	2616	2616	256	57	149	0	11	217
25929	16636s (+0.5s)	2316	2316	256	37	147	0	9	193
25930	16637s (+0.9s)	3904	3904	256	90	217	0	16	323
25931	16638s (+0.4s)	1508	1508	128	28	122	0	4	154
25932	16638s (+0.6s)	1972	1972	128	46	155	0	5	206
25933	16639s (+0.6s)	2532	2532	256	42	163	0	10	215
25934	16639s (+0.5s)	1848	1848	128	52	126	8	0	186
25935	16640s (+0.5s)	1576	1576	128	29	134	0	3	166
25936	16640s (+0.6s)	2580	2580	256	51	164	0	10	225
25937	16641s (+0.7s)	2808	2808	256	42	185	0	13	240
25938	16642s (+0.7s)	2700	2700	256	55	165	0	10	230
25939	16643s (+0.8s)	3380	3380	256	81	191	14	0	286
25940	16644s (+1.2s)	6032	6032	512	108	297	20	1	426
25941	16645s (+0.8s)	3104	3104	256	81	164	19	0	264
25942	16645s (+0.7s)	2860	2860	256	75	156	15	0	246
25943	16646s (+0.7s)	3148	3148	256	56	193	9	0	258
25944	16647s (+0.8s)	3520	3520	256	70	215	14	0	299
25945	16648s (+1.0s)	4916	4916	512	92	242	14	0	348
25946	16649s (+0.6s)	1936	1936	128	56	135	6	0	197
25947	16650s (+1.0s)	4396	4396	256	109	242	18	0	369
25948	16651s (+1.2s)	5964	5964	512	113	289	23	0	425
25949	16651s (+0.5s)	1540	1540	128	32	120	11	0	163
25950	16652s (+0.7s)	2716	2716	256	66	156	10	0	232
25951	16652s (+0.5s)	1736	1736	128	39	134	7	0	180
25952	16653s (+0.5s)	1856	1856	128	42	136	9	0	187
25953	16653s (+0.4s)	1344	1344	128	40	94	7	0	141
25954	16654s (+0.5s)	1748	1748	128	33	137	7	0	177
25955	16654s (+0.5s)	1752	1752	128	33	139	4	0	176
25956	16655s (+0.5s)	1744	1744	128	38	133	4	0	175
25957	16655s (+0.5s)	1772	1772	128	46	128	8	0	182
25958	16656s (+0.6s)	1936	1936	128	52	140	5	0	197
25959	16657s (+0.5s)	1876	1876	128	49	136	7	0	192
25960	16657s (+0.5s)	1804	1804	128	41	134	10	0	185
25961	16658s (+0.4s)	1420	1420	128	33	103	8	0	144
25962	16658s (+0.7s)	2492	2492	128	70	148	13	0	231
25963	16659s (+0.8s)	3424	3424	256	66	208	13	0	287
25964	16659s (+0.4s)	1432	1432	128	29	118	7	0	154
25965	16660s (+0.4s)	1140	1140	64	31	100	6	0	137
25966	16660s (+0.5s)	1860	1860	128	51	135	9	0	195
25967	16661s (+0.7s)	3220	3220	256	51	211	6	0	268
25968	16662s (+0.8s)	3424	3424	256	81	191	15	0	287
25969	16662s (+0.5s)	1816	1816	128	36	141	11	0	188
25970	16663s (+1.0s)	4804	4804	512	101	223	16	0	340
25971	16664s (+0.5s)	1736	1736	128	40	126	8	0	174
25972	16665s (+0.6s)	2552	2552	256	49	165	10	0	224
25973	16665s (+0.3s)	904	904	64	35	75	7	0	117
25974	16666s (+0.8s)	3500	3500	256	68	216	10	0	294
25975	16666s (+0.3s)	1076	1076	128	25	85	8	0	118
25976	16667s (+0.6s)	1904	1904	128	56	128	10	1	195
25977	16667s (+0.5s)	1500	1500	128	40	109	9	1	159
25978	16668s (+0.5s)	1920	1920	128	54	133	11	0	198
25979	16668s (+0.5s)	1644	1644	128	30	133	4	0	167
25980	16669s (+0.5s)	1660	1660	128	32	132	0	4	168
25981	16669s (+0.7s)	3080	3080	256	59	193	0	8	260
25982	16670s (+0.7s)	3108	3108	256	47	199	0	11	257
25983	16671s (+0.8s)	3240	3240	256	45	218	0	8	271
25984	16671s (+0.5s)	1860	1860	128	35	135	0	8	178
25985	16672s (+0.4s)	1104	1104	64	29	96	0	8	133
25986	16673s (+0.8s)	3260	3260	256	58	201	0	19	278
25987	16673s (+0.4s)	1592	1592	128	38	111	0	8	157
25988	16673s (+0.3s)	680	680	64	15	70	0	4	89
25989	16674s (+0.7s)	2948	2948	256	61	195	0	7	263
25990	16674s (+0.4s)	1344	1344	128	27	108	0	4	139
25991	16675s (+0.5s)	2020	2020	128	48	136	0	9	193
25992	16676s (+1.3s)	6196	6196	512	91	328	0	21	440
25993	16677s (+0.4s)	1468	1468	128	27	112	0	9	148
25994	16678s (+0.8s)	3272	3272	256	54	213	0	9	276
25995	16678s (+0.7s)	3056	3056	256	59	189	0	11	259
25996	16679s (+0.7s)	2772	2772	256	48	181	0	7	236
25997	16679s (+0.5s)	2208	2208	256	39	143	0	6	188
25998	16680s (+0.5s)	1732	1732	128	42	118	0	9	169
25999	16681s (+0.8s)	3544	3544	256	55	216	0	15	286
Episode	Time	Reward	Score	Highest	L	U	R	D	Steps
26000	16682s (+0.9s)	3872	3872	256	74	228	0	17	319
26001	16682s (+0.4s)	1488	1488	128	41	110	5	0	156
26002	16683s (+1.2s)	6008	6008	512	112	298	19	0	429
26003	16684s (+0.7s)	2340	2340	128	55	167	16	1	239
26004	16684s (+0.3s)	968	968	64	27	86	8	0	121
26005	16685s (+0.7s)	2924	2924	256	79	150	14	0	243
26006	16686s (+0.5s)	1628	1628	128	42	120	8	0	170
26007	16686s (+0.8s)	3244	3244	256	61	200	12	1	274
26008	16687s (+0.6s)	1912	1912	128	48	140	8	0	196
26009	16687s (+0.6s)	1904	1904	128	39	151	4	0	194
26010	16688s (+0.7s)	3064	3064	256	58	191	0	12	261
26011	16689s (+0.7s)	2868	2868	256	66	168	0	10	244
26012	16690s (+0.6s)	2244	2244	128	44	155	0	17	216
26013	16690s (+0.3s)	728	728	64	16	70	0	5	91
26014	16691s (+0.8s)	3544	3544	256	75	212	13	0	300
26015	16691s (+0.7s)	3092	3092	256	78	164	14	0	256
26016	16692s (+1.1s)	4364	4364	256	91	259	19	0	369
26017	16693s (+0.5s)	1508	1508	128	42	106	12	0	160
26018	16694s (+1.0s)	4320	4320	256	109	227	16	2	354
26019	16695s (+0.8s)	3544	3544	256	84	196	20	0	300
26020	16695s (+0.4s)	1444	1444	128	38	101	10	0	149
26021	16696s (+1.0s)	4304	4304	256	95	239	20	0	354
26022	16696s (+0.3s)	656	656	64	20	68	3	1	92
26023	16697s (+0.6s)	2012	2012	128	63	132	9	0	204
26024	16698s (+0.6s)	1944	1944	128	53	134	10	0	197
26025	16699s (+1.5s)	7544	7544	512	149	353	24	0	526
26026	16700s (+0.6s)	2096	2096	128	61	134	9	0	204
26027	16701s (+1.0s)	5088	5088	512	92	257	13	0	362
26028	16702s (+0.8s)	3248	3248	256	76	181	11	0	268
26029	16702s (+0.5s)	1572	1572	128	44	113	8	0	165
26030	16703s (+0.8s)	3332	3332	256	45	217	8	0	270
26031	16704s (+0.8s)	3244	3244	256	69	192	12	1	274
26032	16704s (+0.4s)	1452	1452	128	32	113	5	0	150
26033	16705s (+0.5s)	1888	1888	128	49	138	8	0	195
26034	16705s (+0.7s)	2512	2512	128	61	163	10	0	234
26035	16706s (+0.5s)	1796	1796	128	38	142	4	0	184
26036	16706s (+0.4s)	1292	1292	128	33	101	5	0	139
26037	16707s (+0.7s)	2936	2936	256	57	196	7	0	260
26038	16707s (+0.3s)	656	656	64	22	65	3	0	90
26039	16708s (+0.8s)	3492	3492	256	60	216	11	0	287
26040	16709s (+0.8s)	3404	3404	256	73	199	14	1	287
26041	16710s (+0.6s)	1852	1852	128	50	139	4	0	193
26042	16710s (+0.9s)	3668	3668	256	74	212	14	0	300
26043	16711s (+0.5s)	1588	1588	128	46	115	3	0	164
26044	16712s (+1.1s)	5812	5812	512	112	268	23	1	404
26045	16713s (+0.4s)	1320	1320	128	23	110	2	0	135
26046	16713s (+0.7s)	2756	2756	256	59	164	12	0	235
26047	16714s (+0.8s)	3524	3524	256	90	192	11	0	293
26048	16715s (+0.8s)	3428	3428	256	84	177	19	1	281
26049	16715s (+0.5s)	1912	1912	128	48	139	9	1	197
26050	16716s (+0.6s)	2232	2232	256	32	155	7	0	194
26051	16716s (+0.5s)	1672	1672	128	33	130	6	0	169
26052	16717s (+0.5s)	1756	1756	128	43	126	10	0	179
26053	16717s (+0.5s)	1680	1680	128	41	120	10	0	171
26054	16718s (+0.6s)	2460	2460	128	52	158	16	0	226
26055	16719s (+0.8s)	3524	3524	256	62	219	14	0	295
26056	16720s (+1.1s)	5584	5584	512	97	274	20	0	391
26057	16720s (+0.3s)	888	888	64	30	80	3	0	113
26058	16721s (+0.6s)	2492	2492	256	50	154	10	0	214
26059	16722s (+0.9s)	3884	3884	256	106	205	15	0	326
26060	16723s (+1.1s)	5496	5496	512	93	272	24	1	390
26061	16723s (+0.4s)	1324	1324	128	27	105	5	0	137
26062	16724s (+0.6s)	2300	2300	256	43	142	8	0	193
26063	16724s (+0.3s)	724	724	64	18	70	5	0	93
26064	16725s (+0.6s)	2436	2436	256	64	133	9	0	206
26065	16725s (+0.6s)	2444	2444	256	43	159	11	1	214
26066	16726s (+0.9s)	3592	3592	256	81	204	17	0	302
26067	16727s (+0.5s)	1500	1500	128	32	118	7	0	157
26068	16728s (+0.9s)	4764	4764	512	75	251	8	0	334
26069	16728s (+0.4s)	1536	1536	128	36	121	5	0	162
26070	16729s (+0.6s)	2104	2104	128	43	144	11	0	198
26071	16729s (+0.6s)	2176	2176	128	71	133	11	0	215
26072	16730s (+0.5s)	1868	1868	128	43	137	10	0	190
26073	16731s (+0.8s)	3392	3392	256	81	182	20	0	283
26074	16731s (+0.5s)	1844	1844	128	39	140	5	0	184
26075	16732s (+0.7s)	2920	2920	256	65	175	16	0	256
26076	16733s (+0.7s)	2744	2744	256	63	172	6	0	241
26077	16733s (+0.4s)	1016	1016	64	32	96	5	0	133
26078	16733s (+0.4s)	1200	1200	128	33	90	9	0	132
26079	16734s (+0.6s)	1944	1944	128	56	135	13	0	204
26080	16734s (+0.3s)	964	964	64	29	82	6	0	117
26081	16735s (+0.5s)	1604	1604	128	30	127	0	11	168
26082	16736s (+0.9s)	4028	4028	256	79	230	0	21	330
26083	16736s (+0.4s)	1292	1292	128	22	102	0	6	130
26084	16737s (+0.9s)	3720	3720	256	58	247	0	8	313
26085	16738s (+0.5s)	1628	1628	128	32	130	0	7	169
26086	16738s (+0.8s)	2968	2968	256	55	198	0	10	263
26087	16739s (+0.4s)	1196	1196	128	25	99	1	3	128
26088	16740s (+0.8s)	3684	3684	256	57	238	0	9	304
26089	16740s (+0.4s)	1364	1364	128	29	107	0	6	142
26090	16741s (+0.7s)	3180	3180	256	48	203	0	12	263
26091	16741s (+0.5s)	1712	1712	128	38	128	0	10	176
26092	16742s (+0.6s)	2804	2804	256	47	173	0	7	227
26093	16742s (+0.5s)	1756	1756	128	32	140	0	7	179
26094	16743s (+0.6s)	2528	2528	256	45	161	0	14	220
26095	16744s (+0.8s)	3560	3560	256	60	227	0	17	304
26096	16744s (+0.3s)	1132	1132	128	24	95	3	0	122
26097	16745s (+0.4s)	1164	1164	64	29	102	7	1	139
26098	16745s (+0.7s)	2872	2872	256	60	169	12	0	241
26099	16746s (+0.7s)	3180	3180	256	60	195	8	0	263
Episode	Time	Reward	Score	Highest	L	U	R	D	Steps
26100	16747s (+0.9s)	3688	3688	256	79	216	14	0	309
26101	16748s (+0.7s)	2736	2736	256	47	179	6	0	232
26102	16749s (+1.1s)	5536	5536	512	110	265	20	0	395
26103	16750s (+0.8s)	3224	3224	256	69	187	13	0	269
26104	16750s (+0.8s)	3512	3512	256	99	186	12	0	297
26105	16751s (+0.7s)	2916	2916	256	59	186	10	0	255
26106	16752s (+0.6s)	1936	1936	128	45	150	7	0	202
26107	16752s (+0.5s)	1656	1656	128	43	116	10	0	169
26108	16753s (+1.0s)	4320	4320	256	86	251	22	0	359
26109	16754s (+0.5s)	1836	1836	128	53	121	12	0	186
26110	16755s (+1.0s)	5108	5108	512	84	257	19	1	361
26111	16756s (+1.0s)	5240	5240	512	109	243	17	0	369
26112	16756s (+0.5s)	1656	1656	128	41	118	8	0	167
26113	16757s (+0.6s)	2148	2148	128	53	144	15	0	212
26114	16757s (+0.4s)	1352	1352	128	36	95	7	0	138
26115	16758s (+0.9s)	4568	4568	512	69	226	12	1	308
26116	16759s (+0.5s)	1848	1848	128	61	110	14	1	186
26117	16759s (+0.3s)	692	692	64	22	64	5	0	91
26118	16760s (+0.6s)	2536	2536	256	47	159	11	0	217
26119	16760s (+0.7s)	2908	2908	256	76	162	15	0	253
26120	16761s (+0.9s)	4036	4036	256	82	240	10	0	332
26121	16762s (+0.4s)	1484	1484	128	43	99	12	0	154
26122	16763s (+0.9s)	3704	3704	256	80	212	21	0	313
26123	16763s (+0.6s)	2280	2280	256	45	143	6	0	194
26124	16764s (+0.6s)	2668	2668	256	50	166	10	0	226
26125	16765s (+0.7s)	2932	2932	256	55	180	9	0	244
26126	16765s (+0.3s)	968	968	64	26	89	0	6	121
26127	16765s (+0.3s)	752	752	64	15	79	0	4	98
26128	16765s (+0.3s)	772	772	64	23	75	7	0	105
26129	16766s (+0.5s)	1868	1868	128	62	115	13	0	190
26130	16767s (+0.6s)	2084	2084	128	51	141	13	0	205
26131	16767s (+0.5s)	1652	1652	128	39	116	12	0	167
26132	16768s (+0.5s)	1816	1816	128	46	133	9	0	188
26133	16768s (+0.8s)	3352	3352	256	72	190	12	0	274
26134	16769s (+0.4s)	1308	1308	128	30	96	0	10	136
26135	16770s (+0.9s)	4016	4016	256	89	222	20	0	331
26136	16771s (+0.9s)	3732	3732	256	86	215	14	0	315
26137	16772s (+1.3s)	6452	6452	512	127	304	24	0	455
26138	16773s (+1.0s)	4268	4268	256	100	232	21	0	353
26139	16773s (+0.5s)	1932	1932	128	47	130	9	0	186
26140	16774s (+0.6s)	2544	2544	256	64	144	8	0	216
26141	16775s (+0.5s)	1808	1808	128	45	134	8	0	187
26142	16775s (+0.5s)	1680	1680	128	43	120	9	0	172
26143	16776s (+1.1s)	5720	5720	512	113	267	25	0	405
26144	16777s (+0.4s)	1448	1448	128	36	109	8	0	153
26145	16777s (+0.5s)	1712	1712	128	48	121	5	1	175
26146	16778s (+0.6s)	2176	2176	128	45	148	11	0	204
26147	16778s (+0.4s)	1240	1240	64	36	103	6	0	145
26148	16779s (+0.9s)	4080	4080	256	97	216	15	0	328
26149	16780s (+0.6s)	2408	2408	128	47	166	12	1	226
26150	16781s (+0.8s)	3512	3512	256	65	213	8	1	287
26151	16781s (+0.8s)	3228	3228	256	60	202	9	0	271
26152	16782s (+0.6s)	2268	2268	256	39	148	8	0	195
26153	16783s (+0.7s)	3172	3172	256	70	178	13	0	261
26154	16784s (+0.9s)	3876	3876	256	101	211	16	0	328
26155	16784s (+0.5s)	1872	1872	128	47	135	9	0	191
26156	16785s (+0.7s)	2496	2496	128	47	178	11	0	236
26157	16785s (+0.5s)	1744	1744	128	40	131	4	0	175
26158	16786s (+0.6s)	2488	2488	256	47	155	12	0	214
26159	16787s (+0.9s)	3736	3736	256	78	213	13	1	305
26160	16787s (+0.6s)	2196	2196	128	58	138	13	0	209
26161	16788s (+0.4s)	1412	1412	128	40	89	13	0	142
26162	16789s (+0.9s)	3624	3624	256	84	207	12	0	303
26163	16789s (+0.6s)	2488	2488	256	50	161	3	0	214
26164	16790s (+0.3s)	976	976	64	28	82	4	0	114
26165	16791s (+0.9s)	3836	3836	256	87	224	14	0	325
26166	16791s (+0.4s)	1376	1376	128	32	106	6	0	144
26167	16792s (+0.7s)	2796	2796	256	57	173	12	0	242
26168	16793s (+0.9s)	3852	3852	256	77	225	11	1	314
26169	16793s (+0.4s)	1368	1368	128	33	97	7	0	137
26170	16793s (+0.3s)	908	908	64	38	74	6	0	118
26171	16794s (+0.5s)	1796	1796	128	51	120	13	0	184
26172	16794s (+0.6s)	2100	2100	128	61	143	7	0	211
26173	16795s (+0.4s)	1380	1380	128	26	115	4	0	145
26174	16795s (+0.4s)	1460	1460	128	31	112	8	2	153
26175	16796s (+0.3s)	800	800	64	26	75	5	0	106
26176	16796s (+0.5s)	1920	1920	128	43	149	6	0	198
26177	16797s (+0.7s)	2904	2904	256	65	158	14	1	238
26178	16797s (+0.6s)	2456	2456	256	46	158	7	0	211
26179	16798s (+0.9s)	3976	3976	256	79	228	14	0	321
26180	16799s (+0.8s)	2788	2788	128	72	179	12	0	263
26181	16800s (+0.6s)	2424	2424	256	60	137	10	0	207
26182	16800s (+0.5s)	1760	1760	128	58	107	11	1	177
26183	16801s (+1.2s)	5932	5932	512	79	321	0	18	418
26184	16802s (+0.6s)	2572	2572	256	36	177	0	6	219
26185	16803s (+0.8s)	3424	3424	256	54	218	0	15	287
26186	16803s (+0.5s)	1508	1508	128	25	130	0	5	160
26187	16804s (+0.4s)	1052	1052	64	33	84	0	10	127
26188	16804s (+0.3s)	716	716	64	16	78	0	2	96
26189	16805s (+0.8s)	3212	3212	256	59	197	0	11	267
26190	16805s (+0.5s)	1744	1744	128	30	138	0	7	175
26191	16806s (+0.6s)	2500	2500	256	45	163	9	0	217
26192	16807s (+0.7s)	2572	2572	128	64	159	19	0	242
26193	16807s (+0.7s)	2760	2760	256	54	172	12	0	238
26194	16808s (+0.7s)	2776	2776	256	63	162	16	0	241
26195	16809s (+0.6s)	2136	2136	128	61	134	10	0	205
26196	16809s (+0.9s)	4004	4004	256	86	213	17	1	317
26197	16810s (+0.5s)	1692	1692	128	37	127	5	0	169
26198	16811s (+0.7s)	2812	2812	256	57	176	12	0	245
26199	16811s (+0.4s)	1060	1060	64	37	89	3	0	129
Episode	Time	Reward	Score	Highest	L	U	R	D	Steps
26200	16811s (+0.4s)	1072	1072	64	37	87	7	0	131
26201	16812s (+0.3s)	1076	1076	128	24	84	6	0	114
26202	16812s (+0.5s)	1740	1740	128	46	132	7	0	185
26203	16813s (+0.8s)	3260	3260	256	70	197	11	0	278
26204	16814s (+0.9s)	4104	4104	256	86	229	17	0	332
26205	16814s (+0.4s)	1268	1268	128	28	96	4	0	128
26206	16815s (+0.6s)	1932	1932	128	46	146	9	0	201
26207	16816s (+0.5s)	1616	1616	128	36	127	7	0	170
26208	16816s (+0.5s)	1732	1732	128	44	125	7	0	176
26209	16817s (+0.6s)	1952	1952	128	54	143	4	0	201
26210	16817s (+0.7s)	2964	2964	256	61	189	12	0	262
26211	16818s (+0.7s)	2924	2924	256	64	183	10	0	257
26212	16819s (+0.5s)	2216	2216	256	44	135	8	0	187
26213	16819s (+0.6s)	2584	2584	256	46	167	8	0	221
26214	16820s (+0.4s)	1452	1452	128	35	113	4	0	152
26215	16820s (+0.4s)	1268	1268	128	36	86	7	1	130
26216	16821s (+0.5s)	1936	1936	128	51	137	7	1	196
26217	16821s (+0.9s)	3600	3600	256	72	216	14	0	302
26218	16822s (+0.6s)	1904	1904	128	49	141	4	0	194
26219	16822s (+0.4s)	1168	1168	128	33	88	4	0	125
26220	16823s (+0.6s)	2372	2372	256	57	143	5	0	205
26221	16824s (+0.8s)	3284	3284	256	66	193	13	0	272
26222	16825s (+0.8s)	3320	3320	256	69	197	11	0	277
26223	16825s (+0.8s)	3400	3400	256	78	195	19	0	292
26224	16826s (+0.5s)	1508	1508	128	33	120	4	0	157
26225	16827s (+0.9s)	3856	3856	256	90	213	15	0	318
26226	16827s (+0.4s)	1316	1316	64	46	94	8	1	149
26227	16828s (+0.4s)	1176	1176	128	26	98	3	0	127
26228	16828s (+0.7s)	3288	3288	256	58	192	13	1	264
26229	16829s (+0.5s)	1528	1528	64	48	114	8	0	170
26230	16830s (+0.8s)	3288	3288	256	60	202	12	1	275
26231	16830s (+0.4s)	1068	1068	64	40	82	5	0	127
26232	16830s (+0.5s)	2064	2064	128	54	124	10	0	188
26233	16831s (+0.4s)	1516	1516	128	47	105	5	0	157
26234	16831s (+0.4s)	1164	1164	128	23	98	0	4	125
26235	16832s (+0.7s)	3044	3044	256	48	188	0	13	249
26236	16832s (+0.3s)	708	708	64	11	78	0	5	94
26237	16833s (+0.4s)	1424	1424	128	33	109	0	6	148
26238	16833s (+0.5s)	1804	1804	128	45	132	8	0	185
26239	16834s (+0.5s)	1644	1644	128	52	106	8	0	166
26240	16834s (+0.4s)	1424	1424	128	27	112	7	0	146
26241	16835s (+0.5s)	1732	1732	128	32	138	5	0	175
26242	16835s (+0.8s)	3380	3380	256	65	205	13	1	284
26243	16836s (+0.6s)	2460	2460	256	52	153	6	0	211
26244	16837s (+1.0s)	5032	5032	512	74	268	13	0	355
26245	16838s (+1.0s)	4236	4236	256	83	253	14	0	350
26246	16839s (+0.4s)	1416	1416	128	33	107	5	0	145
26247	16840s (+1.0s)	4336	4336	256	92	250	20	0	362
26248	16840s (+0.7s)	2600	2600	128	71	160	13	1	245
26249	16841s (+0.8s)	3432	3432	256	70	202	16	1	289
26250	16842s (+0.9s)	3964	3964	256	71	242	12	0	325
26251	16842s (+0.2s)	472	472	64	15	52	2	0	69
26252	16843s (+0.4s)	1212	1212	128	29	98	4	0	131
26253	16843s (+0.5s)	1676	1676	128	44	117	9	0	170
26254	16844s (+0.5s)	1612	1612	128	47	116	7	0	170
26255	16844s (+0.5s)	1584	1584	128	40	114	5	1	160
26256	16845s (+0.5s)	1732	1732	128	46	120	7	0	173
26257	16846s (+1.0s)	4300	4300	256	84	251	18	0	353
26258	16846s (+0.4s)	1476	1476	128	39	109	5	0	153
26259	16846s (+0.5s)	1552	1552	128	33	126	8	0	167
26260	16847s (+0.3s)	792	792	64	21	83	2	0	106
26261	16848s (+0.8s)	3352	3352	256	60	210	10	0	280
26262	16848s (+0.6s)	2336	2336	128	49	156	13	0	218
26263	16849s (+0.4s)	1360	1360	128	33	99	9	0	141
26264	16849s (+0.7s)	3220	3220	256	64	198	6	0	268
26265	16850s (+0.3s)	744	744	64	36	55	8	0	99
26266	16850s (+0.5s)	1664	1664	128	42	117	12	0	171
26267	16851s (+0.8s)	3452	3452	256	74	205	14	0	293
26268	16852s (+0.6s)	2608	2608	256	47	155	14	0	216
26269	16853s (+1.1s)	5780	5780	512	99	275	18	0	392
26270	16853s (+0.5s)	1488	1488	128	33	114	8	0	155
26271	16854s (+0.5s)	1860	1860	128	41	136	10	1	188
26272	16855s (+1.2s)	5780	5780	512	100	289	22	0	411
26273	16855s (+0.5s)	1780	1780	128	46	127	7	0	180
26274	16856s (+0.8s)	3356	3356	256	71	196	14	0	281
26275	16857s (+0.6s)	2716	2716	256	57	163	13	0	233
26276	16858s (+0.8s)	3496	3496	256	61	217	0	15	293
26277	16858s (+0.5s)	1700	1700	128	33	137	0	6	176
26278	16859s (+0.8s)	3388	3388	256	59	216	0	13	288
26279	16860s (+0.8s)	3668	3668	256	57	229	0	15	301
26280	16861s (+0.7s)	2716	2716	256	41	178	0	10	229
26281	16861s (+0.7s)	2540	2540	128	48	180	1	12	241
26282	16862s (+0.3s)	1016	1016	64	23	90	0	5	118
26283	16863s (+1.0s)	4332	4332	256	94	251	17	0	362
26284	16863s (+0.5s)	1856	1856	128	42	136	9	0	187
26285	16864s (+0.5s)	1752	1752	128	36	132	10	0	178
26286	16864s (+0.8s)	3220	3220	256	63	190	0	15	268
26287	16865s (+0.3s)	1120	1120	128	26	88	0	6	120
26288	16866s (+0.9s)	3936	3936	256	74	235	0	14	323
26289	16866s (+0.2s)	396	396	32	9	53	0	4	66
26290	16866s (+0.5s)	1676	1676	128	37	129	4	0	170
26291	16867s (+0.9s)	3924	3924	256	83	223	14	0	320
26292	16868s (+0.6s)	2160	2160	128	47	142	12	0	201
26293	16869s (+0.8s)	3476	3476	256	69	210	13	0	292
26294	16870s (+1.2s)	5840	5840	512	114	284	23	0	421
26295	16870s (+0.5s)	1840	1840	128	43	136	8	0	187
26296	16871s (+0.8s)	3468	3468	256	63	212	10	1	286
26297	16872s (+0.5s)	1556	1556	128	45	108	7	1	161
26298	16872s (+0.7s)	2776	2776	256	66	164	11	1	242
26299	16873s (+0.4s)	1440	1440	128	32	112	5	0	149
Episode	Time	Reward	Score	Highest	L	U	R	D	Steps
26300	16874s (+0.8s)	3412	3412	256	66	215	10	0	291
26301	16874s (+0.4s)	1484	1484	128	47	101	6	0	154
26302	16875s (+0.8s)	3688	3688	256	73	209	15	1	298
26303	16876s (+0.9s)	3984	3984	256	98	213	19	0	330
26304	16876s (+0.4s)	1400	1400	128	40	94	5	0	139
26305	16877s (+0.4s)	1308	1308	128	30	99	9	0	138
26306	16877s (+0.5s)	1800	1800	128	59	116	10	0	185
26307	16878s (+0.5s)	1892	1892	128	48	122	0	13	183
26308	16878s (+0.5s)	1872	1872	128	45	135	7	0	187
26309	16879s (+0.9s)	3924	3924	256	67	238	0	14	319
26310	16880s (+0.5s)	1664	1664	128	36	123	10	0	169
26311	16881s (+0.9s)	3532	3532	256	67	212	23	0	302
26312	16881s (+0.7s)	3068	3068	256	56	180	13	0	249
26313	16882s (+0.4s)	1356	1356	128	32	98	10	0	140
26314	16883s (+0.9s)	4168	4168	256	87	234	16	0	337
26315	16883s (+0.4s)	1104	1104	64	26	99	0	4	129
26316	16884s (+0.5s)	1712	1712	128	28	135	0	7	170
26317	16884s (+0.2s)	584	584	64	11	68	4	0	83
26318	16885s (+0.9s)	3552	3552	256	74	213	16	0	303
26319	16885s (+0.7s)	3040	3040	256	44	203	0	9	256
26320	16886s (+1.1s)	4396	4396	256	98	252	18	0	368
26321	16887s (+0.3s)	828	828	64	28	71	5	0	104
26322	16888s (+0.8s)	3348	3348	256	54	216	9	0	279
26323	16889s (+1.0s)	4324	4324	256	96	236	23	0	355
26324	16889s (+0.8s)	3540	3540	256	82	205	12	1	300
26325	16890s (+0.7s)	2924	2924	256	66	179	12	0	257
26326	16891s (+0.7s)	3148	3148	256	53	202	0	9	264
26327	16892s (+0.6s)	2516	2516	256	44	169	0	7	220
26328	16892s (+0.9s)	4084	4084	256	84	225	18	1	328
26329	16893s (+0.5s)	1808	1808	128	43	135	9	0	187
26330	16894s (+0.5s)	1760	1760	128	56	114	10	0	180
26331	16895s (+1.1s)	4612	4612	256	102	266	19	0	387
26332	16895s (+0.4s)	1228	1228	64	51	92	6	0	149
26333	16895s (+0.4s)	1336	1336	128	49	84	7	0	140
26334	16896s (+0.4s)	1336	1336	64	42	96	8	0	146
26335	16896s (+0.3s)	660	660	64	18	67	4	1	90
26336	16897s (+0.8s)	3280	3280	256	55	213	0	10	278
26337	16897s (+0.5s)	2200	2200	256	41	141	0	8	190
26338	16898s (+0.6s)	2656	2656	256	54	165	0	10	229
26339	16899s (+0.4s)	1424	1424	128	31	108	0	5	144
26340	16899s (+0.7s)	2800	2800	256	54	172	0	12	238
26341	16900s (+0.5s)	1552	1552	128	25	129	0	7	161
26342	16901s (+0.8s)	3280	3280	256	59	204	0	15	278
26343	16901s (+0.3s)	948	948	64	26	77	0	8	111
26344	16901s (+0.6s)	2532	2532	256	45	160	0	9	214
26345	16902s (+0.9s)	3836	3836	256	60	236	0	14	310
26346	16903s (+0.4s)	1340	1340	128	25	111	0	5	141
26347	16904s (+0.8s)	3308	3308	256	56	208	0	10	274
26348	16904s (+0.6s)	2028	2028	128	37	146	0	12	195
26349	16905s (+0.5s)	1780	1780	128	46	131	9	0	186
26350	16905s (+0.4s)	1492	1492	128	33	118	6	0	157
26351	16906s (+1.0s)	4128	4128	256	84	237	18	0	339
26352	16907s (+0.4s)	1500	1500	128	41	113	4	0	158
26353	16908s (+1.0s)	4340	4340	256	99	239	17	0	355
26354	16908s (+0.4s)	1308	1308	128	31	103	6	0	140
26355	16908s (+0.5s)	1688	1688	128	44	121	8	0	173
26356	16909s (+0.8s)	3552	3552	256	72	216	14	0	302
26357	16910s (+0.5s)	1704	1704	128	53	114	6	0	173
26358	16911s (+0.8s)	3484	3484	256	89	192	15	1	297
26359	16911s (+0.6s)	1952	1952	128	60	135	6	0	201
26360	16912s (+0.4s)	1476	1476	128	37	108	6	1	152
26361	16913s (+0.9s)	3660	3660	256	95	208	10	0	313
26362	16913s (+0.9s)	4640	4640	512	69	236	15	1	321
26363	16914s (+0.4s)	1444	1444	128	30	112	8	0	150
26364	16915s (+0.8s)	3216	3216	256	66	191	11	1	269
26365	16916s (+0.9s)	3748	3748	256	93	209	17	0	319
26366	16917s (+0.9s)	4036	4036	256	90	222	16	0	328
26367	16917s (+0.8s)	3436	3436	256	64	215	11	0	290
26368	16918s (+0.4s)	1292	1292	128	29	103	7	0	139
26369	16918s (+0.7s)	3172	3172	256	66	183	11	0	260
26370	16919s (+0.5s)	1872	1872	128	51	121	9	0	181
26371	16920s (+0.9s)	3980	3980	256	83	225	14	0	322
26372	16920s (+0.6s)	2060	2060	128	58	130	13	0	201
26373	16921s (+0.6s)	2656	2656	256	50	165	9	0	224
26374	16922s (+0.7s)	2852	2852	256	70	164	10	0	244
26375	16923s (+0.8s)	3252	3252	256	63	200	13	0	276
26376	16924s (+1.0s)	4948	4948	512	90	236	12	0	338
26377	16925s (+1.0s)	4328	4328	256	96	245	15	0	356
26378	16925s (+0.6s)	1864	1864	128	41	149	6	0	196
26379	16926s (+0.9s)	3724	3724	256	80	215	14	0	309
26380	16927s (+0.5s)	1940	1940	128	44	140	12	0	196
26381	16927s (+0.3s)	900	900	64	34	81	1	0	116
26382	16928s (+0.6s)	2420	2420	128	66	149	13	0	228
26383	16928s (+0.7s)	2612	2612	256	45	175	0	8	228
26384	16929s (+0.5s)	1624	1624	128	27	131	0	6	164
26385	16929s (+0.7s)	2888	2888	256	59	181	0	9	249
26386	16930s (+0.5s)	1792	1792	128	41	136	0	6	183
26387	16930s (+0.5s)	1716	1716	128	48	120	4	2	174
26388	16931s (+0.9s)	3640	3640	256	86	203	19	0	308
26389	16932s (+0.6s)	2552	2552	256	56	150	12	0	218
26390	16933s (+0.8s)	3288	3288	256	88	177	15	0	280
26391	16934s (+1.0s)	4484	4484	256	102	243	22	0	367
26392	16934s (+0.6s)	2232	2232	128	44	158	10	1	213
26393	16935s (+0.5s)	1992	1992	128	46	142	7	0	195
26394	16936s (+0.7s)	2848	2848	256	62	160	11	1	234
26395	16937s (+1.1s)	4656	4656	256	115	249	22	0	386
26396	16937s (+0.5s)	1676	1676	128	32	121	10	1	164
26397	16938s (+0.5s)	1532	1532	128	36	122	4	0	162
26398	16939s (+0.8s)	3540	3540	256	77	194	13	0	284
26399	16940s (+1.1s)	5696	5696	512	99	281	21	0	401
Episode	Time	Reward	Score	Highest	L	U	R	D	Steps
26400	16940s (+0.6s)	2748	2748	256	45	182	8	0	235
26401	16941s (+0.5s)	1592	1592	128	47	108	9	1	165
26402	16942s (+0.8s)	3192	3192	256	77	172	17	0	266
26403	16942s (+0.4s)	1572	1572	128	47	104	4	0	155
26404	16943s (+0.9s)	3540	3540	256	78	210	11	0	299
26405	16943s (+0.4s)	1520	1520	128	42	107	10	0	159
26406	16944s (+0.7s)	2848	2848	256	64	176	9	1	250
26407	16945s (+0.8s)	3224	3224	256	63	194	11	0	268
26408	16946s (+0.9s)	3852	3852	256	76	220	17	0	313
26409	16947s (+1.0s)	4232	4232	256	92	242	19	0	353
26410	16947s (+0.5s)	1724	1724	128	37	132	12	0	181
26411	16948s (+0.4s)	1460	1460	128	41	104	9	0	154
26412	16948s (+0.4s)	1316	1316	64	31	107	11	0	149
26413	16949s (+0.7s)	2784	2784	256	61	167	9	0	237
26414	16950s (+1.0s)	4276	4276	256	92	240	17	0	349
26415	16950s (+0.5s)	2132	2132	256	53	116	9	0	178
26416	16951s (+1.0s)	5368	5368	512	77	281	16	0	374
26417	16952s (+0.7s)	2704	2704	256	54	162	11	0	227
26418	16953s (+0.5s)	1864	1864	128	44	132	10	0	186
26419	16953s (+0.7s)	2840	2840	256	64	165	13	0	242
26420	16954s (+0.6s)	2540	2540	256	48	158	9	0	215
26421	16954s (+0.7s)	2724	2724	256	55	159	16	0	230
26422	16955s (+0.7s)	3212	3212	256	67	187	13	0	267
26423	16956s (+0.6s)	2328	2328	256	54	138	9	0	201
26424	16956s (+0.6s)	2460	2460	256	52	149	8	0	209
26425	16957s (+0.7s)	3184	3184	256	65	189	11	0	265
26426	16958s (+0.7s)	2720	2720	256	51	172	7	0	230
26427	16958s (+0.5s)	1728	1728	128	36	129	7	1	173
26428	16959s (+0.4s)	1460	1460	128	44	102	7	0	153
26429	16960s (+1.0s)	4348	4348	256	96	243	22	0	361
26430	16961s (+0.9s)	3980	3980	256	94	214	21	0	329
26431	16962s (+1.0s)	4256	4256	256	95	242	17	0	354
26432	16962s (+0.6s)	2672	2672	256	50	166	11	0	227
26433	16963s (+0.3s)	812	812	64	33	71	6	0	110
26434	16963s (+0.7s)	2616	2616	128	52	187	9	0	248
26435	16964s (+0.7s)	2848	2848	256	62	171	14	0	247
26436	16965s (+0.8s)	3316	3316	256	70	191	12	2	275
26437	16966s (+0.8s)	3252	3252	256	60	200	9	0	269
26438	16966s (+0.7s)	2496	2496	128	73	144	11	0	228
26439	16967s (+0.6s)	2308	2308	128	52	153	11	1	217
26440	16967s (+0.5s)	1632	1632	128	43	114	6	1	164
26441	16968s (+0.8s)	3432	3432	256	73	202	13	0	288
26442	16969s (+0.8s)	3320	3320	256	81	182	11	0	274
26443	16970s (+0.6s)	2204	2204	128	43	165	3	0	211
26444	16970s (+0.6s)	1968	1968	128	53	145	7	0	205
26445	16971s (+0.8s)	3464	3464	256	81	188	16	0	285
26446	16972s (+0.9s)	3812	3812	256	76	214	15	0	305
26447	16972s (+0.3s)	776	776	64	25	72	5	0	102
26448	16973s (+0.5s)	2232	2232	256	36	138	10	0	184
26449	16973s (+0.7s)	2804	2804	256	41	184	9	0	234
26450	16974s (+0.7s)	3164	3164	256	69	177	13	0	259
26451	16975s (+0.5s)	1740	1740	128	50	118	7	0	175
26452	16975s (+0.4s)	1116	1116	64	30	98	3	0	131
26453	16975s (+0.4s)	1336	1336	64	34	107	5	1	147
26454	16976s (+0.7s)	2928	2928	256	50	182	11	0	243
26455	16977s (+1.0s)	4196	4196	256	94	222	25	0	341
26456	16978s (+1.1s)	5416	5416	512	96	260	22	0	378
26457	16979s (+1.0s)	4084	4084	256	77	251	15	0	343
26458	16979s (+0.3s)	876	876	64	25	83	6	0	114
26459	16980s (+0.9s)	3912	3912	256	66	237	14	0	317
26460	16981s (+0.5s)	1784	1784	128	43	126	12	0	181
26461	16981s (+0.4s)	1088	1088	64	40	87	8	0	135
26462	16982s (+0.5s)	1748	1748	128	45	125	8	0	178
26463	16983s (+1.0s)	4176	4176	256	87	235	16	1	339
26464	16983s (+0.5s)	1520	1520	128	34	117	7	1	159
26465	16984s (+0.5s)	1776	1776	128	43	131	5	0	179
26466	16984s (+0.5s)	1588	1588	128	38	120	6	0	164
26467	16985s (+0.6s)	1940	1940	128	41	155	7	0	203
26468	16985s (+0.6s)	2272	2272	128	50	156	6	0	212
26469	16986s (+0.8s)	3232	3232	256	67	191	13	1	272
26470	16987s (+0.6s)	2300	2300	128	51	160	8	0	219
26471	16988s (+0.8s)	3284	3284	256	72	180	19	1	272
26472	16988s (+0.8s)	3228	3228	256	59	203	9	0	271
26473	16989s (+0.7s)	2880	2880	256	77	151	16	0	244
26474	16990s (+0.5s)	1792	1792	128	50	123	5	0	178
26475	16990s (+0.6s)	1976	1976	128	55	130	15	0	200
26476	16991s (+0.8s)	3324	3324	256	61	203	0	14	278
26477	16992s (+0.8s)	3704	3704	256	78	218	0	8	304
26478	16993s (+0.8s)	3356	3356	256	56	211	0	18	285
26479	16993s (+0.7s)	2792	2792	256	53	175	0	14	242
26480	16994s (+0.5s)	2008	2008	128	36	143	0	10	189
26481	16994s (+0.2s)	496	496	32	13	60	0	2	75
26482	16995s (+0.6s)	2616	2616	256	48	158	0	13	219
26483	16995s (+0.7s)	2784	2784	256	54	177	0	9	240
26484	16996s (+0.5s)	1812	1812	128	41	140	0	7	188
26485	16997s (+0.9s)	3716	3716	256	70	229	0	17	316
26486	16998s (+1.0s)	4216	4216	256	80	245	19	0	344
26487	16998s (+0.5s)	1820	1820	128	52	126	7	0	185
26488	16999s (+0.4s)	1500	1500	128	43	105	10	0	158
26489	17000s (+0.8s)	3144	3144	256	77	175	16	2	270
26490	17000s (+0.6s)	1908	1908	128	53	134	8	0	195
26491	17001s (+0.6s)	2212	2212	128	68	143	12	0	223
26492	17001s (+0.6s)	2560	2560	256	53	159	9	0	221
26493	17002s (+0.6s)	2480	2480	128	68	153	11	0	232
26494	17003s (+0.9s)	3548	3548	256	60	232	0	9	301
26495	17003s (+0.6s)	1940	1940	128	40	149	0	10	199
26496	17004s (+0.5s)	1796	1796	128	31	147	0	6	184
26497	17005s (+0.5s)	1792	1792	128	35	138	0	10	183
26498	17005s (+0.6s)	2584	2584	256	54	156	11	0	221
26499	17006s (+0.4s)	1360	1360	128	29	107	6	0	142
Episode	Time	Reward	Score	Highest	L	U	R	D	Steps
26500	17006s (+0.7s)	2932	2932	256	63	183	13	0	259
26501	17007s (+0.5s)	1788	1788	128	44	127	10	1	182
26502	17007s (+0.3s)	1032	1032	128	20	87	4	0	111
26503	17008s (+0.5s)	1904	1904	128	55	124	13	0	192
26504	17009s (+0.9s)	4312	4312	256	82	228	20	2	332
26505	17009s (+0.4s)	1384	1384	128	29	110	7	0	146
26506	17010s (+0.6s)	2512	2512	256	48	156	12	0	216
26507	17010s (+0.4s)	1552	1552	128	29	113	0	10	152
26508	17011s (+0.8s)	3544	3544	256	60	227	0	13	300
26509	17012s (+0.8s)	3528	3528	256	49	231	0	16	296
26510	17012s (+0.5s)	1768	1768	128	37	137	0	8	182
26511	17013s (+0.4s)	1424	1424	128	23	116	0	5	144
26512	17013s (+0.5s)	1828	1828	128	47	134	0	10	191
26513	17014s (+0.5s)	1800	1800	128	36	136	0	14	186
26514	17014s (+0.5s)	1644	1644	128	44	110	9	0	163
26515	17015s (+0.9s)	3920	3920	256	79	238	14	0	331
26516	17016s (+0.8s)	3632	3632	256	62	225	9	0	296
26517	17017s (+1.2s)	5844	5844	512	106	292	24	0	422
26518	17018s (+0.8s)	2964	2964	256	64	189	9	0	262
26519	17018s (+0.2s)	428	428	64	15	46	2	0	63
26520	17019s (+0.3s)	920	920	64	33	77	10	0	120
26521	17019s (+0.8s)	3236	3236	256	62	198	11	1	272
26522	17020s (+0.4s)	1308	1308	128	28	111	4	0	143
26523	17021s (+0.8s)	3528	3528	256	61	218	16	2	297
26524	17021s (+0.4s)	1260	1260	64	38	102	6	1	147
26525	17022s (+0.7s)	2528	2528	128	61	155	16	1	233
26526	17023s (+0.6s)	2672	2672	256	65	151	11	1	228
26527	17023s (+0.7s)	3172	3172	256	69	181	11	0	261
26528	17024s (+1.0s)	4288	4288	256	90	248	19	0	357
26529	17025s (+0.4s)	1424	1424	128	30	109	4	2	145
26530	17025s (+0.7s)	3076	3076	256	71	163	13	0	247
26531	17026s (+0.5s)	2372	2372	256	41	143	8	0	192
26532	17027s (+0.8s)	3524	3524	256	67	219	13	1	300
26533	17027s (+0.4s)	1288	1288	128	28	106	4	0	138
26534	17028s (+1.0s)	4216	4216	256	101	234	16	0	351
26535	17029s (+0.5s)	1716	1716	128	41	121	7	0	169
26536	17029s (+0.6s)	1912	1912	128	47	140	9	0	196
26537	17030s (+0.9s)	3580	3580	256	79	210	13	0	302
26538	17031s (+1.0s)	4112	4112	256	77	251	16	1	345
26539	17032s (+0.5s)	1828	1828	128	53	120	12	0	185
26540	17033s (+0.9s)	3612	3612	256	92	199	14	0	305
26541	17033s (+0.4s)	1228	1228	128	33	96	5	0	134
26542	17033s (+0.4s)	1084	1084	64	24	98	5	1	128
26543	17034s (+0.7s)	2900	2900	256	41	199	0	13	253
26544	17035s (+0.6s)	2452	2452	256	40	159	0	6	205
26545	17035s (+0.7s)	2872	2872	256	66	165	18	0	249
26546	17036s (+0.4s)	1408	1408	128	31	111	6	0	148
26547	17036s (+0.5s)	1812	1812	128	59	121	8	0	188
26548	17037s (+0.7s)	3196	3196	256	71	187	9	0	267
26549	17037s (+0.3s)	796	796	64	28	72	6	0	106
26550	17038s (+0.8s)	3456	3456	256	65	212	10	1	288
26551	17039s (+0.7s)	2772	2772	256	53	172	15	1	241
26552	17039s (+0.3s)	720	720	64	24	68	2	0	94
26553	17040s (+0.7s)	3120	3120	256	55	196	9	0	260
26554	17041s (+1.0s)	5128	5128	512	98	255	12	1	366
26555	17042s (+0.9s)	3684	3684	256	75	211	18	0	304
26556	17042s (+0.4s)	1216	1216	64	33	110	0	3	146
26557	17043s (+0.4s)	1384	1384	128	24	111	0	5	140
26558	17043s (+0.7s)	3208	3208	256	57	197	0	12	266
26559	17044s (+0.7s)	3208	3208	256	55	202	0	9	266
26560	17045s (+0.9s)	3952	3952	256	78	227	0	17	322
26561	17045s (+0.2s)	472	472	32	21	50	0	3	74
26562	17046s (+0.4s)	1484	1484	128	28	119	0	8	155
26563	17047s (+1.1s)	5648	5648	512	79	297	0	20	396
26564	17047s (+0.5s)	1628	1628	128	36	128	0	10	174
26565	17048s (+0.5s)	1796	1796	128	38	137	10	0	185
26566	17049s (+0.9s)	3836	3836	256	77	237	11	0	325
26567	17049s (+0.5s)	1516	1516	128	35	120	7	0	162
26568	17050s (+0.7s)	3068	3068	256	66	169	18	0	253
26569	17050s (+0.5s)	1612	1612	128	42	113	5	0	160
26570	17051s (+0.5s)	1864	1864	128	44	131	9	0	184
26571	17051s (+0.5s)	1772	1772	128	48	118	12	0	178
26572	17052s (+0.5s)	1716	1716	128	48	115	10	0	173
26573	17053s (+0.9s)	3644	3644	256	90	199	20	0	309
26574	17053s (+0.5s)	1732	1732	128	28	141	0	5	174
26575	17054s (+0.5s)	1648	1648	128	30	132	0	5	167
26576	17054s (+0.4s)	1548	1548	128	29	121	0	6	156
26577	17055s (+0.5s)	1628	1628	128	36	129	0	6	171
26578	17055s (+0.6s)	2412	2412	256	48	149	0	10	207
26579	17056s (+1.0s)	4248	4248	256	77	253	0	22	352
26580	17057s (+0.5s)	1496	1496	128	37	112	8	1	158
26581	17058s (+0.6s)	2432	2432	128	64	153	14	0	231
26582	17058s (+0.7s)	3064	3064	256	78	172	10	1	261
26583	17059s (+0.4s)	1280	1280	128	26	109	3	0	138
26584	17059s (+0.8s)	3204	3204	256	58	194	17	0	269
26585	17060s (+0.9s)	4012	4012	256	88	234	10	1	333
26586	17061s (+0.8s)	3500	3500	256	72	206	16	0	294
26587	17062s (+0.9s)	3836	3836	256	91	200	20	0	311
26588	17063s (+0.5s)	2308	2308	256	46	142	4	0	192
26589	17063s (+0.6s)	2356	2356	256	46	140	14	1	201
26590	17064s (+0.4s)	1220	1220	128	39	87	6	1	133
26591	17064s (+0.4s)	1208	1208	128	33	95	0	6	134
26592	17065s (+0.5s)	1724	1724	128	39	133	0	6	178
26593	17065s (+0.3s)	680	680	32	18	77	0	4	99
26594	17066s (+0.9s)	3576	3576	256	49	245	0	14	308
26595	17066s (+0.7s)	3104	3104	256	48	196	0	12	256
26596	17067s (+0.8s)	3408	3408	256	61	207	0	16	284
26597	17068s (+0.3s)	892	892	64	22	93	0	4	119
26598	17068s (+0.5s)	1712	1712	128	29	136	0	5	170
26599	17068s (+0.3s)	916	916	64	21	85	0	5	111
Episode	Time	Reward	Score	Highest	L	U	R	D	Steps
26600	17069s (+0.7s)	2916	2916	256	50	184	0	8	242
26601	17070s (+0.5s)	1900	1900	128	43	144	0	7	194
26602	17070s (+0.5s)	1668	1668	128	43	119	6	0	168
26603	17071s (+0.5s)	1820	1820	128	45	140	4	0	189
26604	17071s (+0.3s)	760	760	64	24	73	5	0	102
26605	17071s (+0.5s)	1892	1892	128	43	138	10	0	191
26606	17072s (+0.5s)	1648	1648	128	41	127	0	7	175
26607	17073s (+0.8s)	3204	3204	256	55	199	0	14	268
26608	17073s (+0.2s)	476	476	32	15	58	0	1	74
26609	17074s (+0.9s)	3728	3728	256	72	213	0	13	298
26610	17075s (+0.8s)	3632	3632	256	61	219	0	15	295
26611	17075s (+0.4s)	1160	1160	64	25	107	0	6	138
26612	17075s (+0.4s)	1328	1328	128	25	103	0	8	136
26613	17076s (+0.7s)	2772	2772	256	56	178	0	3	237
26614	17077s (+0.6s)	2576	2576	256	49	169	0	8	226
26615	17077s (+0.6s)	2388	2388	256	36	161	0	8	205
26616	17078s (+0.4s)	1124	1124	64	30	93	0	7	130
26617	17078s (+0.5s)	1812	1812	128	38	138	0	9	185
26618	17079s (+0.6s)	2052	2052	128	45	138	0	17	200
26619	17079s (+0.3s)	696	696	64	15	73	0	4	92
26620	17080s (+0.5s)	1576	1576	128	42	113	7	0	162
26621	17080s (+0.8s)	3240	3240	256	74	180	19	1	274
26622	17081s (+1.0s)	4344	4344	256	91	255	18	0	364
26623	17082s (+0.5s)	1696	1696	128	45	121	9	0	175
26624	17083s (+1.3s)	6500	6500	512	130	313	23	1	467
26625	17084s (+0.8s)	3432	3432	256	68	204	17	0	289
26626	17085s (+0.4s)	1524	1524	128	45	102	11	0	158
26627	17085s (+0.5s)	1568	1568	128	46	108	10	0	164
26628	17086s (+0.7s)	2848	2848	256	55	176	12	0	243
26629	17087s (+0.8s)	3696	3696	256	67	215	11	0	293
26630	17087s (+0.6s)	2368	2368	256	44	150	6	0	200
26631	17088s (+0.4s)	1432	1432	128	41	99	6	0	146
26632	17088s (+0.7s)	3168	3168	256	72	177	10	0	259
26633	17089s (+0.4s)	1332	1332	128	35	103	10	0	148
26634	17089s (+0.7s)	3136	3136	256	68	178	10	0	256
26635	17090s (+0.5s)	1896	1896	128	51	129	12	0	192
26636	17091s (+0.5s)	1620	1620	128	39	126	7	0	172
26637	17091s (+0.8s)	3564	3564	256	65	217	16	0	298
26638	17092s (+0.6s)	2172	2172	128	56	155	7	0	218
26639	17092s (+0.3s)	760	760	64	29	70	4	0	103
26640	17093s (+0.9s)	3824	3824	256	95	211	12	0	318
26641	17094s (+0.8s)	3260	3260	256	63	206	9	0	278
26642	17095s (+0.7s)	2952	2952	256	65	183	11	0	259
26643	17096s (+1.0s)	4328	4328	256	89	251	16	0	356
26644	17097s (+1.1s)	5688	5688	512	98	285	21	0	404
26645	17097s (+0.5s)	1688	1688	128	38	125	9	1	173
26646	17098s (+0.4s)	1164	1164	128	17	111	0	0	128
26647	17098s (+0.5s)	1880	1880	128	42	136	10	0	188
26648	17099s (+0.5s)	1684	1684	128	49	116	11	0	176
26649	17100s (+0.9s)	3672	3672	256	73	214	14	0	301
26650	17100s (+0.3s)	1112	1112	128	28	88	4	0	120
26651	17101s (+0.5s)	1836	1836	128	48	118	9	1	176
26652	17101s (+0.5s)	1848	1848	128	34	146	9	0	189
26653	17102s (+0.9s)	3716	3716	256	91	199	16	0	306
26654	17103s (+0.6s)	2612	2612	256	52	169	7	0	228
26655	17103s (+0.7s)	2864	2864	256	65	169	13	0	247
26656	17104s (+0.6s)	2148	2148	128	73	134	9	0	216
26657	17105s (+0.8s)	3528	3528	256	60	222	14	0	296
26658	17106s (+0.9s)	4856	4856	512	85	240	16	0	341
26659	17106s (+0.5s)	1796	1796	128	41	132	9	0	182
26660	17107s (+0.5s)	1672	1672	128	48	111	11	0	170
26661	17107s (+0.6s)	2556	2556	256	70	139	7	0	216
26662	17108s (+0.5s)	1636	1636	128	55	107	8	0	170
26663	17108s (+0.5s)	1772	1772	128	46	124	7	1	178
26664	17109s (+0.2s)	412	412	64	7	51	0	2	60
26665	17109s (+0.5s)	1900	1900	128	37	145	0	11	193
26666	17110s (+1.0s)	4456	4456	256	74	273	0	20	367
26667	17111s (+0.6s)	1904	1904	128	43	140	0	11	194
26668	17111s (+0.2s)	592	592	64	20	56	0	4	80
26669	17111s (+0.5s)	1572	1572	128	43	115	6	0	164
26670	17112s (+0.4s)	1436	1436	128	33	109	6	0	148
26671	17113s (+1.2s)	6136	6136	512	105	315	16	1	437
26672	17114s (+0.6s)	2512	2512	256	39	171	6	0	216
26673	17115s (+0.6s)	2612	2612	256	65	154	9	0	228
26674	17115s (+0.8s)	3592	3592	256	56	237	8	0	301
26675	17116s (+0.4s)	1368	1368	128	37	102	4	0	143
26676	17117s (+0.9s)	3684	3684	256	79	224	15	0	318
26677	17118s (+1.3s)	6428	6428	512	115	310	30	0	455
26678	17119s (+0.5s)	1800	1800	128	51	125	9	0	185
26679	17119s (+0.3s)	680	680	64	15	71	3	0	89
26680	17120s (+0.8s)	3244	3244	256	80	179	15	0	274
26681	17120s (+0.6s)	2120	2120	128	50	137	8	1	196
26682	17120s (+0.3s)	856	856	64	27	79	4	0	110
26683	17121s (+0.5s)	1588	1588	128	36	121	7	0	164
26684	17121s (+0.5s)	1896	1896	128	59	122	11	0	192
26685	17122s (+0.3s)	928	928	64	26	82	8	1	117
26686	17123s (+0.7s)	3028	3028	256	84	155	17	0	256
26687	17123s (+0.7s)	3128	3128	256	71	178	13	0	262
26688	17124s (+0.5s)	1688	1688	128	50	107	10	1	168
26689	17124s (+0.4s)	1420	1420	128	32	109	9	0	150
26690	17125s (+0.7s)	2756	2756	256	64	157	15	1	237
26691	17126s (+0.7s)	2604	2604	128	76	154	15	0	245
26692	17126s (+0.5s)	1836	1836	128	39	139	8	1	187
26693	17127s (+0.8s)	3312	3312	256	56	208	11	0	275
26694	17128s (+0.6s)	1992	1992	128	55	149	7	0	211
26695	17128s (+0.5s)	1732	1732	128	23	151	0	8	182
26696	17129s (+0.7s)	2892	2892	256	66	169	0	14	249
26697	17129s (+0.4s)	1500	1500	128	32	112	0	9	153
26698	17130s (+0.7s)	2596	2596	128	63	163	0	13	239
26699	17131s (+1.1s)	5380	5380	512	90	265	0	18	373
Episode	Time	Reward	Score	Highest	L	U	R	D	Steps
26700	17132s (+0.8s)	3220	3220	256	51	205	0	12	268
26701	17132s (+0.6s)	2340	2340	128	68	144	11	0	223
26702	17133s (+1.0s)	4140	4140	256	99	226	16	0	341
26703	17134s (+1.0s)	4224	4224	256	91	244	18	0	353
26704	17135s (+0.8s)	3288	3288	256	80	184	15	0	279
26705	17136s (+0.4s)	1344	1344	128	31	98	7	1	137
26706	17137s (+0.9s)	4072	4072	256	93	228	14	0	335
26707	17137s (+0.5s)	1644	1644	128	34	120	9	0	163
26708	17137s (+0.5s)	1640	1640	128	36	132	5	0	173
26709	17138s (+0.6s)	2396	2396	128	62	147	17	0	226
26710	17139s (+0.8s)	3500	3500	256	75	205	14	0	294
26711	17140s (+0.8s)	3404	3404	256	70	208	14	0	292
26712	17140s (+0.5s)	2240	2240	256	45	145	5	0	195
26713	17141s (+0.8s)	3212	3212	256	63	197	11	0	271
26714	17142s (+0.7s)	2504	2504	128	59	169	10	0	238
26715	17142s (+0.5s)	1564	1564	128	35	121	4	0	160
26716	17143s (+0.5s)	1852	1852	128	41	142	3	0	186
26717	17143s (+0.6s)	1944	1944	128	58	130	11	0	199
26718	17144s (+0.9s)	3628	3628	256	100	193	20	0	313
26719	17145s (+0.7s)	2852	2852	256	74	166	10	0	250
26720	17146s (+0.6s)	2596	2596	256	56	145	12	1	214
26721	17146s (+0.4s)	1448	1448	128	44	105	7	1	157
26722	17147s (+0.8s)	3308	3308	256	83	181	15	0	279
26723	17148s (+1.1s)	5512	5512	512	108	265	20	0	393
26724	17148s (+0.5s)	1800	1800	128	53	123	9	0	185
26725	17149s (+0.6s)	1920	1920	128	47	138	13	0	198
26726	17150s (+0.6s)	2472	2472	256	44	161	7	0	212
26727	17150s (+0.7s)	2728	2728	256	62	156	11	1	230
26728	17151s (+0.9s)	3532	3532	256	85	202	15	0	302
26729	17152s (+0.5s)	1792	1792	128	43	133	7	0	183
26730	17152s (+0.6s)	2280	2280	128	51	151	8	0	210
26731	17153s (+0.6s)	2124	2124	128	64	131	15	0	210
26732	17154s (+0.8s)	3488	3488	256	73	202	16	0	291
26733	17154s (+0.4s)	1372	1372	128	28	107	3	0	138
26734	17155s (+1.0s)	4076	4076	256	78	247	15	1	341
26735	17156s (+0.5s)	1620	1620	128	52	113	6	0	171
26736	17156s (+0.6s)	2280	2280	128	62	152	6	0	220
26737	17157s (+0.5s)	2000	2000	128	41	137	9	2	189
26738	17157s (+0.7s)	2648	2648	256	59	164	11	0	234
26739	17158s (+0.8s)	3140	3140	256	68	183	13	0	264
26740	17159s (+0.6s)	2420	2420	256	54	144	10	0	208
26741	17159s (+0.3s)	888	888	64	27	85	5	0	117
26742	17159s (+0.3s)	932	932	64	32	75	7	0	114
26743	17160s (+0.5s)	1612	1612	128	35	130	5	0	170
26744	17160s (+0.4s)	1152	1152	64	33	96	6	0	135
26745	17161s (+0.4s)	1176	1176	64	28	108	5	0	141
26746	17161s (+0.7s)	2464	2464	128	61	160	11	0	232
26747	17162s (+0.4s)	1296	1296	128	23	102	5	0	130
26748	17162s (+0.4s)	1464	1464	128	43	100	6	1	150
26749	17163s (+0.7s)	2780	2780	128	73	170	15	0	258
26750	17164s (+0.8s)	3324	3324	256	68	196	14	0	278
26751	17165s (+0.9s)	3572	3572	256	77	218	12	0	307
26752	17165s (+0.3s)	664	664	64	17	73	0	0	90
26753	17166s (+0.9s)	4000	4000	256	78	234	16	1	329
26754	17166s (+0.6s)	2236	2236	128	57	156	11	0	224
26755	17167s (+0.4s)	1508	1508	128	32	114	10	0	156
26756	17168s (+0.7s)	3200	3200	256	62	188	0	14	264
26757	17168s (+0.6s)	1928	1928	128	32	162	0	6	200
26758	17169s (+0.8s)	3332	3332	256	53	210	0	16	279
26759	17169s (+0.5s)	1752	1752	128	39	132	0	6	177
26760	17170s (+0.5s)	1860	1860	128	48	128	11	1	188
26761	17170s (+0.4s)	1216	1216	128	30	96	7	0	133
26762	17171s (+0.8s)	3432	3432	256	63	217	9	1	290
26763	17172s (+0.5s)	1688	1688	128	43	115	10	0	168
26764	17172s (+0.4s)	1500	1500	128	37	110	10	1	158
26765	17173s (+0.4s)	1104	1104	128	33	88	3	0	124
26766	17173s (+0.5s)	1904	1904	128	47	141	6	0	194
26767	17174s (+0.8s)	3200	3200	256	75	177	16	0	268
26768	17175s (+0.7s)	2744	2744	256	40	186	8	0	234
26769	17175s (+0.6s)	2548	2548	256	51	153	14	0	218
26770	17176s (+0.5s)	1604	1604	128	29	135	5	0	169
26771	17176s (+0.6s)	2472	2472	256	36	167	7	0	210
26772	17176s (+0.2s)	520	520	32	13	59	4	0	76
26773	17177s (+1.0s)	4080	4080	256	97	227	18	0	342
26774	17178s (+0.5s)	1600	1600	128	39	120	8	0	167
26775	17179s (+1.0s)	5164	5164	512	86	263	12	0	361
26776	17179s (+0.5s)	1496	1496	128	40	110	6	1	157
26777	17180s (+1.0s)	5328	5328	512	93	255	20	0	368
26778	17181s (+0.6s)	2016	2016	128	57	136	9	0	202
26779	17181s (+0.4s)	1284	1284	128	31	94	4	0	129
26780	17182s (+0.8s)	3244	3244	256	78	177	14	1	270
26781	17183s (+1.1s)	5352	5352	512	116	240	14	1	371
26782	17184s (+0.6s)	2508	2508	256	49	153	9	0	211
26783	17185s (+0.8s)	3384	3384	256	75	199	14	0	288
26784	17185s (+0.4s)	1432	1432	128	42	95	9	1	147
26785	17186s (+0.7s)	2964	2964	256	54	184	10	0	248
26786	17187s (+1.1s)	4552	4552	256	102	253	25	0	380
26787	17188s (+0.7s)	2560	2560	256	54	160	13	0	227
26788	17188s (+0.6s)	2388	2388	128	60	156	9	0	225
26789	17189s (+0.5s)	1644	1644	128	34	125	5	0	164
26790	17189s (+0.3s)	696	696	64	21	65	4	0	90
26791	17190s (+0.9s)	4696	4696	512	75	224	18	1	318
26792	17190s (+0.5s)	1716	1716	128	34	133	8	0	175
26793	17191s (+0.5s)	1708	1708	128	50	121	3	0	174
26794	17192s (+1.3s)	6428	6428	512	117	315	23	0	455
26795	17193s (+0.6s)	2764	2764	256	59	153	11	0	223
26796	17194s (+0.7s)	3144	3144	256	62	188	15	0	265
26797	17194s (+0.8s)	2920	2920	128	75	183	18	0	276
26798	17195s (+0.7s)	2836	2836	256	60	170	14	0	244
26799	17196s (+0.5s)	1652	1652	128	36	127	6	0	169
Episode	Time	Reward	Score	Highest	L	U	R	D	Steps
26800	17196s (+0.5s)	1592	1592	128	38	122	10	0	170
26801	17197s (+0.5s)	1796	1796	128	48	127	9	0	184
26802	17197s (+0.7s)	2768	2768	256	57	168	8	0	233
26803	17198s (+0.6s)	2552	2552	256	47	169	0	8	224
26804	17198s (+0.6s)	2360	2360	256	41	153	0	8	202
26805	17199s (+0.2s)	496	496	64	19	50	0	4	73
26806	17200s (+1.1s)	5456	5456	512	69	289	0	21	379
26807	17200s (+0.3s)	744	744	64	22	72	0	3	97
26808	17200s (+0.3s)	1000	1000	64	29	83	0	7	119
26809	17201s (+0.3s)	952	952	64	26	79	0	7	112
26810	17202s (+1.2s)	5780	5780	512	87	306	0	19	412
26811	17202s (+0.3s)	884	884	64	23	78	0	5	106
26812	17203s (+0.9s)	3576	3576	256	76	219	13	0	308
26813	17204s (+0.7s)	2484	2484	128	69	145	18	0	232
26814	17204s (+0.5s)	1632	1632	128	36	133	6	0	175
26815	17205s (+0.5s)	1896	1896	128	55	129	8	0	192
26816	17206s (+0.8s)	3440	3440	256	74	196	20	1	291
26817	17206s (+0.7s)	2904	2904	256	66	174	12	0	252
26818	17207s (+1.0s)	4304	4304	256	81	257	17	0	355
26819	17208s (+0.5s)	1764	1764	128	38	136	6	0	180
26820	17209s (+0.9s)	3848	3848	256	69	224	17	2	312
26821	17209s (+0.7s)	3160	3160	256	70	187	7	0	264
26822	17210s (+0.5s)	1572	1572	128	40	119	6	0	165
26823	17211s (+0.7s)	3160	3160	256	61	181	16	0	258
26824	17211s (+0.5s)	1772	1772	128	46	127	8	0	181
26825	17212s (+0.9s)	3860	3860	256	77	222	11	0	310
26826	17213s (+0.8s)	3604	3604	256	65	218	8	0	291
26827	17213s (+0.4s)	1300	1300	128	34	102	4	1	141
26828	17214s (+0.9s)	3960	3960	256	80	227	17	0	324
26829	17215s (+0.8s)	3424	3424	256	65	211	11	0	287
26830	17216s (+0.6s)	2572	2572	256	55	158	9	0	222
26831	17216s (+0.4s)	1480	1480	128	35	112	7	0	154
26832	17217s (+0.4s)	1344	1344	64	39	110	7	0	156
26833	17217s (+0.8s)	3316	3316	256	51	214	0	11	276
26834	17218s (+0.7s)	2736	2736	256	41	187	0	8	236
26835	17219s (+0.4s)	1356	1356	128	28	108	0	5	141
26836	17220s (+1.0s)	5288	5288	512	67	277	0	16	360
26837	17220s (+0.5s)	1616	1616	128	36	128	0	7	171
26838	17221s (+0.6s)	2572	2572	256	39	174	0	7	220
26839	17221s (+0.1s)	264	264	32	11	34	0	4	49
26840	17222s (+0.7s)	2796	2796	256	52	180	0	9	241
26841	17222s (+0.3s)	688	688	64	15	69	0	6	90
26842	17223s (+0.9s)	3704	3704	256	60	237	0	15	312
26843	17223s (+0.5s)	1664	1664	128	30	134	4	0	168
26844	17224s (+0.6s)	2496	2496	256	48	155	12	1	216
26845	17224s (+0.7s)	2792	2792	256	50	180	11	0	241
26846	17225s (+0.7s)	2696	2696	256	50	171	12	0	233
26847	17226s (+1.0s)	4212	4212	256	73	258	12	0	343
26848	17227s (+0.7s)	2908	2908	256	58	185	10	0	253
26849	17227s (+0.6s)	2360	2360	256	41	150	7	0	198
26850	17228s (+0.4s)	1504	1504	128	38	115	6	0	159
26851	17229s (+0.9s)	4592	4592	512	80	216	16	1	313
26852	17229s (+0.5s)	1504	1504	128	43	109	7	0	159
26853	17230s (+0.6s)	2496	2496	256	61	137	17	0	215
26854	17231s (+0.7s)	3092	3092	256	60	175	15	0	250
26855	17231s (+0.5s)	1616	1616	128	47	118	6	0	171
26856	17231s (+0.4s)	1156	1156	64	30	106	2	0	138
26857	17232s (+0.5s)	1840	1840	128	38	140	9	0	187
26858	17233s (+0.8s)	3636	3636	256	89	207	15	0	311
26859	17233s (+0.4s)	1436	1436	128	32	108	7	0	147
26860	17234s (+0.7s)	3272	3272	256	65	190	14	0	269
26861	17234s (+0.4s)	1444	1444	128	45	97	8	0	150
26862	17235s (+0.5s)	1628	1628	128	31	128	5	0	164
26863	17235s (+0.6s)	2640	2640	256	47	167	10	0	224
26864	17236s (+0.6s)	2336	2336	256	42	146	7	0	195
26865	17237s (+0.5s)	1584	1584	128	41	114	7	1	163
26866	17237s (+0.5s)	1780	1780	128	44	126	10	0	180
26867	17238s (+0.8s)	3504	3504	256	72	207	16	0	295
26868	17238s (+0.3s)	912	912	64	26	89	4	0	119
26869	17239s (+0.8s)	3384	3384	256	66	197	15	0	278
26870	17240s (+0.7s)	2856	2856	256	56	183	6	0	245
26871	17240s (+0.6s)	2276	2276	128	56	149	9	0	214
26872	17241s (+0.8s)	3372	3372	256	82	187	10	0	279
26873	17242s (+1.0s)	4520	4520	256	104	248	19	0	371
26874	17243s (+0.6s)	2268	2268	256	56	131	9	0	196
26875	17243s (+0.6s)	2004	2004	128	57	127	12	1	197
26876	17244s (+0.3s)	1056	1056	128	29	79	6	0	114
26877	17244s (+0.6s)	2556	2556	256	50	161	8	0	219
26878	17245s (+0.5s)	1588	1588	128	43	116	5	0	164
26879	17246s (+0.9s)	3832	3832	256	66	230	13	0	309
26880	17246s (+0.8s)	3176	3176	256	56	195	0	12	263
26881	17247s (+0.8s)	3316	3316	256	56	203	0	14	273
26882	17248s (+0.9s)	3600	3600	256	72	221	0	21	314
26883	17249s (+0.9s)	3864	3864	256	70	233	0	14	317
26884	17250s (+0.7s)	3228	3228	256	49	207	0	14	270
26885	17250s (+0.5s)	1868	1868	128	34	149	0	7	190
26886	17251s (+0.8s)	3168	3168	256	52	211	0	11	274
26887	17252s (+0.6s)	2388	2388	256	41	160	0	5	206
26888	17252s (+0.6s)	2196	2196	128	41	154	0	13	208
26889	17253s (+0.6s)	2068	2068	128	45	148	0	11	204
26890	17254s (+1.1s)	4640	4640	256	106	260	19	0	385
26891	17255s (+0.7s)	2708	2708	256	52	164	12	1	229
26892	17255s (+0.3s)	936	936	64	28	81	6	0	115
26893	17256s (+1.0s)	4224	4224	256	85	251	11	0	347
26894	17256s (+0.5s)	1576	1576	128	41	118	7	0	166
26895	17257s (+0.6s)	2352	2352	256	37	154	4	0	195
26896	17258s (+0.7s)	3228	3228	256	71	187	12	0	270
26897	17258s (+0.6s)	2440	2440	256	62	136	11	0	209
26898	17259s (+0.6s)	2316	2316	128	65	132	12	2	211
26899	17260s (+0.8s)	3676	3676	256	71	211	18	0	300
Episode	Time	Reward	Score	Highest	L	U	R	D	Steps
26900	17261s (+1.3s)	6468	6468	512	111	335	17	0	463
26901	17262s (+0.6s)	1908	1908	128	52	131	11	0	194
26902	17262s (+0.6s)	1844	1844	128	48	141	2	0	191
26903	17263s (+0.4s)	1400	1400	128	32	98	14	0	144
26904	17263s (+0.4s)	1324	1324	128	33	100	4	0	137
26905	17264s (+0.8s)	3508	3508	256	65	218	0	13	296
26906	17264s (+0.5s)	1596	1596	128	29	131	0	6	166
26907	17265s (+0.4s)	1260	1260	128	26	102	1	3	132
26908	17265s (+0.5s)	1784	1784	128	41	134	0	7	182
26909	17266s (+0.2s)	648	648	64	16	64	1	4	85
26910	17266s (+0.5s)	1604	1604	128	38	122	8	0	168
26911	17266s (+0.4s)	1420	1420	128	38	99	7	0	144
26912	17267s (+1.0s)	5364	5364	512	92	259	21	0	372
26913	17268s (+0.5s)	1788	1788	128	55	116	11	0	182
26914	17268s (+0.5s)	1792	1792	128	58	110	11	0	179
26915	17269s (+0.4s)	1504	1504	128	38	111	10	0	159
26916	17269s (+0.4s)	1484	1484	128	34	116	5	0	155
26917	17270s (+0.4s)	1000	1000	64	34	86	9	0	129
26918	17270s (+0.4s)	1452	1452	128	42	104	6	0	152
26919	17271s (+0.8s)	3240	3240	256	66	196	11	0	273
26920	17272s (+0.7s)	3140	3140	256	61	182	11	0	254
26921	17272s (+0.5s)	1604	1604	128	34	119	0	5	158
26922	17273s (+0.8s)	3348	3348	256	67	200	0	16	283
26923	17274s (+1.0s)	4036	4036	256	66	263	0	9	338
26924	17274s (+0.3s)	864	864	64	13	86	0	4	103
26925	17275s (+0.5s)	1604	1604	128	42	122	0	4	168
26926	17275s (+0.5s)	1576	1576	128	45	110	10	0	165
26927	17276s (+1.2s)	5796	5796	512	101	296	18	0	415
26928	17277s (+0.5s)	1528	1528	128	43	112	6	0	161
26929	17277s (+0.3s)	952	952	64	30	82	6	0	118
26930	17278s (+0.8s)	3336	3336	256	83	181	16	0	280
26931	17279s (+0.8s)	3552	3552	256	76	211	14	1	302
26932	17279s (+0.5s)	2008	2008	128	42	135	10	2	189
26933	17280s (+0.5s)	1880	1880	128	37	145	7	0	189
26934	17280s (+0.4s)	1456	1456	128	42	108	8	0	158
26935	17281s (+0.8s)	3288	3288	256	59	197	14	0	270
26936	17282s (+0.7s)	2804	2804	256	51	184	8	0	243
26937	17282s (+0.6s)	1908	1908	128	48	139	8	0	195
26938	17283s (+0.4s)	1196	1196	128	28	92	7	0	127
26939	17283s (+0.6s)	2320	2320	128	48	161	0	9	218
26940	17284s (+0.3s)	684	684	32	19	71	0	9	99
26941	17284s (+0.5s)	1788	1788	128	49	122	8	1	180
26942	17285s (+0.4s)	1484	1484	128	33	114	7	0	154
26943	17285s (+0.3s)	656	656	64	25	63	5	0	93
26944	17285s (+0.4s)	1436	1436	128	35	105	8	0	148
26945	17286s (+0.8s)	3536	3536	256	71	216	11	0	298
26946	17287s (+0.8s)	3524	3524	256	74	203	18	0	295
26947	17287s (+0.4s)	1144	1144	128	19	98	0	7	124
26948	17288s (+0.3s)	784	784	64	14	83	0	4	101
26949	17288s (+0.4s)	1452	1452	128	35	105	7	0	147
26950	17289s (+0.6s)	2496	2496	256	53	152	11	0	216
26951	17289s (+0.7s)	2720	2720	256	64	169	7	0	240
26952	17290s (+0.7s)	3100	3100	256	72	166	21	0	259
26953	17291s (+0.7s)	2808	2808	256	58	171	11	0	240
26954	17292s (+0.8s)	3288	3288	256	78	175	18	2	273
26955	17293s (+0.9s)	4188	4188	256	94	230	19	0	343
26956	17293s (+0.7s)	3168	3168	256	79	168	14	0	261
26957	17294s (+0.5s)	1772	1772	128	40	134	5	0	179
26958	17295s (+0.7s)	3128	3128	256	57	184	13	1	255
26959	17295s (+0.5s)	1688	1688	128	43	114	10	0	167
26960	17296s (+0.5s)	2040	2040	256	35	130	4	0	169
26961	17297s (+1.4s)	7224	7224	512	117	354	28	1	500
26962	17298s (+0.6s)	2532	2532	256	56	159	8	1	224
26963	17299s (+0.9s)	3916	3916	256	84	218	16	0	318
26964	17299s (+0.7s)	3152	3152	256	61	185	11	0	257
26965	17300s (+0.5s)	1636	1636	128	56	106	7	0	169
26966	17300s (+0.5s)	1680	1680	128	39	123	9	0	171
26967	17301s (+0.6s)	2624	2624	256	49	164	9	0	222
26968	17301s (+0.3s)	1084	1084	128	23	83	7	0	113
26969	17302s (+0.8s)	3340	3340	256	64	208	10	0	282
26970	17303s (+0.9s)	4068	4068	256	79	238	22	0	339
26971	17304s (+0.6s)	1892	1892	128	50	130	14	0	194
26972	17304s (+0.5s)	1744	1744	128	33	135	8	0	176
26973	17305s (+0.7s)	3044	3044	256	49	201	6	0	256
26974	17306s (+0.9s)	3896	3896	256	61	245	0	14	320
26975	17306s (+0.5s)	2080	2080	128	39	145	0	9	193
26976	17307s (+0.2s)	624	624	64	11	66	0	9	86
26977	17307s (+0.5s)	1796	1796	128	40	118	0	12	170
26978	17308s (+0.5s)	1796	1796	128	46	130	8	0	184
26979	17308s (+0.7s)	2820	2820	256	50	192	7	0	249
26980	17309s (+0.3s)	920	920	64	28	89	4	0	121
26981	17310s (+0.9s)	4068	4068	256	83	233	19	0	335
26982	17310s (+0.9s)	3828	3828	256	92	208	18	0	318
26983	17311s (+0.5s)	1832	1832	128	43	140	7	0	190
26984	17312s (+1.0s)	4156	4156	256	88	237	16	0	341
26985	17313s (+0.8s)	3320	3320	256	67	202	11	0	280
26986	17313s (+0.7s)	2824	2824	256	62	172	14	0	248
26987	17314s (+0.6s)	2456	2456	128	68	145	13	0	226
26988	17315s (+0.8s)	3196	3196	256	72	182	13	0	267
26989	17315s (+0.6s)	1916	1916	128	51	136	10	0	197
26990	17316s (+0.4s)	1568	1568	128	41	112	11	0	164
26991	17317s (+0.9s)	3624	3624	256	82	207	19	1	309
26992	17317s (+0.5s)	1632	1632	128	37	127	7	1	172
26993	17318s (+0.5s)	1792	1792	128	39	138	6	0	183
26994	17318s (+0.6s)	2532	2532	256	53	155	12	0	220
26995	17319s (+0.4s)	1456	1456	128	42	107	6	0	155
26996	17319s (+0.4s)	1456	1456	128	33	110	6	0	149
26997	17320s (+1.1s)	4548	4548	256	101	254	23	0	378
26998	17322s (+1.2s)	5828	5828	512	110	291	17	0	418
26999	17322s (+0.6s)	2608	2608	256	61	151	12	0	224
Episode	Time	Reward	Score	Highest	L	U	R	D	Steps
27000	17323s (+0.6s)	2204	2204	128	57	140	10	0	207
27001	17324s (+0.8s)	3404	3404	256	78	200	14	0	292
27002	17324s (+0.7s)	2848	2848	256	51	196	7	0	254
27003	17325s (+0.4s)	1428	1428	128	33	97	8	0	138
27004	17325s (+0.4s)	1156	1156	128	19	104	2	0	125
27005	17326s (+0.8s)	3192	3192	256	69	187	10	0	266
27006	17326s (+0.4s)	1124	1124	64	37	87	9	0	133
27007	17327s (+0.7s)	3096	3096	256	73	172	12	1	258
27008	17328s (+0.7s)	3072	3072	256	65	186	15	1	267
27009	17328s (+0.6s)	2452	2452	128	53	171	7	1	232
27010	17329s (+0.6s)	2668	2668	256	51	164	12	0	227
27011	17330s (+0.8s)	3524	3524	256	71	216	13	0	300
27012	17330s (+0.5s)	2280	2280	256	49	126	10	0	185
27013	17331s (+0.5s)	1672	1672	128	34	129	7	0	170
27014	17332s (+0.6s)	2284	2284	128	60	146	12	0	218
27015	17332s (+0.5s)	1840	1840	128	36	134	0	10	180
27016	17333s (+0.5s)	1624	1624	128	36	129	0	8	173
27017	17334s (+1.0s)	5044	5044	512	97	237	15	0	349
27018	17334s (+0.5s)	1660	1660	128	42	125	8	0	175
27019	17335s (+0.5s)	1544	1544	128	35	120	9	0	164
27020	17335s (+0.7s)	3124	3124	256	66	186	9	0	261
27021	17336s (+0.5s)	1848	1848	128	49	129	8	0	186
27022	17337s (+0.8s)	3288	3288	256	78	184	12	0	274
27023	17337s (+0.7s)	3224	3224	256	76	184	10	0	270
27024	17338s (+0.2s)	512	512	32	12	62	3	0	77
27025	17338s (+0.6s)	2368	2368	128	60	153	9	0	222
27026	17339s (+0.8s)	3484	3484	256	82	197	16	0	295
27027	17340s (+1.2s)	6064	6064	512	140	279	20	0	439
27028	17341s (+0.7s)	3004	3004	256	55	184	12	0	251
27029	17341s (+0.4s)	1332	1332	128	25	109	3	0	137
27030	17342s (+0.7s)	2904	2904	256	52	191	9	0	252
27031	17343s (+0.7s)	2804	2804	256	57	161	9	0	227
27032	17344s (+0.7s)	3112	3112	256	62	182	0	11	255
27033	17344s (+0.4s)	1352	1352	128	28	104	0	7	139
27034	17344s (+0.6s)	1980	1980	128	49	138	11	0	198
27035	17345s (+0.6s)	1936	1936	128	52	136	14	0	202
27036	17346s (+0.6s)	2468	2468	256	63	137	9	0	209
27037	17346s (+0.6s)	2836	2836	256	56	163	11	0	230
27038	17347s (+0.4s)	1432	1432	128	25	118	4	0	147
27039	17347s (+0.5s)	1820	1820	128	44	135	10	0	189
27040	17348s (+0.7s)	2868	2868	256	81	162	12	0	255
27041	17349s (+0.5s)	1772	1772	128	38	136	4	0	178
27042	17349s (+0.6s)	2140	2140	128	36	157	6	0	199
27043	17350s (+0.7s)	2800	2800	256	62	169	11	0	242
27044	17350s (+0.5s)	1736	1736	128	32	132	5	0	169
27045	17351s (+0.3s)	784	784	64	27	73	4	0	104
27046	17351s (+0.7s)	3228	3228	256	64	196	10	0	270
27047	17352s (+0.4s)	1400	1400	128	31	108	8	0	147
27048	17352s (+0.7s)	2976	2976	256	51	201	0	13	265
27049	17353s (+0.8s)	3324	3324	256	57	206	0	15	278
27050	17354s (+0.9s)	3976	3976	256	68	242	0	18	328
27051	17355s (+0.9s)	4160	4160	256	74	243	0	17	334
27052	17356s (+0.5s)	1544	1544	128	35	115	0	9	159
27053	17356s (+0.3s)	828	828	64	16	78	0	4	98
27054	17357s (+0.9s)	3960	3960	256	67	250	0	8	325
27055	17358s (+0.9s)	3852	3852	256	67	227	0	16	310
27056	17359s (+0.8s)	3468	3468	256	62	212	0	13	287
27057	17359s (+0.4s)	1360	1360	128	34	105	0	6	145
27058	17360s (+0.6s)	2572	2572	256	44	168	0	7	219
27059	17360s (+0.5s)	1744	1744	128	35	142	0	4	181
27060	17361s (+0.7s)	2792	2792	256	49	183	0	9	241
27061	17361s (+0.5s)	1832	1832	128	48	135	5	0	188
27062	17362s (+0.4s)	1240	1240	64	30	107	6	0	143
27063	17362s (+0.4s)	1360	1360	128	44	96	5	0	145
27064	17363s (+0.3s)	1080	1080	128	23	90	5	0	118
27065	17363s (+0.4s)	1468	1468	128	36	108	7	0	151
27066	17364s (+0.8s)	3228	3228	256	55	205	10	0	270
27067	17364s (+0.7s)	2860	2860	256	60	176	10	0	246
27068	17365s (+0.4s)	1228	1228	128	28	102	4	0	134
27069	17366s (+0.9s)	4128	4128	256	75	248	11	0	334
27070	17366s (+0.3s)	756	756	64	31	66	4	0	101
27071	17367s (+0.5s)	1608	1608	128	41	117	7	1	166
27072	17368s (+0.9s)	3996	3996	256	94	218	16	0	328
27073	17368s (+0.6s)	2608	2608	256	54	157	16	0	227
27074	17369s (+0.7s)	3192	3192	256	57	197	11	0	265
27075	17370s (+0.7s)	3108	3108	256	69	177	11	1	258
27076	17370s (+0.5s)	1844	1844	128	42	143	6	0	191
27077	17371s (+1.0s)	5212	5212	512	96	244	23	1	364
27078	17372s (+0.7s)	2600	2600	256	51	167	7	0	225
27079	17372s (+0.5s)	1620	1620	128	40	122	10	0	172
27080	17373s (+1.0s)	4184	4184	256	100	231	16	1	348
27081	17374s (+0.4s)	1496	1496	128	27	124	6	0	157
27082	17375s (+0.8s)	3384	3384	256	73	195	13	0	281
27083	17375s (+0.5s)	1740	1740	128	48	117	9	0	174
27084	17376s (+0.7s)	2556	2556	128	63	162	13	0	238
27085	17376s (+0.4s)	1404	1404	128	35	111	5	0	151
27086	17377s (+0.9s)	4032	4032	256	83	231	10	0	324
27087	17377s (+0.3s)	1132	1132	128	20	95	0	6	121
27088	17378s (+0.5s)	1644	1644	128	29	127	0	7	163
27089	17378s (+0.2s)	608	608	64	27	57	4	0	88
27090	17379s (+0.6s)	2280	2280	256	42	141	11	0	194
27091	17379s (+0.6s)	2760	2760	256	51	178	8	0	237
27092	17380s (+0.7s)	2872	2872	256	50	193	6	0	249
27093	17381s (+0.6s)	2452	2452	128	58	163	8	0	229
27094	17381s (+0.7s)	2780	2780	256	56	170	12	0	238
27095	17382s (+0.8s)	2976	2976	256	73	184	8	0	265
27096	17383s (+0.5s)	1620	1620	128	55	109	8	0	172
27097	17383s (+0.5s)	1948	1948	128	54	130	10	0	194
27098	17384s (+0.9s)	3800	3800	256	76	218	11	0	305
27099	17385s (+0.8s)	3364	3364	256	71	205	11	0	287
Episode	Time	Reward	Score	Highest	L	U	R	D	Steps
27100	17386s (+0.7s)	2772	2772	256	68	158	10	0	236
27101	17386s (+0.6s)	2208	2208	128	63	130	15	0	208
27102	17387s (+0.4s)	1480	1480	128	34	112	7	0	153
27103	17388s (+0.9s)	3608	3608	256	68	225	12	0	305
27104	17388s (+0.8s)	3264	3264	256	72	187	13	0	272
27105	17389s (+0.4s)	1312	1312	128	31	99	5	0	135
27106	17389s (+0.8s)	3188	3188	256	59	193	11	1	264
27107	17390s (+0.3s)	920	920	64	23	91	7	0	121
27108	17390s (+0.5s)	1808	1808	128	47	129	10	0	186
27109	17391s (+0.7s)	3148	3148	256	61	186	12	0	259
27110	17391s (+0.2s)	560	560	64	20	54	2	0	76
27111	17392s (+0.5s)	1712	1712	128	41	128	11	0	180
27112	17392s (+0.5s)	1884	1884	128	52	134	8	0	194
27113	17393s (+0.9s)	3784	3784	256	76	223	13	0	312
27114	17394s (+0.5s)	1788	1788	128	43	129	10	0	182
27115	17395s (+0.8s)	3188	3188	256	62	189	0	14	265
27116	17395s (+0.6s)	2692	2692	256	52	166	0	9	227
27117	17396s (+0.7s)	2984	2984	256	41	200	0	6	247
27118	17396s (+0.4s)	1436	1436	128	30	115	0	5	150
27119	17397s (+0.5s)	1756	1756	128	47	126	0	7	180
27120	17397s (+0.5s)	1752	1752	128	40	131	0	8	179
27121	17398s (+0.5s)	2332	2332	256	41	142	0	13	196
27122	17399s (+0.8s)	3188	3188	256	70	186	0	13	269
27123	17399s (+0.7s)	2924	2924	256	43	209	0	6	258
27124	17400s (+0.4s)	1484	1484	128	32	120	0	3	155
27125	17401s (+0.8s)	3500	3500	256	59	218	0	17	294
27126	17402s (+1.1s)	4536	4536	256	106	242	24	0	372
27127	17403s (+0.7s)	3060	3060	256	66	169	15	1	251
27128	17404s (+1.0s)	4436	4436	256	99	251	17	0	367
27129	17404s (+0.3s)	836	836	64	22	80	5	0	107
27130	17405s (+0.7s)	3112	3112	256	66	188	11	0	265
27131	17406s (+1.0s)	4208	4208	256	69	263	14	0	346
27132	17406s (+0.6s)	2580	2580	256	49	168	7	0	224
27133	17407s (+0.9s)	4540	4540	512	83	216	12	0	311
27134	17407s (+0.2s)	536	536	32	18	58	0	4	80
27135	17408s (+0.8s)	3236	3236	256	65	194	0	13	272
27136	17408s (+0.4s)	1180	1180	64	34	100	0	8	142
27137	17409s (+0.8s)	3308	3308	256	57	208	0	10	275
27138	17410s (+0.4s)	1040	1040	64	31	88	5	0	124
27139	17410s (+0.7s)	3076	3076	256	57	191	9	0	257
27140	17411s (+0.9s)	3960	3960	256	80	234	12	0	326
27141	17412s (+0.3s)	728	728	64	21	68	5	0	94
27142	17412s (+0.5s)	1772	1772	128	45	123	10	0	178
27143	17413s (+0.8s)	3476	3476	256	73	202	12	1	288
27144	17414s (+0.6s)	2280	2280	128	71	136	13	0	220
27145	17414s (+0.9s)	3756	3756	256	80	219	15	0	314
27146	17415s (+0.7s)	2692	2692	256	58	160	14	0	232
27147	17416s (+0.5s)	1628	1628	128	32	127	5	0	164
27148	17416s (+0.3s)	696	696	64	30	58	4	0	92
27149	17416s (+0.4s)	1484	1484	128	32	117	6	0	155
27150	17417s (+0.3s)	1020	1020	64	21	95	0	5	121
27151	17417s (+0.5s)	1792	1792	128	37	135	0	12	184
27152	17418s (+0.7s)	3184	3184	256	73	178	0	10	261
27153	17418s (+0.4s)	1008	1008	64	25	90	0	6	121
27154	17419s (+0.8s)	3156	3156	256	50	205	0	11	266
27155	17420s (+0.8s)	3176	3176	256	51	201	0	10	262
27156	17421s (+0.8s)	3216	3216	256	59	198	0	10	267
27157	17421s (+0.6s)	1948	1948	128	41	145	0	14	200
27158	17422s (+0.5s)	1556	1556	128	37	117	0	8	162
27159	17422s (+0.4s)	1332	1332	128	31	106	0	2	139
27160	17423s (+0.6s)	2204	2204	256	36	147	9	0	192
27161	17423s (+0.7s)	3036	3036	256	63	181	7	0	251
27162	17424s (+0.9s)	4132	4132	256	90	227	18	0	335
27163	17425s (+0.6s)	1948	1948	128	49	145	10	1	205
27164	17426s (+0.7s)	2788	2788	256	49	172	13	0	234
27165	17426s (+0.3s)	864	864	64	26	82	4	0	112
27166	17426s (+0.5s)	1836	1836	128	37	140	10	0	187
27167	17427s (+0.4s)	1432	1432	128	28	117	1	0	146
27168	17427s (+0.5s)	1592	1592	128	40	128	4	0	172
27169	17428s (+0.4s)	1392	1392	64	30	122	3	1	156
27170	17429s (+0.8s)	3244	3244	256	82	180	20	0	282
27171	17430s (+0.9s)	5012	5012	512	80	237	17	0	334
27172	17430s (+0.7s)	3176	3176	256	73	176	14	0	263
27173	17431s (+0.6s)	1928	1928	128	50	136	11	0	197
27174	17431s (+0.4s)	1252	1252	64	39	103	3	0	145
27175	17432s (+0.4s)	1504	1504	128	41	105	12	1	159
27176	17432s (+0.7s)	2788	2788	256	62	164	14	0	240
27177	17433s (+0.8s)	3420	3420	256	75	198	13	0	286
27178	17434s (+0.4s)	1364	1364	128	38	98	9	0	145
27179	17434s (+0.5s)	1872	1872	128	46	137	8	0	191
27180	17435s (+0.8s)	3472	3472	256	69	207	11	0	287
27181	17435s (+0.4s)	1220	1220	64	25	108	0	5	138
27182	17436s (+0.5s)	1808	1808	128	38	140	0	9	187
27183	17436s (+0.4s)	1240	1240	128	28	98	5	0	131
27184	17437s (+0.3s)	668	668	64	21	64	4	1	90
27185	17437s (+0.6s)	2480	2480	256	36	174	0	4	214
27186	17437s (+0.3s)	688	688	64	14	75	0	2	91
27187	17438s (+0.4s)	1396	1396	128	35	99	0	8	142
27188	17438s (+0.2s)	680	680	64	14	71	4	0	89
27189	17439s (+0.7s)	2804	2804	256	66	167	11	0	244
27190	17440s (+0.7s)	3032	3032	256	58	182	8	0	248
27191	17440s (+0.5s)	1832	1832	128	53	120	12	1	186
27192	17441s (+0.8s)	3528	3528	256	63	222	11	0	296
27193	17441s (+0.1s)	236	236	16	13	32	0	4	49
27194	17442s (+0.6s)	2532	2532	256	41	170	0	6	217
27195	17443s (+0.8s)	3356	3356	256	64	207	0	14	285
27196	17443s (+0.9s)	3688	3688	256	54	239	0	13	306
27197	17444s (+0.7s)	3104	3104	256	51	192	0	14	257
27198	17445s (+0.9s)	3824	3824	256	63	230	0	14	307
27199	17446s (+0.6s)	1908	1908	128	38	148	0	9	195
Episode	Time	Reward	Score	Highest	L	U	R	D	Steps
27200	17446s (+0.5s)	1868	1868	128	31	154	0	5	190
27201	17447s (+0.5s)	1740	1740	128	37	127	10	0	174
27202	17447s (+0.7s)	2892	2892	256	56	184	10	0	250
27203	17448s (+0.7s)	2916	2916	256	52	195	8	0	255
27204	17448s (+0.3s)	840	840	64	28	67	7	0	102
27205	17449s (+0.5s)	2288	2288	256	34	152	5	0	191
27206	17450s (+0.7s)	2888	2888	256	68	170	10	0	248
27207	17450s (+0.4s)	1304	1304	128	34	101	7	0	142
27208	17450s (+0.2s)	616	616	64	13	68	3	0	84
27209	17451s (+0.5s)	1672	1672	128	35	128	7	1	171
27210	17452s (+0.8s)	3356	3356	256	81	192	13	0	286
27211	17453s (+0.9s)	3596	3596	256	93	192	16	0	301
27212	17453s (+0.4s)	1408	1408	128	39	93	10	0	142
27213	17454s (+0.9s)	3988	3988	256	88	223	20	0	331
27214	17455s (+1.0s)	4404	4404	256	101	246	19	0	366
27215	17455s (+0.5s)	1572	1572	128	38	121	7	0	166
27216	17456s (+1.0s)	4228	4228	256	75	259	13	0	347
27217	17457s (+0.8s)	3484	3484	256	51	226	0	15	292
27218	17458s (+0.4s)	1108	1108	64	26	102	0	8	136
27219	17458s (+0.3s)	948	948	64	22	85	0	4	111
27220	17459s (+0.6s)	2180	2180	128	59	134	11	1	205
27221	17459s (+0.5s)	1732	1732	128	52	114	6	1	173
27222	17460s (+1.1s)	4500	4500	256	82	280	10	0	372
27223	17461s (+0.7s)	2760	2760	256	60	159	18	0	237
27224	17462s (+0.9s)	4076	4076	256	86	234	17	0	337
27225	17462s (+0.6s)	2444	2444	256	44	158	5	0	207
27226	17463s (+0.4s)	1316	1316	64	38	102	8	0	148
27227	17463s (+0.5s)	1608	1608	128	47	113	9	0	169
27228	17464s (+1.0s)	4448	4448	256	109	241	20	0	370
27229	17465s (+0.5s)	1808	1808	128	53	128	6	0	187
27230	17465s (+0.4s)	1268	1268	128	27	102	5	0	134
27231	17466s (+0.6s)	1932	1932	128	56	138	7	0	201
27232	17467s (+0.9s)	4076	4076	256	89	225	16	0	330
27233	17467s (+0.5s)	1824	1824	128	51	133	6	0	190
27234	17468s (+0.5s)	1572	1572	128	40	118	7	0	165
27235	17468s (+0.4s)	1172	1172	64	39	93	8	0	140
27236	17469s (+0.8s)	3188	3188	256	75	179	17	0	271
27237	17470s (+1.0s)	4312	4312	256	90	248	18	0	356
27238	17470s (+0.4s)	1136	1136	64	36	91	5	0	132
27239	17471s (+0.5s)	1720	1720	128	55	110	9	0	174
27240	17472s (+1.1s)	4600	4600	256	85	277	18	0	380
27241	17473s (+0.6s)	2528	2528	256	45	158	0	6	209
27242	17473s (+0.6s)	1888	1888	128	28	158	0	9	195
27243	17474s (+0.6s)	2508	2508	256	39	163	0	7	209
27244	17474s (+0.7s)	2660	2660	256	44	181	0	10	235
27245	17475s (+0.4s)	1128	1128	64	32	90	0	8	130
27246	17475s (+0.5s)	1540	1540	128	31	120	0	7	158
27247	17476s (+0.7s)	2916	2916	256	55	175	0	11	241
27248	17477s (+0.8s)	3356	3356	256	73	185	13	0	271
27249	17477s (+0.7s)	2748	2748	256	62	154	16	2	234
27250	17479s (+1.1s)	4528	4528	256	129	226	18	0	373
27251	17479s (+0.4s)	1480	1480	128	40	107	7	0	154
27252	17480s (+0.7s)	2984	2984	256	65	168	13	1	247
27253	17480s (+0.7s)	2728	2728	256	69	159	9	0	237
27254	17481s (+0.8s)	3488	3488	256	89	184	19	0	292
27255	17482s (+1.1s)	5540	5540	512	105	272	18	0	395
27256	17483s (+0.6s)	2600	2600	256	50	169	6	0	225
27257	17483s (+0.3s)	752	752	64	28	69	3	0	100
27258	17484s (+0.4s)	1440	1440	128	31	107	7	0	145
27259	17485s (+0.9s)	3620	3620	256	73	222	12	0	307
27260	17486s (+1.2s)	6108	6108	512	121	288	21	0	430
27261	17487s (+0.7s)	3116	3116	256	60	189	9	0	258
27262	17487s (+0.4s)	1364	1364	128	29	114	3	0	146
27263	17488s (+0.5s)	1856	1856	128	53	127	8	0	188
27264	17488s (+0.4s)	1460	1460	128	39	110	4	0	153
27265	17489s (+0.8s)	3244	3244	256	64	198	12	0	274
27266	17489s (+0.4s)	1304	1304	128	37	98	6	0	141
27267	17490s (+0.7s)	2744	2744	128	75	173	12	0	260
27268	17491s (+1.1s)	4544	4544	256	96	264	18	0	378
27269	17492s (+1.0s)	4320	4320	256	97	243	18	0	358
27270	17492s (+0.5s)	1608	1608	128	39	121	9	0	169
27271	17493s (+0.8s)	3584	3584	256	88	199	12	0	299
27272	17494s (+0.6s)	2420	2420	256	44	147	11	0	202
27273	17494s (+0.3s)	656	656	32	18	71	3	0	92
27274	17495s (+0.4s)	1184	1184	128	36	85	0	5	126
27275	17495s (+0.6s)	1932	1932	128	37	153	0	6	196
27276	17495s (+0.3s)	640	640	64	20	60	0	9	89
27277	17496s (+0.6s)	2600	2600	256	51	162	0	12	225
27278	17497s (+0.8s)	3232	3232	256	59	192	0	20	271
27279	17497s (+0.5s)	2056	2056	128	47	136	8	0	191
27280	17498s (+0.5s)	1872	1872	128	49	130	12	0	191
27281	17499s (+0.7s)	2708	2708	256	73	144	11	1	229
27282	17499s (+0.5s)	1684	1684	128	42	121	10	0	173
27283	17500s (+0.5s)	1620	1620	128	37	126	9	0	172
27284	17500s (+0.3s)	856	856	64	16	91	4	0	111
27285	17501s (+0.7s)	2712	2712	256	58	160	13	0	231
27286	17501s (+0.7s)	2912	2912	256	61	183	10	0	254
27287	17502s (+0.8s)	3428	3428	256	81	191	15	0	287
27288	17503s (+0.4s)	1360	1360	128	31	110	10	0	151
27289	17503s (+0.3s)	804	804	64	24	81	3	0	108
27290	17504s (+0.6s)	2456	2456	256	60	150	7	0	217
27291	17504s (+0.6s)	2484	2484	256	57	152	4	0	213
27292	17505s (+0.7s)	2704	2704	256	50	176	9	0	235
27293	17506s (+1.0s)	4280	4280	256	104	231	20	0	355
27294	17506s (+0.5s)	1796	1796	128	34	126	9	0	169
27295	17507s (+1.0s)	4552	4552	256	107	251	22	0	380
27296	17508s (+0.8s)	3476	3476	256	71	213	11	0	295
27297	17509s (+0.5s)	1688	1688	128	56	103	8	0	167
27298	17509s (+0.7s)	2784	2784	256	58	170	15	0	243
27299	17510s (+0.4s)	1104	1104	64	36	86	10	0	132
Episode	Time	Reward	Score	Highest	L	U	R	D	Steps
27300	17510s (+0.6s)	2760	2760	256	49	178	8	1	236
27301	17511s (+0.4s)	976	976	64	36	89	5	0	130
27302	17512s (+0.8s)	2800	2800	128	88	160	15	0	263
27303	17512s (+0.5s)	1792	1792	128	46	129	9	0	184
27304	17513s (+0.5s)	1780	1780	128	38	135	7	0	180
27305	17513s (+0.3s)	900	900	64	27	82	6	0	115
27306	17514s (+0.6s)	2584	2584	256	59	153	7	0	219
27307	17514s (+0.5s)	1696	1696	128	47	117	8	0	172
27308	17515s (+0.8s)	2868	2868	128	78	165	20	1	264
27309	17515s (+0.5s)	1880	1880	128	43	138	8	0	189
27310	17516s (+0.4s)	1180	1180	64	34	100	7	0	141
27311	17516s (+0.6s)	2504	2504	256	49	154	14	0	217
27312	17517s (+0.8s)	3556	3556	256	56	228	0	15	299
27313	17518s (+0.9s)	3792	3792	256	59	239	0	16	314
27314	17519s (+0.4s)	1292	1292	64	28	112	0	5	145
27315	17519s (+0.3s)	804	804	64	17	78	0	4	99
27316	17519s (+0.6s)	2080	2080	128	42	145	9	1	197
27317	17520s (+0.4s)	1048	1048	64	37	84	4	1	126
27318	17520s (+0.5s)	1540	1540	128	39	118	6	0	163
27319	17521s (+0.6s)	2152	2152	128	59	129	15	0	203
27320	17521s (+0.5s)	1576	1576	128	34	119	7	0	160
27321	17522s (+0.8s)	3528	3528	256	70	215	11	0	296
27322	17523s (+0.7s)	2864	2864	256	43	190	10	0	243
27323	17524s (+0.8s)	3428	3428	256	60	219	9	0	288
27324	17524s (+0.5s)	1744	1744	128	40	138	7	1	186
27325	17525s (+0.4s)	1492	1492	128	38	110	7	1	156
27326	17525s (+0.7s)	2820	2820	256	69	157	15	0	241
27327	17526s (+0.5s)	1812	1812	128	40	140	9	0	189
27328	17526s (+0.6s)	2164	2164	128	49	141	9	1	200
27329	17527s (+0.4s)	1444	1444	128	34	105	8	0	147
27330	17528s (+0.8s)	3588	3588	256	65	223	11	0	299
27331	17529s (+0.9s)	3784	3784	256	90	207	19	0	316
27332	17529s (+0.6s)	2760	2760	256	56	162	13	0	231
27333	17530s (+0.8s)	3208	3208	256	66	193	11	0	270
27334	17531s (+0.7s)	2792	2792	256	57	168	16	0	241
27335	17532s (+1.3s)	6280	6280	512	102	321	22	0	445
27336	17533s (+0.6s)	1928	1928	128	44	147	9	0	200
27337	17534s (+1.0s)	4288	4288	256	98	239	20	0	357
27338	17534s (+0.7s)	2984	2984	256	76	160	17	0	253
27339	17535s (+0.8s)	3620	3620	256	69	220	13	0	302
27340	17536s (+0.8s)	3148	3148	256	69	188	14	0	271
27341	17536s (+0.5s)	1604	1604	128	42	115	11	0	168
27342	17537s (+0.2s)	628	628	64	22	63	2	0	87
27343	17538s (+1.3s)	6540	6540	512	135	313	24	0	472
27344	17539s (+0.6s)	1908	1908	128	38	151	6	0	195
27345	17539s (+0.4s)	1432	1432	128	35	110	8	0	153
27346	17540s (+0.5s)	2232	2232	256	45	127	6	0	178
27347	17540s (+0.3s)	928	928	64	29	85	8	0	122
27348	17541s (+0.7s)	2984	2984	256	69	168	14	2	253
27349	17541s (+0.6s)	2608	2608	256	68	146	13	0	227
27350	17542s (+0.4s)	1488	1488	128	33	116	7	0	156
27351	17542s (+0.5s)	1860	1860	128	37	143	8	0	188
27352	17543s (+0.4s)	1468	1468	128	25	120	7	0	152
27353	17543s (+0.6s)	2096	2096	128	58	140	7	0	205
27354	17544s (+0.4s)	1312	1312	128	18	115	1	0	134
27355	17545s (+1.0s)	4480	4480	256	98	243	25	0	366
27356	17545s (+0.7s)	2816	2816	256	60	178	9	0	247
27357	17546s (+0.7s)	3040	3040	256	68	176	11	0	255
27358	17547s (+1.0s)	5052	5052	512	102	234	22	0	358
27359	17548s (+0.5s)	1760	1760	128	41	130	8	1	180
27360	17548s (+0.6s)	2376	2376	256	47	145	10	0	202
27361	17549s (+0.7s)	2908	2908	256	61	169	12	0	242
27362	17550s (+0.8s)	3404	3404	256	67	204	12	0	283
27363	17551s (+0.8s)	3240	3240	256	77	182	14	0	273
27364	17551s (+0.5s)	1800	1800	128	55	124	7	0	186
27365	17552s (+0.7s)	2924	2924	128	77	168	17	1	263
27366	17553s (+0.6s)	2176	2176	128	74	133	12	0	219
27367	17553s (+0.6s)	1932	1932	128	55	135	11	0	201
27368	17554s (+0.8s)	3644	3644	256	67	220	7	0	294
27369	17555s (+0.7s)	2820	2820	256	53	175	10	0	238
27370	17555s (+0.5s)	1832	1832	128	44	126	12	0	182
27371	17556s (+0.5s)	1712	1712	128	48	115	16	0	179
27372	17557s (+0.8s)	3316	3316	256	60	207	0	13	280
27373	17557s (+0.8s)	3416	3416	256	53	221	0	12	286
27374	17558s (+0.8s)	3700	3700	256	63	225	0	15	303
27375	17559s (+1.1s)	5528	5528	512	85	294	0	18	397
27376	17560s (+0.3s)	912	912	64	35	78	1	4	118
27377	17560s (+0.8s)	3176	3176	256	53	198	0	12	263
27378	17561s (+0.5s)	1848	1848	128	33	147	0	6	186
27379	17562s (+0.8s)	3408	3408	256	61	209	0	14	284
27380	17562s (+0.6s)	2340	2340	128	47	169	0	7	223
27381	17563s (+0.6s)	2340	2340	256	44	141	1	9	195
27382	17564s (+0.6s)	2496	2496	256	45	165	0	6	216
27383	17564s (+0.3s)	1148	1148	128	23	91	0	6	120
27384	17565s (+0.8s)	3544	3544	256	66	221	0	13	300
27385	17566s (+0.8s)	3356	3356	256	65	208	0	12	285
27386	17566s (+0.6s)	2104	2104	128	40	146	0	11	197
27387	17567s (+0.5s)	1528	1528	128	35	125	0	6	166
27388	17567s (+0.5s)	1892	1892	128	55	128	8	0	191
27389	17568s (+0.4s)	1416	1416	128	28	113	5	0	146
27390	17568s (+0.5s)	1784	1784	128	52	120	9	0	181
27391	17569s (+0.7s)	2920	2920	256	56	190	10	0	256
27392	17570s (+0.7s)	2848	2848	256	73	156	14	0	243
27393	17570s (+0.5s)	1604	1604	128	42	119	7	0	168
27394	17571s (+0.8s)	3432	3432	256	68	207	9	0	284
27395	17571s (+0.4s)	1468	1468	128	34	113	4	0	151
27396	17572s (+0.8s)	3356	3356	256	73	191	21	0	285
27397	17573s (+0.7s)	3140	3140	256	60	188	10	0	258
27398	17573s (+0.5s)	1788	1788	128	36	126	5	1	168
27399	17574s (+0.7s)	2812	2812	256	66	172	9	0	247
Episode	Time	Reward	Score	Highest	L	U	R	D	Steps
27400	17575s (+0.4s)	1156	1156	64	42	86	9	0	137
27401	17575s (+0.6s)	2608	2608	256	38	172	7	0	217
27402	17576s (+0.4s)	1368	1368	128	38	98	7	0	143
27403	17576s (+0.9s)	3892	3892	256	81	223	13	0	317
27404	17577s (+0.9s)	3616	3616	256	71	223	12	0	306
27405	17578s (+0.8s)	3236	3236	256	65	196	11	0	272
27406	17579s (+0.8s)	3600	3600	256	78	212	12	0	302
27407	17580s (+1.5s)	7380	7380	512	159	320	32	1	512
27408	17582s (+1.0s)	4348	4348	256	107	239	15	0	361
27409	17582s (+0.5s)	1692	1692	128	49	117	8	0	174
27410	17583s (+0.6s)	1912	1912	128	48	140	7	1	196
27411	17583s (+0.8s)	3180	3180	256	73	174	16	0	263
27412	17584s (+0.7s)	2412	2412	128	43	175	0	12	230
27413	17585s (+0.4s)	1464	1464	128	29	114	0	11	154
27414	17585s (+0.9s)	3632	3632	256	59	228	0	9	296
27415	17586s (+0.2s)	524	524	64	14	53	0	5	72
27416	17586s (+0.5s)	1784	1784	128	36	136	0	9	181
27417	17587s (+0.4s)	1488	1488	128	30	122	4	0	156
27418	17587s (+0.6s)	2696	2696	256	54	161	9	0	224
27419	17588s (+0.9s)	4052	4052	256	108	212	16	0	336
27420	17589s (+0.7s)	2500	2500	128	59	166	11	0	236
27421	17590s (+1.0s)	4484	4484	256	103	244	20	0	367
27422	17591s (+0.7s)	2792	2792	256	58	173	10	0	241
27423	17592s (+0.9s)	3740	3740	256	77	217	12	0	306
27424	17592s (+0.7s)	3200	3200	256	76	171	16	0	263
27425	17592s (+0.2s)	376	376	32	25	40	2	0	67
27426	17593s (+0.4s)	1408	1408	128	41	100	5	0	146
27427	17594s (+0.7s)	3192	3192	256	66	189	11	0	266
27428	17594s (+0.6s)	2220	2220	128	53	140	7	0	200
27429	17595s (+0.5s)	1872	1872	128	43	137	11	0	191
27430	17595s (+0.4s)	1480	1480	128	28	123	3	0	154
27431	17596s (+0.9s)	4132	4132	256	72	250	17	0	339
27432	17597s (+0.8s)	3364	3364	256	64	211	7	0	282
27433	17598s (+0.5s)	1792	1792	128	33	142	6	2	183
27434	17599s (+1.1s)	5500	5500	512	96	276	19	0	391
27435	17599s (+0.6s)	2312	2312	256	62	123	10	1	196
27436	17600s (+0.8s)	3488	3488	256	70	205	16	0	291
27437	17601s (+0.8s)	3428	3428	256	68	206	13	1	288
27438	17601s (+0.4s)	1364	1364	128	28	109	5	0	142
27439	17602s (+0.4s)	1372	1372	128	39	99	6	0	144
27440	17603s (+1.0s)	4276	4276	256	87	254	15	0	356
27441	17603s (+0.4s)	1396	1396	128	25	106	8	0	139
27442	17604s (+1.0s)	3904	3904	256	90	229	15	0	334
27443	17605s (+0.6s)	2640	2640	256	61	152	12	0	225
27444	17605s (+0.3s)	748	748	64	31	63	6	0	100
27445	17606s (+0.9s)	3928	3928	256	80	229	13	0	322
27446	17607s (+0.6s)	2440	2440	256	49	148	10	0	207
27447	17607s (+0.5s)	1564	1564	128	54	103	4	0	161
27448	17608s (+0.5s)	1956	1956	128	38	146	9	0	193
27449	17608s (+0.7s)	2928	2928	256	73	172	13	0	258
27450	17609s (+0.9s)	3840	3840	256	84	221	11	0	316
27451	17610s (+1.0s)	4172	4172	256	106	214	24	1	345
27452	17611s (+0.4s)	1396	1396	128	36	108	4	0	148
27453	17611s (+0.3s)	1124	1124	128	26	88	4	1	119
27454	17611s (+0.3s)	876	876	64	28	83	4	0	115
27455	17612s (+0.9s)	3932	3932	256	71	234	13	0	318
27456	17613s (+1.1s)	4532	4532	256	103	254	21	1	379
27457	17614s (+0.5s)	1788	1788	128	33	144	5	0	182
27458	17615s (+0.7s)	3080	3080	256	63	174	17	1	255
27459	17615s (+0.7s)	3080	3080	256	66	182	12	0	260
27460	17616s (+0.7s)	2812	2812	256	62	169	14	0	245
27461	17617s (+0.6s)	2404	2404	256	54	143	9	0	206
27462	17617s (+0.7s)	2540	2540	128	65	158	15	0	238
27463	17618s (+0.4s)	1232	1232	128	33	92	10	0	135
27464	17618s (+0.4s)	1256	1256	64	32	106	8	0	146
27465	17619s (+1.2s)	5868	5868	512	129	245	32	0	406
27466	17620s (+0.5s)	1792	1792	128	41	135	7	0	183
27467	17620s (+0.6s)	2416	2416	256	45	147	10	0	202
27468	17621s (+0.6s)	2028	2028	128	52	140	7	0	199
27469	17622s (+1.0s)	4216	4216	256	98	227	19	1	345
27470	17623s (+0.8s)	3316	3316	256	69	198	13	0	280
27471	17623s (+0.5s)	1596	1596	128	30	128	8	0	166
27472	17624s (+0.5s)	1808	1808	128	39	139	0	9	187
27473	17624s (+0.5s)	1784	1784	128	36	136	0	9	181
27474	17625s (+0.5s)	1580	1580	128	34	129	0	4	167
27475	17626s (+1.0s)	3996	3996	256	56	263	0	15	334
27476	17626s (+0.6s)	1960	1960	128	54	141	8	0	203
27477	17627s (+0.3s)	736	736	64	19	71	6	0	96
27478	17627s (+0.5s)	1816	1816	128	50	129	9	0	188
27479	17628s (+0.4s)	1304	1304	64	39	98	9	0	146
27480	17628s (+0.7s)	2788	2788	256	53	170	11	0	234
27481	17629s (+0.9s)	3992	3992	256	80	230	17	0	327
27482	17630s (+1.0s)	4040	4040	256	75	247	12	0	334
27483	17631s (+0.5s)	1504	1504	128	40	112	8	0	160
27484	17631s (+0.6s)	1876	1876	128	39	149	4	0	192
27485	17633s (+1.4s)	7184	7184	512	145	329	21	0	495
27486	17634s (+1.0s)	4224	4224	256	87	238	17	0	342
27487	17634s (+0.8s)	3148	3148	256	59	199	8	0	266
27488	17635s (+0.5s)	1500	1500	128	33	118	7	0	158
27489	17635s (+0.5s)	1748	1748	128	54	118	5	0	177
27490	17636s (+0.4s)	1304	1304	128	26	101	6	0	133
27491	17637s (+1.1s)	5604	5604	512	83	299	0	17	399
27492	17637s (+0.5s)	1604	1604	128	42	120	0	6	168
27493	17638s (+0.9s)	3864	3864	256	64	236	0	16	316
27494	17639s (+0.7s)	2860	2860	256	43	184	0	15	242
27495	17640s (+0.8s)	3276	3276	256	68	196	14	0	278
27496	17641s (+0.9s)	3812	3812	256	86	208	14	0	308
27497	17641s (+0.3s)	740	740	64	17	75	4	1	97
27498	17642s (+0.9s)	3508	3508	256	84	195	17	0	296
27499	17642s (+0.5s)	1504	1504	128	45	103	12	0	160
Episode	Time	Reward	Score	Highest	L	U	R	D	Steps
27500	17643s (+0.7s)	2712	2712	256	55	163	11	1	230
27501	17644s (+0.9s)	4140	4140	256	82	235	20	0	337
27502	17644s (+0.4s)	1528	1528	128	44	111	5	0	160
27503	17645s (+1.1s)	5676	5676	512	110	274	18	0	402
27504	17647s (+1.2s)	5884	5884	512	122	275	25	0	422
27505	17647s (+0.8s)	3424	3424	256	65	215	7	0	287
27506	17648s (+0.6s)	2552	2552	256	60	158	7	0	225
27507	17649s (+0.8s)	3292	3292	256	65	198	15	1	279
27508	17649s (+0.5s)	1792	1792	128	39	136	9	0	184
27509	17650s (+0.5s)	1656	1656	128	35	137	4	0	176
27510	17650s (+0.3s)	836	836	64	25	78	4	0	107
27511	17651s (+0.8s)	3132	3132	256	64	188	10	1	263
27512	17652s (+0.6s)	2504	2504	256	58	148	6	1	213
27513	17652s (+0.2s)	396	396	32	11	52	2	0	65
27514	17652s (+0.6s)	2396	2396	256	46	145	11	0	202
27515	17653s (+0.3s)	764	764	64	26	71	6	0	103
27516	17653s (+0.6s)	2244	2244	128	58	146	12	0	216
27517	17654s (+1.1s)	5528	5528	512	91	277	18	0	386
27518	17655s (+0.5s)	1824	1824	128	42	137	11	0	190
27519	17656s (+0.7s)	2972	2972	256	56	184	10	0	250
27520	17657s (+0.8s)	3432	3432	256	80	199	10	0	289
27521	17657s (+0.5s)	1604	1604	128	44	116	8	0	168
27522	17658s (+0.9s)	3996	3996	256	58	248	0	17	323
27523	17659s (+1.1s)	5512	5512	512	88	289	0	16	393
27524	17659s (+0.3s)	1024	1024	128	18	87	0	5	110
27525	17660s (+0.4s)	1344	1344	128	26	110	0	6	142
27526	17661s (+0.9s)	3588	3588	256	77	208	14	0	299
27527	17661s (+0.8s)	3008	3008	256	60	197	10	0	267
27528	17663s (+1.3s)	6476	6476	512	130	310	28	0	468
27529	17663s (+0.5s)	1608	1608	128	41	121	7	0	169
27530	17664s (+0.5s)	1580	1580	128	39	120	8	0	167
27531	17664s (+0.7s)	3168	3168	256	67	179	14	0	260
27532	17665s (+0.4s)	1316	1316	128	35	95	6	0	136
27533	17665s (+0.6s)	2412	2412	256	46	148	12	0	206
27534	17666s (+0.7s)	2804	2804	256	67	168	10	0	245
27535	17667s (+0.6s)	1928	1928	128	46	145	9	0	200
27536	17667s (+0.4s)	1432	1432	128	39	110	7	0	156
27537	17668s (+0.7s)	3104	3104	256	53	184	12	0	249
27538	17669s (+0.7s)	3128	3128	256	66	184	11	0	261
27539	17669s (+0.3s)	888	888	64	23	90	4	0	117
27540	17669s (+0.4s)	1372	1372	128	29	110	4	0	143
27541	17670s (+0.5s)	1616	1616	128	48	113	10	0	171
27542	17671s (+0.9s)	3772	3772	256	69	231	14	0	314
27543	17672s (+1.4s)	7232	7232	512	142	325	28	1	496
27544	17673s (+0.5s)	1616	1616	128	49	114	8	0	171
27545	17673s (+0.8s)	3428	3428	256	57	214	0	17	288
27546	17674s (+0.4s)	1560	1560	128	30	114	0	8	152
27547	17674s (+0.4s)	1292	1292	128	21	110	0	5	136
27548	17675s (+0.7s)	2868	2868	256	72	164	12	0	248
27549	17675s (+0.4s)	1192	1192	128	31	90	9	0	130
27550	17676s (+0.8s)	3460	3460	256	70	209	16	0	295
27551	17677s (+0.5s)	1604	1604	128	40	118	9	0	167
27552	17677s (+0.3s)	848	848	64	21	87	4	0	112
27553	17678s (+0.5s)	1892	1892	128	50	135	6	0	191
27554	17678s (+0.3s)	748	748	64	22	73	4	0	99
27555	17678s (+0.3s)	1020	1020	64	31	80	9	0	120
27556	17679s (+0.6s)	2664	2664	256	55	156	9	1	221
27557	17679s (+0.3s)	1080	1080	128	24	90	0	2	116
27558	17680s (+0.4s)	1544	1544	128	25	125	0	6	156
27559	17680s (+0.4s)	1216	1216	128	24	100	0	5	129
27560	17681s (+1.1s)	4464	4464	256	77	277	0	15	369
27561	17682s (+0.7s)	2840	2840	256	44	190	0	14	248
27562	17682s (+0.5s)	1812	1812	128	40	135	0	13	188
27563	17683s (+0.6s)	2044	2044	128	41	145	0	12	198
27564	17684s (+0.6s)	2488	2488	256	43	161	0	10	214
27565	17684s (+0.6s)	2552	2552	256	41	167	0	11	219
27566	17684s (+0.3s)	1004	1004	64	28	89	0	3	120
27567	17685s (+0.4s)	1452	1452	128	32	110	0	7	149
27568	17686s (+0.6s)	2632	2632	256	45	162	0	15	222
27569	17686s (+0.4s)	1436	1436	128	23	120	0	5	148
27570	17686s (+0.5s)	1788	1788	128	37	140	0	5	182
27571	17687s (+0.6s)	2332	2332	256	38	148	0	10	196
27572	17687s (+0.4s)	1344	1344	128	21	113	0	3	137
27573	17688s (+0.6s)	2624	2624	256	47	163	0	12	222
27574	17689s (+0.5s)	1840	1840	128	38	142	0	10	190
27575	17690s (+1.2s)	6180	6180	512	118	274	23	1	416
27576	17691s (+0.7s)	2484	2484	128	41	186	4	1	232
27577	17691s (+0.7s)	2884	2884	256	42	201	8	1	252
27578	17692s (+0.8s)	3196	3196	256	77	179	13	1	270
27579	17692s (+0.3s)	844	844	64	27	79	5	0	111
27580	17693s (+0.6s)	1912	1912	128	43	146	7	0	196
27581	17694s (+0.6s)	1904	1904	128	37	150	7	0	194
27582	17694s (+0.7s)	3056	3056	256	66	182	11	0	259
27583	17695s (+1.1s)	4448	4448	256	115	237	18	0	370
27584	17696s (+0.7s)	2848	2848	256	65	175	10	0	250
27585	17697s (+0.5s)	1740	1740	128	47	124	10	1	182
27586	17697s (+0.9s)	3640	3640	256	66	235	11	0	312
27587	17698s (+0.5s)	1788	1788	128	42	132	8	0	182
27588	17699s (+0.7s)	2804	2804	256	62	165	15	1	243
27589	17699s (+0.4s)	1284	1284	128	25	111	5	0	141
27590	17700s (+0.5s)	1624	1624	128	53	112	7	0	172
27591	17700s (+0.4s)	1048	1048	64	33	86	7	0	126
27592	17700s (+0.5s)	1512	1512	128	34	121	6	0	161
27593	17701s (+0.8s)	3420	3420	256	72	204	10	0	286
27594	17702s (+1.2s)	6144	6144	512	105	306	17	0	428
27595	17703s (+1.0s)	4140	4140	256	62	259	0	17	338
27596	17704s (+0.5s)	1836	1836	128	32	145	0	6	183
27597	17704s (+0.3s)	1104	1104	128	26	87	0	4	117
27598	17705s (+0.8s)	2964	2964	256	51	202	0	9	262
27599	17706s (+0.7s)	2636	2636	128	59	179	0	12	250
Episode	Time	Reward	Score	Highest	L	U	R	D	Steps
27600	17706s (+0.6s)	1912	1912	128	34	154	0	8	196
27601	17707s (+0.6s)	2540	2540	256	49	158	9	0	216
27602	17708s (+0.7s)	2788	2788	256	57	174	9	0	240
27603	17708s (+0.3s)	1116	1116	128	24	95	2	0	121
27604	17709s (+0.9s)	3592	3592	256	75	211	18	0	304
27605	17709s (+0.3s)	696	696	64	17	69	5	0	91
27606	17710s (+0.8s)	3432	3432	256	94	176	13	0	283
27607	17711s (+0.7s)	2792	2792	256	51	183	7	0	241
27608	17711s (+0.4s)	1364	1364	128	40	106	5	0	151
27609	17712s (+0.8s)	3308	3308	256	73	188	12	2	275
27610	17712s (+0.3s)	836	836	64	22	76	6	1	105
27611	17713s (+0.4s)	1108	1108	128	24	94	3	0	121
27612	17713s (+0.4s)	1440	1440	128	36	113	10	0	159
27613	17714s (+0.8s)	3712	3712	256	81	208	14	0	303
27614	17714s (+0.4s)	1548	1548	128	47	104	8	0	159
27615	17715s (+0.5s)	1548	1548	128	43	116	7	0	166
27616	17715s (+0.6s)	2108	2108	128	60	131	8	0	199
27617	17716s (+0.6s)	1912	1912	128	42	153	1	0	196
27618	17716s (+0.3s)	856	856	64	22	84	5	0	111
27619	17717s (+0.3s)	1088	1088	128	22	90	3	0	115
27620	17717s (+0.7s)	3052	3052	256	66	172	11	0	249
27621	17718s (+1.0s)	4060	4060	256	86	235	11	0	332
27622	17719s (+0.4s)	1328	1328	128	33	106	5	0	144
27623	17719s (+0.8s)	3300	3300	256	76	188	13	0	277
27624	17720s (+0.5s)	1736	1736	128	44	118	12	0	174
27625	17720s (+0.3s)	728	728	32	26	74	4	1	105
27626	17721s (+0.5s)	1668	1668	128	38	118	6	0	162
27627	17721s (+0.7s)	3104	3104	256	58	188	10	0	256
27628	17722s (+0.7s)	2736	2736	256	49	170	0	14	233
27629	17723s (+0.7s)	3184	3184	256	53	204	0	7	264
27630	17724s (+1.0s)	4144	4144	256	74	253	0	11	338
27631	17724s (+0.3s)	720	720	64	22	68	0	4	94
27632	17725s (+0.9s)	3540	3540	256	60	227	0	12	299
27633	17725s (+0.3s)	1020	1020	128	21	81	0	4	106
27634	17726s (+0.8s)	3116	3116	256	55	196	0	10	261
27635	17727s (+0.7s)	3144	3144	256	51	200	0	10	261
27636	17727s (+0.5s)	1592	1592	128	45	108	0	12	165
27637	17728s (+0.7s)	3080	3080	256	58	183	0	13	254
27638	17729s (+0.6s)	2592	2592	256	44	169	0	10	223
27639	17729s (+0.7s)	2784	2784	256	52	171	0	16	239
27640	17730s (+0.3s)	1124	1124	128	21	95	0	4	120
27641	17730s (+0.6s)	2112	2112	128	42	147	0	11	200
27642	17731s (+0.9s)	3528	3528	256	62	220	0	15	297
27643	17732s (+0.7s)	2928	2928	256	48	186	0	9	243
27644	17732s (+0.4s)	1340	1340	128	31	100	0	6	137
27645	17733s (+0.6s)	2628	2628	256	38	173	0	8	219
27646	17733s (+0.4s)	1504	1504	128	30	116	0	7	153
27647	17734s (+0.6s)	2488	2488	256	44	160	0	4	208
27648	17735s (+0.8s)	3224	3224	256	49	207	0	13	269
27649	17735s (+0.8s)	3288	3288	256	47	211	0	12	270
27650	17736s (+0.7s)	2880	2880	256	50	190	0	11	251
27651	17737s (+0.4s)	1528	1528	128	37	107	11	0	155
27652	17737s (+0.7s)	3216	3216	256	62	188	16	0	266
27653	17738s (+0.3s)	876	876	64	23	88	3	0	114
27654	17738s (+0.5s)	1620	1620	128	38	128	0	5	171
27655	17739s (+0.5s)	1752	1752	128	33	133	0	12	178
27656	17740s (+1.1s)	5720	5720	512	105	278	18	0	401
27657	17740s (+0.5s)	1508	1508	128	36	115	9	1	161
27658	17741s (+0.5s)	1624	1624	128	52	114	7	0	173
27659	17742s (+0.8s)	3380	3380	256	60	206	15	0	281
27660	17742s (+0.8s)	2840	2840	128	77	177	11	0	265
27661	17743s (+0.9s)	3624	3624	256	69	223	16	0	308
27662	17744s (+1.2s)	6128	6128	512	118	295	21	0	434
27663	17745s (+0.5s)	1672	1672	128	43	133	4	0	180
27664	17745s (+0.4s)	1412	1412	128	31	102	6	0	139
27665	17746s (+0.5s)	1556	1556	128	38	115	8	0	161
27666	17746s (+0.5s)	1772	1772	128	57	119	12	0	188
27667	17747s (+0.8s)	3036	3036	256	91	156	16	0	263
27668	17748s (+0.6s)	1972	1972	128	37	150	0	10	197
27669	17748s (+0.8s)	3396	3396	256	58	198	0	11	267
27670	17749s (+0.5s)	1768	1768	128	41	131	5	0	177
27671	17750s (+0.8s)	3296	3296	256	71	196	9	0	276
27672	17750s (+0.6s)	2456	2456	256	47	155	8	0	210
27673	17751s (+0.3s)	736	736	64	25	66	0	5	96
27674	17751s (+0.8s)	3364	3364	256	67	208	0	12	287
27675	17752s (+0.5s)	1884	1884	128	41	144	0	5	190
27676	17752s (+0.2s)	536	536	64	14	55	0	2	71
27677	17753s (+0.3s)	904	904	64	18	86	0	5	109
27678	17753s (+0.7s)	3160	3160	256	40	215	0	12	267
27679	17754s (+0.8s)	3300	3300	256	69	192	0	12	273
27680	17755s (+0.9s)	3972	3972	256	86	221	20	0	327
27681	17756s (+0.8s)	3536	3536	256	78	197	13	0	288
27682	17756s (+0.6s)	2044	2044	128	59	129	14	0	202
27683	17757s (+0.7s)	2720	2720	128	75	159	13	0	247
27684	17758s (+0.7s)	3064	3064	256	65	173	12	1	251
27685	17759s (+0.7s)	3008	3008	256	51	189	7	0	247
27686	17759s (+0.7s)	2976	2976	256	77	162	16	0	255
27687	17760s (+0.7s)	2684	2684	256	63	160	11	0	234
27688	17760s (+0.4s)	960	960	64	33	89	4	0	126
27689	17761s (+0.6s)	2644	2644	256	51	166	6	0	223
27690	17762s (+0.6s)	2268	2268	128	48	147	12	1	208
27691	17762s (+0.6s)	2168	2168	128	53	148	6	0	207
27692	17763s (+0.9s)	3988	3988	256	80	225	17	0	322
27693	17764s (+0.7s)	2912	2912	256	62	183	8	1	254
27694	17764s (+0.4s)	1504	1504	128	36	104	13	0	153
27695	17765s (+0.4s)	1336	1336	128	29	99	6	0	134
27696	17765s (+0.5s)	1860	1860	128	52	130	7	0	189
27697	17766s (+0.4s)	1180	1180	64	42	93	7	0	142
27698	17766s (+0.6s)	2520	2520	256	43	166	8	0	217
27699	17767s (+0.4s)	1576	1576	128	37	116	8	0	161
Episode	Time	Reward	Score	Highest	L	U	R	D	Steps
27700	17767s (+0.4s)	1288	1288	128	20	107	5	0	132
27701	17768s (+0.8s)	3224	3224	256	75	179	15	0	269
27702	17769s (+0.8s)	3748	3748	256	64	219	15	0	298
27703	17770s (+0.7s)	3148	3148	256	60	191	10	0	261
27704	17771s (+1.0s)	4208	4208	256	91	232	19	0	342
27705	17771s (+0.8s)	3508	3508	256	71	208	17	0	296
27706	17772s (+1.0s)	4248	4248	256	90	248	14	0	352
27707	17773s (+0.9s)	3804	3804	256	91	215	15	1	322
27708	17774s (+0.4s)	1320	1320	128	27	110	8	0	145
27709	17774s (+0.5s)	1788	1788	128	47	125	10	0	182
27710	17775s (+0.8s)	3568	3568	256	69	217	13	0	299
27711	17776s (+0.9s)	4008	4008	256	76	236	12	1	325
27712	17777s (+0.8s)	3484	3484	256	78	193	18	1	290
27713	17778s (+0.8s)	3328	3328	256	68	198	16	0	282
27714	17778s (+0.8s)	3492	3492	256	59	219	14	0	292
27715	17779s (+0.8s)	3212	3212	256	73	183	14	0	270
27716	17780s (+0.5s)	1648	1648	128	27	136	0	6	169
27717	17781s (+0.8s)	3544	3544	256	110	166	24	1	301
27718	17781s (+0.3s)	1056	1056	128	20	88	1	0	109
27719	17782s (+1.0s)	4124	4124	256	89	235	14	0	338
27720	17783s (+0.9s)	3700	3700	256	82	215	10	0	307
27721	17783s (+0.7s)	2924	2924	256	46	186	11	0	243
27722	17784s (+0.5s)	1604	1604	128	46	112	10	0	168
27723	17785s (+1.2s)	5664	5664	512	88	292	23	0	403
27724	17786s (+0.6s)	1916	1916	128	47	138	12	0	197
27725	17786s (+0.8s)	3248	3248	256	65	198	11	0	274
27726	17787s (+0.9s)	4048	4048	256	92	231	11	0	334
27727	17788s (+0.5s)	1672	1672	128	38	125	7	0	170
27728	17788s (+0.4s)	1516	1516	128	36	114	8	0	158
27729	17789s (+0.9s)	3928	3928	256	96	204	21	0	321
27730	17790s (+0.6s)	2452	2452	256	45	152	8	0	205
27731	17790s (+0.4s)	1036	1036	64	27	91	5	0	123
27732	17790s (+0.3s)	1072	1072	128	17	91	3	0	111
27733	17791s (+0.5s)	1840	1840	128	57	126	7	0	190
27734	17792s (+0.6s)	1976	1976	128	54	145	8	0	207
27735	17792s (+0.5s)	1632	1632	128	34	120	8	0	162
27736	17793s (+0.5s)	1712	1712	128	45	122	6	0	173
27737	17793s (+0.4s)	1448	1448	128	31	113	7	0	151
27738	17794s (+0.8s)	3348	3348	256	63	200	11	0	274
27739	17794s (+0.6s)	2632	2632	256	56	164	10	0	230
27740	17795s (+1.0s)	4236	4236	256	89	246	14	0	349
27741	17796s (+0.8s)	3328	3328	256	73	192	13	0	278
27742	17797s (+0.4s)	1456	1456	128	43	104	6	0	153
27743	17798s (+0.9s)	3960	3960	256	76	227	22	0	325
27744	17798s (+0.3s)	940	940	64	37	80	4	0	121
27745	17798s (+0.5s)	1528	1528	128	32	122	7	0	161
27746	17799s (+1.0s)	4232	4232	256	78	259	11	0	348
27747	17801s (+1.2s)	5780	5780	512	95	295	21	0	411
27748	17801s (+0.7s)	2916	2916	256	51	193	11	0	255
27749	17802s (+0.3s)	752	752	64	20	75	3	0	98
27750	17802s (+0.8s)	3308	3308	256	76	192	12	0	280
27751	17803s (+0.7s)	2788	2788	256	52	176	12	0	240
27752	17803s (+0.4s)	1416	1416	128	34	108	7	0	149
27753	17804s (+0.4s)	1192	1192	128	27	97	6	0	130
27754	17805s (+0.8s)	3516	3516	256	75	207	12	0	294
27755	17805s (+0.5s)	1656	1656	128	37	121	8	0	166
27756	17806s (+0.4s)	1340	1340	128	31	98	7	0	136
27757	17807s (+1.0s)	4160	4160	256	89	230	20	0	339
27758	17807s (+0.4s)	1348	1348	128	28	106	4	0	138
27759	17808s (+0.7s)	2712	2712	256	53	163	11	0	227
27760	17809s (+0.9s)	4740	4740	512	84	228	17	0	329
27761	17809s (+0.5s)	1520	1520	128	42	112	9	0	163
27762	17810s (+0.5s)	1620	1620	128	38	118	6	0	162
27763	17810s (+0.8s)	3356	3356	256	54	223	8	0	285
27764	17811s (+0.4s)	1536	1536	128	39	105	10	0	154
27765	17811s (+0.6s)	1920	1920	128	47	144	7	0	198
27766	17812s (+0.9s)	4668	4668	512	70	237	14	0	321
27767	17813s (+0.8s)	3468	3468	256	54	236	8	0	298
27768	17814s (+0.5s)	1784	1784	128	41	133	8	0	182
27769	17814s (+0.4s)	1048	1048	64	28	95	4	0	127
27770	17815s (+1.0s)	4140	4140	256	103	216	22	0	341
27771	17816s (+1.1s)	4412	4412	256	131	219	23	0	373
27772	17816s (+0.4s)	1060	1060	64	33	91	5	0	129
27773	17817s (+0.5s)	1548	1548	128	31	126	0	9	166
27774	17817s (+0.5s)	2240	2240	256	36	145	0	6	187
27775	17818s (+0.5s)	1764	1764	128	41	134	0	6	181
27776	17819s (+0.6s)	2616	2616	256	35	186	0	8	229
27777	17819s (+0.6s)	2092	2092	128	38	155	0	10	203
27778	17820s (+0.3s)	1024	1024	128	25	83	2	0	110
27779	17820s (+0.5s)	1744	1744	128	51	122	9	0	182
27780	17820s (+0.3s)	960	960	64	27	85	4	0	116
27781	17821s (+1.0s)	4904	4904	512	90	242	9	1	342
27782	17822s (+0.7s)	3096	3096	256	64	175	15	0	254
27783	17823s (+0.5s)	1944	1944	128	52	130	7	0	189
27784	17824s (+0.9s)	3544	3544	256	95	185	20	0	300
27785	17824s (+0.5s)	1868	1868	128	57	124	9	0	190
27786	17825s (+0.9s)	3976	3976	256	87	228	13	0	328
27787	17826s (+0.8s)	3396	3396	256	73	202	10	0	285
27788	17826s (+0.5s)	1564	1564	128	27	139	3	0	169
27789	17827s (+0.4s)	1352	1352	128	37	105	6	0	148
27790	17827s (+0.5s)	1668	1668	128	30	133	6	0	169
27791	17828s (+0.4s)	1360	1360	64	35	111	9	0	155
27792	17828s (+0.5s)	2228	2228	256	34	143	5	1	183
27793	17829s (+0.5s)	1568	1568	128	43	107	10	0	160
27794	17829s (+0.6s)	2460	2460	256	52	149	6	0	207
27795	17830s (+0.5s)	1680	1680	128	53	114	5	0	172
27796	17830s (+0.5s)	1672	1672	128	47	114	8	0	169
27797	17831s (+0.6s)	2452	2452	128	73	150	10	0	233
27798	17832s (+0.7s)	2840	2840	256	44	195	7	0	246
27799	17833s (+1.0s)	4292	4292	256	97	232	22	0	351
Episode	Time	Reward	Score	Highest	L	U	R	D	Steps
27800	17834s (+1.3s)	6480	6480	512	129	300	32	1	462
27801	17834s (+0.4s)	1484	1484	128	46	105	4	0	155
27802	17835s (+0.5s)	1908	1908	128	50	133	12	0	195
27803	17835s (+0.6s)	2412	2412	256	46	149	5	0	200
27804	17836s (+0.7s)	2752	2752	128	79	166	10	0	255
27805	17837s (+1.1s)	5732	5732	512	94	284	25	0	403
27806	17838s (+0.8s)	2944	2944	256	64	184	14	0	262
27807	17839s (+0.4s)	1460	1460	128	27	121	5	0	153
27808	17839s (+0.7s)	2604	2604	256	59	158	9	0	226
27809	17840s (+0.8s)	3180	3180	256	75	175	13	0	263
27810	17841s (+0.7s)	3236	3236	256	62	199	11	0	272
27811	17841s (+0.5s)	1664	1664	128	49	111	8	0	168
27812	17842s (+0.7s)	2916	2916	256	70	155	16	0	241
27813	17842s (+0.6s)	2056	2056	128	50	141	10	0	201
27814	17843s (+0.4s)	1488	1488	128	35	113	7	0	155
27815	17843s (+0.5s)	1664	1664	128	49	114	4	1	168
27816	17844s (+0.7s)	2768	2768	256	61	159	15	0	235
27817	17845s (+0.8s)	3092	3092	256	81	168	16	0	265
27818	17845s (+0.4s)	1268	1268	128	25	108	4	0	137
27819	17846s (+1.0s)	4212	4212	256	98	232	20	0	350
27820	17847s (+0.8s)	3164	3164	256	71	191	16	0	278
27821	17847s (+0.4s)	1304	1304	128	40	90	11	0	141
27822	17848s (+0.9s)	3568	3568	256	77	215	13	1	306
27823	17849s (+0.5s)	1568	1568	128	40	116	7	0	163
27824	17850s (+1.0s)	4248	4248	256	91	243	18	0	352
27825	17850s (+0.7s)	2684	2684	256	66	157	7	0	230
27826	17851s (+0.6s)	1920	1920	128	43	151	4	0	198
27827	17852s (+1.0s)	4180	4180	256	102	215	23	0	340
27828	17853s (+0.7s)	2868	2868	256	57	182	9	0	248
27829	17853s (+0.7s)	3168	3168	256	75	170	15	0	260
27830	17854s (+1.0s)	4224	4224	256	97	230	19	0	346
27831	17855s (+0.8s)	3420	3420	256	70	207	13	1	291
27832	17856s (+0.5s)	1652	1652	128	41	128	6	0	175
27833	17856s (+0.5s)	1564	1564	128	36	121	6	0	163
27834	17857s (+0.8s)	3220	3220	256	67	189	13	0	269
27835	17858s (+1.0s)	4252	4252	256	72	262	0	12	346
27836	17859s (+0.5s)	2060	2060	128	37	145	0	10	192
27837	17859s (+0.8s)	3388	3388	256	63	211	0	13	287
27838	17860s (+0.4s)	1196	1196	128	21	107	0	3	131
27839	17860s (+0.7s)	3148	3148	256	45	201	0	10	256
27840	17861s (+0.8s)	3244	3244	256	52	199	0	22	273
27841	17862s (+0.3s)	1140	1140	128	29	86	6	1	122
27842	17862s (+0.7s)	2784	2784	256	60	174	9	0	243
27843	17863s (+0.3s)	656	656	64	23	65	5	0	93
27844	17863s (+0.6s)	2676	2676	256	50	153	12	0	215
27845	17864s (+0.5s)	1576	1576	128	49	107	10	0	166
27846	17864s (+0.5s)	1644	1644	128	54	112	8	0	174
27847	17864s (+0.3s)	868	868	64	26	79	5	0	110
27848	17865s (+0.4s)	1488	1488	128	42	105	8	0	155
27849	17866s (+0.7s)	2772	2772	256	44	189	0	8	241
27850	17866s (+0.7s)	2904	2904	256	47	178	0	14	239
27851	17867s (+0.5s)	2176	2176	256	36	142	0	7	185
27852	17867s (+0.7s)	2656	2656	256	43	181	0	9	233
27853	17868s (+0.7s)	3052	3052	256	52	185	0	10	247
27854	17868s (+0.3s)	756	756	64	19	77	0	6	102
27855	17869s (+0.5s)	1616	1616	128	42	122	0	7	171
27856	17869s (+0.2s)	332	332	32	10	46	0	5	61
27857	17870s (+0.4s)	1120	1120	64	30	97	0	6	133
27858	17870s (+0.5s)	1828	1828	128	34	143	0	10	187
27859	17870s (+0.3s)	1004	1004	64	22	90	0	8	120
27860	17871s (+0.6s)	2480	2480	256	40	159	0	10	209
27861	17871s (+0.3s)	748	748	64	17	78	4	0	99
27862	17873s (+1.4s)	6652	6652	512	135	326	28	0	489
27863	17873s (+0.6s)	1856	1856	128	43	138	13	0	194
27864	17874s (+0.8s)	3448	3448	256	78	189	19	0	286
27865	17875s (+0.6s)	2364	2364	256	38	155	4	0	197
27866	17875s (+0.5s)	1812	1812	128	43	141	4	0	188
27867	17876s (+0.5s)	1624	1624	128	46	118	8	0	172
27868	17876s (+0.7s)	2508	2508	128	50	171	14	3	238
27869	17877s (+0.5s)	1904	1904	128	51	131	12	0	194
27870	17878s (+1.1s)	5612	5612	512	126	255	20	0	401
27871	17879s (+0.8s)	3532	3532	256	73	212	12	0	297
27872	17879s (+0.4s)	1444	1444	128	42	96	11	0	149
27873	17880s (+0.6s)	1908	1908	128	39	148	0	13	200
27874	17881s (+0.6s)	2504	2504	256	31	175	0	9	215
27875	17881s (+0.5s)	1772	1772	128	34	141	0	5	180
27876	17882s (+0.5s)	1656	1656	128	42	126	0	8	176
27877	17882s (+0.3s)	712	712	64	16	75	0	7	98
27878	17882s (+0.4s)	1072	1072	64	30	90	0	7	127
27879	17883s (+0.7s)	3120	3120	256	59	193	0	7	259
27880	17884s (+0.5s)	2160	2160	256	38	139	0	6	183
27881	17884s (+0.3s)	740	740	64	14	78	5	1	98
27882	17884s (+0.3s)	852	852	64	28	74	7	0	109
27883	17885s (+0.8s)	3328	3328	256	73	184	16	1	274
27884	17885s (+0.4s)	1200	1200	128	29	97	6	0	132
27885	17886s (+1.2s)	6156	6156	512	111	295	26	0	432
27886	17887s (+0.3s)	816	816	64	29	67	5	0	101
27887	17887s (+0.5s)	1600	1600	128	31	129	7	0	167
27888	17888s (+0.5s)	1740	1740	128	38	139	2	0	179
27889	17889s (+0.8s)	3460	3460	256	67	189	19	0	275
27890	17889s (+0.4s)	1552	1552	128	37	111	9	0	157
27891	17889s (+0.2s)	572	572	64	12	65	1	0	78
27892	17890s (+0.6s)	2032	2032	128	47	143	10	0	200
27893	17891s (+1.3s)	6404	6404	512	124	302	33	0	459
27894	17892s (+1.1s)	4476	4476	256	99	247	19	0	365
27895	17893s (+1.3s)	6436	6436	512	138	286	32	0	456
27896	17894s (+0.6s)	2560	2560	256	62	147	11	0	220
27897	17895s (+0.8s)	3500	3500	256	71	209	14	1	295
27898	17895s (+0.3s)	1048	1048	64	33	86	7	0	126
27899	17896s (+0.4s)	1308	1308	128	28	103	2	0	133
Episode	Time	Reward	Score	Highest	L	U	R	D	Steps
27900	17896s (+0.5s)	1804	1804	128	47	130	9	0	186
27901	17897s (+0.7s)	2440	2440	128	64	157	11	0	232
27902	17897s (+0.5s)	1564	1564	128	47	105	12	0	164
27903	17898s (+0.7s)	2884	2884	256	57	170	11	0	238
27904	17899s (+0.5s)	1508	1508	128	40	112	8	0	160
27905	17900s (+1.3s)	6464	6464	512	119	328	16	0	463
27906	17901s (+0.7s)	2836	2836	256	55	189	7	0	251
27907	17901s (+0.5s)	1612	1612	128	34	131	5	0	170
27908	17901s (+0.4s)	1348	1348	128	26	110	0	2	138
27909	17902s (+0.5s)	1888	1888	128	41	140	0	10	191
27910	17903s (+0.5s)	1780	1780	128	43	120	12	0	175
27911	17903s (+0.4s)	924	924	64	35	84	3	0	122
27912	17903s (+0.4s)	1560	1560	128	29	121	8	0	158
27913	17904s (+0.3s)	716	716	64	25	69	5	0	99
27914	17904s (+0.3s)	1152	1152	128	31	86	5	0	122
27915	17905s (+0.6s)	2520	2520	256	51	151	12	1	215
27916	17905s (+0.4s)	1480	1480	128	31	110	0	9	150
27917	17906s (+0.7s)	2924	2924	256	53	174	0	11	238
27918	17906s (+0.5s)	1624	1624	128	26	134	0	4	164
27919	17907s (+0.4s)	1164	1164	128	23	97	0	5	125
27920	17907s (+0.5s)	2184	2184	256	42	142	0	6	190
27921	17908s (+0.7s)	2872	2872	256	48	190	0	11	249
27922	17908s (+0.4s)	1160	1160	64	34	97	0	6	137
27923	17909s (+0.7s)	2828	2828	256	53	179	0	13	245
27924	17909s (+0.3s)	868	868	64	24	82	0	6	112
27925	17910s (+0.4s)	1420	1420	128	28	112	0	11	151
27926	17910s (+0.7s)	3056	3056	256	53	187	0	15	255
27927	17911s (+0.6s)	2368	2368	256	37	159	0	5	201
27928	17912s (+0.7s)	2624	2624	256	44	175	0	11	230
27929	17913s (+0.9s)	3504	3504	256	62	224	0	15	301
27930	17913s (+0.5s)	2284	2284	256	47	134	9	0	190
27931	17914s (+0.7s)	3020	3020	256	82	158	18	0	258
27932	17915s (+0.9s)	4088	4088	256	84	241	14	1	340
27933	17916s (+0.9s)	3696	3696	256	74	223	18	0	315
27934	17916s (+0.6s)	2508	2508	256	48	159	11	1	219
27935	17917s (+0.4s)	1428	1428	128	45	101	9	0	155
27936	17917s (+0.4s)	1164	1164	128	25	95	5	0	125
27937	17918s (+0.6s)	2612	2612	256	56	159	13	0	228
27938	17919s (+0.8s)	3320	3320	256	85	185	11	0	281
27939	17919s (+0.9s)	3992	3992	256	81	231	20	0	332
27940	17920s (+0.5s)	1688	1688	128	30	134	4	0	168
27941	17921s (+0.7s)	3240	3240	256	73	188	11	0	272
27942	17921s (+0.3s)	688	688	64	20	68	5	0	93
27943	17922s (+0.6s)	2000	2000	128	59	129	14	0	202
27944	17922s (+0.5s)	1904	1904	128	49	136	9	0	194
27945	17923s (+0.7s)	2592	2592	128	59	173	14	0	246
27946	17923s (+0.5s)	1940	1940	128	45	141	7	0	193
27947	17924s (+0.8s)	3268	3268	256	66	199	10	0	275
27948	17925s (+1.2s)	5692	5692	512	117	275	18	0	410
27949	17926s (+0.5s)	1564	1564	128	45	112	6	0	163
27950	17926s (+0.5s)	2108	2108	256	47	123	10	0	180
27951	17927s (+0.6s)	2472	2472	256	57	147	8	0	212
27952	17928s (+0.8s)	3312	3312	256	56	211	9	0	276
27953	17928s (+0.5s)	1552	1552	128	38	121	7	0	166
27954	17929s (+0.7s)	3100	3100	256	54	190	11	0	255
27955	17930s (+0.7s)	2616	2616	128	67	165	13	0	245
27956	17930s (+0.7s)	2740	2740	256	57	167	10	0	234
27957	17931s (+0.7s)	2960	2960	256	47	187	11	0	245
27958	17932s (+1.2s)	5912	5912	512	113	275	28	0	416
27959	17933s (+0.8s)	3232	3232	256	70	183	17	0	270
27960	17934s (+0.6s)	2668	2668	256	57	162	8	0	227
27961	17935s (+0.9s)	4808	4808	512	84	233	18	0	335
27962	17935s (+0.5s)	1576	1576	128	35	124	6	0	165
27963	17935s (+0.3s)	980	980	64	25	84	5	0	114
27964	17936s (+0.5s)	1936	1936	128	47	134	6	0	187
27965	17936s (+0.5s)	1680	1680	128	39	126	6	0	171
27966	17937s (+0.9s)	3528	3528	256	64	219	17	1	301
27967	17938s (+0.4s)	1516	1516	128	35	106	9	0	150
27968	17939s (+0.8s)	3640	3640	256	93	192	12	1	298
27969	17939s (+0.8s)	3072	3072	256	83	167	16	0	266
27970	17939s (+0.1s)	112	112	16	9	22	2	0	33
27971	17940s (+0.7s)	2796	2796	256	54	176	0	10	240
27972	17941s (+0.7s)	2844	2844	256	48	174	0	11	233
27973	17941s (+0.4s)	1272	1272	128	27	97	0	4	128
27974	17942s (+0.3s)	988	988	64	17	97	0	3	117
27975	17942s (+0.5s)	1692	1692	128	32	133	0	10	175
27976	17943s (+0.6s)	2360	2360	256	32	161	0	6	199
27977	17943s (+0.5s)	1744	1744	128	30	142	0	6	178
27978	17944s (+0.5s)	1872	1872	128	47	128	12	0	187
27979	17944s (+0.7s)	2952	2952	256	57	174	8	0	239
27980	17945s (+0.4s)	1488	1488	128	37	111	8	0	156
27981	17945s (+0.4s)	1060	1060	64	30	90	9	0	129
27982	17946s (+0.8s)	3380	3380	256	79	193	14	0	286
27983	17946s (+0.4s)	1080	1080	64	37	83	7	0	127
27984	17947s (+0.4s)	1484	1484	128	35	116	4	0	155
27985	17948s (+1.1s)	5220	5220	512	102	257	13	0	372
27986	17948s (+0.5s)	1492	1492	128	38	113	6	0	157
27987	17949s (+0.4s)	1488	1488	128	36	116	4	0	156
27988	17950s (+0.9s)	4028	4028	256	76	234	20	0	330
27989	17950s (+0.6s)	2116	2116	128	61	137	13	1	212
27990	17951s (+0.5s)	1780	1780	128	51	118	13	0	182
27991	17952s (+0.9s)	3816	3816	256	100	198	24	0	322
27992	17952s (+0.3s)	1028	1028	128	26	82	2	0	110
27993	17953s (+0.6s)	2756	2756	256	62	152	9	0	223
27994	17953s (+0.8s)	3180	3180	256	61	200	9	0	270
27995	17954s (+0.7s)	2920	2920	256	67	181	8	0	256
27996	17955s (+0.7s)	2904	2904	256	56	186	13	1	256
27997	17956s (+1.2s)	6044	6044	512	121	291	22	0	434
27998	17957s (+0.4s)	1200	1200	128	38	89	5	0	132
27999	17957s (+0.6s)	2488	2488	256	54	149	10	0	213
Episode	Time	Reward	Score	Highest	L	U	R	D	Steps
28000	17958s (+0.5s)	1892	1892	128	47	135	9	0	191
28001	17958s (+0.4s)	1484	1484	128	32	115	7	1	155
28002	17959s (+0.4s)	1480	1480	128	32	115	6	0	153
28003	17959s (+0.7s)	2624	2624	256	57	160	0	14	231
28004	17960s (+0.8s)	3268	3268	256	74	193	0	12	279
28005	17961s (+0.5s)	1608	1608	128	26	130	0	4	160
28006	17961s (+0.7s)	2628	2628	256	41	174	0	17	232
28007	17962s (+0.7s)	2904	2904	256	65	181	11	0	257
28008	17963s (+1.1s)	4512	4512	256	86	263	27	0	376
28009	17964s (+0.7s)	2684	2684	256	65	164	7	0	236
28010	17964s (+0.7s)	2876	2876	256	56	172	7	1	236
28011	17965s (+0.8s)	3208	3208	256	67	188	14	1	270
28012	17966s (+0.5s)	1780	1780	128	38	131	7	1	177
28013	17966s (+0.3s)	1052	1052	128	20	89	3	0	112
28014	17967s (+0.6s)	2252	2252	128	61	142	14	0	217
28015	17968s (+1.0s)	4180	4180	256	88	243	16	0	347
28016	17968s (+0.8s)	3212	3212	256	68	185	13	0	266
28017	17969s (+0.5s)	1696	1696	128	41	130	5	0	176
28018	17970s (+0.6s)	2364	2364	256	39	149	12	0	200
28019	17970s (+0.9s)	3784	3784	256	89	192	25	0	306
28020	17971s (+0.5s)	1592	1592	128	36	123	6	0	165
28021	17972s (+1.1s)	5528	5528	512	101	260	29	0	390
28022	17972s (+0.4s)	1456	1456	128	34	112	5	0	151
28023	17973s (+0.6s)	2356	2356	256	47	142	10	0	199
28024	17974s (+0.6s)	2472	2472	256	54	145	11	1	211
28025	17974s (+0.5s)	1596	1596	128	51	118	4	0	173
28026	17974s (+0.3s)	900	900	64	32	77	6	1	116
28027	17975s (+0.8s)	3540	3540	256	77	200	15	1	293
28028	17976s (+0.4s)	1460	1460	128	31	118	5	0	154
28029	17976s (+0.3s)	1032	1032	64	29	89	4	0	122
28030	17977s (+0.5s)	1756	1756	128	54	118	9	0	181
28031	17977s (+0.5s)	2068	2068	128	55	128	11	0	194
28032	17978s (+0.6s)	2504	2504	128	57	163	16	1	237
28033	17978s (+0.6s)	2228	2228	128	50	151	11	0	212
28034	17979s (+0.6s)	2696	2696	256	50	163	12	0	225
28035	17980s (+0.7s)	2604	2604	128	74	165	7	0	246
28036	17980s (+0.6s)	1924	1924	128	53	134	12	0	199
28037	17981s (+0.5s)	1504	1504	128	28	127	5	0	160
28038	17981s (+0.6s)	2180	2180	128	54	138	13	0	205
28039	17982s (+0.2s)	660	660	64	21	61	3	0	85
28040	17983s (+0.9s)	3912	3912	256	89	214	13	1	317
28041	17983s (+0.5s)	1764	1764	128	38	133	6	0	177
28042	17983s (+0.4s)	1296	1296	128	34	94	11	0	139
28043	17984s (+0.8s)	3264	3264	256	69	192	11	1	273
28044	17985s (+0.3s)	804	804	64	27	79	2	0	108
28045	17985s (+0.5s)	1896	1896	128	40	149	0	5	194
28046	17986s (+0.6s)	2224	2224	128	42	158	0	11	211
28047	17986s (+0.5s)	1728	1728	128	32	133	0	8	173
28048	17987s (+0.6s)	2492	2492	256	35	170	0	7	212
28049	17988s (+0.8s)	3096	3096	256	49	209	0	10	268
28050	17988s (+0.3s)	716	716	64	16	73	0	4	93
28051	17989s (+1.0s)	4308	4308	256	89	255	0	18	362
28052	17989s (+0.5s)	1492	1492	128	33	117	1	6	157
28053	17990s (+0.5s)	1876	1876	128	36	145	0	9	190
28054	17991s (+0.8s)	3384	3384	256	48	211	0	18	277
28055	17991s (+0.6s)	2416	2416	256	52	142	0	12	206
28056	17992s (+1.2s)	6168	6168	512	94	310	0	25	429
28057	17993s (+0.4s)	1528	1528	128	24	124	0	4	152
28058	17994s (+0.7s)	2996	2996	256	65	180	13	2	260
28059	17994s (+0.8s)	3512	3512	256	76	199	17	0	292
28060	17995s (+0.4s)	1500	1500	128	44	106	8	0	158
28061	17995s (+0.4s)	1408	1408	128	33	108	4	0	145
28062	17996s (+0.5s)	1692	1692	128	36	131	7	0	174
28063	17996s (+0.7s)	2824	2824	256	60	182	7	0	249
28064	17997s (+0.8s)	3508	3508	256	74	206	16	0	296
28065	17998s (+0.2s)	672	672	64	18	66	2	1	87
28066	17999s (+1.1s)	5216	5216	512	86	277	13	0	376
28067	17999s (+0.8s)	3512	3512	256	66	214	12	0	292
28068	18000s (+0.5s)	1600	1600	128	32	123	9	0	164
28069	18000s (+0.3s)	868	868	64	24	86	3	0	113
28070	18001s (+0.5s)	1676	1676	128	37	131	3	0	171
28071	18002s (+1.1s)	5440	5440	512	89	279	18	0	386
28072	18003s (+0.9s)	3648	3648	256	77	216	21	0	314
28073	18003s (+0.5s)	2316	2316	256	50	139	4	0	193
28074	18004s (+0.6s)	2644	2644	256	57	158	11	0	226
28075	18005s (+0.6s)	2536	2536	256	44	164	0	7	215
28076	18005s (+0.6s)	2624	2624	256	41	178	0	12	231
28077	18006s (+0.6s)	2532	2532	256	58	147	0	13	218
28078	18007s (+0.8s)	3212	3212	256	50	212	0	8	270
28079	18007s (+0.7s)	2832	2832	256	38	198	0	8	244
28080	18008s (+0.7s)	3232	3232	256	54	204	0	13	271
28081	18009s (+1.0s)	4248	4248	256	81	254	0	17	352
28082	18010s (+0.5s)	1612	1612	128	38	125	6	1	170
28083	18010s (+0.7s)	2584	2584	128	60	168	13	0	241
28084	18011s (+0.6s)	2676	2676	256	60	157	10	1	228
28085	18012s (+1.2s)	6244	6244	512	126	295	26	0	447
28086	18013s (+0.9s)	3764	3764	256	80	218	13	1	312
28087	18014s (+0.8s)	3536	3536	256	73	216	9	0	298
28088	18015s (+1.1s)	5332	5332	512	89	264	13	0	366
28089	18015s (+0.3s)	916	916	64	27	90	3	0	120
28090	18016s (+0.8s)	3160	3160	256	86	170	16	1	273
28091	18017s (+0.5s)	1860	1860	128	51	127	10	0	188
28092	18017s (+0.3s)	808	808	64	21	80	4	1	106
28093	18018s (+0.6s)	2112	2112	128	66	124	13	1	204
28094	18018s (+0.6s)	2256	2256	128	63	136	13	0	212
28095	18019s (+0.4s)	1492	1492	128	44	103	10	0	157
28096	18019s (+0.5s)	1788	1788	128	56	112	8	0	176
28097	18020s (+0.6s)	1832	1832	128	42	141	9	0	192
28098	18020s (+0.4s)	1188	1188	128	26	94	0	7	127
28099	18021s (+0.4s)	1480	1480	128	35	111	0	8	154
Episode	Time	Reward	Score	Highest	L	U	R	D	Steps
28100	18021s (+0.4s)	1108	1108	64	32	100	0	4	136
28101	18021s (+0.4s)	1324	1324	128	28	103	0	5	136
28102	18022s (+0.7s)	2828	2828	256	62	167	0	11	240
28103	18023s (+1.0s)	4212	4212	256	86	243	19	0	348
28104	18024s (+0.7s)	2868	2868	256	62	188	5	0	255
28105	18024s (+0.8s)	3208	3208	256	64	194	11	0	269
28106	18025s (+0.6s)	2356	2356	128	70	145	12	0	227
28107	18026s (+0.5s)	1804	1804	128	39	142	5	0	186
28108	18027s (+1.0s)	4392	4392	256	86	267	14	0	367
28109	18027s (+0.3s)	1016	1016	128	26	78	4	0	108
28110	18027s (+0.4s)	1028	1028	64	31	87	6	1	125
28111	18028s (+0.5s)	1480	1480	64	45	114	9	1	169
28112	18029s (+0.8s)	3348	3348	256	70	199	13	1	283
28113	18030s (+0.8s)	3504	3504	256	66	214	10	0	290
28114	18030s (+0.6s)	2316	2316	256	48	143	11	0	202
28115	18031s (+0.9s)	3544	3544	256	73	211	16	0	300
28116	18032s (+0.8s)	3400	3400	256	67	201	15	0	283
28117	18032s (+0.7s)	2916	2916	256	59	175	14	0	248
28118	18033s (+0.4s)	1164	1164	64	34	95	9	0	138
28119	18034s (+0.8s)	3216	3216	256	71	183	13	0	267
28120	18034s (+0.3s)	828	828	64	25	79	0	6	110
28121	18034s (+0.4s)	1564	1564	128	27	122	0	11	160
28122	18035s (+0.2s)	636	636	64	12	71	0	2	85
28123	18035s (+0.2s)	372	372	32	7	50	0	4	61
28124	18036s (+0.7s)	3136	3136	256	54	186	0	13	253
28125	18036s (+0.3s)	1016	1016	128	22	82	5	0	109
28126	18037s (+1.1s)	5656	5656	512	85	298	18	0	401
28127	18037s (+0.3s)	896	896	64	24	83	7	0	114
28128	18038s (+0.4s)	1328	1328	128	35	100	8	0	143
28129	18038s (+0.5s)	1628	1628	128	46	115	5	0	166
28130	18039s (+0.5s)	1540	1540	128	39	113	6	0	158
28131	18039s (+0.7s)	2696	2696	256	61	161	10	0	232
28132	18040s (+0.7s)	2792	2792	256	64	168	9	0	241
28133	18041s (+0.5s)	1576	1576	128	39	117	5	0	161
28134	18042s (+1.0s)	4320	4320	256	98	248	19	0	365
28135	18042s (+0.4s)	1064	1064	64	30	92	7	0	129
28136	18043s (+0.6s)	1904	1904	128	46	141	9	0	196
28137	18043s (+0.3s)	748	748	64	25	68	7	0	100
28138	18043s (+0.5s)	1824	1824	128	54	124	8	0	186
28139	18044s (+0.2s)	420	420	32	14	48	3	1	66
28140	18044s (+0.9s)	3788	3788	256	76	217	20	0	313
28141	18046s (+1.1s)	5484	5484	512	83	285	18	0	386
28142	18046s (+0.6s)	2440	2440	128	67	146	15	0	228
28143	18047s (+0.5s)	1948	1948	128	54	132	9	0	195
28144	18047s (+0.7s)	2944	2944	256	53	177	8	0	238
28145	18048s (+0.4s)	1264	1264	128	26	107	3	0	136
28146	18049s (+0.9s)	4224	4224	256	83	246	17	0	346
28147	18049s (+0.5s)	1796	1796	128	42	132	10	0	184
28148	18050s (+0.6s)	2180	2180	128	69	136	14	0	219
28149	18051s (+0.9s)	4092	4092	256	100	207	24	0	331
28150	18052s (+1.0s)	4100	4100	256	97	231	14	0	342
28151	18053s (+0.8s)	3288	3288	256	66	200	8	0	274
28152	18053s (+0.2s)	604	604	64	17	62	3	0	82
28153	18053s (+0.5s)	1672	1672	128	33	128	7	1	169
28154	18054s (+0.9s)	3972	3972	256	77	236	14	0	327
28155	18055s (+0.3s)	1136	1136	128	28	86	0	7	121
28156	18055s (+0.6s)	1944	1944	128	50	135	7	1	193
28157	18056s (+0.7s)	2880	2880	256	71	160	19	0	250
28158	18057s (+0.9s)	3948	3948	256	83	224	14	0	321
28159	18057s (+0.4s)	1264	1264	64	30	101	9	1	141
28160	18058s (+0.9s)	3532	3532	256	70	213	13	1	297
28161	18059s (+0.7s)	2664	2664	256	47	171	9	0	227
28162	18059s (+0.4s)	1348	1348	128	30	106	6	0	142
28163	18060s (+0.8s)	3552	3552	256	89	190	18	0	297
28164	18061s (+0.9s)	3868	3868	256	76	236	16	0	328
28165	18061s (+0.4s)	1056	1056	64	37	82	9	0	128
28166	18062s (+0.8s)	3340	3340	256	79	194	8	0	281
28167	18063s (+0.7s)	2960	2960	256	49	184	12	0	245
28168	18063s (+0.2s)	568	568	64	23	49	5	0	77
28169	18064s (+1.2s)	5968	5968	512	125	273	18	0	416
28170	18065s (+0.5s)	1700	1700	128	39	128	3	0	170
28171	18065s (+0.5s)	1564	1564	128	29	133	7	0	169
28172	18066s (+0.8s)	3516	3516	256	67	214	12	0	293
28173	18066s (+0.3s)	860	860	64	25	81	5	0	111
28174	18067s (+0.5s)	1548	1548	128	33	118	8	0	159
28175	18067s (+0.4s)	1540	1540	128	31	118	8	0	157
28176	18068s (+0.3s)	876	876	64	23	88	4	0	115
28177	18068s (+0.8s)	3480	3480	256	85	194	10	0	289
28178	18069s (+0.6s)	2196	2196	128	59	141	8	0	208
28179	18070s (+1.1s)	5708	5708	512	115	257	25	1	398
28180	18071s (+0.8s)	3252	3252	256	66	183	13	0	262
28181	18071s (+0.4s)	1036	1036	64	28	89	7	0	124
28182	18072s (+0.8s)	3400	3400	256	60	209	12	0	281
28183	18073s (+0.5s)	1952	1952	128	44	140	0	11	195
28184	18073s (+0.3s)	888	888	64	22	81	0	7	110
28185	18073s (+0.5s)	1776	1776	128	36	136	0	11	183
28186	18075s (+1.1s)	5636	5636	512	77	298	0	22	397
28187	18075s (+0.7s)	2984	2984	256	54	190	0	9	253
28188	18076s (+0.6s)	2516	2516	256	45	165	0	10	220
28189	18077s (+0.7s)	2812	2812	256	50	183	0	12	245
28190	18077s (+0.7s)	2892	2892	256	56	175	0	9	240
28191	18078s (+0.5s)	1564	1564	128	29	124	0	6	159
28192	18078s (+0.5s)	1752	1752	128	35	138	0	5	178
28193	18079s (+0.3s)	800	800	64	20	81	0	4	105
28194	18079s (+0.5s)	1508	1508	128	32	124	4	0	160
28195	18080s (+0.9s)	3756	3756	256	83	209	18	0	310
28196	18080s (+0.4s)	1484	1484	128	31	113	11	1	156
28197	18081s (+0.5s)	1760	1760	128	45	126	9	0	180
28198	18081s (+0.5s)	1444	1444	64	49	101	10	0	160
28199	18082s (+0.8s)	3528	3528	256	78	200	18	0	296
Episode	Time	Reward	Score	Highest	L	U	R	D	Steps
28200	18083s (+0.4s)	1412	1412	128	46	96	3	1	146
28201	18084s (+1.0s)	4412	4412	256	99	248	21	0	368
28202	18084s (+0.7s)	2724	2724	256	45	182	6	0	233
28203	18085s (+0.3s)	1008	1008	128	22	89	1	0	112
28204	18085s (+0.4s)	1152	1152	64	30	99	6	0	135
28205	18086s (+0.8s)	3516	3516	256	77	205	12	0	294
28206	18087s (+0.9s)	3624	3624	256	77	215	16	0	308
28207	18087s (+0.6s)	2216	2216	256	45	140	8	0	193
28208	18088s (+0.5s)	1524	1524	128	32	119	8	0	159
28209	18089s (+0.7s)	3096	3096	256	56	188	10	0	254
28210	18089s (+0.8s)	3232	3232	256	52	215	9	0	276
28211	18090s (+0.5s)	1644	1644	128	53	115	5	0	173
28212	18090s (+0.4s)	1120	1120	64	34	100	5	0	139
28213	18091s (+0.8s)	3448	3448	256	73	200	12	0	285
28214	18092s (+0.5s)	1772	1772	128	36	132	11	0	179
28215	18092s (+0.5s)	1796	1796	128	49	124	10	1	184
28216	18093s (+0.5s)	1792	1792	128	40	138	6	0	184
28217	18094s (+0.8s)	3384	3384	256	88	191	9	0	288
28218	18094s (+0.7s)	2912	2912	256	69	168	17	0	254
28219	18095s (+0.4s)	1244	1244	128	22	103	5	0	130
28220	18095s (+0.6s)	2672	2672	256	50	165	7	0	222
28221	18096s (+0.9s)	4008	4008	256	102	203	20	0	325
28222	18097s (+0.5s)	1672	1672	128	39	119	11	0	169
28223	18097s (+0.4s)	1496	1496	128	40	102	9	0	151
28224	18097s (+0.3s)	1044	1044	64	30	89	5	1	125
28225	18099s (+1.2s)	5936	5936	512	94	309	0	19	422
28226	18099s (+0.6s)	2156	2156	128	47	138	0	15	200
28227	18100s (+0.5s)	1600	1600	128	34	125	0	8	167
28228	18100s (+0.5s)	1816	1816	128	37	143	0	4	184
28229	18101s (+0.5s)	1592	1592	128	44	112	0	9	165
28230	18101s (+0.2s)	420	420	32	15	48	0	4	67
28231	18102s (+0.8s)	3368	3368	256	56	212	1	9	278
28232	18102s (+0.7s)	3116	3116	256	48	195	0	10	253
28233	18103s (+0.9s)	3544	3544	256	70	212	0	18	300
28234	18104s (+0.8s)	3432	3432	256	57	209	0	16	282
28235	18104s (+0.2s)	464	464	64	14	49	0	5	68
28236	18105s (+0.6s)	1972	1972	128	62	137	7	0	206
28237	18106s (+0.8s)	3316	3316	256	52	220	8	0	280
28238	18106s (+0.4s)	1464	1464	128	26	120	6	0	152
28239	18107s (+0.8s)	3544	3544	256	81	193	19	0	293
28240	18107s (+0.3s)	1028	1028	128	24	81	7	0	112
28241	18109s (+1.3s)	6536	6536	512	106	342	21	0	469
28242	18109s (+0.3s)	788	788	64	23	75	6	1	105
28243	18109s (+0.5s)	1588	1588	128	30	125	4	0	159
28244	18110s (+0.7s)	2872	2872	256	56	170	9	0	235
28245	18111s (+0.5s)	1876	1876	128	58	121	12	0	191
28246	18111s (+0.7s)	2976	2976	256	60	193	12	0	265
28247	18112s (+0.7s)	3068	3068	256	75	171	11	0	257
28248	18113s (+1.1s)	5688	5688	512	111	271	27	0	409
28249	18114s (+0.8s)	3208	3208	256	65	194	7	0	266
28250	18114s (+0.4s)	1344	1344	128	35	96	6	0	137
28251	18115s (+0.8s)	3228	3228	256	64	191	15	0	270
28252	18116s (+1.2s)	6028	6028	512	112	292	21	0	425
28253	18117s (+0.4s)	1268	1268	128	31	104	3	0	138
28254	18117s (+0.7s)	2844	2844	256	75	154	13	1	243
28255	18118s (+0.6s)	2224	2224	128	55	148	9	0	212
28256	18118s (+0.3s)	860	860	64	19	90	2	0	111
28257	18119s (+1.0s)	4320	4320	256	77	265	10	1	353
28258	18120s (+0.6s)	2548	2548	256	48	169	7	0	224
28259	18121s (+0.5s)	1856	1856	128	42	138	8	0	188
28260	18121s (+0.5s)	1952	1952	128	50	119	15	0	184
28261	18122s (+0.7s)	2828	2828	256	53	165	12	0	230
28262	18123s (+0.9s)	4668	4668	512	86	210	18	1	315
28263	18123s (+0.5s)	1496	1496	128	31	119	8	0	158
28264	18124s (+0.7s)	2596	2596	128	62	172	10	0	244
28265	18124s (+0.3s)	1044	1044	128	19	92	1	0	112
28266	18125s (+0.4s)	1496	1496	128	29	123	5	0	157
28267	18125s (+0.4s)	1472	1472	128	37	108	5	0	150
28268	18126s (+0.8s)	3512	3512	256	86	195	17	0	298
28269	18126s (+0.4s)	1216	1216	128	29	99	6	1	135
28270	18127s (+0.4s)	1488	1488	128	41	107	8	0	156
28271	18127s (+0.4s)	1560	1560	128	45	98	10	0	153
28272	18128s (+0.8s)	3384	3384	256	62	217	13	0	292
28273	18129s (+0.5s)	1848	1848	128	41	139	5	0	185
28274	18129s (+0.8s)	3524	3524	256	77	200	19	0	296
28275	18130s (+0.7s)	2704	2704	256	62	163	11	0	236
28276	18131s (+0.8s)	3316	3316	256	56	211	9	0	276
28277	18132s (+0.6s)	2060	2060	128	51	146	9	0	206
28278	18132s (+0.9s)	3768	3768	256	70	220	13	2	305
28279	18133s (+0.8s)	3396	3396	256	74	189	15	0	278
28280	18134s (+0.6s)	2340	2340	128	54	158	7	1	220
28281	18135s (+0.7s)	2924	2924	256	55	193	9	0	257
28282	18135s (+0.5s)	2088	2088	128	51	131	10	0	192
28283	18136s (+0.6s)	2556	2556	256	52	159	9	0	220
28284	18136s (+0.3s)	860	860	64	17	91	3	0	111
28285	18137s (+0.5s)	1736	1736	128	38	129	8	0	175
28286	18137s (+1.0s)	4128	4128	256	96	226	16	0	338
28287	18138s (+0.5s)	1812	1812	128	50	129	8	0	187
28288	18139s (+1.0s)	4260	4260	256	93	250	12	0	355
28289	18140s (+0.7s)	2932	2932	256	57	193	9	0	259
28290	18140s (+0.4s)	1376	1376	128	30	107	7	0	144
28291	18141s (+0.7s)	2860	2860	256	68	164	14	0	246
28292	18141s (+0.6s)	1896	1896	128	49	134	9	0	192
28293	18142s (+0.3s)	692	692	32	33	65	3	0	101
28294	18142s (+0.6s)	2244	2244	128	50	150	9	0	209
28295	18143s (+0.4s)	1348	1348	128	27	107	6	0	140
28296	18143s (+0.7s)	2856	2856	256	76	146	12	1	235
28297	18144s (+0.8s)	3684	3684	256	91	196	17	0	304
28298	18146s (+1.4s)	6620	6620	512	129	323	28	0	480
28299	18146s (+0.5s)	1656	1656	128	43	114	7	2	166
Episode	Time	Reward	Score	Highest	L	U	R	D	Steps
28300	18147s (+0.3s)	872	872	64	25	87	2	0	114
28301	18147s (+0.7s)	3124	3124	256	74	181	14	0	269
28302	18148s (+0.6s)	2332	2332	128	65	140	13	0	218
28303	18148s (+0.3s)	876	876	64	23	87	4	0	114
28304	18149s (+1.0s)	4080	4080	256	82	242	18	0	342
28305	18150s (+1.1s)	5596	5596	512	105	270	22	0	397
28306	18151s (+0.9s)	4020	4020	256	79	235	14	0	328
28307	18152s (+0.3s)	732	732	64	18	73	0	5	96
28308	18153s (+1.0s)	4348	4348	256	94	227	20	0	341
28309	18153s (+0.7s)	2728	2728	256	51	173	7	0	231
28310	18154s (+0.8s)	3192	3192	256	86	164	15	0	265
28311	18155s (+1.0s)	4848	4848	512	88	237	14	0	339
28312	18156s (+1.3s)	6792	6792	512	127	310	28	0	465
28313	18157s (+0.3s)	680	680	64	20	70	1	0	91
28314	18157s (+1.0s)	5008	5008	512	94	248	16	0	358
28315	18158s (+0.3s)	864	864	64	27	82	3	0	112
28316	18159s (+1.0s)	4196	4196	256	68	257	19	0	344
28317	18159s (+0.6s)	2480	2480	256	62	137	13	0	212
28318	18160s (+0.9s)	3584	3584	256	62	221	16	0	299
28319	18161s (+0.9s)	4004	4004	256	91	219	16	0	326
28320	18162s (+0.7s)	2780	2780	256	47	179	11	1	238
28321	18162s (+0.4s)	1364	1364	128	45	102	5	0	152
28322	18163s (+0.6s)	2044	2044	128	43	152	11	0	206
28323	18163s (+0.4s)	1328	1328	128	26	116	5	0	147
28324	18164s (+0.8s)	3212	3212	256	65	188	14	0	267
28325	18165s (+0.5s)	1688	1688	128	36	126	12	0	174
28326	18165s (+0.8s)	3224	3224	256	72	186	10	0	268
28327	18166s (+0.9s)	4088	4088	256	95	220	14	0	329
28328	18167s (+0.7s)	2788	2788	256	50	173	11	0	234
28329	18167s (+0.5s)	1492	1492	128	31	123	4	0	158
28330	18168s (+0.8s)	3496	3496	256	69	208	15	1	293
28331	18169s (+0.7s)	3040	3040	256	58	176	11	0	245
28332	18170s (+0.8s)	3288	3288	256	69	199	12	0	280
28333	18171s (+0.9s)	4644	4644	512	89	216	11	0	316
28334	18171s (+0.7s)	3032	3032	256	60	174	10	0	244
28335	18172s (+0.9s)	3920	3920	256	81	226	13	0	320
28336	18173s (+0.8s)	3588	3588	256	74	210	12	0	296
28337	18174s (+0.7s)	3124	3124	256	65	179	16	1	261
28338	18175s (+1.1s)	4492	4492	256	100	259	16	1	376
28339	18176s (+0.9s)	3976	3976	256	75	240	13	0	328
28340	18177s (+0.9s)	4032	4032	256	87	229	15	0	331
28341	18178s (+0.8s)	3528	3528	256	81	199	16	0	296
28342	18178s (+0.6s)	1904	1904	128	48	140	6	0	194
28343	18179s (+0.7s)	2540	2540	128	68	151	16	0	235
28344	18180s (+1.0s)	4312	4312	256	95	237	20	0	352
28345	18181s (+0.8s)	3428	3428	256	64	212	12	0	288
28346	18181s (+0.7s)	3196	3196	256	48	207	7	0	262
28347	18182s (+0.6s)	1920	1920	128	47	142	9	0	198
28348	18183s (+0.5s)	2260	2260	256	60	129	5	0	194
28349	18183s (+0.4s)	1160	1160	128	30	91	5	0	126
28350	18184s (+0.6s)	2540	2540	256	49	169	8	0	226
28351	18184s (+0.3s)	1212	1212	128	31	85	9	0	125
28352	18185s (+0.8s)	3364	3364	256	67	208	12	0	287
28353	18185s (+0.3s)	748	748	64	19	77	4	0	100
28354	18186s (+0.4s)	1448	1448	128	42	101	8	0	151
28355	18187s (+1.1s)	4704	4704	256	125	250	20	1	396
28356	18187s (+0.8s)	3080	3080	256	60	193	0	11	264
28357	18188s (+0.5s)	1804	1804	128	31	148	0	7	186
28358	18189s (+0.9s)	3712	3712	256	68	230	0	13	311
28359	18190s (+0.7s)	2812	2812	256	47	190	0	9	246
28360	18190s (+0.9s)	3972	3972	256	68	243	0	16	327
28361	18191s (+0.8s)	3444	3444	256	73	201	0	14	288
28362	18192s (+0.5s)	1640	1640	128	39	127	1	0	167
28363	18192s (+0.5s)	1792	1792	128	37	142	7	1	187
28364	18193s (+0.8s)	3544	3544	256	79	200	19	0	298
28365	18194s (+0.7s)	2764	2764	256	53	176	10	0	239
28366	18195s (+0.8s)	3544	3544	256	78	201	16	0	295
28367	18195s (+0.7s)	2784	2784	128	72	173	14	0	259
28368	18196s (+0.8s)	3356	3356	256	65	205	15	0	285
28369	18197s (+0.7s)	2768	2768	256	71	154	11	0	236
28370	18197s (+0.4s)	1476	1476	128	38	107	8	0	153
28371	18198s (+0.5s)	1864	1864	128	48	136	5	0	189
28372	18198s (+0.5s)	1616	1616	128	42	122	7	0	171
28373	18199s (+1.0s)	4136	4136	256	95	223	23	0	341
28374	18200s (+0.9s)	4764	4764	512	74	242	13	0	329
28375	18201s (+1.0s)	4280	4280	256	72	264	0	20	356
28376	18202s (+0.6s)	2400	2400	256	39	160	0	5	204
28377	18202s (+0.4s)	1220	1220	64	27	105	0	5	137
28378	18203s (+0.4s)	1052	1052	64	22	98	0	8	128
28379	18203s (+0.7s)	2856	2856	256	60	177	8	0	245
28380	18204s (+0.7s)	3204	3204	256	59	193	12	0	264
28381	18205s (+0.6s)	2572	2572	256	54	159	10	0	223
28382	18206s (+1.1s)	4572	4572	256	99	259	19	0	377
28383	18206s (+0.5s)	1696	1696	128	41	128	6	0	175
28384	18207s (+0.5s)	1564	1564	128	43	118	4	0	165
28385	18207s (+0.4s)	984	984	64	35	84	6	0	125
28386	18207s (+0.3s)	1188	1188	128	36	85	5	0	126
28387	18208s (+0.7s)	2772	2772	256	60	173	7	1	241
28388	18209s (+1.3s)	6416	6416	512	109	326	23	0	458
28389	18210s (+0.4s)	1336	1336	128	38	94	7	0	139
28390	18210s (+0.6s)	1904	1904	128	41	148	5	0	194
28391	18211s (+0.6s)	2000	2000	128	45	144	14	0	203
28392	18212s (+0.6s)	1992	1992	128	54	140	10	0	204
28393	18212s (+0.6s)	1956	1956	128	48	147	7	0	202
28394	18213s (+0.7s)	3192	3192	256	70	177	14	0	261
28395	18214s (+0.7s)	2776	2776	256	52	174	11	0	237
28396	18214s (+0.6s)	2004	2004	128	63	128	8	0	199
28397	18215s (+0.5s)	1904	1904	128	41	146	7	0	194
28398	18215s (+0.4s)	1376	1376	128	46	93	6	0	145
28399	18216s (+0.4s)	1304	1304	64	39	104	9	0	152
Episode	Time	Reward	Score	Highest	L	U	R	D	Steps
28400	18216s (+0.7s)	2916	2916	256	66	178	11	0	255
28401	18217s (+0.3s)	856	856	64	22	85	3	0	110
28402	18218s (+0.8s)	3544	3544	256	71	208	18	0	297
28403	18218s (+0.7s)	2780	2780	128	76	162	20	0	258
28404	18219s (+0.5s)	1736	1736	128	36	128	10	0	174
28405	18219s (+0.6s)	2688	2688	256	43	173	11	0	227
28406	18220s (+0.6s)	2748	2748	256	54	159	9	0	222
28407	18221s (+0.7s)	2356	2356	128	55	157	14	1	227
28408	18222s (+1.0s)	5172	5172	512	78	261	16	1	356
28409	18222s (+0.4s)	892	892	64	26	87	5	0	118
28410	18222s (+0.3s)	1112	1112	128	26	89	5	0	120
28411	18224s (+1.0s)	4604	4604	256	96	265	20	0	381
28412	18224s (+0.7s)	2776	2776	256	49	186	6	0	241
28413	18225s (+0.5s)	1664	1664	128	34	133	2	0	169
28414	18225s (+0.6s)	2156	2156	128	55	145	10	0	210
28415	18226s (+0.2s)	620	620	64	14	65	3	0	82
28416	18226s (+0.6s)	2396	2396	256	43	154	3	1	201
28417	18227s (+0.9s)	3724	3724	256	63	239	0	15	317
28418	18227s (+0.2s)	568	568	64	19	55	1	2	77
28419	18228s (+0.7s)	2912	2912	256	61	186	0	7	254
28420	18229s (+0.9s)	3740	3740	256	64	230	0	13	307
28421	18229s (+0.6s)	1832	1832	128	38	142	0	12	192
28422	18230s (+0.3s)	680	680	64	17	72	0	5	94
28423	18230s (+0.6s)	2276	2276	128	71	136	11	0	218
28424	18231s (+0.7s)	3244	3244	256	67	184	14	2	267
28425	18231s (+0.4s)	1032	1032	64	21	101	4	0	126
28426	18232s (+0.9s)	3968	3968	256	70	244	14	0	328
28427	18233s (+0.5s)	1564	1564	64	55	113	6	0	174
28428	18233s (+0.2s)	560	560	64	16	55	3	1	75
28429	18234s (+0.5s)	1680	1680	128	28	140	4	0	172
28430	18234s (+0.6s)	2384	2384	256	39	159	3	0	201
28431	18235s (+0.8s)	3580	3580	256	85	205	13	0	303
28432	18235s (+0.3s)	984	984	64	25	95	5	0	125
28433	18236s (+1.0s)	5452	5452	512	112	253	19	0	384
28434	18237s (+0.3s)	868	868	64	25	83	4	0	112
28435	18237s (+0.6s)	2420	2420	256	39	156	7	0	202
28436	18238s (+0.4s)	1472	1472	128	38	106	8	1	153
28437	18238s (+0.4s)	1484	1484	128	39	113	6	0	158
28438	18239s (+0.6s)	2484	2484	256	49	155	8	1	213
28439	18240s (+0.8s)	3292	3292	256	65	192	14	0	271
28440	18241s (+1.1s)	5788	5788	512	107	270	26	0	403
28441	18241s (+0.5s)	1800	1800	128	54	119	12	0	185
28442	18242s (+0.5s)	1560	1560	128	33	128	7	0	168
28443	18242s (+0.5s)	1528	1528	128	41	111	9	0	161
28444	18243s (+0.5s)	1772	1772	128	59	112	12	0	183
28445	18244s (+0.8s)	3564	3564	256	83	199	16	0	298
28446	18244s (+0.4s)	1292	1292	128	23	107	7	0	137
28447	18245s (+0.7s)	2808	2808	256	61	168	15	1	245
28448	18246s (+0.9s)	3856	3856	256	89	220	14	0	323
28449	18246s (+0.3s)	924	924	64	30	78	4	0	112
28450	18247s (+0.6s)	2220	2220	128	69	139	13	0	221
28451	18247s (+0.6s)	1916	1916	128	48	144	5	0	197
28452	18248s (+0.4s)	1224	1224	128	32	98	4	0	134
28453	18248s (+0.3s)	1040	1040	128	24	84	0	2	110
28454	18248s (+0.5s)	1488	1488	128	29	122	0	6	157
28455	18249s (+0.4s)	1452	1452	128	23	125	0	4	152
28456	18250s (+0.8s)	3256	3256	256	47	214	0	11	272
28457	18250s (+0.5s)	1716	1716	128	34	137	0	7	178
28458	18251s (+0.5s)	1936	1936	128	37	144	0	8	189
28459	18251s (+0.4s)	1484	1484	128	30	115	0	7	152
28460	18251s (+0.3s)	828	828	64	22	78	0	7	107
28461	18252s (+0.5s)	1916	1916	128	46	126	0	5	177
28462	18252s (+0.5s)	1712	1712	128	36	130	0	7	173
28463	18253s (+0.6s)	2028	2028	128	45	141	0	8	194
28464	18253s (+0.4s)	1312	1312	128	25	105	0	3	133
28465	18254s (+0.5s)	1792	1792	128	34	140	0	9	183
28466	18254s (+0.4s)	1296	1296	128	34	101	5	0	140
28467	18255s (+0.9s)	3628	3628	256	72	222	15	0	309
28468	18256s (+0.4s)	1328	1328	128	42	97	9	0	148
28469	18256s (+0.6s)	2080	2080	128	63	135	12	0	210
28470	18257s (+0.5s)	1796	1796	128	50	124	7	0	181
28471	18257s (+0.5s)	1584	1584	128	41	115	7	0	163
28472	18258s (+0.8s)	3296	3296	256	75	182	18	0	275
28473	18258s (+0.4s)	1300	1300	128	38	96	6	1	141
28474	18259s (+0.6s)	2232	2232	128	47	154	12	0	213
28475	18260s (+0.8s)	3248	3248	256	65	195	15	0	275
28476	18260s (+0.2s)	344	344	32	13	43	0	7	63
28477	18261s (+0.6s)	2400	2400	128	47	165	0	12	224
28478	18261s (+0.6s)	2432	2432	256	49	152	7	0	208
28479	18262s (+0.6s)	2356	2356	256	49	142	9	0	200
28480	18263s (+0.8s)	3320	3320	256	75	191	11	0	277
28481	18263s (+0.6s)	2192	2192	128	37	157	0	10	204
28482	18263s (+0.3s)	704	704	64	15	73	0	3	91
28483	18264s (+0.3s)	804	804	64	22	83	3	0	108
28484	18264s (+0.6s)	2476	2476	256	52	151	9	0	212
28485	18265s (+0.7s)	2924	2924	256	60	189	8	0	257
28486	18266s (+0.4s)	1448	1448	128	33	110	4	0	147
28487	18266s (+0.5s)	1796	1796	128	53	125	6	0	184
28488	18267s (+0.7s)	2844	2844	256	48	190	0	11	249
28489	18268s (+1.0s)	4224	4224	256	81	241	0	24	346
28490	18268s (+0.4s)	1464	1464	128	25	123	2	1	151
28491	18269s (+0.5s)	1704	1704	128	48	117	11	0	176
28492	18270s (+1.0s)	4080	4080	256	100	224	14	0	338
28493	18270s (+0.8s)	3604	3604	256	87	197	16	0	300
28494	18271s (+0.7s)	2776	2776	128	74	173	13	0	260
28495	18272s (+0.7s)	3328	3328	256	71	183	15	0	269
28496	18272s (+0.5s)	1680	1680	128	35	138	2	0	175
28497	18273s (+0.9s)	3756	3756	256	80	221	13	0	314
28498	18274s (+0.7s)	3188	3188	256	72	173	20	0	265
28499	18275s (+0.7s)	2768	2768	256	55	173	11	0	239
Episode	Time	Reward	Score	Highest	L	U	R	D	Steps
28500	18275s (+0.5s)	1920	1920	128	49	126	8	0	183
28501	18276s (+0.7s)	2932	2932	256	61	188	10	0	259
28502	18276s (+0.4s)	1120	1120	64	36	84	8	0	128
28503	18277s (+0.8s)	3528	3528	256	75	202	16	1	294
28504	18278s (+0.8s)	3480	3480	256	78	201	10	0	289
28505	18279s (+0.6s)	2260	2260	128	59	132	13	0	204
28506	18279s (+0.6s)	2560	2560	256	50	163	8	0	221
28507	18280s (+0.6s)	2216	2216	128	56	149	16	0	221
28508	18281s (+0.6s)	2228	2228	128	60	143	13	0	216
28509	18281s (+0.3s)	796	796	64	23	77	6	0	106
28510	18281s (+0.4s)	1324	1324	128	32	98	3	0	133
28511	18282s (+0.8s)	3360	3360	256	56	207	14	0	277
28512	18283s (+0.5s)	1416	1416	64	36	120	6	0	162
28513	18283s (+0.8s)	3480	3480	256	72	201	0	17	290
28514	18284s (+0.7s)	2796	2796	256	67	159	0	16	242
28515	18284s (+0.3s)	908	908	64	24	78	0	6	108
28516	18285s (+0.1s)	244	244	32	12	33	1	3	49
28517	18286s (+1.0s)	5240	5240	512	68	273	0	22	363
28518	18286s (+0.5s)	1780	1780	128	45	127	8	0	180
28519	18287s (+0.8s)	3456	3456	256	76	197	15	0	288
28520	18288s (+1.2s)	6056	6056	512	110	290	22	0	422
28521	18289s (+0.5s)	1812	1812	128	49	130	4	0	183
28522	18289s (+0.7s)	2448	2448	128	52	160	15	1	228
28523	18290s (+0.5s)	1764	1764	128	42	127	12	0	181
28524	18290s (+0.6s)	2008	2008	128	62	125	10	0	197
28525	18291s (+0.8s)	3344	3344	256	65	197	20	0	282
28526	18292s (+0.5s)	1792	1792	128	37	141	6	0	184
28527	18292s (+0.2s)	516	516	64	20	51	4	0	75
28528	18293s (+0.6s)	1920	1920	128	41	152	5	0	198
28529	18293s (+0.5s)	1688	1688	128	52	113	8	0	173
28530	18294s (+0.9s)	4160	4160	256	90	235	11	1	337
28531	18295s (+0.6s)	2356	2356	128	57	151	8	1	217
28532	18295s (+0.8s)	3372	3372	256	74	201	14	0	289
28533	18296s (+0.4s)	1080	1080	64	45	80	5	0	130
28534	18296s (+0.3s)	880	880	64	27	75	5	0	107
28535	18296s (+0.3s)	664	664	64	20	63	0	5	88
28536	18297s (+0.4s)	1428	1428	128	29	117	0	6	152
28537	18297s (+0.7s)	2632	2632	256	52	170	0	11	233
28538	18298s (+0.2s)	564	564	64	11	63	0	2	76
28539	18298s (+0.7s)	3144	3144	256	57	195	0	9	261
28540	18299s (+0.8s)	3228	3228	256	73	186	0	11	270
28541	18300s (+0.9s)	3560	3560	256	67	215	15	1	298
28542	18301s (+0.6s)	1912	1912	128	39	149	9	0	197
28543	18301s (+0.5s)	1908	1908	128	46	139	10	0	195
28544	18302s (+0.5s)	1672	1672	128	35	127	8	0	170
28545	18303s (+0.8s)	3352	3352	256	72	193	1	19	285
28546	18304s (+1.0s)	4156	4156	256	72	249	0	20	341
28547	18304s (+0.7s)	2908	2908	256	70	179	0	5	254
28548	18305s (+0.8s)	3320	3320	256	64	208	0	9	281
28549	18305s (+0.4s)	1532	1532	128	30	118	0	4	152
28550	18306s (+0.7s)	3168	3168	256	48	207	0	10	265
28551	18307s (+0.5s)	1668	1668	128	47	112	9	1	169
28552	18307s (+0.5s)	1604	1604	128	43	115	9	0	167
28553	18308s (+0.7s)	2760	2760	256	66	159	13	0	238
28554	18309s (+0.9s)	3876	3876	256	82	222	15	1	320
28555	18310s (+0.9s)	3892	3892	256	76	228	19	0	323
28556	18310s (+0.5s)	1948	1948	128	42	145	7	0	194
28557	18311s (+0.7s)	3180	3180	256	67	186	12	0	265
28558	18311s (+0.5s)	1784	1784	128	42	128	10	0	180
28559	18312s (+0.4s)	1308	1308	128	28	106	4	0	138
28560	18312s (+0.6s)	1924	1924	128	52	137	10	0	199
28561	18313s (+0.6s)	2420	2420	256	34	156	11	1	202
28562	18314s (+1.1s)	4532	4532	256	90	273	16	0	379
28563	18315s (+0.9s)	3888	3888	256	79	223	14	0	316
28564	18315s (+0.3s)	992	992	64	30	85	5	0	120
28565	18316s (+0.7s)	2752	2752	256	38	191	6	1	236
28566	18317s (+0.7s)	2700	2700	256	57	162	15	0	234
28567	18317s (+0.6s)	2220	2220	128	56	153	12	0	221
28568	18318s (+0.8s)	3356	3356	256	67	202	16	0	285
28569	18319s (+0.9s)	3620	3620	256	86	218	10	0	314
28570	18320s (+0.6s)	2372	2372	128	59	151	10	0	220
28571	18320s (+0.4s)	1304	1304	128	37	97	8	0	142
28572	18321s (+0.7s)	2908	2908	256	62	182	9	0	253
28573	18321s (+0.3s)	812	812	64	26	77	4	0	107
28574	18322s (+0.6s)	2532	2532	256	43	159	0	8	210
28575	18323s (+0.8s)	3380	3380	256	51	214	0	12	277
28576	18323s (+0.6s)	1908	1908	128	42	146	0	7	195
28577	18324s (+0.5s)	1816	1816	128	49	122	10	0	181
28578	18324s (+0.3s)	1280	1280	128	41	82	3	1	127
28579	18325s (+0.6s)	2352	2352	256	46	143	8	0	197
28580	18325s (+0.9s)	4644	4644	512	84	221	16	1	322
28581	18326s (+0.7s)	2848	2848	256	56	165	13	0	234
28582	18327s (+1.3s)	6492	6492	512	112	324	25	1	462
28583	18328s (+0.4s)	1340	1340	64	42	102	9	1	154
28584	18329s (+0.9s)	3968	3968	256	98	217	11	0	326
28585	18329s (+0.3s)	756	756	64	26	70	5	0	101
28586	18330s (+1.1s)	4692	4692	256	108	270	17	0	395
28587	18331s (+0.8s)	3500	3500	256	79	199	16	0	294
28588	18332s (+0.5s)	1648	1648	128	34	125	9	0	168
28589	18332s (+0.9s)	3900	3900	256	74	231	12	0	317
28590	18333s (+0.5s)	1816	1816	128	45	139	5	0	189
28591	18334s (+0.6s)	2208	2208	128	56	145	5	1	207
28592	18334s (+0.4s)	1172	1172	128	39	81	5	0	125
28593	18335s (+0.5s)	1776	1776	128	54	118	7	0	179
28594	18335s (+0.8s)	3468	3468	256	64	216	10	0	290
28595	18336s (+0.4s)	1084	1084	64	26	103	5	0	134
28596	18336s (+0.5s)	1612	1612	128	35	125	6	0	166
28597	18337s (+0.4s)	1288	1288	128	41	93	5	0	139
28598	18337s (+0.3s)	936	936	64	30	81	3	1	115
28599	18338s (+0.6s)	2656	2656	256	64	155	8	0	227
Episode	Time	Reward	Score	Highest	L	U	R	D	Steps
28600	18338s (+0.8s)	3320	3320	256	87	174	16	0	277
28601	18339s (+0.4s)	928	928	64	40	75	8	0	123
28602	18339s (+0.4s)	1224	1224	128	19	103	0	3	125
28603	18340s (+0.7s)	3084	3084	256	42	197	0	13	252
28604	18341s (+0.9s)	3844	3844	256	64	235	0	13	312
28605	18341s (+0.7s)	2760	2760	256	47	180	0	11	238
28606	18342s (+1.0s)	4028	4028	256	62	258	0	16	336
28607	18343s (+0.6s)	2144	2144	128	41	150	0	13	204
28608	18344s (+0.5s)	1708	1708	128	33	131	0	8	172
28609	18344s (+0.5s)	1744	1744	128	37	131	0	10	178
28610	18344s (+0.3s)	652	652	64	16	69	0	7	92
28611	18345s (+0.4s)	1036	1036	64	36	84	3	0	123
28612	18345s (+0.4s)	1340	1340	128	41	98	6	0	145
28613	18346s (+0.8s)	3364	3364	256	68	202	17	0	287
28614	18347s (+0.7s)	2748	2748	256	50	177	8	0	235
28615	18348s (+0.9s)	4036	4036	256	109	206	16	0	331
28616	18348s (+0.9s)	3736	3736	256	87	210	13	0	310
28617	18349s (+0.6s)	2760	2760	256	50	165	8	0	223
28618	18349s (+0.4s)	1028	1028	64	32	86	8	0	126
28619	18350s (+0.3s)	668	668	64	19	66	4	0	89
28620	18350s (+0.5s)	1572	1572	128	30	132	3	0	165
28621	18350s (+0.3s)	1048	1048	128	16	94	3	0	113
28622	18351s (+0.8s)	2856	2856	128	74	176	15	0	265
28623	18352s (+0.8s)	3364	3364	256	68	193	16	0	277
28624	18353s (+0.8s)	3408	3408	256	73	202	12	0	287
28625	18354s (+0.8s)	3212	3212	256	62	190	14	0	266
28626	18354s (+0.6s)	2644	2644	256	50	156	16	0	222
28627	18355s (+0.7s)	2932	2932	256	56	169	8	0	233
28628	18356s (+0.9s)	3832	3832	256	57	236	0	16	309
28629	18357s (+1.0s)	4100	4100	256	79	248	0	12	339
28630	18358s (+0.8s)	3440	3440	256	64	216	0	10	290
28631	18358s (+0.5s)	1796	1796	128	42	138	4	0	184
28632	18359s (+0.6s)	2076	2076	128	49	131	15	0	195
28633	18359s (+0.5s)	1684	1684	128	36	126	11	0	173
28634	18360s (+0.4s)	1488	1488	128	32	118	0	6	156
28635	18361s (+0.8s)	3364	3364	256	57	221	0	9	287
28636	18361s (+0.6s)	1944	1944	128	51	143	0	10	204
28637	18362s (+0.4s)	1404	1404	128	25	112	0	7	144
28638	18362s (+0.8s)	3596	3596	256	82	201	14	0	297
28639	18363s (+0.4s)	1312	1312	128	36	92	12	0	140
28640	18364s (+0.9s)	3988	3988	256	82	226	16	0	324
28641	18364s (+0.7s)	2900	2900	256	57	182	12	1	252
28642	18365s (+1.0s)	5256	5256	512	101	253	19	0	373
28643	18367s (+1.2s)	6172	6172	512	116	293	22	0	431
28644	18368s (+0.9s)	3864	3864	256	82	212	17	0	311
28645	18368s (+0.4s)	1512	1512	128	43	109	6	0	158
28646	18369s (+0.5s)	1924	1924	128	45	121	11	2	179
28647	18369s (+0.5s)	1832	1832	128	49	125	7	0	181
28648	18370s (+0.8s)	3368	3368	256	74	199	17	0	290
28649	18371s (+1.4s)	7000	7000	512	140	316	28	0	484
28650	18372s (+0.4s)	1436	1436	128	40	105	4	0	149
28651	18373s (+0.8s)	3272	3272	256	63	207	6	0	276
28652	18373s (+0.4s)	1120	1120	64	32	99	2	0	133
28653	18374s (+0.7s)	3160	3160	256	56	195	10	0	261
28654	18375s (+1.0s)	4344	4344	256	101	235	21	0	357
28655	18375s (+0.3s)	920	920	64	23	82	6	0	111
28656	18376s (+0.5s)	1784	1784	128	43	127	10	1	181
28657	18376s (+0.6s)	2340	2340	256	50	140	8	0	198
28658	18377s (+0.6s)	2524	2524	256	46	153	10	1	210
28659	18378s (+0.8s)	3284	3284	256	71	194	14	0	279
28660	18378s (+0.5s)	1932	1932	128	60	124	16	1	201
28661	18379s (+0.5s)	1908	1908	128	55	125	13	0	193
28662	18379s (+0.8s)	3216	3216	256	61	193	15	0	269
28663	18380s (+0.5s)	1784	1784	128	31	142	8	0	181
28664	18381s (+0.8s)	3212	3212	256	69	185	12	0	266
28665	18381s (+0.6s)	2672	2672	256	51	162	7	1	221
28666	18382s (+0.7s)	2676	2676	256	49	172	8	0	229
28667	18383s (+0.8s)	3308	3308	256	70	199	13	0	282
28668	18383s (+0.3s)	888	888	64	31	81	5	0	117
28669	18384s (+0.5s)	1896	1896	128	44	127	0	11	182
28670	18384s (+0.7s)	2604	2604	128	44	181	0	11	236
28671	18385s (+0.4s)	1048	1048	64	26	96	0	5	127
28672	18385s (+0.6s)	2384	2384	256	38	158	0	5	201
28673	18386s (+0.7s)	2992	2992	256	56	175	0	14	245
28674	18386s (+0.5s)	1516	1516	128	38	111	0	9	158
28675	18387s (+0.4s)	1532	1532	128	29	117	0	6	152
28676	18387s (+0.5s)	1620	1620	128	35	121	0	6	162
28677	18388s (+0.3s)	904	904	64	19	86	0	6	111
28678	18388s (+0.6s)	1856	1856	128	54	131	9	0	194
28679	18389s (+0.7s)	3112	3112	256	62	185	11	0	258
28680	18390s (+0.8s)	3520	3520	256	81	197	15	1	294
28681	18391s (+0.7s)	3176	3176	256	62	190	10	1	263
28682	18391s (+0.8s)	3336	3336	256	69	190	16	0	275
28683	18392s (+0.5s)	1828	1828	128	37	139	5	0	181
28684	18392s (+0.3s)	912	912	64	34	78	7	0	119
28685	18393s (+0.8s)	3312	3312	256	73	190	12	0	275
28686	18394s (+0.5s)	1824	1824	128	34	149	0	5	188
28687	18394s (+0.3s)	876	876	64	25	85	0	5	115
28688	18394s (+0.4s)	1444	1444	128	33	109	0	7	149
28689	18395s (+0.7s)	3144	3144	256	55	190	0	11	256
28690	18396s (+0.8s)	3308	3308	256	66	200	0	12	278
28691	18396s (+0.4s)	1324	1324	128	24	108	0	5	137
28692	18397s (+0.9s)	3964	3964	256	68	243	0	14	325
28693	18398s (+0.8s)	3340	3340	256	55	212	0	14	281
28694	18398s (+0.5s)	1612	1612	128	40	116	0	5	161
28695	18399s (+0.4s)	1084	1084	64	27	94	0	10	131
28696	18399s (+0.4s)	1128	1128	64	32	92	0	10	134
28697	18400s (+0.5s)	1800	1800	128	39	131	0	15	185
28698	18400s (+0.6s)	1916	1916	128	37	154	6	0	197
28699	18401s (+0.9s)	4036	4036	256	88	229	14	1	332
Episode	Time	Reward	Score	Highest	L	U	R	D	Steps
28700	18402s (+0.6s)	2228	2228	128	54	144	14	0	212
28701	18403s (+0.7s)	2772	2772	256	47	180	9	0	236
28702	18403s (+0.4s)	1376	1376	128	26	112	7	0	145
28703	18403s (+0.4s)	1276	1276	128	32	91	6	1	130
28704	18404s (+0.9s)	3512	3512	256	67	214	14	2	297
28705	18405s (+0.8s)	3236	3236	256	73	183	16	0	272
28706	18406s (+0.7s)	2828	2828	256	65	169	16	0	250
28707	18406s (+0.8s)	3292	3292	256	59	215	7	0	281
28708	18407s (+0.7s)	3136	3136	256	84	164	15	0	263
28709	18408s (+0.5s)	1912	1912	128	41	134	10	1	186
28710	18408s (+0.6s)	2264	2264	128	48	152	5	1	206
28711	18409s (+0.6s)	2396	2396	256	43	151	8	0	202
28712	18409s (+0.5s)	1616	1616	128	33	132	6	0	171
28713	18410s (+0.7s)	3296	3296	256	94	169	13	0	276
28714	18411s (+0.7s)	2924	2924	256	73	170	14	0	257
28715	18412s (+1.1s)	5356	5356	512	110	246	16	0	372
28716	18413s (+0.6s)	1992	1992	128	52	141	11	0	204
28717	18413s (+0.9s)	4124	4124	256	84	230	17	0	331
28718	18414s (+0.7s)	2788	2788	256	60	165	16	0	241
28719	18415s (+0.7s)	2732	2732	256	66	151	13	0	230
28720	18415s (+0.5s)	1600	1600	128	53	104	10	0	167
28721	18416s (+0.6s)	2480	2480	256	55	142	15	0	212
28722	18416s (+0.4s)	1324	1324	128	24	105	6	0	135
28723	18417s (+0.8s)	3240	3240	256	62	201	9	0	272
28724	18418s (+0.5s)	1780	1780	128	32	144	6	0	182
28725	18418s (+0.8s)	3216	3216	256	79	184	18	0	281
28726	18419s (+0.3s)	880	880	64	28	84	4	0	116
28727	18419s (+0.6s)	2224	2224	128	69	143	14	0	226
28728	18420s (+0.8s)	3308	3308	256	60	200	14	0	274
28729	18421s (+0.5s)	1676	1676	128	37	126	8	0	171
28730	18421s (+0.5s)	1744	1744	128	39	129	8	0	176
28731	18422s (+0.3s)	784	784	64	28	73	3	0	104
28732	18423s (+1.2s)	5940	5940	512	94	309	15	2	420
28733	18423s (+0.4s)	1348	1348	128	21	110	5	0	136
28734	18424s (+0.5s)	1840	1840	128	43	130	14	0	187
28735	18424s (+0.5s)	2132	2132	256	40	130	8	1	179
28736	18425s (+1.2s)	6408	6408	512	104	315	22	0	441
28737	18426s (+0.6s)	2420	2420	256	52	151	8	1	212
28738	18427s (+0.5s)	2080	2080	128	60	115	15	0	190
28739	18427s (+1.0s)	4132	4132	256	93	236	11	0	340
28740	18428s (+0.5s)	1760	1760	128	44	127	9	0	180
28741	18429s (+0.7s)	3096	3096	256	72	169	13	0	254
28742	18429s (+0.4s)	1200	1200	64	43	87	9	0	139
28743	18430s (+0.7s)	2740	2740	256	68	156	10	0	234
28744	18430s (+0.4s)	1056	1056	64	39	83	6	0	128
28745	18431s (+0.7s)	3052	3052	256	68	178	15	1	262
28746	18432s (+0.6s)	1924	1924	128	45	148	0	6	199
28747	18433s (+1.1s)	5496	5496	512	72	299	0	18	389
28748	18433s (+0.5s)	1556	1556	128	35	127	0	5	167
28749	18434s (+0.6s)	2472	2472	256	39	164	0	7	210
28750	18434s (+0.5s)	1808	1808	128	33	143	0	11	187
28751	18435s (+0.5s)	1948	1948	128	39	133	0	12	184
28752	18436s (+1.0s)	4256	4256	256	68	267	0	15	350
28753	18436s (+0.6s)	2648	2648	256	48	166	0	9	223
28754	18437s (+0.9s)	3748	3748	256	58	242	0	15	315
28755	18439s (+1.2s)	5752	5752	512	79	311	0	19	409
28756	18440s (+1.2s)	6316	6316	512	97	317	0	20	434
28757	18440s (+0.7s)	2772	2772	256	44	184	0	8	236
28758	18441s (+0.3s)	884	884	64	24	85	0	8	117
28759	18441s (+0.5s)	1572	1572	128	29	126	0	10	165
28760	18442s (+0.8s)	3244	3244	256	56	200	0	14	270
28761	18443s (+0.8s)	3216	3216	256	60	193	0	14	267
28762	18444s (+0.7s)	2412	2412	128	41	171	0	15	227
28763	18444s (+0.5s)	1764	1764	128	34	133	0	9	176
28764	18444s (+0.3s)	700	700	64	25	72	2	0	99
28765	18445s (+0.8s)	3540	3540	256	87	206	7	0	300
28766	18446s (+0.4s)	1468	1468	128	39	104	9	0	152
28767	18446s (+0.5s)	1736	1736	64	61	113	15	0	189
28768	18447s (+0.8s)	3352	3352	256	80	179	15	0	274
28769	18447s (+0.5s)	1540	1540	128	33	124	6	1	164
28770	18448s (+0.5s)	1924	1924	128	34	150	9	1	194
28771	18449s (+0.9s)	3840	3840	256	76	223	17	0	316
28772	18449s (+0.5s)	1520	1520	128	35	124	3	1	163
28773	18450s (+0.5s)	1772	1772	128	45	132	5	0	182
28774	18451s (+0.8s)	3176	3176	256	60	195	13	0	268
28775	18451s (+0.7s)	2692	2692	256	51	169	11	0	231
28776	18452s (+0.3s)	800	800	64	25	76	6	0	107
28777	18452s (+0.8s)	3388	3388	256	68	197	12	0	277
28778	18454s (+1.0s)	4332	4332	256	104	235	22	0	361
28779	18454s (+0.8s)	3216	3216	256	80	172	15	1	268
28780	18455s (+0.5s)	1676	1676	128	41	126	7	0	174
28781	18455s (+0.5s)	1644	1644	128	43	116	7	1	167
28782	18456s (+0.6s)	2432	2432	256	39	153	0	14	206
28783	18457s (+0.8s)	3236	3236	256	61	200	0	11	272
28784	18457s (+0.8s)	3284	3284	256	50	221	0	8	279
28785	18458s (+0.2s)	312	312	32	6	49	0	2	57
28786	18458s (+0.2s)	480	480	64	9	57	0	4	70
28787	18458s (+0.6s)	2216	2216	128	40	154	0	15	209
28788	18459s (+0.5s)	1516	1516	128	34	125	4	0	163
28789	18459s (+0.3s)	768	768	64	18	84	2	0	104
28790	18460s (+0.3s)	968	968	64	34	78	6	0	118
28791	18460s (+0.5s)	1764	1764	128	39	129	9	0	177
28792	18461s (+1.1s)	5428	5428	512	82	273	17	0	372
28793	18462s (+1.0s)	4248	4248	256	82	254	16	0	352
28794	18463s (+0.5s)	1740	1740	128	46	123	7	0	176
28795	18463s (+0.7s)	3160	3160	256	75	179	11	0	265
28796	18464s (+0.4s)	1076	1076	64	37	89	6	0	132
28797	18465s (+0.7s)	2504	2504	128	73	157	17	0	247
28798	18465s (+0.6s)	2680	2680	256	40	173	10	0	223
28799	18466s (+0.6s)	1928	1928	128	46	147	7	0	200
Episode	Time	Reward	Score	Highest	L	U	R	D	Steps
28800	18466s (+0.7s)	2904	2904	256	65	174	13	0	252
28801	18467s (+0.7s)	2964	2964	256	64	182	14	0	260
28802	18468s (+0.9s)	3852	3852	256	76	224	0	14	314
28803	18469s (+0.5s)	1852	1852	128	35	152	0	2	189
28804	18469s (+0.4s)	1144	1144	64	25	105	0	5	135
28805	18470s (+0.6s)	2216	2216	128	41	157	0	13	211
28806	18470s (+0.7s)	2748	2748	256	54	171	0	9	234
28807	18471s (+0.7s)	3196	3196	256	48	208	0	11	267
28808	18471s (+0.3s)	972	972	128	20	77	1	4	102
28809	18472s (+0.8s)	3412	3412	256	53	218	0	15	286
28810	18472s (+0.3s)	684	684	64	19	66	0	4	89
28811	18473s (+0.8s)	3460	3460	256	51	222	0	22	295
28812	18474s (+0.3s)	780	780	64	23	66	3	2	94
28813	18474s (+0.6s)	2300	2300	128	53	154	7	0	214
28814	18475s (+0.7s)	2940	2940	256	57	165	11	0	233
28815	18475s (+0.3s)	852	852	64	16	83	5	1	105
28816	18476s (+0.5s)	1540	1540	128	45	113	6	0	164
28817	18476s (+0.7s)	2572	2572	128	61	161	16	0	238
28818	18477s (+0.9s)	3788	3788	256	81	221	11	0	313
28819	18478s (+0.4s)	1304	1304	128	22	113	4	0	139
28820	18478s (+0.5s)	1676	1676	128	42	122	7	0	171
28821	18479s (+0.7s)	2872	2872	256	51	187	10	0	248
28822	18480s (+0.8s)	3272	3272	256	75	180	15	0	270
28823	18480s (+0.4s)	996	996	64	28	95	5	0	128
28824	18481s (+1.0s)	5316	5316	512	90	259	18	0	367
28825	18482s (+0.8s)	3280	3280	256	64	192	15	0	271
28826	18482s (+0.4s)	1588	1588	128	25	128	3	0	156
28827	18483s (+0.4s)	1508	1508	128	48	104	5	0	157
28828	18483s (+0.5s)	1568	1568	128	36	121	7	0	164
28829	18484s (+0.7s)	3312	3312	256	88	165	15	1	269
28830	18484s (+0.5s)	1508	1508	128	28	127	5	0	160
28831	18485s (+0.7s)	2824	2824	256	53	179	10	0	242
28832	18486s (+0.7s)	3164	3164	256	59	191	13	0	263
28833	18486s (+0.4s)	1364	1364	128	42	94	6	0	142
28834	18487s (+0.5s)	1872	1872	128	49	127	14	0	190
28835	18488s (+0.9s)	3792	3792	256	70	217	17	0	304
28836	18488s (+0.8s)	3068	3068	128	96	179	16	0	291
28837	18489s (+0.6s)	2296	2296	128	66	141	8	0	215
28838	18490s (+1.1s)	5512	5512	512	100	263	23	0	386
28839	18491s (+0.7s)	3104	3104	256	51	195	11	0	257
28840	18492s (+0.8s)	3388	3388	256	72	202	11	0	285
28841	18493s (+0.8s)	3492	3492	256	77	200	15	0	292
28842	18494s (+1.0s)	5024	5024	512	102	234	20	0	356
28843	18494s (+0.4s)	1436	1436	128	41	104	4	0	149
28844	18495s (+0.5s)	1828	1828	128	46	130	5	0	181
28845	18495s (+0.4s)	1476	1476	128	35	112	7	0	154
28846	18495s (+0.3s)	804	804	64	21	84	3	0	108
28847	18496s (+0.8s)	3172	3172	256	59	198	11	0	268
28848	18496s (+0.4s)	1480	1480	128	35	114	4	0	153
28849	18497s (+0.7s)	3008	3008	256	56	172	13	0	241
28850	18498s (+0.6s)	2716	2716	256	64	162	8	0	234
28851	18499s (+0.7s)	3088	3088	256	70	163	12	0	245
28852	18499s (+0.9s)	3844	3844	256	87	214	22	1	324
28853	18500s (+0.7s)	3132	3132	256	55	193	8	0	256
28854	18501s (+1.0s)	4112	4112	256	86	239	20	0	345
28855	18502s (+0.4s)	1164	1164	128	34	88	6	0	128
28856	18502s (+0.7s)	2740	2740	256	63	152	17	1	233
28857	18503s (+0.8s)	3316	3316	256	79	192	9	0	280
28858	18504s (+0.9s)	3956	3956	256	83	232	13	0	328
28859	18505s (+0.7s)	2928	2928	256	69	177	12	0	258
28860	18505s (+0.5s)	1796	1796	128	37	137	10	0	184
28861	18506s (+0.6s)	2492	2492	256	52	151	11	0	214
28862	18506s (+0.4s)	1292	1292	128	36	96	4	0	136
28863	18507s (+0.5s)	1816	1816	128	38	131	13	0	182
28864	18507s (+0.7s)	2760	2760	256	62	164	11	0	237
28865	18508s (+0.9s)	4044	4044	256	97	224	13	0	334
28866	18509s (+0.5s)	1744	1744	128	47	121	8	0	176
28867	18510s (+0.8s)	3592	3592	256	71	218	11	0	300
28868	18510s (+0.7s)	3088	3088	256	80	180	7	0	267
28869	18511s (+0.7s)	3068	3068	256	61	178	13	0	252
28870	18512s (+0.7s)	3172	3172	256	66	182	14	1	263
28871	18513s (+0.8s)	3480	3480	256	78	195	17	0	290
28872	18514s (+0.9s)	4648	4648	512	72	238	11	1	322
28873	18515s (+0.8s)	3580	3580	256	57	216	11	0	284
28874	18515s (+0.5s)	1760	1760	128	43	128	9	0	180
28875	18516s (+0.7s)	2976	2976	256	68	173	18	0	259
28876	18516s (+0.5s)	1516	1516	128	47	105	6	0	158
28877	18517s (+0.6s)	2052	2052	128	61	130	13	0	204
28878	18518s (+0.8s)	3320	3320	256	66	206	10	0	282
28879	18518s (+0.6s)	2600	2600	256	58	148	15	0	221
28880	18519s (+0.7s)	3044	3044	256	54	198	0	10	262
28881	18520s (+0.5s)	1936	1936	128	44	137	0	11	192
28882	18520s (+0.7s)	2932	2932	256	42	195	0	7	244
28883	18521s (+0.3s)	1056	1056	64	22	96	0	3	121
28884	18521s (+0.5s)	1576	1576	128	40	118	0	8	166
28885	18522s (+0.8s)	3304	3304	256	71	192	14	0	277
28886	18522s (+0.3s)	808	808	64	24	79	6	0	109
28887	18523s (+1.2s)	5652	5652	512	110	282	19	0	411
28888	18524s (+0.6s)	2524	2524	256	58	152	8	0	218
28889	18525s (+0.5s)	2216	2216	256	44	139	7	0	190
28890	18526s (+0.9s)	3920	3920	256	66	237	16	0	319
28891	18526s (+0.6s)	2488	2488	256	48	153	12	1	214
28892	18527s (+1.2s)	5744	5744	512	114	271	21	1	407
28893	18528s (+0.6s)	2596	2596	256	47	173	4	0	224
28894	18529s (+0.7s)	2536	2536	128	62	160	11	0	233
28895	18530s (+1.0s)	4268	4268	256	81	252	14	0	347
28896	18531s (+0.9s)	3592	3592	256	98	181	22	0	301
28897	18531s (+0.9s)	3728	3728	256	97	200	21	0	318
28898	18532s (+0.5s)	1572	1572	128	41	117	4	0	162
28899	18533s (+0.8s)	3316	3316	256	73	182	21	0	276
Episode	Time	Reward	Score	Highest	L	U	R	D	Steps
28900	18533s (+0.5s)	2116	2116	256	35	139	8	0	182
28901	18534s (+0.5s)	1800	1800	128	40	139	6	0	185
28902	18534s (+0.7s)	2876	2876	256	73	158	15	0	246
28903	18535s (+0.5s)	2260	2260	256	39	138	7	0	184
28904	18536s (+0.6s)	2268	2268	128	56	139	15	1	211
28905	18536s (+0.4s)	1264	1264	128	27	95	5	0	127
28906	18537s (+0.7s)	3048	3048	256	67	174	10	0	251
28907	18537s (+0.4s)	1100	1100	64	30	93	5	0	128
28908	18538s (+0.5s)	1828	1828	128	41	140	0	6	187
28909	18538s (+0.5s)	1792	1792	128	50	125	0	8	183
28910	18539s (+0.4s)	1044	1044	64	29	90	7	0	126
28911	18539s (+0.7s)	2696	2696	256	48	178	7	0	233
28912	18540s (+0.7s)	2736	2736	128	66	174	10	0	250
28913	18540s (+0.5s)	1848	1848	128	46	143	3	0	192
28914	18541s (+0.8s)	3456	3456	256	63	207	15	0	285
28915	18542s (+0.4s)	1372	1372	128	33	101	6	0	140
28916	18542s (+0.6s)	2504	2504	256	47	162	9	0	218
28917	18543s (+0.8s)	3204	3204	256	72	185	11	0	268
28918	18544s (+0.8s)	3268	3268	256	81	173	17	2	273
28919	18545s (+0.7s)	2608	2608	256	51	171	5	0	227
28920	18545s (+0.7s)	2960	2960	256	76	173	12	0	261
28921	18546s (+0.8s)	3504	3504	256	75	209	0	11	295
28922	18547s (+0.8s)	3444	3444	256	53	227	0	12	292
28923	18547s (+0.2s)	628	628	64	18	61	0	2	81
28924	18548s (+0.6s)	1928	1928	128	46	145	0	9	200
28925	18548s (+0.5s)	1728	1728	128	46	117	9	0	172
28926	18549s (+0.7s)	2992	2992	256	57	174	14	1	246
28927	18550s (+0.6s)	2308	2308	256	36	154	8	0	198
28928	18550s (+0.6s)	2520	2520	256	55	157	6	0	218
28929	18551s (+0.9s)	3996	3996	256	88	229	10	0	327
28930	18552s (+0.5s)	1492	1492	128	32	119	6	0	157
28931	18552s (+0.7s)	3272	3272	256	70	187	13	0	270
28932	18553s (+0.4s)	1472	1472	128	33	118	5	0	156
28933	18553s (+0.5s)	1828	1828	128	38	135	12	0	185
28934	18554s (+0.4s)	1056	1056	64	28	92	7	0	127
28935	18554s (+0.3s)	1140	1140	128	31	83	9	0	123
28936	18555s (+0.7s)	2660	2660	256	36	179	0	11	226
28937	18556s (+0.9s)	3908	3908	256	54	255	0	14	323
28938	18556s (+0.7s)	3148	3148	256	44	204	0	9	257
28939	18557s (+0.3s)	872	872	64	27	81	0	6	114
28940	18557s (+0.6s)	2120	2120	128	53	154	0	5	212
28941	18558s (+0.8s)	3524	3524	256	67	218	0	11	296
28942	18559s (+0.5s)	1772	1772	128	40	128	0	11	179
28943	18559s (+0.7s)	2620	2620	256	46	172	0	9	227
28944	18560s (+0.2s)	620	620	64	12	68	0	5	85
28945	18560s (+0.6s)	1916	1916	128	45	145	7	0	197
28946	18561s (+0.4s)	1348	1348	128	32	98	8	0	138
28947	18561s (+0.3s)	1116	1116	128	29	82	7	0	118
28948	18561s (+0.3s)	916	916	64	31	83	6	0	120
28949	18562s (+0.6s)	2168	2168	128	47	157	13	0	217
28950	18562s (+0.5s)	1864	1864	128	43	140	6	0	189
28951	18563s (+0.8s)	3464	3464	256	68	202	16	0	286
28952	18564s (+0.7s)	2792	2792	256	48	181	12	0	241
28953	18565s (+0.7s)	3204	3204	256	65	193	0	12	270
28954	18565s (+0.6s)	2480	2480	256	37	169	1	7	214
28955	18566s (+0.6s)	2388	2388	256	50	145	0	6	201
28956	18567s (+0.7s)	2944	2944	256	52	195	0	11	258
28957	18567s (+0.7s)	2860	2860	256	45	184	0	7	236
28958	18568s (+0.8s)	3192	3192	256	53	218	0	9	280
28959	18569s (+0.8s)	3424	3424	256	69	206	0	13	288
28960	18570s (+0.7s)	3148	3148	256	55	198	0	5	258
28961	18571s (+0.9s)	3552	3552	256	58	232	0	12	302
28962	18571s (+0.4s)	1432	1432	128	25	117	0	5	147
28963	18571s (+0.4s)	1504	1504	128	28	121	0	10	159
28964	18572s (+0.5s)	1720	1720	128	38	129	0	7	174
28965	18572s (+0.4s)	1300	1300	128	29	106	0	6	141
28966	18573s (+0.6s)	2528	2528	256	47	168	0	4	219
28967	18574s (+0.7s)	3132	3132	256	55	199	0	9	263
28968	18574s (+0.5s)	1792	1792	128	46	129	0	8	183
28969	18575s (+0.6s)	2504	2504	256	48	157	0	8	213
28970	18575s (+0.3s)	816	816	64	26	72	0	6	104
28971	18576s (+0.4s)	1412	1412	64	27	121	0	10	158
28972	18576s (+0.3s)	900	900	64	23	78	0	6	107
28973	18577s (+0.7s)	2876	2876	256	47	192	0	7	246
28974	18577s (+0.9s)	3744	3744	256	75	211	1	18	305
28975	18578s (+1.0s)	4296	4296	256	114	228	17	0	359
28976	18579s (+0.5s)	1612	1612	128	45	117	8	0	170
28977	18579s (+0.3s)	1088	1088	128	24	88	3	0	115
28978	18580s (+0.5s)	1824	1824	128	56	124	6	0	186
28979	18580s (+0.5s)	1496	1496	128	39	110	8	0	157
28980	18581s (+0.5s)	1884	1884	128	58	114	8	0	180
28981	18582s (+1.0s)	4212	4212	256	90	240	18	0	348
28982	18582s (+0.5s)	1736	1736	128	37	135	6	0	178
28983	18583s (+0.6s)	2556	2556	256	45	154	0	11	210
28984	18584s (+0.9s)	3724	3724	256	60	225	0	14	299
28985	18584s (+0.7s)	2840	2840	256	60	178	0	10	248
28986	18585s (+0.5s)	1752	1752	128	35	132	0	8	175
28987	18586s (+0.8s)	3348	3348	256	50	222	0	12	284
28988	18586s (+0.6s)	2440	2440	256	39	156	0	9	204
28989	18587s (+0.4s)	1172	1172	128	26	98	0	3	127
28990	18587s (+0.2s)	532	532	64	14	58	0	4	76
28991	18588s (+0.6s)	2464	2464	256	39	161	0	10	210
28992	18588s (+0.9s)	3780	3780	256	67	232	0	12	311
28993	18590s (+1.2s)	5804	5804	512	91	305	0	21	417
28994	18590s (+0.5s)	1768	1768	128	36	132	0	9	177
28995	18590s (+0.3s)	896	896	64	13	90	0	3	106
28996	18591s (+0.9s)	3880	3880	256	55	250	0	15	320
28997	18592s (+0.5s)	1876	1876	128	48	134	1	9	192
28998	18593s (+0.9s)	3928	3928	256	61	251	0	16	328
28999	18593s (+0.5s)	1812	1812	128	45	135	8	0	188
Episode	Time	Reward	Score	Highest	L	U	R	D	Steps
29000	18594s (+0.8s)	3288	3288	256	80	183	11	0	274
29001	18595s (+0.7s)	2836	2836	256	56	171	14	0	241
29002	18595s (+0.5s)	1948	1948	128	49	140	9	0	198
29003	18596s (+0.8s)	3232	3232	256	68	193	10	0	271
29004	18597s (+0.3s)	892	892	64	25	85	5	0	115
29005	18597s (+0.7s)	3064	3064	256	52	187	11	0	250
29006	18598s (+0.7s)	2876	2876	256	64	185	8	0	257
29007	18598s (+0.4s)	1336	1336	128	33	98	8	0	139
29008	18599s (+0.7s)	3008	3008	256	58	182	12	0	252
29009	18600s (+0.6s)	2664	2664	256	53	160	6	0	219
29010	18600s (+0.6s)	2528	2528	256	48	163	8	0	219
29011	18601s (+0.5s)	1596	1596	128	33	127	6	0	166
29012	18602s (+0.8s)	3256	3256	256	70	192	15	0	277
29013	18602s (+0.7s)	2720	2720	256	62	163	9	0	234
29014	18603s (+0.9s)	3732	3732	256	77	207	20	0	304
29015	18604s (+0.4s)	1236	1236	128	45	86	6	0	137
29016	18604s (+0.7s)	2700	2700	256	54	165	9	0	228
29017	18605s (+0.6s)	2084	2084	128	46	148	0	16	210
29018	18605s (+0.2s)	320	320	32	9	47	0	3	59
29019	18606s (+0.7s)	2700	2700	256	40	181	0	7	228
29020	18606s (+0.6s)	2476	2476	128	54	169	0	8	231
29021	18607s (+0.8s)	3224	3224	256	59	204	0	11	274
29022	18608s (+0.8s)	3252	3252	256	49	215	0	11	275
29023	18609s (+0.6s)	2644	2644	256	51	156	0	14	221
29024	18609s (+0.5s)	1576	1576	128	43	116	6	1	166
29025	18610s (+0.5s)	1676	1676	128	39	119	12	0	170
29026	18610s (+0.8s)	3392	3392	256	61	216	14	0	291
29027	18611s (+0.6s)	2664	2664	256	49	167	9	0	225
29028	18612s (+0.5s)	1792	1792	128	40	134	8	1	183
29029	18613s (+1.0s)	4356	4356	256	94	252	17	0	363
29030	18613s (+0.7s)	2620	2620	256	52	169	9	0	230
29031	18614s (+0.4s)	1464	1464	128	42	102	7	0	151
29032	18614s (+0.7s)	2720	2720	256	66	163	10	0	239
29033	18615s (+0.4s)	1468	1468	128	40	108	4	0	152
29034	18616s (+0.7s)	3040	3040	256	64	177	10	0	251
29035	18616s (+0.5s)	1920	1920	128	46	137	8	0	191
29036	18617s (+0.4s)	1348	1348	128	28	106	6	0	140
29037	18617s (+0.6s)	2660	2660	256	48	168	8	1	225
29038	18618s (+0.7s)	2640	2640	128	81	157	12	1	251
29039	18618s (+0.6s)	2056	2056	128	55	139	7	0	201
29040	18619s (+0.6s)	2240	2240	128	64	144	12	0	220
29041	18619s (+0.4s)	1092	1092	128	33	84	5	0	122
29042	18620s (+0.7s)	2796	2796	256	41	192	9	0	242
29043	18621s (+0.4s)	1472	1472	128	31	115	6	0	152
29044	18621s (+0.7s)	2776	2776	256	42	181	0	15	238
29045	18621s (+0.1s)	264	264	32	6	40	0	4	50
29046	18622s (+0.4s)	1404	1404	128	31	110	6	0	147
29047	18623s (+0.8s)	3424	3424	256	80	189	17	0	286
29048	18623s (+0.8s)	2824	2824	128	84	165	16	0	265
29049	18624s (+0.7s)	3160	3160	256	60	187	15	0	262
29050	18625s (+0.8s)	3564	3564	256	62	223	13	0	298
29051	18626s (+1.0s)	3976	3976	256	98	229	16	0	343
29052	18627s (+0.8s)	3232	3232	256	53	207	11	0	271
29053	18627s (+0.7s)	3092	3092	256	59	180	14	0	253
29054	18628s (+0.8s)	3520	3520	256	68	218	8	0	294
29055	18629s (+0.8s)	3456	3456	256	75	198	11	0	284
29056	18630s (+0.5s)	1576	1576	128	42	110	6	0	158
29057	18630s (+0.5s)	1804	1804	128	38	138	9	1	186
29058	18631s (+0.5s)	1644	1644	128	39	124	7	1	171
29059	18631s (+0.6s)	2040	2040	128	53	134	10	0	197
29060	18632s (+0.4s)	928	928	64	32	86	4	0	122
29061	18633s (+1.0s)	5152	5152	512	88	246	16	1	351
29062	18633s (+0.6s)	2188	2188	128	56	134	17	0	207
29063	18633s (+0.4s)	1220	1220	128	29	100	4	0	133
29064	18634s (+0.5s)	2120	2120	256	54	123	5	0	182
29065	18634s (+0.3s)	880	880	128	18	73	1	0	92
29066	18635s (+0.4s)	1184	1184	128	23	98	7	0	128
29067	18635s (+0.8s)	3420	3420	256	65	199	12	0	276
29068	18637s (+1.1s)	5208	5208	512	95	267	18	0	380
29069	18637s (+0.4s)	1376	1376	128	32	104	8	0	144
29070	18637s (+0.4s)	1436	1436	128	40	103	5	0	148
29071	18638s (+0.8s)	3460	3460	256	76	196	16	0	288
29072	18639s (+1.1s)	5428	5428	512	88	267	12	0	367
29073	18640s (+0.5s)	2296	2296	256	38	146	4	0	188
29074	18640s (+0.6s)	1944	1944	128	56	137	11	0	204
29075	18641s (+0.8s)	3508	3508	256	83	188	18	0	289
29076	18642s (+0.8s)	3348	3348	256	65	196	13	0	274
29077	18643s (+0.5s)	1616	1616	128	28	131	3	0	162
29078	18643s (+0.9s)	4140	4140	256	87	227	17	0	331
29079	18645s (+1.2s)	6280	6280	512	124	299	24	2	449
29080	18645s (+0.7s)	3120	3120	256	57	195	8	0	260
29081	18646s (+0.7s)	3208	3208	256	63	190	12	0	265
29082	18647s (+1.0s)	4216	4216	256	84	242	22	0	348
29083	18648s (+0.4s)	1076	1076	64	26	104	3	0	133
29084	18648s (+0.6s)	2616	2616	256	50	169	10	0	229
29085	18649s (+0.6s)	2816	2816	256	57	158	10	0	225
29086	18650s (+0.8s)	3416	3416	256	59	209	10	0	278
29087	18650s (+0.5s)	1532	1532	128	41	112	8	1	162
29088	18650s (+0.2s)	548	548	32	28	49	4	0	81
29089	18651s (+0.9s)	3564	3564	256	71	218	16	0	305
29090	18652s (+0.4s)	1388	1388	64	37	105	12	1	155
29091	18652s (+0.5s)	1896	1896	128	32	156	5	0	193
29092	18653s (+0.4s)	1476	1476	128	44	101	8	0	153
29093	18654s (+0.8s)	3496	3496	256	72	208	13	0	293
29094	18654s (+0.7s)	3152	3152	256	54	193	15	0	262
29095	18655s (+1.0s)	4416	4416	256	96	247	19	0	362
29096	18656s (+0.6s)	1992	1992	128	57	146	8	0	211
29097	18656s (+0.4s)	1412	1412	128	26	113	4	0	143
29098	18657s (+0.5s)	1772	1772	128	43	130	5	0	178
29099	18658s (+1.0s)	4160	4160	256	103	223	16	0	342
Episode	Time	Reward	Score	Highest	L	U	R	D	Steps
29100	18658s (+0.6s)	2472	2472	256	48	155	7	0	210
29101	18659s (+0.6s)	2284	2284	128	55	154	6	0	215
29102	18660s (+0.9s)	3748	3748	256	53	249	0	13	315
29103	18660s (+0.4s)	1012	1012	64	20	96	0	6	122
29104	18661s (+0.8s)	3396	3396	256	61	202	0	18	281
29105	18662s (+0.8s)	3400	3400	256	62	207	0	13	282
29106	18662s (+0.4s)	1436	1436	128	28	115	0	5	148
29107	18663s (+0.5s)	1748	1748	128	42	121	0	9	172
29108	18663s (+0.6s)	2560	2560	256	46	162	0	13	221
29109	18664s (+0.4s)	1312	1312	128	25	104	5	0	134
29110	18665s (+0.7s)	2840	2840	256	73	161	15	0	249
29111	18666s (+1.3s)	6548	6548	512	115	304	24	1	444
29112	18666s (+0.6s)	2480	2480	256	43	164	6	0	213
29113	18667s (+0.6s)	1908	1908	128	47	145	4	0	196
29114	18668s (+0.7s)	2732	2732	256	54	165	12	0	231
29115	18668s (+0.5s)	2320	2320	256	40	145	5	0	190
29116	18669s (+0.7s)	3112	3112	256	62	187	13	0	262
29117	18670s (+0.6s)	2464	2464	256	65	134	13	0	212
29118	18670s (+0.8s)	3228	3228	256	81	175	14	0	270
29119	18671s (+0.4s)	1444	1444	128	37	107	6	0	150
29120	18672s (+1.0s)	4164	4164	256	103	222	18	0	343
29121	18673s (+0.8s)	3308	3308	256	70	193	11	0	274
29122	18673s (+0.9s)	4040	4040	256	87	221	24	0	332
29123	18674s (+0.8s)	3216	3216	256	59	197	11	0	267
29124	18675s (+0.5s)	1804	1804	128	49	130	7	0	186
29125	18675s (+0.6s)	1896	1896	128	46	138	8	0	192
29126	18676s (+0.4s)	1352	1352	128	34	103	6	0	143
29127	18676s (+0.6s)	2488	2488	256	57	145	11	1	214
29128	18677s (+0.3s)	744	744	64	25	68	6	0	99
29129	18677s (+0.7s)	2916	2916	256	60	182	0	13	255
29130	18678s (+0.4s)	1492	1492	128	36	111	0	9	156
29131	18678s (+0.5s)	1768	1768	128	36	137	0	8	181
29132	18679s (+0.6s)	2604	2604	256	45	170	0	11	226
29133	18679s (+0.3s)	720	720	64	19	73	0	6	98
29134	18680s (+0.9s)	4076	4076	256	54	251	0	18	323
29135	18681s (+0.7s)	2792	2792	256	60	172	8	0	240
29136	18681s (+0.5s)	1796	1796	128	40	136	11	1	188
29137	18682s (+0.2s)	588	588	64	16	62	2	0	80
29138	18682s (+0.7s)	2748	2748	256	56	169	10	0	235
29139	18683s (+0.6s)	2388	2388	256	50	147	8	0	205
29140	18683s (+0.5s)	1728	1728	128	47	119	5	1	172
29141	18685s (+1.1s)	5672	5672	512	92	290	19	0	401
29142	18685s (+0.7s)	2460	2460	128	68	155	8	0	231
29143	18686s (+0.6s)	2464	2464	256	47	154	11	0	212
29144	18687s (+0.8s)	3200	3200	256	65	186	13	0	264
29145	18687s (+0.7s)	2908	2908	256	62	178	13	0	253
29146	18688s (+0.9s)	4696	4696	512	65	250	12	0	327
29147	18689s (+0.9s)	4048	4048	256	80	236	18	0	334
29148	18690s (+1.1s)	5476	5476	512	102	260	21	0	383
29149	18691s (+0.3s)	1000	1000	64	42	69	4	0	115
29150	18691s (+0.5s)	1812	1812	128	45	133	10	0	188
29151	18692s (+0.7s)	3072	3072	256	62	182	7	1	252
29152	18692s (+0.4s)	1564	1564	128	41	113	9	0	163
29153	18693s (+0.7s)	2812	2812	256	49	189	7	0	245
29154	18694s (+0.4s)	1488	1488	128	32	117	7	0	156
29155	18694s (+0.7s)	2872	2872	256	71	166	6	1	244
29156	18695s (+0.8s)	3420	3420	256	88	166	25	0	279
29157	18696s (+0.4s)	1476	1476	128	24	127	3	0	154
29158	18696s (+0.5s)	1796	1796	128	41	135	8	0	184
29159	18697s (+0.4s)	1508	1508	128	40	110	5	1	156
29160	18697s (+0.4s)	1192	1192	64	25	106	3	0	134
29161	18697s (+0.5s)	1796	1796	128	34	139	10	1	184
29162	18698s (+0.5s)	1792	1792	128	37	141	6	0	184
29163	18699s (+0.5s)	1876	1876	128	47	138	7	0	192
29164	18699s (+0.4s)	1264	1264	128	33	89	6	1	129
29165	18699s (+0.5s)	1796	1796	128	37	143	4	0	184
29166	18700s (+0.8s)	3324	3324	256	72	191	11	0	274
29167	18701s (+0.4s)	1484	1484	128	43	110	2	0	155
29168	18701s (+0.7s)	2884	2884	256	63	178	11	0	252
29169	18702s (+0.7s)	3112	3112	256	71	174	12	1	258
29170	18703s (+0.7s)	2752	2752	256	58	162	0	17	237
29171	18703s (+0.4s)	1148	1148	64	25	105	0	9	139
29172	18704s (+0.9s)	3648	3648	256	60	233	0	17	310
29173	18705s (+0.4s)	1488	1488	128	37	111	0	7	155
29174	18706s (+1.2s)	6040	6040	512	125	278	25	0	428
29175	18706s (+0.5s)	1808	1808	128	40	142	4	0	186
29176	18707s (+0.9s)	4116	4116	256	88	226	21	1	336
29177	18708s (+0.4s)	1168	1168	64	33	98	8	0	139
29178	18708s (+0.3s)	1088	1088	128	21	90	4	0	115
29179	18709s (+0.7s)	2864	2864	256	60	176	10	1	247
29180	18709s (+0.7s)	2840	2840	256	70	168	10	0	248
29181	18711s (+1.4s)	6936	6936	512	115	353	25	0	493
29182	18712s (+1.1s)	4628	4628	256	114	254	19	0	387
29183	18713s (+0.9s)	3580	3580	256	96	191	15	0	302
29184	18714s (+0.8s)	3496	3496	256	89	187	17	0	293
29185	18714s (+0.8s)	3332	3332	256	74	190	16	0	280
29186	18715s (+1.0s)	4132	4132	256	98	238	14	0	350
29187	18716s (+0.6s)	2620	2620	256	59	149	14	0	222
29188	18717s (+0.8s)	3432	3432	256	72	202	14	1	289
29189	18717s (+0.3s)	864	864	64	27	81	4	0	112
29190	18718s (+0.7s)	3232	3232	256	66	189	14	1	270
29191	18718s (+0.5s)	1796	1796	128	41	138	5	0	184
29192	18719s (+0.4s)	1180	1180	128	32	88	5	0	125
29193	18720s (+0.7s)	3124	3124	256	55	191	10	0	256
29194	18720s (+0.5s)	1616	1616	128	29	131	2	0	162
29195	18720s (+0.4s)	1336	1336	128	36	101	7	1	145
29196	18721s (+0.3s)	1108	1108	128	24	88	3	0	115
29197	18722s (+1.0s)	4200	4200	256	96	231	19	0	346
29198	18722s (+0.4s)	1416	1416	128	31	107	7	0	145
29199	18723s (+0.8s)	3564	3564	256	69	209	16	0	294
Episode	Time	Reward	Score	Highest	L	U	R	D	Steps
29200	18724s (+0.6s)	1976	1976	128	45	147	9	0	201
29201	18724s (+0.2s)	668	668	64	19	62	5	0	86
29202	18724s (+0.4s)	1268	1268	64	40	91	10	0	141
29203	18725s (+0.5s)	1864	1864	128	49	126	10	0	185
29204	18725s (+0.5s)	1676	1676	128	48	115	8	0	171
29205	18726s (+0.5s)	1760	1760	128	42	126	11	0	179
29206	18727s (+0.7s)	2944	2944	256	55	182	10	0	247
29207	18727s (+0.5s)	1536	1536	128	43	111	8	0	162
29208	18728s (+0.7s)	3132	3132	256	60	179	16	0	255
29209	18728s (+0.7s)	2680	2680	256	62	160	7	0	229
29210	18730s (+1.1s)	5048	5048	256	126	248	21	1	396
29211	18730s (+0.4s)	1452	1452	128	39	107	0	6	152
29212	18731s (+1.2s)	6132	6132	512	89	332	0	25	446
29213	18731s (+0.2s)	476	476	64	13	51	0	5	69
29214	18732s (+0.6s)	2448	2448	256	46	155	0	8	209
29215	18733s (+0.5s)	2144	2144	256	42	131	0	9	182
29216	18733s (+0.7s)	2652	2652	256	47	184	0	2	233
29217	18733s (+0.2s)	544	544	64	9	64	0	2	75
29218	18734s (+0.4s)	1192	1192	64	24	111	0	7	142
29219	18734s (+0.5s)	1584	1584	128	32	130	0	6	168
29220	18735s (+0.5s)	1736	1736	128	34	137	0	4	175
29221	18736s (+0.8s)	3228	3228	256	59	200	0	11	270
29222	18736s (+0.6s)	2592	2592	256	39	176	0	9	224
29223	18737s (+0.4s)	1492	1492	128	35	115	0	5	155
29224	18737s (+0.6s)	2732	2732	256	53	168	0	7	228
29225	18738s (+0.5s)	1740	1740	128	39	127	0	10	176
29226	18738s (+0.5s)	1760	1760	128	41	131	7	0	179
29227	18739s (+0.5s)	1492	1492	64	55	104	8	0	167
29228	18739s (+0.5s)	2052	2052	128	43	139	10	0	192
29229	18740s (+0.7s)	2568	2568	128	71	157	12	1	241
29230	18741s (+0.5s)	1588	1588	128	41	123	5	0	169
29231	18741s (+0.5s)	1784	1784	128	39	138	5	0	182
29232	18742s (+0.8s)	3468	3468	256	78	195	18	0	291
29233	18743s (+0.9s)	3848	3848	256	93	204	16	0	313
29234	18744s (+0.7s)	2624	2624	128	73	159	17	1	250
29235	18744s (+0.6s)	2040	2040	128	51	141	8	1	201
29236	18745s (+0.7s)	3244	3244	256	62	197	14	0	273
29237	18745s (+0.5s)	1820	1820	128	41	144	5	0	190
29238	18746s (+0.4s)	1352	1352	128	29	105	3	0	137
29239	18747s (+1.0s)	4236	4236	256	111	211	23	0	345
29240	18747s (+0.4s)	1488	1488	128	46	98	8	0	152
29241	18748s (+0.5s)	1852	1852	128	51	133	5	1	190
29242	18749s (+0.9s)	3788	3788	256	75	214	11	2	302
29243	18750s (+0.9s)	3928	3928	256	90	215	16	0	321
29244	18750s (+0.6s)	2456	2456	256	51	150	9	0	210
29245	18751s (+0.5s)	1540	1540	128	36	120	5	0	161
29246	18751s (+0.6s)	2640	2640	256	40	177	3	0	220
29247	18752s (+0.5s)	1756	1756	128	39	125	14	0	178
29248	18752s (+0.7s)	3212	3212	256	66	187	13	0	266
29249	18753s (+0.7s)	2884	2884	256	69	169	14	0	252
29250	18753s (+0.3s)	944	944	128	15	76	0	5	96
29251	18754s (+0.5s)	1604	1604	128	26	127	0	7	160
29252	18754s (+0.4s)	1408	1408	128	25	111	1	7	144
29253	18755s (+0.7s)	2652	2652	256	43	177	0	13	233
29254	18755s (+0.5s)	1648	1648	128	28	128	0	8	164
29255	18756s (+0.8s)	3344	3344	256	65	204	0	13	282
29256	18757s (+0.5s)	1648	1648	128	33	139	0	3	175
29257	18758s (+0.9s)	3836	3836	256	50	254	0	7	311
29258	18758s (+0.6s)	2776	2776	256	46	181	0	11	238
29259	18758s (+0.2s)	348	348	32	12	43	0	4	59
29260	18759s (+0.5s)	1768	1768	128	42	128	0	7	177
29261	18760s (+0.8s)	3224	3224	256	67	190	12	0	269
29262	18760s (+0.7s)	2856	2856	256	55	173	10	0	238
29263	18761s (+0.6s)	2204	2204	128	54	155	12	0	221
29264	18762s (+1.0s)	5040	5040	512	92	230	22	1	345
29265	18762s (+0.4s)	1072	1072	64	32	94	5	0	131
29266	18764s (+1.1s)	5724	5724	512	116	267	18	1	402
29267	18765s (+1.1s)	4620	4620	256	109	254	22	0	385
29268	18765s (+0.7s)	2872	2872	256	58	164	14	0	236
29269	18766s (+1.0s)	5180	5180	512	106	243	17	0	366
29270	18767s (+0.6s)	2520	2520	256	56	144	11	0	211
29271	18767s (+0.3s)	832	832	64	30	73	5	0	108
29272	18768s (+0.3s)	820	820	64	30	71	5	0	106
29273	18768s (+0.6s)	2704	2704	256	59	157	9	0	225
29274	18769s (+0.4s)	1240	1240	128	39	90	6	0	135
29275	18769s (+0.5s)	1712	1712	128	45	116	12	1	174
29276	18770s (+0.6s)	2424	2424	256	42	146	16	0	204
29277	18770s (+0.5s)	1620	1620	128	42	121	9	0	172
29278	18771s (+0.7s)	3056	3056	256	56	187	10	0	253
29279	18772s (+0.6s)	2500	2500	256	48	162	7	0	217
29280	18772s (+0.6s)	1904	1904	128	34	150	11	0	195
29281	18773s (+0.5s)	1736	1736	128	50	119	12	0	181
29282	18773s (+0.6s)	2328	2328	128	60	154	11	0	225
29283	18774s (+0.5s)	1444	1444	128	46	104	10	0	160
29284	18775s (+0.9s)	3556	3556	256	72	219	13	0	304
29285	18775s (+0.8s)	3308	3308	256	67	207	10	0	284
29286	18776s (+0.4s)	1452	1452	128	38	105	8	0	151
29287	18776s (+0.6s)	2436	2436	256	59	137	9	0	205
29288	18777s (+0.9s)	3904	3904	256	71	229	14	1	315
29289	18778s (+0.9s)	3792	3792	256	76	222	16	0	314
29290	18779s (+0.9s)	4152	4152	256	81	236	16	1	334
29291	18780s (+0.5s)	1568	1568	128	34	118	8	0	160
29292	18780s (+0.4s)	1384	1384	64	37	110	7	0	154
29293	18781s (+0.9s)	3660	3660	256	74	213	12	0	299
29294	18782s (+0.5s)	1888	1888	128	44	145	6	0	195
29295	18782s (+0.5s)	1652	1652	128	41	119	7	0	167
29296	18783s (+0.8s)	3324	3324	256	63	195	16	0	274
29297	18783s (+0.5s)	2368	2368	256	35	154	6	0	195
29298	18784s (+0.8s)	3320	3320	256	95	168	15	0	278
29299	18785s (+0.7s)	2916	2916	256	68	161	11	0	240
Episode	Time	Reward	Score	Highest	L	U	R	D	Steps
29300	18786s (+0.9s)	3800	3800	256	78	217	11	0	306
29301	18787s (+0.8s)	3396	3396	256	64	204	11	1	280
29302	18787s (+0.4s)	1320	1320	128	37	99	9	0	145
29303	18788s (+0.8s)	3196	3196	256	60	198	14	0	272
29304	18788s (+0.3s)	1016	1016	64	29	83	0	7	119
29305	18789s (+0.6s)	2316	2316	128	39	160	0	13	212
29306	18789s (+0.7s)	2900	2900	256	50	192	0	9	251
29307	18790s (+0.4s)	1308	1308	128	24	105	0	4	133
29308	18790s (+0.1s)	196	196	16	6	37	0	2	45
29309	18791s (+0.4s)	1332	1332	128	32	107	0	10	149
29310	18791s (+0.8s)	3228	3228	256	76	186	0	8	270
29311	18792s (+0.4s)	1568	1568	128	39	109	9	0	157
29312	18792s (+0.7s)	2916	2916	256	61	182	12	0	255
29313	18793s (+0.3s)	716	716	64	15	73	0	5	93
29314	18793s (+0.5s)	1808	1808	128	49	126	7	0	182
29315	18794s (+0.5s)	1948	1948	128	52	126	11	0	189
29316	18795s (+0.8s)	3440	3440	256	63	213	14	0	290
29317	18795s (+0.5s)	1748	1748	128	40	132	5	0	177
29318	18796s (+0.6s)	2476	2476	256	57	145	13	0	215
29319	18796s (+0.7s)	3076	3076	256	71	165	13	0	249
29320	18797s (+0.5s)	1500	1500	128	42	108	9	0	159
29321	18797s (+0.5s)	1556	1556	128	36	117	7	1	161
29322	18798s (+0.9s)	3588	3588	256	72	223	8	0	303
29323	18799s (+0.7s)	2876	2876	256	40	198	0	8	246
29324	18799s (+0.4s)	1332	1332	128	28	106	0	5	139
29325	18800s (+0.4s)	1460	1460	128	22	125	0	3	150
29326	18801s (+0.9s)	4156	4156	256	77	254	0	10	341
29327	18801s (+0.5s)	1772	1772	128	44	131	7	0	182
29328	18802s (+0.4s)	1392	1392	64	43	104	9	0	156
29329	18802s (+0.6s)	1992	1992	128	51	139	11	0	201
29330	18803s (+0.6s)	1912	1912	128	40	150	6	0	196
29331	18803s (+0.4s)	1496	1496	128	32	116	9	0	157
29332	18804s (+0.4s)	1272	1272	128	22	111	2	0	135
29333	18804s (+0.7s)	2568	2568	256	43	173	0	12	228
29334	18805s (+0.5s)	1660	1660	128	34	129	5	0	168
29335	18806s (+0.7s)	2776	2776	256	71	155	15	0	241
29336	18806s (+0.4s)	1284	1284	128	36	93	8	0	137
29337	18806s (+0.4s)	1448	1448	128	30	117	4	0	151
29338	18807s (+0.3s)	944	944	64	32	80	4	0	116
29339	18808s (+0.9s)	3792	3792	256	91	207	16	0	314
29340	18809s (+1.0s)	4228	4228	256	89	237	21	0	347
29341	18809s (+0.6s)	2308	2308	128	71	137	16	0	224
29342	18810s (+0.8s)	3572	3572	256	82	206	12	0	300
29343	18811s (+0.6s)	2416	2416	128	57	155	14	0	226
29344	18811s (+0.5s)	1916	1916	128	43	133	7	1	184
29345	18812s (+0.6s)	2652	2652	256	60	147	11	0	218
29346	18812s (+0.5s)	1796	1796	128	45	130	7	1	183
29347	18813s (+1.0s)	4536	4536	256	85	270	0	17	372
29348	18814s (+0.7s)	2900	2900	256	50	179	0	8	237
29349	18815s (+0.6s)	2588	2588	256	43	168	0	11	222
29350	18816s (+0.7s)	3176	3176	256	51	195	0	16	262
29351	18816s (+0.5s)	1620	1620	128	27	137	0	3	167
29352	18817s (+1.3s)	7092	7092	512	122	330	29	0	481
29353	18818s (+0.4s)	1500	1500	128	34	117	8	0	159
29354	18818s (+0.5s)	1780	1780	128	43	126	11	0	180
29355	18819s (+0.6s)	2304	2304	128	50	161	7	0	218
29356	18820s (+0.9s)	3704	3704	256	84	217	9	0	310
29357	18820s (+0.6s)	1916	1916	128	49	138	10	0	197
29358	18821s (+0.8s)	3524	3524	256	63	220	12	0	295
29359	18822s (+0.8s)	3608	3608	256	62	221	8	0	291
29360	18823s (+0.9s)	3884	3884	256	71	238	12	0	321
29361	18824s (+0.6s)	1936	1936	128	53	139	7	0	199
29362	18824s (+0.6s)	2488	2488	128	62	157	13	1	233
29363	18825s (+0.9s)	3568	3568	256	90	189	19	1	299
29364	18825s (+0.3s)	1252	1252	128	22	99	4	1	126
29365	18826s (+0.8s)	3348	3348	256	57	206	11	0	274
29366	18827s (+0.8s)	3360	3360	256	60	209	16	1	286
29367	18828s (+0.6s)	2428	2428	256	37	157	7	0	201
29368	18828s (+0.7s)	2720	2720	256	56	165	9	0	230
29369	18829s (+1.0s)	4072	4072	256	80	243	17	0	340
29370	18830s (+0.9s)	4060	4060	256	74	246	17	1	338
29371	18831s (+0.6s)	1964	1964	128	55	134	5	0	194
29372	18832s (+0.9s)	3916	3916	256	72	236	11	0	319
29373	18832s (+0.4s)	1376	1376	128	35	106	4	0	145
29374	18833s (+0.6s)	1912	1912	128	47	143	6	0	196
29375	18834s (+1.0s)	4304	4304	256	90	247	17	0	354
29376	18835s (+0.9s)	4168	4168	256	81	236	21	0	338
29377	18835s (+0.8s)	3560	3560	256	68	203	19	0	290
29378	18836s (+0.6s)	1984	1984	128	59	144	6	0	209
29379	18837s (+1.0s)	4256	4256	256	88	246	20	0	354
29380	18838s (+0.7s)	2408	2408	128	61	150	13	1	225
29381	18839s (+0.7s)	3168	3168	256	58	191	11	1	261
29382	18839s (+0.9s)	3912	3912	256	84	215	18	0	317
29383	18840s (+0.7s)	2476	2476	128	77	144	13	1	235
29384	18841s (+0.9s)	4032	4032	256	68	245	14	0	327
29385	18842s (+1.0s)	4144	4144	256	88	243	13	0	344
29386	18843s (+0.5s)	1944	1944	128	37	145	7	0	189
29387	18843s (+0.8s)	3504	3504	256	68	212	15	0	295
29388	18844s (+0.6s)	1920	1920	128	44	146	8	0	198
29389	18845s (+1.0s)	4280	4280	256	90	242	16	0	348
29390	18845s (+0.5s)	1552	1552	128	45	108	0	8	161
29391	18846s (+1.0s)	4220	4220	256	105	230	17	0	352
29392	18847s (+0.6s)	2736	2736	256	50	157	11	0	218
29393	18848s (+0.8s)	3220	3220	256	73	184	11	0	268
29394	18849s (+0.7s)	3256	3256	256	65	187	14	0	266
29395	18849s (+0.5s)	1916	1916	128	52	125	6	0	183
29396	18850s (+0.8s)	3436	3436	256	81	183	15	0	279
29397	18851s (+0.8s)	3580	3580	256	99	193	11	0	303
29398	18851s (+0.5s)	1752	1752	128	52	111	11	0	174
29399	18852s (+0.5s)	1812	1812	128	48	126	8	0	182
Episode	Time	Reward	Score	Highest	L	U	R	D	Steps
29400	18852s (+0.5s)	1848	1848	128	47	112	11	1	171
29401	18853s (+0.5s)	1632	1632	128	41	114	9	0	164
29402	18853s (+0.4s)	1304	1304	128	21	105	6	0	132
29403	18854s (+1.0s)	4788	4788	512	120	202	19	0	341
29404	18855s (+0.7s)	3060	3060	256	56	185	9	0	250
29405	18856s (+1.2s)	5116	5116	256	126	252	27	0	405
29406	18856s (+0.4s)	1460	1460	128	43	96	9	1	149
29407	18857s (+0.5s)	1836	1836	128	43	141	5	0	189
29408	18857s (+0.3s)	916	916	64	24	89	7	0	120
29409	18858s (+0.3s)	1128	1128	128	31	90	4	0	125
29410	18858s (+0.8s)	3360	3360	256	62	211	13	0	286
29411	18859s (+0.4s)	1224	1224	64	42	103	3	0	148
29412	18860s (+0.8s)	3172	3172	256	69	179	18	0	266
29413	18861s (+0.9s)	4232	4232	256	100	228	20	0	348
29414	18861s (+0.5s)	1788	1788	128	40	136	6	0	182
29415	18862s (+0.6s)	2484	2484	256	44	163	7	0	214
29416	18862s (+0.2s)	608	608	64	19	62	4	0	85
29417	18862s (+0.2s)	612	612	64	21	63	2	0	86
29418	18863s (+0.5s)	1608	1608	128	39	125	5	0	169
29419	18864s (+0.8s)	3408	3408	256	64	207	9	0	280
29420	18864s (+0.7s)	3060	3060	256	54	186	9	0	249
29421	18865s (+0.9s)	4164	4164	256	91	225	19	0	335
29422	18866s (+0.7s)	3088	3088	256	64	175	12	1	252
29423	18867s (+0.9s)	3528	3528	256	89	196	15	0	300
29424	18867s (+0.4s)	1104	1104	64	33	90	6	0	129
29425	18868s (+0.4s)	1524	1524	128	40	117	3	0	160
29426	18868s (+0.8s)	3468	3468	256	63	210	13	0	286
29427	18869s (+0.7s)	2804	2804	256	51	183	10	0	244
29428	18870s (+0.8s)	3404	3404	256	72	197	12	1	282
29429	18871s (+0.8s)	3340	3340	256	62	206	13	0	281
29430	18871s (+0.6s)	2644	2644	256	58	155	16	0	229
29431	18872s (+0.4s)	1336	1336	128	22	110	0	8	140
29432	18872s (+0.2s)	620	620	64	16	65	0	4	85
29433	18873s (+0.6s)	2456	2456	256	38	164	0	6	208
29434	18874s (+1.0s)	4272	4272	256	86	258	14	0	358
29435	18874s (+0.7s)	2856	2856	256	69	162	16	0	247
29436	18875s (+0.8s)	3492	3492	256	79	201	12	0	292
29437	18876s (+0.5s)	1692	1692	128	36	129	9	0	174
29438	18876s (+0.7s)	3112	3112	256	86	161	20	0	267
29439	18877s (+0.7s)	2840	2840	256	59	171	12	0	242
29440	18878s (+0.6s)	2476	2476	256	52	151	7	0	210
29441	18878s (+0.7s)	2924	2924	256	69	182	5	0	256
29442	18879s (+0.4s)	1448	1448	128	34	110	6	1	151
29443	18879s (+0.5s)	1860	1860	128	43	132	13	0	188
29444	18880s (+0.9s)	3996	3996	256	77	241	14	1	333
29445	18881s (+0.4s)	1348	1348	128	39	100	8	0	147
29446	18881s (+0.5s)	1812	1812	128	48	134	6	0	188
29447	18882s (+0.6s)	2240	2240	128	58	140	16	1	215
29448	18882s (+0.5s)	1764	1764	128	44	131	5	0	180
29449	18883s (+0.4s)	1200	1200	64	27	104	3	0	134
29450	18884s (+0.7s)	3036	3036	256	62	172	11	0	245
29451	18884s (+0.7s)	3112	3112	256	65	178	14	0	257
29452	18885s (+0.2s)	600	600	64	18	64	4	0	86
29453	18885s (+0.4s)	1416	1416	128	16	127	2	0	145
29454	18886s (+0.9s)	4060	4060	256	76	235	22	0	333
29455	18887s (+0.6s)	2632	2632	256	68	148	13	0	229
29456	18887s (+0.5s)	1612	1612	128	31	130	0	9	170
29457	18888s (+0.7s)	3084	3084	256	74	168	11	2	255
29458	18889s (+0.7s)	2896	2896	256	60	178	14	0	252
29459	18889s (+0.7s)	2820	2820	256	55	168	11	0	234
29460	18889s (+0.3s)	760	760	64	22	74	6	0	102
29461	18890s (+0.7s)	3024	3024	256	84	166	10	0	260
29462	18891s (+0.6s)	2536	2536	256	55	144	11	0	210
29463	18892s (+0.7s)	3208	3208	256	45	213	0	7	265
29464	18892s (+0.5s)	1736	1736	128	29	140	0	6	175
29465	18892s (+0.2s)	300	300	32	8	43	0	3	54
29466	18893s (+0.5s)	1956	1956	128	46	132	0	10	188
29467	18893s (+0.7s)	2824	2824	256	47	190	0	7	244
29468	18894s (+0.8s)	3692	3692	256	67	211	0	13	291
29469	18895s (+0.8s)	3356	3356	256	56	209	0	10	275
29470	18896s (+0.5s)	1792	1792	128	36	145	0	3	184
29471	18896s (+0.5s)	1816	1816	128	41	136	0	12	189
29472	18897s (+0.5s)	1576	1576	128	40	115	10	0	165
29473	18897s (+0.4s)	1468	1468	128	28	120	4	0	152
29474	18898s (+0.8s)	3388	3388	256	59	201	19	1	280
29475	18899s (+0.7s)	2908	2908	256	62	179	12	0	253
29476	18899s (+0.6s)	2416	2416	256	55	142	9	1	207
29477	18900s (+0.7s)	2436	2436	128	68	149	14	0	231
29478	18901s (+1.0s)	4348	4348	256	111	231	23	0	365
29479	18902s (+1.0s)	4104	4104	256	86	229	21	0	336
29480	18903s (+0.8s)	3448	3448	256	80	193	19	1	293
29481	18903s (+0.8s)	3164	3164	256	61	196	9	0	266
29482	18904s (+0.7s)	3252	3252	256	73	182	14	0	269
29483	18905s (+0.6s)	2512	2512	128	67	152	13	0	232
29484	18906s (+1.0s)	4220	4220	256	83	252	15	0	350
29485	18906s (+0.5s)	1580	1580	128	42	115	5	0	162
29486	18908s (+1.3s)	6680	6680	512	140	296	25	0	461
29487	18909s (+1.0s)	4364	4364	256	101	241	20	0	362
29488	18909s (+0.5s)	1548	1548	128	34	118	7	0	159
29489	18910s (+1.3s)	6476	6476	512	121	322	19	0	462
29490	18911s (+0.5s)	1816	1816	128	45	136	7	0	188
29491	18911s (+0.3s)	968	968	64	48	66	4	0	118
29492	18912s (+0.4s)	1528	1528	128	32	125	5	0	162
29493	18912s (+0.5s)	1596	1596	128	38	110	10	0	158
29494	18913s (+1.1s)	4444	4444	256	93	258	19	0	370
29495	18914s (+0.5s)	1792	1792	128	42	138	4	0	184
29496	18914s (+0.5s)	1744	1744	128	53	118	12	0	183
29497	18915s (+0.6s)	2356	2356	128	53	152	12	0	217
29498	18916s (+0.6s)	2472	2472	256	51	153	7	0	211
29499	18916s (+0.5s)	1840	1840	128	40	134	11	0	185
Episode	Time	Reward	Score	Highest	L	U	R	D	Steps
29500	18917s (+0.7s)	2876	2876	256	50	184	11	1	246
29501	18918s (+0.8s)	3400	3400	256	57	215	14	1	287
29502	18919s (+1.0s)	5148	5148	512	97	251	17	0	365
29503	18919s (+0.3s)	1008	1008	128	18	87	2	0	107
29504	18920s (+0.7s)	2488	2488	128	61	160	12	0	233
29505	18920s (+0.7s)	2832	2832	256	56	169	11	0	236
29506	18921s (+1.0s)	4208	4208	256	109	221	19	0	349
29507	18922s (+0.6s)	2540	2540	256	57	154	10	0	221
29508	18923s (+1.0s)	4096	4096	256	86	244	11	0	341
29509	18923s (+0.3s)	1156	1156	128	29	89	5	0	123
29510	18924s (+0.6s)	2416	2416	256	50	149	9	0	208
29511	18924s (+0.5s)	1796	1796	128	45	133	6	0	184
29512	18925s (+0.7s)	2748	2748	256	52	178	5	0	235
29513	18925s (+0.3s)	672	672	64	14	75	3	0	92
29514	18926s (+0.7s)	2748	2748	256	60	164	10	1	235
29515	18926s (+0.4s)	1328	1328	64	37	105	9	1	152
29516	18927s (+0.5s)	1752	1752	128	34	133	11	0	178
29517	18928s (+0.7s)	3024	3024	256	58	183	15	0	256
29518	18928s (+0.4s)	1376	1376	128	34	105	6	0	145
29519	18929s (+0.6s)	2668	2668	256	59	158	9	0	226
29520	18929s (+0.6s)	2468	2468	256	39	159	0	11	209
29521	18930s (+0.8s)	3340	3340	256	55	213	0	10	278
29522	18930s (+0.3s)	864	864	64	23	81	0	8	112
29523	18931s (+0.5s)	1708	1708	128	35	133	0	11	179
29524	18931s (+0.4s)	1408	1408	128	31	106	1	7	145
29525	18932s (+0.4s)	1304	1304	128	32	93	0	6	131
29526	18932s (+0.5s)	1604	1604	128	27	133	0	7	167
29527	18933s (+1.1s)	5740	5740	512	108	273	25	0	406
29528	18934s (+0.6s)	1912	1912	128	40	147	9	0	196
29529	18935s (+0.6s)	2640	2640	256	63	147	10	0	220
29530	18935s (+0.6s)	2480	2480	256	51	150	12	0	213
29531	18936s (+0.5s)	1884	1884	128	38	145	6	0	189
29532	18936s (+0.5s)	1824	1824	128	49	125	10	0	184
29533	18937s (+0.3s)	1128	1128	128	23	93	1	0	117
29534	18937s (+0.6s)	1884	1884	128	42	139	13	0	194
29535	18938s (+0.5s)	1752	1752	128	49	119	10	0	178
29536	18938s (+0.3s)	792	792	64	16	77	6	1	100
29537	18939s (+0.6s)	2488	2488	256	51	155	8	0	214
29538	18939s (+0.2s)	556	556	64	33	45	2	0	80
29539	18939s (+0.6s)	1908	1908	128	47	143	7	0	197
29540	18940s (+0.5s)	2296	2296	256	47	133	8	1	189
29541	18940s (+0.6s)	2432	2432	256	38	157	8	1	204
29542	18941s (+0.5s)	1732	1732	128	54	109	10	0	173
29543	18942s (+0.6s)	2224	2224	128	58	143	10	0	211
29544	18942s (+0.4s)	1396	1396	128	29	109	7	0	145
29545	18943s (+0.5s)	1724	1724	128	33	129	0	9	171
29546	18943s (+0.4s)	1344	1344	128	28	104	0	6	138
29547	18943s (+0.4s)	1344	1344	128	26	107	0	6	139
29548	18944s (+0.5s)	1744	1744	128	60	101	15	0	176
29549	18944s (+0.6s)	1952	1952	128	40	154	8	0	202
29550	18945s (+0.6s)	2660	2660	256	47	171	8	0	226
29551	18946s (+0.5s)	1820	1820	128	36	149	5	0	190
29552	18946s (+0.4s)	1376	1376	128	35	106	4	0	145
29553	18946s (+0.3s)	844	844	64	25	78	5	0	108
29554	18947s (+0.3s)	980	980	64	28	92	4	0	124
29555	18947s (+0.4s)	1328	1328	128	21	109	0	4	134
29556	18947s (+0.3s)	1124	1124	128	34	87	0	3	124
29557	18948s (+0.7s)	2944	2944	256	48	205	0	9	262
29558	18949s (+0.8s)	3472	3472	256	73	201	13	0	287
29559	18949s (+0.3s)	872	872	64	24	84	5	0	113
29560	18950s (+0.6s)	2220	2220	128	60	138	12	0	210
29561	18951s (+0.8s)	3460	3460	256	73	195	15	1	284
29562	18952s (+0.9s)	3648	3648	256	63	218	0	15	296
29563	18952s (+0.7s)	2804	2804	256	58	177	0	9	244
29564	18953s (+0.5s)	1820	1820	128	41	138	0	10	189
29565	18953s (+0.5s)	1804	1804	128	52	124	11	0	187
29566	18954s (+0.6s)	1936	1936	128	68	120	14	0	202
29567	18954s (+0.6s)	2028	2028	128	54	139	10	0	203
29568	18955s (+0.6s)	2644	2644	256	49	165	8	0	222
29569	18956s (+1.0s)	4272	4272	256	86	248	17	0	351
29570	18957s (+1.1s)	5524	5524	512	106	262	21	0	389
29571	18958s (+0.5s)	1612	1612	128	45	118	7	0	170
29572	18958s (+0.7s)	2908	2908	256	66	177	10	0	253
29573	18959s (+0.6s)	2320	2320	128	59	148	8	0	215
29574	18959s (+0.4s)	1124	1124	64	38	88	6	0	132
29575	18960s (+0.7s)	3164	3164	256	72	174	13	0	259
29576	18961s (+0.7s)	3184	3184	256	66	186	10	0	262
29577	18961s (+0.3s)	672	672	64	15	75	0	0	90
29578	18961s (+0.3s)	692	692	64	15	76	3	0	94
29579	18962s (+0.8s)	3360	3360	256	63	202	12	0	277
29580	18963s (+0.8s)	3468	3468	256	59	217	11	0	287
29581	18964s (+0.5s)	1720	1720	128	44	121	11	0	176
29582	18964s (+0.4s)	1504	1504	128	43	112	4	1	160
29583	18965s (+1.0s)	4248	4248	256	97	248	13	1	359
29584	18966s (+0.8s)	3364	3364	256	79	194	13	1	287
29585	18966s (+0.5s)	1844	1844	128	37	128	6	1	172
29586	18967s (+0.6s)	2500	2500	256	60	147	10	0	217
29587	18968s (+0.8s)	3380	3380	256	64	198	14	0	276
29588	18969s (+0.8s)	3204	3204	256	58	202	10	0	270
29589	18969s (+0.4s)	1184	1184	128	32	92	5	0	129
29590	18969s (+0.3s)	872	872	64	29	79	5	0	113
29591	18970s (+0.8s)	3584	3584	256	77	218	7	1	303
29592	18971s (+0.9s)	4064	4064	256	88	231	19	0	338
29593	18972s (+0.9s)	4876	4876	512	81	256	9	0	346
29594	18972s (+0.5s)	1448	1448	128	32	117	8	0	157
29595	18973s (+0.4s)	1552	1552	128	33	124	4	0	161
29596	18974s (+0.6s)	2644	2644	256	53	167	7	0	227
29597	18974s (+0.8s)	3596	3596	256	74	211	16	0	301
29598	18975s (+0.5s)	1620	1620	128	49	116	7	0	172
29599	18976s (+0.9s)	3884	3884	256	84	222	15	0	321
Episode	Time	Reward	Score	Highest	L	U	R	D	Steps
29600	18977s (+0.8s)	3400	3400	256	80	183	18	0	281
29601	18977s (+0.4s)	1424	1424	128	32	106	8	1	147
29602	18978s (+0.5s)	1808	1808	128	43	136	8	0	187
29603	18978s (+0.7s)	3000	3000	256	62	171	13	0	246
29604	18979s (+0.5s)	2372	2372	256	39	155	8	0	202
29605	18980s (+0.8s)	3184	3184	256	62	189	18	0	269
29606	18980s (+0.1s)	212	212	32	2	41	0	0	43
29607	18981s (+0.7s)	2792	2792	128	88	156	15	1	260
29608	18981s (+0.8s)	3424	3424	256	72	202	13	0	287
29609	18982s (+0.8s)	3268	3268	256	61	200	8	0	269
29610	18983s (+0.9s)	3676	3676	256	69	240	7	0	316
29611	18984s (+0.9s)	3796	3796	256	84	204	17	0	305
29612	18984s (+0.5s)	1816	1816	128	41	138	9	0	188
29613	18985s (+0.4s)	1452	1452	128	29	116	6	0	151
29614	18985s (+0.6s)	2052	2052	128	55	137	8	0	200
29615	18986s (+0.5s)	1760	1760	128	36	137	6	1	180
29616	18987s (+0.5s)	1896	1896	128	55	129	8	0	192
29617	18987s (+0.5s)	1620	1620	128	50	115	7	0	172
29618	18988s (+0.7s)	2732	2732	128	72	163	15	0	250
29619	18988s (+0.3s)	1068	1068	128	18	90	0	5	113
29620	18989s (+0.8s)	3572	3572	256	72	205	0	16	293
29621	18990s (+0.7s)	2816	2816	256	53	180	0	8	241
29622	18991s (+1.0s)	4328	4328	256	97	246	17	0	360
29623	18991s (+0.5s)	1780	1780	128	48	126	6	0	180
29624	18991s (+0.3s)	612	612	32	25	63	4	0	92
29625	18992s (+0.5s)	1632	1632	128	39	119	7	0	165
29626	18993s (+0.7s)	2852	2852	256	51	178	8	0	237
29627	18993s (+0.4s)	1372	1372	128	31	108	5	0	144
29628	18994s (+1.0s)	5300	5300	512	95	249	19	0	363
29629	18995s (+0.6s)	2548	2548	256	43	162	4	0	209
29630	18995s (+0.5s)	1720	1720	128	50	119	12	0	181
29631	18996s (+0.4s)	1388	1388	128	38	105	4	0	147
29632	18996s (+0.8s)	3208	3208	256	70	181	14	0	265
29633	18997s (+0.8s)	3484	3484	256	69	208	0	13	290
29634	18998s (+0.5s)	1500	1500	128	31	117	0	11	159
29635	18998s (+0.7s)	2808	2808	256	43	195	0	6	244
29636	18999s (+0.3s)	1016	1016	64	25	93	0	4	122
29637	18999s (+0.3s)	1060	1060	128	17	94	0	1	112
29638	18999s (+0.5s)	1620	1620	128	30	128	0	4	162
29639	19000s (+0.4s)	1584	1584	128	25	128	0	6	159
29640	19000s (+0.4s)	1540	1540	128	36	114	11	0	161
29641	19001s (+0.5s)	1592	1592	128	39	117	9	0	165
29642	19002s (+0.8s)	3512	3512	256	73	209	16	0	298
29643	19002s (+0.7s)	3060	3060	256	72	173	14	1	260
29644	19003s (+0.8s)	3420	3420	256	59	213	0	14	286
29645	19004s (+0.4s)	1328	1328	64	37	109	0	6	152
29646	19004s (+0.5s)	1740	1740	128	37	130	1	8	176
29647	19005s (+0.3s)	1140	1140	128	25	91	0	6	122
29648	19005s (+0.8s)	3640	3640	256	62	219	1	12	294
29649	19006s (+0.5s)	2020	2020	128	40	149	0	8	197
29650	19007s (+0.6s)	2468	2468	256	40	163	0	7	210
29651	19007s (+0.6s)	2392	2392	128	56	153	13	1	223
29652	19008s (+0.6s)	1948	1948	128	53	141	6	0	200
29653	19009s (+1.2s)	6064	6064	512	120	286	28	0	434
29654	19010s (+1.0s)	4780	4780	512	80	242	15	2	339
29655	19010s (+0.3s)	948	948	64	37	69	8	0	114
29656	19011s (+0.4s)	1416	1416	128	39	99	5	0	143
29657	19011s (+0.4s)	1412	1412	128	29	111	8	0	148
29658	19012s (+0.9s)	4076	4076	256	96	217	14	0	327
29659	19013s (+0.7s)	2640	2640	128	84	148	18	0	250
29660	19013s (+0.5s)	1636	1636	128	41	129	6	0	176
29661	19014s (+0.6s)	2156	2156	128	62	137	10	0	209
29662	19015s (+0.9s)	4352	4352	256	77	244	14	1	336
29663	19015s (+0.3s)	860	860	64	24	85	2	0	111
29664	19016s (+0.4s)	1352	1352	128	28	118	3	0	149
29665	19017s (+0.9s)	3948	3948	256	79	231	16	0	326
29666	19017s (+0.9s)	4208	4208	256	87	244	11	0	342
29667	19018s (+0.5s)	1592	1592	128	35	122	8	0	165
29668	19019s (+0.5s)	2296	2296	256	38	145	4	2	189
29669	19019s (+0.8s)	3232	3232	256	70	191	10	0	271
29670	19020s (+0.8s)	3496	3496	256	82	204	14	0	300
29671	19021s (+0.5s)	2176	2176	256	46	129	10	0	185
29672	19021s (+0.4s)	1248	1248	128	40	93	6	0	139
29673	19022s (+0.6s)	2612	2612	256	34	187	0	7	228
29674	19023s (+0.8s)	3716	3716	256	66	225	0	15	306
29675	19023s (+0.5s)	1804	1804	128	34	142	0	10	186
29676	19024s (+0.5s)	1536	1536	128	37	117	0	8	162
29677	19024s (+0.6s)	1884	1884	128	35	152	0	8	195
29678	19025s (+1.1s)	5496	5496	512	97	274	17	1	389
29679	19026s (+0.6s)	2680	2680	256	45	165	6	0	216
29680	19027s (+0.6s)	2448	2448	256	56	141	10	1	208
29681	19027s (+0.5s)	1624	1624	128	44	121	3	0	168
29682	19028s (+0.5s)	1816	1816	128	56	127	6	0	189
29683	19028s (+0.2s)	568	568	64	11	66	0	0	77
29684	19028s (+0.5s)	1756	1756	128	34	140	5	0	179
29685	19029s (+0.4s)	1492	1492	128	39	113	5	0	157
29686	19029s (+0.3s)	972	972	64	23	87	6	0	116
29687	19030s (+0.5s)	1684	1684	128	46	120	7	0	173
29688	19030s (+0.7s)	2488	2488	128	72	146	16	0	234
29689	19031s (+0.9s)	4168	4168	256	86	237	16	0	339
29690	19031s (+0.2s)	564	564	32	26	53	6	0	85
29691	19032s (+0.3s)	788	788	64	23	75	6	0	104
29692	19032s (+0.4s)	1304	1304	128	30	108	4	0	142
29693	19033s (+1.0s)	4232	4232	256	96	229	24	0	349
29694	19034s (+0.6s)	2404	2404	128	46	170	0	8	224
29695	19034s (+0.4s)	1288	1288	128	20	105	0	5	130
29696	19035s (+0.5s)	1772	1772	128	37	134	0	7	178
29697	19035s (+0.7s)	2904	2904	256	47	177	0	14	238
29698	19036s (+0.6s)	2256	2256	128	43	161	0	15	219
29699	19037s (+0.6s)	2612	2612	256	43	168	0	11	222
Episode	Time	Reward	Score	Highest	L	U	R	D	Steps
29700	19037s (+0.7s)	3136	3136	256	65	183	0	15	263
29701	19038s (+0.6s)	2336	2336	256	38	151	0	6	195
29702	19038s (+0.3s)	1120	1120	128	21	92	0	5	118
29703	19039s (+0.5s)	1784	1784	128	41	134	0	6	181
29704	19039s (+0.3s)	828	828	64	18	79	0	2	99
29705	19040s (+0.5s)	1616	1616	128	37	131	0	3	171
29706	19040s (+0.4s)	1180	1180	128	29	93	5	0	127
29707	19041s (+0.5s)	1716	1716	128	47	121	7	0	175
29708	19041s (+0.8s)	3352	3352	256	69	198	17	0	284
29709	19042s (+0.8s)	3472	3472	256	74	197	15	0	286
29710	19043s (+0.7s)	2744	2744	256	64	156	11	0	231
29711	19044s (+1.4s)	6584	6584	512	124	324	28	1	477
29712	19045s (+0.6s)	2336	2336	128	45	164	4	0	213
29713	19045s (+0.5s)	1808	1808	128	44	137	5	0	186
29714	19046s (+0.3s)	1012	1012	128	18	89	1	0	108
29715	19047s (+1.0s)	4208	4208	256	84	243	14	1	342
29716	19047s (+0.5s)	1632	1632	128	45	116	9	0	170
29717	19048s (+0.6s)	1952	1952	128	58	121	17	0	196
29718	19048s (+0.6s)	2180	2180	128	68	141	11	0	220
29719	19049s (+0.7s)	3116	3116	256	64	184	11	0	259
29720	19050s (+0.4s)	1196	1196	64	36	102	8	0	146
29721	19050s (+0.7s)	3052	3052	256	61	183	13	1	258
29722	19051s (+0.6s)	1896	1896	128	57	130	9	0	196
29723	19051s (+0.4s)	1160	1160	64	23	105	6	0	134
29724	19052s (+0.8s)	3428	3428	256	67	206	0	16	289
29725	19053s (+0.7s)	2812	2812	256	54	178	0	14	246
29726	19053s (+0.6s)	2356	2356	256	33	161	0	6	200
29727	19054s (+1.0s)	5096	5096	512	80	263	0	16	359
29728	19055s (+1.0s)	4364	4364	256	82	258	0	21	361
29729	19056s (+1.1s)	4480	4480	256	74	284	0	15	373
29730	19057s (+0.2s)	436	436	32	10	57	0	3	70
29731	19057s (+0.5s)	1620	1620	128	36	128	0	8	172
29732	19058s (+0.5s)	1820	1820	128	37	145	0	8	190
29733	19058s (+0.4s)	1536	1536	128	20	130	0	4	154
29734	19058s (+0.2s)	540	540	64	12	66	2	0	80
29735	19059s (+0.2s)	344	344	32	15	44	4	0	63
29736	19060s (+1.3s)	6440	6440	512	114	315	23	0	452
29737	19061s (+0.8s)	3308	3308	256	77	179	14	0	270
29738	19061s (+0.4s)	1400	1400	128	36	102	7	0	145
29739	19061s (+0.3s)	780	780	64	23	74	4	0	101
29740	19062s (+0.8s)	3560	3560	256	76	207	15	0	298
29741	19063s (+0.5s)	1852	1852	128	47	138	7	0	192
29742	19063s (+0.7s)	3072	3072	256	68	176	9	0	253
29743	19064s (+0.7s)	3096	3096	256	59	183	12	0	254
29744	19065s (+0.9s)	3596	3596	256	86	194	21	0	301
29745	19066s (+0.6s)	2352	2352	256	46	148	13	0	207
29746	19066s (+0.7s)	2820	2820	256	58	166	8	1	233
29747	19067s (+0.6s)	2380	2380	256	42	150	11	0	203
29748	19067s (+0.4s)	1504	1504	128	35	111	8	1	155
29749	19068s (+0.4s)	1216	1216	128	25	106	4	0	135
29750	19068s (+0.5s)	1908	1908	128	65	122	8	0	195
29751	19069s (+0.6s)	2056	2056	128	37	161	7	0	205
29752	19070s (+0.7s)	3144	3144	256	54	186	15	0	255
29753	19070s (+0.7s)	3200	3200	256	63	172	21	0	256
29754	19071s (+0.4s)	1308	1308	128	33	97	8	1	139
29755	19072s (+0.8s)	3360	3360	256	54	221	11	0	286
29756	19072s (+0.5s)	1516	1516	128	34	121	3	0	158
29757	19073s (+0.6s)	2608	2608	256	45	161	10	1	217
29758	19073s (+0.7s)	2916	2916	256	52	192	11	0	255
29759	19074s (+0.4s)	1288	1288	128	26	100	4	0	130
29760	19075s (+0.8s)	3360	3360	256	68	208	10	0	286
29761	19075s (+0.8s)	3408	3408	256	73	209	11	0	293
29762	19076s (+0.7s)	3104	3104	256	45	203	8	0	256
29763	19078s (+1.6s)	8328	8328	512	144	383	34	1	562
29764	19078s (+0.6s)	2448	2448	256	49	155	11	0	215
29765	19079s (+0.9s)	3904	3904	256	88	212	15	0	315
29766	19080s (+0.7s)	2748	2748	256	59	167	11	0	237
29767	19081s (+0.9s)	3968	3968	256	94	216	16	0	326
29768	19082s (+0.6s)	2080	2080	128	69	115	17	0	201
29769	19082s (+0.4s)	1364	1364	128	26	113	0	3	142
29770	19082s (+0.3s)	792	792	64	24	69	0	7	100
29771	19083s (+0.9s)	3940	3940	256	84	224	11	0	319
29772	19084s (+1.2s)	6212	6212	512	106	316	18	0	440
29773	19085s (+0.6s)	1964	1964	128	44	150	7	0	201
29774	19086s (+0.6s)	2568	2568	256	49	159	9	1	218
29775	19086s (+0.8s)	3252	3252	256	67	197	10	0	274
29776	19087s (+1.0s)	4852	4852	512	75	254	15	1	345
29777	19088s (+0.7s)	3036	3036	256	60	185	9	0	254
29778	19089s (+0.5s)	1936	1936	128	41	131	9	0	181
29779	19090s (+1.0s)	4432	4432	256	92	246	26	2	366
29780	19090s (+0.8s)	3196	3196	256	51	203	12	0	266
29781	19091s (+0.7s)	3180	3180	256	68	178	12	1	259
29782	19092s (+0.7s)	2828	2828	256	56	173	11	0	240
29783	19092s (+0.4s)	1164	1164	64	37	97	5	0	139
29784	19093s (+0.4s)	1332	1332	128	31	107	6	0	144
29785	19094s (+1.0s)	5288	5288	512	90	253	18	0	361
29786	19095s (+1.0s)	4144	4144	256	94	236	13	0	343
29787	19095s (+0.4s)	1188	1188	64	42	94	8	0	144
29788	19096s (+0.8s)	3364	3364	256	70	195	12	0	277
29789	19096s (+0.4s)	1344	1344	128	51	83	7	0	141
29790	19097s (+0.5s)	1580	1580	128	29	124	4	0	157
29791	19097s (+0.7s)	2816	2816	256	65	173	9	0	247
29792	19099s (+1.1s)	4624	4624	256	109	251	22	0	382
29793	19099s (+0.8s)	3144	3144	256	83	166	16	0	265
29794	19100s (+0.7s)	2672	2672	256	42	189	2	0	233
29795	19101s (+0.5s)	1828	1828	128	41	135	8	0	184
29796	19101s (+0.5s)	1668	1668	128	39	121	8	0	168
29797	19102s (+0.7s)	2512	2512	128	64	159	16	0	239
29798	19102s (+0.5s)	2028	2028	128	71	118	9	0	198
29799	19103s (+0.9s)	3952	3952	256	86	221	16	0	323
Episode	Time	Reward	Score	Highest	L	U	R	D	Steps
29800	19104s (+0.8s)	3408	3408	256	74	209	10	0	293
29801	19105s (+0.6s)	2352	2352	256	35	156	6	0	197
29802	19105s (+0.6s)	2316	2316	128	55	155	11	0	221
29803	19106s (+0.5s)	2316	2316	256	37	149	6	0	192
29804	19107s (+0.7s)	2812	2812	256	59	173	13	0	245
29805	19107s (+0.4s)	1404	1404	128	26	121	4	0	151
29806	19107s (+0.4s)	1304	1304	128	36	97	8	1	142
29807	19108s (+0.3s)	656	656	64	21	68	3	0	92
29808	19108s (+0.4s)	1348	1348	128	34	97	6	0	137
29809	19108s (+0.5s)	1676	1676	128	40	122	9	0	171
29810	19109s (+0.3s)	1132	1132	128	23	96	2	0	121
29811	19110s (+0.7s)	3144	3144	256	81	171	17	0	269
29812	19110s (+0.3s)	872	872	64	22	83	8	0	113
29813	19111s (+1.0s)	4412	4412	256	105	240	27	0	372
29814	19112s (+1.2s)	5740	5740	512	120	265	21	1	407
29815	19113s (+0.9s)	3964	3964	256	63	246	16	0	325
29816	19113s (+0.4s)	1348	1348	128	32	110	6	0	148
29817	19114s (+0.8s)	3492	3492	256	88	191	13	0	292
29818	19115s (+0.5s)	1688	1688	128	34	125	7	0	166
29819	19115s (+0.4s)	1072	1072	64	35	88	8	0	131
29820	19116s (+0.7s)	3288	3288	256	57	205	0	11	273
29821	19116s (+0.5s)	1460	1460	128	25	117	0	8	150
29822	19117s (+0.4s)	992	992	64	24	90	0	9	123
29823	19117s (+0.4s)	1292	1292	128	32	89	1	7	129
29824	19118s (+0.5s)	1656	1656	128	39	123	8	0	170
29825	19118s (+0.6s)	2588	2588	256	57	157	8	0	222
29826	19119s (+0.5s)	1764	1764	128	41	130	6	0	177
29827	19120s (+1.0s)	4052	4052	256	83	237	14	1	335
29828	19121s (+1.1s)	4516	4516	256	115	242	18	0	375
29829	19121s (+0.5s)	1852	1852	128	48	131	8	0	187
29830	19122s (+0.7s)	2816	2816	256	52	185	10	0	247
29831	19123s (+0.8s)	3216	3216	256	58	204	16	1	279
29832	19124s (+0.7s)	2620	2620	256	53	165	12	0	230
29833	19124s (+0.8s)	3288	3288	256	44	221	7	0	272
29834	19125s (+0.8s)	3192	3192	256	70	186	10	0	266
29835	19126s (+0.6s)	2364	2364	128	61	158	10	0	229
29836	19127s (+1.0s)	5196	5196	512	106	255	16	0	377
29837	19127s (+0.3s)	864	864	64	28	74	10	0	112
29838	19128s (+0.7s)	2816	2816	256	60	173	13	0	246
29839	19128s (+0.5s)	1768	1768	128	35	141	6	0	182
29840	19129s (+0.3s)	856	856	64	30	71	10	0	111
29841	19129s (+0.4s)	1432	1432	128	28	116	9	0	153
29842	19130s (+0.8s)	3532	3532	256	72	214	11	0	297
29843	19131s (+0.7s)	2472	2472	128	73	156	16	0	245
29844	19131s (+0.7s)	3044	3044	256	60	187	11	0	258
29845	19132s (+0.9s)	4008	4008	256	85	224	20	0	329
29846	19133s (+0.4s)	1148	1148	128	21	102	1	0	124
29847	19134s (+1.1s)	4380	4380	256	102	256	15	0	373
29848	19134s (+0.6s)	1952	1952	128	52	143	11	0	206
29849	19135s (+0.5s)	1784	1784	128	40	133	8	0	181
29850	19135s (+0.3s)	1020	1020	128	19	81	0	9	109
29851	19136s (+0.5s)	1884	1884	128	35	145	0	9	189
29852	19136s (+0.5s)	1636	1636	128	40	121	0	5	166
29853	19137s (+0.3s)	908	908	64	28	87	2	0	117
29854	19137s (+0.8s)	3364	3364	256	95	174	17	1	287
29855	19138s (+0.5s)	2124	2124	128	50	134	12	0	196
29856	19139s (+0.6s)	1924	1924	128	43	149	7	0	199
29857	19139s (+0.3s)	1148	1148	128	31	85	4	0	120
29858	19139s (+0.3s)	1080	1080	128	22	86	5	0	113
29859	19140s (+0.5s)	1680	1680	128	55	108	9	0	172
29860	19141s (+0.9s)	4044	4044	256	78	240	15	1	334
29861	19141s (+0.7s)	3100	3100	256	54	192	0	10	256
29862	19142s (+0.8s)	3296	3296	256	56	199	0	17	272
29863	19143s (+0.8s)	3492	3492	256	61	220	0	11	292
29864	19144s (+0.6s)	2400	2400	128	56	150	0	17	223
29865	19144s (+0.6s)	1924	1924	128	45	146	8	0	199
29866	19146s (+1.5s)	7592	7592	512	162	342	33	0	537
29867	19147s (+0.9s)	3648	3648	256	82	209	14	1	306
29868	19147s (+0.8s)	3668	3668	256	71	214	14	1	300
29869	19148s (+0.3s)	880	880	64	29	70	5	0	104
29870	19148s (+0.6s)	2140	2140	128	48	161	8	0	217
29871	19149s (+0.7s)	3068	3068	256	62	175	11	0	248
29872	19150s (+0.9s)	3700	3700	256	81	218	17	0	316
29873	19151s (+0.9s)	3672	3672	256	89	194	21	1	305
29874	19151s (+0.6s)	2180	2180	128	50	149	6	0	205
29875	19152s (+0.4s)	1460	1460	128	36	110	7	0	153
29876	19152s (+0.5s)	1540	1540	64	40	122	10	0	172
29877	19153s (+0.6s)	2744	2744	256	55	164	14	0	233
29878	19154s (+0.5s)	1704	1704	128	43	122	5	0	170
29879	19154s (+0.6s)	2696	2696	256	63	157	13	0	233
29880	19155s (+0.5s)	1500	1500	128	35	113	10	0	158
29881	19156s (+0.9s)	4064	4064	256	77	241	20	0	338
29882	19156s (+0.4s)	1492	1492	128	41	108	7	0	156
29883	19156s (+0.5s)	1612	1612	128	34	127	9	0	170
29884	19157s (+0.6s)	2628	2628	256	42	174	0	11	227
29885	19158s (+0.4s)	1248	1248	128	23	103	0	3	129
29886	19158s (+0.3s)	696	696	64	19	70	0	3	92
29887	19158s (+0.7s)	2872	2872	256	50	175	0	10	235
29888	19159s (+0.7s)	3120	3120	256	58	190	0	11	259
29889	19159s (+0.3s)	816	816	64	23	74	0	8	105
29890	19160s (+0.8s)	3564	3564	256	63	211	0	12	286
29891	19161s (+0.7s)	2768	2768	256	53	169	0	14	236
29892	19162s (+0.5s)	2260	2260	256	44	132	10	0	186
29893	19162s (+0.5s)	1636	1636	128	43	123	10	0	176
29894	19163s (+0.5s)	2204	2204	256	38	132	10	0	180
29895	19164s (+1.0s)	4212	4212	256	81	242	21	0	344
29896	19165s (+1.0s)	4452	4452	256	91	254	14	0	359
29897	19165s (+0.5s)	1660	1660	128	40	115	12	0	167
29898	19166s (+0.6s)	2504	2504	256	51	146	14	0	211
29899	19166s (+0.6s)	2092	2092	128	57	131	15	0	203
Episode	Time	Reward	Score	Highest	L	U	R	D	Steps
29900	19167s (+0.9s)	3784	3784	256	91	209	16	0	316
29901	19168s (+0.6s)	2396	2396	256	50	140	12	0	202
29902	19169s (+0.8s)	3208	3208	256	68	184	13	0	265
29903	19169s (+0.4s)	1228	1228	128	36	91	7	0	134
29904	19170s (+1.1s)	5364	5364	512	95	263	15	0	373
29905	19171s (+0.5s)	1528	1528	128	27	125	8	1	161
29906	19171s (+0.8s)	3312	3312	256	74	186	12	0	272
29907	19172s (+0.4s)	1348	1348	128	40	101	6	0	147
29908	19173s (+1.2s)	5900	5900	512	111	282	17	0	410
29909	19174s (+0.8s)	3220	3220	256	71	184	14	0	269
29910	19174s (+0.6s)	2680	2680	256	61	158	8	0	227
29911	19175s (+1.0s)	4304	4304	256	86	247	17	0	350
29912	19176s (+0.5s)	1704	1704	128	45	116	12	0	173
29913	19176s (+0.4s)	1512	1512	128	35	119	7	0	161
29914	19177s (+0.6s)	2688	2688	256	42	178	6	0	226
29915	19178s (+0.6s)	2456	2456	256	47	148	12	0	207
29916	19178s (+0.5s)	1660	1660	128	38	125	8	0	171
29917	19179s (+0.6s)	1940	1940	128	52	145	6	0	203
29918	19179s (+0.6s)	2684	2684	256	48	173	11	0	232
29919	19180s (+0.6s)	2236	2236	128	55	147	12	0	214
29920	19181s (+0.8s)	3480	3480	256	58	216	15	0	289
29921	19181s (+0.5s)	1640	1640	128	48	119	5	0	172
29922	19182s (+0.8s)	3456	3456	256	76	205	10	0	291
29923	19183s (+0.6s)	2732	2732	256	53	171	7	0	231
29924	19183s (+0.5s)	1864	1864	128	54	121	13	1	189
29925	19184s (+0.4s)	1360	1360	128	27	115	9	0	151
29926	19184s (+0.5s)	1620	1620	128	39	131	3	0	173
29927	19185s (+0.5s)	1468	1468	128	37	110	8	0	155
29928	19185s (+0.4s)	1352	1352	128	45	101	3	0	149
29929	19186s (+0.5s)	2152	2152	256	41	138	5	0	184
29930	19186s (+0.4s)	1300	1300	128	38	97	6	0	141
29931	19186s (+0.3s)	1080	1080	128	27	87	5	0	119
29932	19187s (+0.5s)	1784	1784	128	43	131	0	7	181
29933	19188s (+0.6s)	2700	2700	256	38	183	0	7	228
29934	19188s (+0.8s)	3528	3528	256	50	232	0	14	296
29935	19189s (+0.3s)	780	780	64	17	80	0	6	103
29936	19189s (+0.6s)	2376	2376	256	36	160	0	8	204
29937	19190s (+0.7s)	2936	2936	256	64	183	13	0	260
29938	19190s (+0.4s)	1464	1464	128	36	110	8	0	154
29939	19191s (+0.4s)	1452	1452	128	39	102	10	0	151
29940	19191s (+0.5s)	1764	1764	128	32	136	0	8	176
29941	19192s (+0.9s)	3844	3844	256	58	241	0	13	312
29942	19193s (+0.6s)	2656	2656	256	65	139	10	0	214
29943	19194s (+0.7s)	3016	3016	256	48	182	13	1	244
29944	19194s (+0.7s)	2960	2960	256	43	192	12	0	247
29945	19195s (+0.6s)	1920	1920	128	46	142	10	0	198
29946	19196s (+0.8s)	2888	2888	128	83	169	17	0	269
29947	19196s (+0.5s)	1532	1532	128	38	116	6	0	160
29948	19197s (+0.5s)	1788	1788	128	50	120	12	0	182
29949	19197s (+0.7s)	2860	2860	256	70	159	9	0	238
29950	19198s (+0.5s)	1492	1492	128	40	112	5	0	157
29951	19198s (+0.6s)	2476	2476	256	58	142	11	1	212
29952	19199s (+0.7s)	3144	3144	256	51	200	9	0	260
29953	19200s (+0.4s)	1484	1484	128	43	110	6	0	159
29954	19200s (+0.6s)	2060	2060	128	56	140	10	0	206
29955	19201s (+0.7s)	3144	3144	256	62	181	16	0	259
29956	19202s (+0.8s)	3188	3188	256	64	184	13	1	262
29957	19203s (+0.8s)	3616	3616	256	69	197	15	0	281
29958	19203s (+0.8s)	3472	3472	256	71	202	14	0	287
29959	19204s (+0.5s)	1816	1816	128	44	138	6	0	188
29960	19205s (+0.7s)	3116	3116	256	64	183	12	0	259
29961	19205s (+0.4s)	1536	1536	128	39	109	5	0	153
29962	19206s (+0.8s)	3404	3404	256	72	192	19	0	283
29963	19207s (+1.0s)	4336	4336	256	98	238	23	0	359
29964	19208s (+0.7s)	2952	2952	256	64	164	10	1	239
29965	19208s (+0.8s)	3500	3500	256	85	191	12	0	288
29966	19209s (+0.7s)	2820	2820	256	65	170	12	0	247
29967	19210s (+0.7s)	3024	3024	256	56	180	15	0	251
29968	19211s (+0.7s)	2808	2808	256	62	177	10	0	249
29969	19211s (+0.5s)	1768	1768	128	41	130	6	0	177
29970	19211s (+0.1s)	232	232	32	7	39	0	0	46
29971	19212s (+0.3s)	744	744	64	33	60	6	0	99
29972	19212s (+0.6s)	2548	2548	256	46	162	9	0	217
29973	19213s (+0.8s)	3188	3188	256	73	180	14	0	267
29974	19214s (+0.6s)	2212	2212	128	44	160	3	1	208
29975	19214s (+0.7s)	2944	2944	256	59	173	11	0	243
29976	19215s (+0.8s)	3228	3228	256	63	197	10	0	270
29977	19215s (+0.5s)	1656	1656	128	39	120	8	0	167
29978	19216s (+0.5s)	1880	1880	128	51	121	6	0	178
29979	19217s (+1.4s)	6616	6616	512	150	292	38	0	480
29980	19218s (+0.6s)	2148	2148	128	62	137	14	0	213
29981	19218s (+0.2s)	584	584	64	10	66	0	4	80
29982	19219s (+0.5s)	1828	1828	128	34	140	0	8	182
29983	19219s (+0.5s)	1904	1904	128	48	137	9	0	194
29984	19220s (+0.6s)	2616	2616	256	70	149	10	0	229
29985	19220s (+0.4s)	1376	1376	128	39	97	11	0	147
29986	19221s (+0.6s)	2720	2720	256	46	171	10	1	228
29987	19221s (+0.4s)	1572	1572	128	32	112	13	0	157
29988	19222s (+0.6s)	2432	2432	128	66	153	12	0	231
29989	19223s (+0.8s)	3612	3612	256	86	188	17	0	291
29990	19224s (+0.8s)	3496	3496	256	73	209	11	0	293
29991	19224s (+0.3s)	772	772	64	28	70	4	0	102
29992	19225s (+0.4s)	1444	1444	128	28	114	7	0	149
29993	19225s (+0.9s)	3612	3612	256	75	212	20	0	307
29994	19226s (+1.0s)	5284	5284	512	82	262	23	1	368
29995	19227s (+0.7s)	2924	2924	256	64	176	13	0	253
29996	19228s (+0.6s)	1956	1956	128	50	146	6	0	202
29997	19228s (+0.3s)	632	632	64	15	67	0	5	87
29998	19229s (+0.8s)	3520	3520	256	66	215	0	14	295
29999	19230s (+0.8s)	3200	3200	256	57	209	8	0	274
Episode	Time	Reward	Score	Highest	L	U	R	D	Steps
30000	19230s (+0.8s)	3244	3244	256	69	187	17	1	274
30001	19231s (+0.8s)	3152	3152	256	72	186	17	0	275
30002	19232s (+0.5s)	1660	1660	128	36	125	7	3	171
30003	19232s (+0.5s)	1752	1752	128	38	135	5	0	178
30004	19233s (+0.9s)	3928	3928	256	71	233	18	0	322
30005	19234s (+0.7s)	2696	2696	256	57	165	12	0	234
30006	19234s (+0.6s)	1876	1876	128	63	128	8	0	199
30007	19235s (+0.9s)	4172	4172	256	78	245	15	0	338
30008	19236s (+0.4s)	1244	1244	128	28	98	3	0	129
30009	19236s (+0.4s)	1092	1092	64	39	89	3	0	131
30010	19237s (+0.4s)	1244	1244	128	40	92	6	0	138
30011	19237s (+0.7s)	3068	3068	256	65	177	10	0	252
30012	19238s (+0.2s)	572	572	32	22	61	4	0	87
30013	19238s (+0.6s)	2120	2120	128	47	149	13	0	209
30014	19239s (+0.8s)	3268	3268	256	56	211	7	0	274
30015	19239s (+0.4s)	1240	1240	128	31	100	6	0	137
30016	19240s (+0.3s)	824	824	64	28	79	2	0	109
30017	19241s (+0.9s)	3992	3992	256	84	231	17	0	332
30018	19241s (+0.7s)	2768	2768	256	56	177	8	0	241
30019	19242s (+1.1s)	5508	5508	512	77	298	0	17	392
30020	19243s (+0.7s)	3132	3132	256	57	191	0	15	263
30021	19244s (+0.4s)	1192	1192	64	33	105	0	7	145
30022	19244s (+0.7s)	2672	2672	256	44	176	0	8	228
30023	19245s (+0.9s)	3820	3820	256	71	224	0	13	308
30024	19246s (+0.6s)	2544	2544	256	54	163	6	0	223
30025	19246s (+0.4s)	1448	1448	128	31	115	5	0	151
30026	19247s (+0.9s)	3608	3608	256	89	195	20	1	305
30027	19248s (+1.0s)	4976	4976	512	78	246	13	2	339
30028	19249s (+0.8s)	3472	3472	256	70	206	11	0	287
30029	19250s (+1.1s)	5420	5420	512	107	251	18	0	376
30030	19250s (+0.3s)	836	836	64	28	76	5	0	109
30031	19251s (+0.5s)	1756	1756	128	36	133	6	0	175
30032	19252s (+0.8s)	3488	3488	256	65	213	10	0	288
30033	19252s (+0.4s)	1216	1216	128	31	90	5	0	126
30034	19252s (+0.4s)	1424	1424	128	18	126	1	0	145
30035	19253s (+0.4s)	1284	1284	128	30	94	6	1	131
30036	19253s (+0.7s)	2884	2884	256	64	176	6	1	247
30037	19254s (+0.8s)	3432	3432	256	82	189	17	0	288
30038	19255s (+0.8s)	3480	3480	256	90	184	15	0	289
30039	19256s (+0.6s)	2512	2512	256	48	155	12	0	215
30040	19256s (+0.5s)	1668	1668	128	42	117	9	1	169
30041	19257s (+0.7s)	2780	2780	256	62	161	15	0	238
30042	19257s (+0.6s)	1932	1932	128	45	147	9	0	201
30043	19258s (+0.6s)	2448	2448	256	52	146	12	0	210
30044	19259s (+0.7s)	2824	2824	256	59	171	12	0	242
30045	19259s (+0.6s)	2772	2772	256	71	150	15	0	236
30046	19260s (+0.7s)	3164	3164	256	68	179	12	0	259
30047	19261s (+0.6s)	2508	2508	256	50	156	12	1	219
30048	19262s (+0.9s)	4652	4652	512	72	232	19	0	323
30049	19263s (+0.9s)	3660	3660	256	76	208	18	0	302
30050	19263s (+0.3s)	876	876	64	28	78	5	0	111
30051	19263s (+0.5s)	1520	1520	128	36	111	12	0	159
30052	19264s (+0.8s)	3072	3072	256	52	196	15	0	263
30053	19265s (+0.9s)	4000	4000	256	56	256	0	18	330
30054	19265s (+0.2s)	656	656	64	13	67	0	4	84
30055	19266s (+0.4s)	1392	1392	128	33	104	0	8	145
30056	19266s (+0.7s)	2696	2696	256	41	189	0	9	239
30057	19267s (+0.5s)	1828	1828	128	31	147	0	5	183
30058	19268s (+0.9s)	3864	3864	256	70	231	0	16	317
30059	19268s (+0.4s)	1172	1172	128	24	99	0	3	126
30060	19269s (+0.4s)	1380	1380	128	28	107	0	10	145
30061	19269s (+0.8s)	3468	3468	256	65	214	0	8	287
30062	19270s (+0.3s)	892	892	128	18	74	0	3	95
30063	19270s (+0.5s)	1696	1696	128	34	126	0	15	175
30064	19271s (+0.8s)	3376	3376	256	65	197	17	0	279
30065	19272s (+0.8s)	2908	2908	128	70	181	18	0	269
30066	19272s (+0.5s)	1632	1632	128	35	127	10	0	172
30067	19273s (+0.9s)	3604	3604	256	89	194	21	0	304
30068	19274s (+0.5s)	2048	2048	128	49	130	10	0	189
30069	19275s (+1.0s)	5456	5456	512	123	237	19	0	379
30070	19275s (+0.7s)	2524	2524	128	68	160	13	0	241
30071	19276s (+0.5s)	1800	1800	128	52	125	7	1	185
30072	19277s (+0.6s)	2436	2436	128	64	147	14	0	225
30073	19278s (+1.1s)	5508	5508	512	90	283	19	0	392
30074	19279s (+0.9s)	3780	3780	256	60	234	11	1	306
30075	19279s (+0.5s)	2296	2296	256	40	146	7	0	193
30076	19280s (+0.9s)	3876	3876	256	70	239	11	0	320
30077	19281s (+0.5s)	1788	1788	128	42	131	9	0	182
30078	19281s (+0.4s)	1568	1568	128	41	112	7	0	160
30079	19282s (+0.7s)	2796	2796	256	60	171	11	0	242
30080	19283s (+0.8s)	3764	3764	256	64	229	14	0	307
30081	19283s (+0.4s)	1020	1020	64	37	79	7	0	123
30082	19284s (+0.8s)	3432	3432	256	71	204	13	1	289
30083	19284s (+0.4s)	1540	1540	128	35	114	6	0	155
30084	19285s (+0.5s)	1808	1808	128	36	143	7	0	186
30085	19285s (+0.3s)	1104	1104	128	20	91	0	3	114
30086	19286s (+0.5s)	1916	1916	128	41	142	0	6	189
30087	19286s (+0.2s)	312	312	32	13	43	0	1	57
30088	19286s (+0.3s)	1092	1092	128	32	82	0	4	118
30089	19287s (+0.4s)	1244	1244	128	23	107	0	8	138
30090	19288s (+1.1s)	5536	5536	512	76	290	0	23	389
30091	19288s (+0.7s)	2808	2808	256	66	167	0	13	246
30092	19289s (+0.6s)	2352	2352	128	46	159	0	12	217
30093	19290s (+0.4s)	1448	1448	128	37	105	9	0	151
30094	19290s (+0.8s)	3396	3396	256	74	194	13	0	281
30095	19291s (+0.5s)	1820	1820	128	36	140	7	0	183
30096	19291s (+0.4s)	1364	1364	128	26	110	6	0	142
30097	19292s (+0.8s)	3224	3224	256	81	175	13	0	269
30098	19293s (+0.8s)	3300	3300	256	75	178	12	2	267
30099	19294s (+0.8s)	3604	3604	256	71	210	9	0	290
Episode	Time	Reward	Score	Highest	L	U	R	D	Steps
30100	19294s (+0.6s)	1904	1904	128	42	146	6	0	194
30101	19295s (+1.2s)	5748	5748	512	111	270	24	0	405
30102	19296s (+0.7s)	2920	2920	256	56	193	7	0	256
30103	19297s (+0.7s)	2884	2884	256	63	167	12	0	242
30104	19298s (+0.7s)	3016	3016	256	60	180	11	0	251
30105	19298s (+0.8s)	3480	3480	256	74	204	11	1	290
30106	19299s (+0.5s)	1956	1956	128	46	141	6	0	193
30107	19300s (+0.8s)	3164	3164	256	68	199	11	0	278
30108	19300s (+0.7s)	2784	2784	256	63	168	7	1	239
30109	19301s (+0.8s)	2976	2976	256	61	198	6	0	265
30110	19302s (+0.5s)	1900	1900	128	42	140	9	0	191
30111	19303s (+1.0s)	4308	4308	256	98	241	16	0	355
30112	19303s (+0.5s)	1684	1684	128	46	118	8	0	172
30113	19304s (+0.3s)	748	748	64	27	67	4	1	99
30114	19304s (+0.4s)	1236	1236	128	29	97	0	10	136
30115	19304s (+0.2s)	548	548	64	11	57	0	6	74
30116	19305s (+0.9s)	3604	3604	256	78	211	15	0	304
30117	19305s (+0.4s)	1260	1260	128	34	88	4	0	126
30118	19306s (+0.7s)	2556	2556	128	56	169	12	1	238
30119	19307s (+0.5s)	1796	1796	128	45	129	9	0	183
30120	19307s (+0.5s)	2300	2300	256	51	128	10	0	189
30121	19308s (+0.4s)	1524	1524	128	35	117	9	0	161
30122	19308s (+0.8s)	3220	3220	256	68	183	17	0	268
30123	19309s (+1.0s)	4232	4232	256	90	242	16	0	348
30124	19310s (+0.5s)	1920	1920	128	35	155	8	0	198
30125	19311s (+0.7s)	2464	2464	128	82	141	16	0	239
30126	19311s (+0.8s)	3420	3420	256	82	189	13	0	284
30127	19312s (+0.8s)	3392	3392	256	60	204	15	0	279
30128	19313s (+0.5s)	1624	1624	128	31	136	0	5	172
30129	19313s (+0.5s)	1772	1772	128	36	133	0	11	180
30130	19314s (+0.5s)	1788	1788	128	39	131	0	12	182
30131	19314s (+0.5s)	1628	1628	128	35	129	0	9	173
30132	19315s (+0.4s)	1400	1400	128	22	117	0	5	144
30133	19315s (+0.5s)	1668	1668	128	40	122	7	0	169
30134	19316s (+0.7s)	2612	2612	256	57	165	6	0	228
30135	19316s (+0.5s)	1632	1632	128	42	115	8	0	165
30136	19317s (+0.5s)	1944	1944	128	43	144	10	0	197
30137	19318s (+0.8s)	3736	3736	256	85	200	17	0	302
30138	19319s (+0.9s)	3764	3764	256	68	222	10	1	301
30139	19319s (+0.9s)	4120	4120	256	83	231	18	0	332
30140	19320s (+0.8s)	3492	3492	256	83	190	19	0	292
30141	19321s (+1.0s)	4296	4296	256	89	255	15	0	359
30142	19322s (+0.8s)	3140	3140	256	66	184	14	0	264
30143	19323s (+0.6s)	2484	2484	256	55	154	5	0	214
30144	19323s (+0.4s)	1204	1204	128	27	100	3	0	130
30145	19324s (+0.5s)	1604	1604	128	45	112	11	0	168
30146	19324s (+0.6s)	2664	2664	256	61	155	10	0	226
30147	19325s (+1.0s)	4052	4052	256	62	259	14	0	335
30148	19326s (+0.8s)	3244	3244	256	77	180	16	0	273
30149	19327s (+0.7s)	3232	3232	256	62	195	13	0	270
30150	19327s (+0.3s)	1144	1144	128	29	91	3	0	123
30151	19328s (+1.1s)	5452	5452	512	92	279	12	0	383
30152	19329s (+1.1s)	5480	5480	512	87	280	18	0	385
30153	19330s (+0.5s)	1532	1532	128	34	120	8	0	162
30154	19331s (+1.1s)	5568	5568	512	96	272	24	0	392
30155	19331s (+0.4s)	1464	1464	128	40	112	5	0	157
30156	19332s (+0.3s)	780	780	64	27	72	4	0	103
30157	19333s (+1.1s)	5504	5504	512	102	261	21	0	384
30158	19333s (+0.8s)	3504	3504	256	88	184	21	2	295
30159	19334s (+0.9s)	3584	3584	256	72	221	13	0	306
30160	19335s (+0.5s)	1620	1620	128	34	119	7	1	161
30161	19335s (+0.3s)	644	644	64	17	69	1	1	88
30162	19336s (+0.7s)	3056	3056	256	80	171	11	1	263
30163	19337s (+0.7s)	3132	3132	256	66	181	15	0	262
30164	19337s (+0.5s)	1844	1844	128	52	116	17	0	185
30165	19338s (+1.2s)	5624	5624	512	99	286	19	0	404
30166	19339s (+0.5s)	1612	1612	128	51	110	9	0	170
30167	19340s (+0.8s)	3188	3188	256	61	187	0	17	265
30168	19340s (+0.6s)	2568	2568	256	58	161	0	9	228
30169	19341s (+0.4s)	1496	1496	128	25	120	0	3	148
30170	19341s (+0.6s)	2564	2564	256	49	167	0	5	221
30171	19342s (+0.3s)	828	828	64	23	79	0	6	108
30172	19342s (+0.8s)	3384	3384	256	50	217	0	16	283
30173	19343s (+0.8s)	3284	3284	256	52	209	0	12	273
30174	19343s (+0.2s)	412	412	32	11	55	0	3	69
30175	19344s (+0.4s)	1308	1308	64	30	108	0	9	147
30176	19345s (+0.8s)	3420	3420	256	74	199	13	0	286
30177	19345s (+0.6s)	2272	2272	256	45	141	11	0	197
30178	19346s (+0.4s)	1180	1180	64	33	94	8	0	135
30179	19346s (+0.7s)	2896	2896	256	55	163	9	0	227
30180	19347s (+0.5s)	1496	1496	128	51	97	9	0	157
30181	19347s (+0.7s)	3172	3172	256	71	173	16	0	260
30182	19348s (+0.8s)	3420	3420	256	78	193	14	0	285
30183	19349s (+0.5s)	2060	2060	256	38	123	12	0	173
30184	19349s (+0.6s)	2288	2288	256	52	132	11	1	196
30185	19350s (+0.5s)	1808	1808	128	55	124	8	0	187
30186	19351s (+0.7s)	3200	3200	256	69	182	12	0	263
30187	19351s (+0.5s)	2160	2160	256	42	131	9	0	182
30188	19352s (+0.6s)	1908	1908	128	52	135	8	0	195
30189	19352s (+0.3s)	752	752	64	23	74	3	0	100
30190	19352s (+0.3s)	1008	1008	64	25	87	4	0	116
30191	19353s (+0.4s)	1340	1340	128	32	110	8	0	150
30192	19354s (+1.1s)	4636	4636	256	118	237	26	0	381
30193	19355s (+0.8s)	3384	3384	256	85	181	15	0	281
30194	19355s (+0.5s)	1776	1776	128	35	136	0	9	180
30195	19356s (+0.5s)	1564	1564	128	32	119	0	8	159
30196	19357s (+0.9s)	3608	3608	256	62	224	0	18	304
30197	19357s (+0.5s)	1664	1664	128	31	140	0	7	178
30198	19358s (+0.5s)	1604	1604	128	40	119	0	8	167
30199	19358s (+0.6s)	2376	2376	256	50	145	10	1	206
Episode	Time	Reward	Score	Highest	L	U	R	D	Steps
30200	19359s (+0.8s)	3516	3516	256	69	214	11	0	294
30201	19359s (+0.4s)	1476	1476	128	42	107	5	0	154
30202	19360s (+0.5s)	1668	1668	128	41	121	9	0	171
30203	19360s (+0.2s)	320	320	32	10	44	3	0	57
30204	19361s (+0.7s)	3172	3172	256	68	181	13	0	262
30205	19361s (+0.6s)	1924	1924	128	46	143	10	0	199
30206	19362s (+0.3s)	984	984	64	34	83	4	1	122
30207	19362s (+0.3s)	920	920	64	38	80	3	0	121
30208	19362s (+0.3s)	736	736	64	17	74	0	6	97
30209	19363s (+0.4s)	1424	1424	128	30	108	0	8	146
30210	19363s (+0.6s)	2660	2660	256	50	165	0	10	225
30211	19364s (+0.5s)	1828	1828	128	33	147	0	9	189
30212	19365s (+0.9s)	3908	3908	256	55	259	0	8	322
30213	19366s (+0.9s)	4120	4120	256	68	252	0	14	334
30214	19367s (+0.8s)	3172	3172	256	62	184	0	15	261
30215	19367s (+0.4s)	1648	1648	128	35	122	0	8	165
30216	19367s (+0.3s)	784	784	64	20	78	0	3	101
30217	19368s (+0.6s)	2496	2496	256	49	149	0	8	206
30218	19369s (+0.8s)	3424	3424	256	58	208	0	14	280
30219	19370s (+1.1s)	5620	5620	512	87	293	0	23	403
30220	19371s (+0.8s)	3424	3424	256	68	202	0	17	287
30221	19371s (+0.6s)	2172	2172	128	46	144	0	12	202
30222	19372s (+0.9s)	3576	3576	256	83	204	14	0	301
30223	19373s (+0.8s)	3604	3604	256	80	202	22	0	304
30224	19373s (+0.4s)	1388	1388	128	25	120	3	0	148
30225	19374s (+0.7s)	3016	3016	256	51	184	9	0	244
30226	19375s (+0.7s)	3200	3200	256	72	179	13	0	264
30227	19375s (+0.5s)	2268	2268	256	39	147	6	0	192
30228	19377s (+1.4s)	6780	6780	512	148	312	29	0	489
30229	19378s (+0.8s)	3280	3280	256	83	183	12	0	278
30230	19378s (+0.6s)	1968	1968	128	52	148	5	0	205
30231	19379s (+0.4s)	1472	1472	128	35	109	9	0	153
30232	19380s (+1.0s)	4184	4184	256	99	228	16	0	343
30233	19380s (+0.6s)	1940	1940	128	46	138	11	1	196
30234	19381s (+0.4s)	1496	1496	128	36	116	5	0	157
30235	19381s (+0.7s)	3120	3120	256	65	185	10	0	260
30236	19382s (+0.8s)	3356	3356	256	57	219	9	0	285
30237	19383s (+0.8s)	3532	3532	256	76	200	15	0	291
30238	19383s (+0.4s)	1184	1184	64	35	102	6	0	143
30239	19384s (+0.8s)	3528	3528	256	84	197	15	0	296
30240	19385s (+0.6s)	2416	2416	256	63	134	10	1	208
30241	19386s (+0.6s)	2636	2636	256	48	150	0	10	208
30242	19386s (+0.7s)	3116	3116	256	49	197	0	10	256
30243	19387s (+0.7s)	2812	2812	256	60	173	0	12	245
30244	19387s (+0.5s)	2080	2080	128	33	150	0	10	193
30245	19388s (+0.5s)	1804	1804	128	44	132	0	10	186
30246	19388s (+0.2s)	384	384	32	6	55	0	2	63
30247	19389s (+0.4s)	1080	1080	64	34	88	0	7	129
30248	19389s (+0.5s)	2152	2152	256	40	131	0	10	181
30249	19390s (+0.7s)	3236	3236	256	57	192	16	0	265
30250	19391s (+0.8s)	3236	3236	256	65	187	20	0	272
30251	19392s (+0.9s)	3968	3968	256	89	224	14	0	327
30252	19392s (+0.6s)	2572	2572	256	48	165	5	0	218
30253	19393s (+1.0s)	4228	4228	256	85	240	22	0	347
30254	19394s (+0.9s)	3592	3592	256	82	206	16	0	304
30255	19395s (+0.8s)	3188	3188	256	62	189	14	0	265
30256	19395s (+0.6s)	2488	2488	256	49	156	8	1	214
30257	19396s (+0.4s)	1024	1024	64	35	83	6	0	124
30258	19397s (+1.1s)	4600	4600	256	122	234	24	0	380
30259	19398s (+0.7s)	2700	2700	256	58	165	11	0	234
30260	19399s (+0.9s)	3948	3948	256	90	220	16	0	326
30261	19399s (+0.5s)	1884	1884	128	43	145	6	0	194
30262	19400s (+0.9s)	4132	4132	256	93	225	18	0	336
30263	19400s (+0.4s)	1408	1408	128	33	106	7	0	146
30264	19401s (+0.4s)	1052	1052	64	26	93	7	1	127
30265	19402s (+1.1s)	4552	4552	256	111	247	22	0	380
30266	19402s (+0.5s)	1608	1608	128	46	117	6	0	169
30267	19403s (+0.8s)	3216	3216	256	63	189	14	1	267
30268	19404s (+0.5s)	1828	1828	128	38	136	7	0	181
30269	19404s (+0.5s)	1548	1548	128	43	115	8	0	166
30270	19405s (+0.6s)	2484	2484	256	42	164	7	0	213
30271	19405s (+0.4s)	1056	1056	64	34	86	7	0	127
30272	19406s (+0.7s)	2680	2680	128	66	173	10	0	249
30273	19407s (+1.0s)	4280	4280	256	70	272	0	14	356
30274	19407s (+0.5s)	1772	1772	128	36	138	0	4	178
30275	19408s (+0.6s)	2448	2448	256	39	156	10	0	205
30276	19409s (+1.3s)	6244	6244	512	127	297	23	0	447
30277	19410s (+0.7s)	2632	2632	256	49	175	9	0	233
30278	19410s (+0.5s)	1500	1500	128	40	106	11	1	158
30279	19412s (+1.1s)	4600	4600	256	108	253	15	0	376
30280	19412s (+0.8s)	2972	2972	256	84	164	15	1	264
30281	19413s (+0.4s)	1168	1168	64	41	94	4	0	139
30282	19413s (+0.5s)	1712	1712	128	36	138	5	0	179
30283	19414s (+0.8s)	3392	3392	256	61	206	11	0	278
30284	19414s (+0.4s)	1452	1452	128	30	114	0	8	152
30285	19415s (+0.6s)	2664	2664	256	54	155	17	0	226
30286	19416s (+0.6s)	2292	2292	128	62	142	13	0	217
30287	19417s (+1.1s)	5508	5508	512	84	282	19	0	385
30288	19418s (+1.3s)	6440	6440	512	118	311	24	0	453
30289	19418s (+0.4s)	1244	1244	128	27	96	4	0	127
30290	19419s (+0.4s)	1096	1096	64	43	75	10	1	129
30291	19419s (+0.5s)	1644	1644	128	42	121	4	0	167
30292	19420s (+0.5s)	1816	1816	128	37	135	6	0	178
30293	19421s (+1.0s)	4324	4324	256	104	231	14	0	349
30294	19421s (+0.6s)	1900	1900	128	58	126	10	0	194
30295	19422s (+0.4s)	1060	1060	64	29	94	6	0	129
30296	19423s (+0.9s)	4100	4100	256	75	249	9	0	333
30297	19423s (+0.6s)	1876	1876	128	50	132	9	0	191
30298	19424s (+0.3s)	1008	1008	128	26	75	6	0	107
30299	19424s (+0.7s)	2788	2788	256	63	168	8	1	240
Episode	Time	Reward	Score	Highest	L	U	R	D	Steps
30300	19425s (+0.9s)	3996	3996	256	99	214	14	1	328
30301	19426s (+0.7s)	2792	2792	256	63	167	11	0	241
30302	19427s (+0.7s)	2732	2732	256	63	162	6	0	231
30303	19427s (+0.8s)	3412	3412	256	70	201	13	0	284
30304	19428s (+0.5s)	1840	1840	128	50	120	13	1	184
30305	19429s (+0.6s)	1876	1876	128	45	139	8	0	192
30306	19429s (+0.6s)	1956	1956	128	47	148	7	0	202
30307	19430s (+0.5s)	1792	1792	128	51	123	8	1	183
30308	19430s (+0.5s)	1796	1796	128	49	127	8	0	184
30309	19431s (+0.4s)	1180	1180	64	31	106	5	0	142
30310	19431s (+0.3s)	1072	1072	128	26	83	8	0	117
30311	19432s (+0.6s)	2480	2480	256	41	165	6	0	212
30312	19432s (+0.4s)	1404	1404	128	26	115	6	0	147
30313	19432s (+0.3s)	1032	1032	64	36	79	8	0	123
30314	19433s (+0.8s)	2976	2976	256	70	183	12	0	265
30315	19434s (+0.4s)	1408	1408	128	29	109	6	0	144
30316	19434s (+1.0s)	4144	4144	256	101	220	17	0	338
30317	19435s (+0.5s)	1916	1916	128	39	151	0	7	197
30318	19436s (+0.7s)	2848	2848	256	48	193	0	10	251
30319	19436s (+0.3s)	952	952	64	25	88	0	5	118
30320	19437s (+0.4s)	1188	1188	64	30	106	0	8	144
30321	19437s (+0.9s)	3536	3536	256	52	238	0	8	298
30322	19438s (+0.6s)	2620	2620	256	49	170	0	11	230
30323	19439s (+0.7s)	2816	2816	256	54	183	0	10	247
30324	19439s (+0.5s)	1580	1580	128	42	112	0	8	162
30325	19440s (+0.5s)	1768	1768	128	37	132	0	9	178
30326	19440s (+0.5s)	1624	1624	128	35	126	0	9	170
30327	19441s (+0.3s)	992	992	64	20	92	0	5	117
30328	19441s (+0.2s)	624	624	64	22	57	0	6	85
30329	19442s (+1.2s)	5772	5772	512	104	281	29	0	414
30330	19443s (+0.8s)	3248	3248	256	84	179	12	0	275
30331	19443s (+0.7s)	2772	2772	256	56	166	13	1	236
30332	19444s (+1.0s)	4168	4168	256	91	234	18	1	344
30333	19445s (+0.6s)	2192	2192	128	48	149	11	0	208
30334	19446s (+0.5s)	1808	1808	128	43	135	9	0	187
30335	19446s (+0.3s)	788	788	64	19	82	4	0	105
30336	19446s (+0.6s)	2456	2456	256	46	157	6	1	210
30337	19447s (+0.8s)	3456	3456	256	82	191	11	0	284
30338	19448s (+0.8s)	3652	3652	256	70	212	14	0	296
30339	19449s (+0.7s)	3108	3108	256	64	180	13	0	257
30340	19449s (+0.3s)	880	880	64	22	89	4	0	115
30341	19450s (+1.0s)	4308	4308	256	102	234	19	0	355
30342	19451s (+1.0s)	4296	4296	256	93	244	15	0	352
30343	19452s (+0.4s)	1264	1264	128	27	102	7	0	136
30344	19452s (+0.8s)	3448	3448	256	61	215	12	0	288
30345	19453s (+0.5s)	1796	1796	128	44	133	7	0	184
30346	19453s (+0.3s)	988	988	128	15	92	0	0	107
30347	19454s (+0.7s)	3232	3232	256	66	193	11	0	270
30348	19454s (+0.4s)	1268	1268	128	29	93	7	0	129
30349	19455s (+0.6s)	2564	2564	256	45	169	7	0	221
30350	19456s (+1.0s)	4180	4180	256	89	231	20	0	340
30351	19457s (+0.6s)	2740	2740	256	59	151	8	0	218
30352	19457s (+0.7s)	3048	3048	256	68	167	12	0	247
30353	19459s (+1.5s)	7472	7472	512	133	368	24	0	525
30354	19459s (+0.5s)	1744	1744	128	48	119	9	0	176
30355	19460s (+0.9s)	4032	4032	256	90	215	25	0	330
30356	19461s (+0.3s)	724	724	64	22	74	3	0	99
30357	19461s (+0.5s)	2004	2004	128	62	117	12	1	192
30358	19462s (+0.7s)	2796	2796	256	58	171	13	0	242
30359	19462s (+0.4s)	1040	1040	64	32	86	6	0	124
30360	19463s (+0.5s)	1884	1884	128	43	141	10	0	194
30361	19463s (+0.4s)	1328	1328	128	30	108	4	1	143
30362	19464s (+0.5s)	1684	1684	128	34	132	0	4	170
30363	19464s (+0.8s)	3292	3292	256	59	203	0	20	282
30364	19465s (+0.8s)	3412	3412	256	65	205	0	18	288
30365	19466s (+0.8s)	3484	3484	256	70	203	17	0	290
30366	19466s (+0.4s)	1284	1284	128	36	92	10	0	138
30367	19467s (+0.5s)	1716	1716	128	40	127	9	0	176
30368	19467s (+0.5s)	1588	1588	128	38	119	7	0	164
30369	19468s (+0.4s)	1504	1504	128	47	101	11	0	159
30370	19468s (+0.5s)	1636	1636	128	51	112	8	0	171
30371	19469s (+0.3s)	812	812	64	38	62	9	0	109
30372	19469s (+0.4s)	1552	1552	128	26	124	0	4	154
30373	19470s (+1.0s)	3996	3996	256	70	243	0	20	333
30374	19471s (+0.6s)	2748	2748	256	60	161	9	2	232
30375	19471s (+0.5s)	1592	1592	128	35	125	0	5	165
30376	19472s (+0.9s)	4120	4120	256	70	250	0	13	333
30377	19473s (+0.5s)	1864	1864	128	41	141	0	7	189
30378	19474s (+0.9s)	3644	3644	256	53	241	0	15	309
30379	19474s (+0.5s)	1504	1504	128	48	101	10	0	159
30380	19475s (+0.8s)	3308	3308	256	55	211	13	0	279
30381	19475s (+0.3s)	860	860	64	36	74	5	0	115
30382	19476s (+0.4s)	1464	1464	128	32	115	7	0	154
30383	19476s (+0.4s)	1060	1060	64	31	93	4	0	128
30384	19477s (+0.9s)	4156	4156	256	83	245	13	0	341
30385	19477s (+0.3s)	744	744	64	23	71	4	0	98
30386	19478s (+0.4s)	1208	1208	64	39	100	0	5	144
30387	19478s (+0.6s)	2244	2244	128	47	151	0	11	209
30388	19479s (+0.3s)	1120	1120	128	26	87	0	6	119
30389	19479s (+0.5s)	1824	1824	128	37	146	0	8	191
30390	19479s (+0.2s)	584	584	64	16	59	0	5	80
30391	19480s (+0.8s)	3320	3320	256	67	198	16	0	281
30392	19481s (+0.6s)	2376	2376	256	42	154	7	0	203
30393	19482s (+0.9s)	3980	3980	256	73	245	11	0	329
30394	19482s (+0.4s)	1480	1480	128	38	109	7	0	154
30395	19483s (+0.8s)	3204	3204	256	62	187	15	0	264
30396	19484s (+0.6s)	2572	2572	256	48	167	8	0	223
30397	19484s (+0.7s)	3156	3156	256	64	194	10	0	268
30398	19485s (+0.8s)	3496	3496	256	84	185	19	0	288
30399	19486s (+0.5s)	1944	1944	128	39	141	10	0	190
Episode	Time	Reward	Score	Highest	L	U	R	D	Steps
30400	19486s (+0.7s)	3040	3040	256	62	182	11	0	255
30401	19487s (+1.0s)	5296	5296	512	87	256	18	0	361
30402	19488s (+0.5s)	1596	1596	128	47	115	4	0	166
30403	19488s (+0.7s)	2792	2792	256	58	171	13	0	242
30404	19489s (+0.5s)	1692	1692	128	36	128	8	0	172
30405	19490s (+1.4s)	6848	6848	512	121	341	31	1	494
30406	19491s (+0.4s)	1572	1572	128	32	120	9	0	161
30407	19492s (+1.0s)	4464	4464	256	92	248	23	0	363
30408	19493s (+0.4s)	1228	1228	64	33	102	8	0	143
30409	19493s (+0.4s)	1028	1028	64	28	94	3	0	125
30410	19493s (+0.4s)	1496	1496	128	32	115	10	0	157
30411	19494s (+0.5s)	1732	1732	128	34	124	8	0	166
30412	19494s (+0.4s)	1436	1436	128	43	99	6	0	148
30413	19495s (+0.6s)	1976	1976	128	51	153	3	0	207
30414	19496s (+0.9s)	3504	3504	256	78	207	11	0	296
30415	19497s (+1.1s)	5680	5680	512	112	267	19	0	398
30416	19498s (+0.8s)	3344	3344	256	68	200	14	0	282
30417	19498s (+0.4s)	1048	1048	64	26	95	8	0	129
30418	19499s (+0.7s)	2968	2968	256	53	187	9	0	249
30419	19499s (+0.3s)	680	680	64	20	70	4	0	94
30420	19500s (+0.8s)	3192	3192	256	66	192	7	0	265
30421	19500s (+0.3s)	708	708	64	23	68	4	0	95
30422	19501s (+1.3s)	6492	6492	512	112	331	22	0	465
30423	19502s (+0.4s)	1184	1184	64	39	95	9	0	143
30424	19503s (+1.0s)	4340	4340	256	89	249	21	1	360
30425	19503s (+0.5s)	2160	2160	256	40	136	5	0	181
30426	19504s (+0.6s)	2348	2348	256	48	144	4	0	196
30427	19504s (+0.6s)	1940	1940	128	58	136	9	0	203
30428	19505s (+0.7s)	3220	3220	256	61	195	11	1	268
30429	19506s (+0.5s)	1540	1540	128	48	109	6	1	164
30430	19506s (+0.4s)	1164	1164	128	22	103	4	0	129
30431	19507s (+0.5s)	2360	2360	256	48	140	8	0	196
30432	19507s (+0.7s)	2976	2976	256	53	178	7	1	239
30433	19508s (+1.0s)	5020	5020	512	93	239	21	1	354
30434	19509s (+0.6s)	2604	2604	256	66	152	8	0	226
30435	19510s (+0.6s)	1876	1876	128	45	138	9	0	192
30436	19510s (+0.4s)	1488	1488	128	24	123	9	0	156
30437	19511s (+0.6s)	1900	1900	128	45	143	5	0	193
30438	19511s (+0.5s)	1736	1736	128	46	123	6	0	175
30439	19512s (+0.4s)	1472	1472	128	36	109	7	0	152
30440	19512s (+0.4s)	1472	1472	128	29	114	8	0	151
30441	19512s (+0.5s)	1648	1648	128	37	125	6	0	168
30442	19513s (+0.3s)	876	876	64	21	87	6	0	114
30443	19514s (+0.7s)	3152	3152	256	46	202	0	13	261
30444	19514s (+0.7s)	2764	2764	256	44	181	0	10	235
30445	19515s (+0.7s)	2912	2912	256	52	181	0	11	244
30446	19515s (+0.6s)	2428	2428	256	45	152	0	7	204
30447	19516s (+0.3s)	800	800	64	22	81	0	5	108
30448	19517s (+0.8s)	3468	3468	256	65	212	0	10	287
30449	19517s (+0.4s)	1632	1632	128	24	139	0	2	165
30450	19518s (+0.4s)	1384	1384	128	22	121	0	3	146
30451	19518s (+0.6s)	2096	2096	128	41	148	0	7	196
30452	19519s (+0.5s)	1728	1728	128	37	130	6	0	173
30453	19519s (+0.7s)	3176	3176	256	58	194	10	0	262
30454	19520s (+0.4s)	1376	1376	128	34	102	8	0	144
30455	19520s (+0.7s)	2964	2964	256	44	186	8	0	238
30456	19521s (+1.0s)	4208	4208	256	86	243	18	0	347
30457	19522s (+0.5s)	1812	1812	128	49	127	7	0	183
30458	19523s (+0.7s)	2744	2744	256	56	167	11	0	234
30459	19523s (+0.5s)	1776	1776	128	37	135	8	0	180
30460	19524s (+0.5s)	1740	1740	128	47	126	6	0	179
30461	19525s (+0.9s)	3784	3784	256	100	205	11	0	316
30462	19525s (+0.8s)	3456	3456	256	57	225	0	13	295
30463	19526s (+0.1s)	264	264	32	11	37	0	2	50
30464	19526s (+0.4s)	1036	1036	64	25	91	0	8	124
30465	19526s (+0.5s)	1484	1484	128	29	119	0	9	157
30466	19527s (+0.5s)	1632	1632	128	51	115	5	0	171
30467	19529s (+1.6s)	8044	8044	512	155	374	36	0	565
30468	19529s (+0.5s)	1808	1808	128	53	119	12	0	184
30469	19530s (+0.8s)	3244	3244	256	56	206	12	0	274
30470	19531s (+0.6s)	2656	2656	256	66	149	9	0	224
30471	19531s (+0.6s)	1932	1932	128	37	158	6	0	201
30472	19532s (+0.6s)	2056	2056	128	51	144	9	0	204
30473	19533s (+0.9s)	3956	3956	256	77	232	15	0	324
30474	19534s (+0.8s)	3528	3528	256	77	208	11	0	296
30475	19534s (+0.5s)	1668	1668	128	43	113	12	0	168
30476	19535s (+0.7s)	2816	2816	256	56	183	8	0	247
30477	19536s (+0.8s)	3200	3200	256	77	173	17	1	268
30478	19536s (+0.7s)	2836	2836	256	52	188	6	1	247
30479	19537s (+0.7s)	3172	3172	256	67	195	5	0	267
30480	19538s (+0.8s)	2916	2916	128	77	183	15	0	275
30481	19538s (+0.5s)	1784	1784	128	46	126	9	0	181
30482	19539s (+0.5s)	1660	1660	128	46	125	6	0	177
30483	19539s (+0.3s)	952	952	64	28	86	4	0	118
30484	19540s (+0.5s)	1804	1804	128	48	125	8	0	181
30485	19540s (+0.5s)	1816	1816	128	35	147	0	7	189
30486	19541s (+0.6s)	2356	2356	256	44	147	0	8	199
30487	19542s (+0.8s)	3428	3428	256	60	215	0	12	287
30488	19542s (+0.7s)	2752	2752	256	51	177	0	12	240
30489	19543s (+0.4s)	1056	1056	64	29	89	0	10	128
30490	19543s (+0.6s)	1984	1984	128	60	141	8	0	209
30491	19544s (+0.5s)	1720	1720	128	36	132	4	0	172
30492	19544s (+0.4s)	1544	1544	128	40	114	6	0	160
30493	19545s (+0.2s)	628	628	64	16	62	3	0	81
30494	19545s (+0.7s)	3080	3080	256	67	183	10	0	260
30495	19546s (+0.8s)	3408	3408	256	69	207	11	0	287
30496	19547s (+0.7s)	2900	2900	256	55	187	8	1	251
30497	19547s (+0.5s)	1972	1972	128	45	129	11	1	186
30498	19549s (+1.2s)	6068	6068	512	103	293	23	0	419
30499	19549s (+0.8s)	3304	3304	256	84	182	9	1	276
Episode	Time	Reward	Score	Highest	L	U	R	D	Steps
30500	19550s (+0.5s)	1748	1748	128	38	134	6	0	178
30501	19550s (+0.3s)	664	664	64	17	72	2	0	91
30502	19551s (+0.5s)	1912	1912	128	57	129	10	0	196
30503	19551s (+0.4s)	1188	1188	128	30	92	6	0	128
30504	19552s (+0.9s)	4672	4672	512	83	224	17	0	324
30505	19552s (+0.3s)	888	888	64	38	68	11	0	117
30506	19553s (+0.5s)	1788	1788	128	35	141	7	0	183
30507	19553s (+0.6s)	2272	2272	256	50	137	8	1	196
30508	19554s (+0.4s)	1456	1456	128	32	118	3	0	153
30509	19555s (+0.9s)	3920	3920	256	92	225	17	0	334
30510	19556s (+0.8s)	3284	3284	256	71	197	8	0	276
30511	19556s (+0.8s)	3472	3472	256	84	198	10	0	292
30512	19557s (+0.6s)	2180	2180	128	47	152	0	12	211
30513	19557s (+0.3s)	728	728	64	18	75	0	4	97
30514	19558s (+0.4s)	1436	1436	128	26	120	0	6	152
30515	19558s (+0.6s)	1856	1856	128	43	145	0	5	193
30516	19559s (+0.5s)	1588	1588	128	30	134	0	5	169
30517	19559s (+0.4s)	1484	1484	128	30	120	0	5	155
30518	19560s (+0.6s)	1964	1964	128	60	127	11	0	198
30519	19561s (+0.7s)	2780	2780	256	46	183	9	0	238
30520	19561s (+0.9s)	3796	3796	256	78	217	20	0	315
30521	19562s (+0.4s)	1484	1484	128	31	117	6	0	154
30522	19563s (+0.8s)	3108	3108	256	84	174	9	0	267
30523	19563s (+0.8s)	3636	3636	256	80	192	24	0	296
30524	19564s (+0.5s)	1796	1796	128	48	121	8	2	179
30525	19565s (+0.8s)	3544	3544	256	85	192	18	0	295
30526	19565s (+0.6s)	2148	2148	128	67	134	11	1	213
30527	19567s (+1.3s)	6740	6740	512	93	355	0	22	470
30528	19567s (+0.6s)	2484	2484	256	43	165	0	5	213
30529	19568s (+0.2s)	376	376	32	10	47	0	5	62
30530	19568s (+0.5s)	1800	1800	128	36	141	0	8	185
30531	19569s (+0.6s)	2664	2664	256	53	165	8	0	226
30532	19570s (+0.8s)	3336	3336	256	61	211	8	0	280
30533	19570s (+0.7s)	2592	2592	128	71	160	16	0	247
30534	19571s (+0.7s)	2980	2980	256	61	178	13	0	252
30535	19572s (+0.8s)	3296	3296	256	64	204	8	0	276
30536	19572s (+0.5s)	2308	2308	256	47	138	6	0	191
30537	19573s (+0.6s)	2636	2636	256	37	178	9	0	224
30538	19573s (+0.3s)	908	908	64	40	72	6	0	118
30539	19574s (+0.6s)	2300	2300	128	62	145	11	0	218
30540	19575s (+1.0s)	4292	4292	256	98	240	19	1	358
30541	19576s (+0.6s)	1856	1856	128	48	139	7	0	194
30542	19576s (+0.3s)	800	800	64	26	70	8	0	104
30543	19576s (+0.5s)	1544	1544	128	43	110	7	0	160
30544	19577s (+0.4s)	1268	1268	128	37	99	5	0	141
30545	19577s (+0.6s)	2468	2468	256	50	147	12	0	209
30546	19578s (+0.5s)	1448	1448	128	38	111	8	0	157
30547	19579s (+0.8s)	3244	3244	256	67	200	7	0	274
30548	19579s (+0.5s)	2140	2140	256	36	142	3	0	181
30549	19580s (+0.5s)	1768	1768	128	37	137	7	0	181
30550	19580s (+0.7s)	3092	3092	256	71	174	16	0	261
30551	19581s (+0.2s)	648	648	64	27	54	3	0	84
30552	19581s (+0.7s)	2796	2796	256	59	175	8	0	242
30553	19582s (+0.4s)	1580	1580	128	33	119	5	0	157
30554	19582s (+0.6s)	1932	1932	128	43	144	14	0	201
30555	19583s (+0.8s)	3372	3372	256	65	210	14	0	289
30556	19584s (+0.6s)	1876	1876	128	47	133	10	2	192
30557	19584s (+0.6s)	2496	2496	256	58	142	9	0	209
30558	19585s (+0.5s)	1608	1608	128	37	126	0	6	169
30559	19586s (+0.6s)	2636	2636	256	41	179	0	13	233
30560	19586s (+0.4s)	1188	1188	128	22	104	0	3	129
30561	19586s (+0.4s)	1100	1100	64	36	90	0	8	134
30562	19587s (+0.7s)	2828	2828	256	65	172	0	8	245
30563	19588s (+0.8s)	3224	3224	256	64	189	0	16	269
30564	19588s (+0.5s)	1604	1604	128	30	130	0	9	169
30565	19589s (+0.7s)	2660	2660	256	47	178	0	10	235
30566	19589s (+0.6s)	2512	2512	256	38	166	0	9	213
30567	19590s (+0.4s)	1432	1432	128	32	109	0	7	148
30568	19590s (+0.4s)	1220	1220	128	22	105	6	0	133
30569	19591s (+0.4s)	1336	1336	128	28	110	7	0	145
30570	19591s (+0.6s)	2644	2644	256	37	181	8	0	226
30571	19592s (+0.3s)	980	980	128	27	74	6	0	107
30572	19593s (+1.0s)	4240	4240	256	86	247	17	0	350
30573	19594s (+1.1s)	5484	5484	512	96	274	16	0	386
30574	19594s (+0.8s)	3220	3220	256	62	195	8	0	265
30575	19595s (+0.5s)	1876	1876	128	57	127	8	0	192
30576	19596s (+0.5s)	1992	1992	256	40	118	6	0	164
30577	19596s (+0.5s)	1924	1924	128	60	117	17	1	195
30578	19597s (+0.5s)	1760	1760	128	48	120	8	0	176
30579	19597s (+0.7s)	2852	2852	256	63	172	13	0	248
30580	19598s (+0.5s)	1616	1616	128	41	113	7	0	161
30581	19598s (+0.6s)	2472	2472	256	40	162	9	0	211
30582	19599s (+0.7s)	2752	2752	256	54	173	10	0	237
30583	19600s (+1.0s)	5404	5404	512	87	264	19	1	371
30584	19601s (+0.5s)	1744	1744	128	45	129	8	0	182
30585	19601s (+0.5s)	1900	1900	128	45	135	8	0	188
30586	19602s (+0.7s)	3044	3044	256	62	185	17	0	264
30587	19602s (+0.5s)	1752	1752	128	30	145	3	0	178
30588	19603s (+0.5s)	1780	1780	128	42	132	6	0	180
30589	19603s (+0.4s)	1336	1336	128	34	110	5	0	149
30590	19604s (+0.4s)	1448	1448	128	39	109	3	0	151
30591	19604s (+0.5s)	1464	1464	64	43	107	12	0	162
30592	19605s (+0.4s)	1160	1160	64	31	102	4	0	137
30593	19605s (+0.6s)	2440	2440	256	37	175	2	0	214
30594	19606s (+0.4s)	1444	1444	128	33	113	5	0	151
30595	19606s (+0.7s)	3184	3184	256	65	187	12	0	264
30596	19607s (+0.8s)	3456	3456	256	62	215	8	0	285
30597	19608s (+0.8s)	3700	3700	256	77	212	17	0	306
30598	19609s (+0.6s)	2596	2596	256	72	135	16	0	223
30599	19610s (+0.9s)	3796	3796	256	92	211	12	0	315
Episode	Time	Reward	Score	Highest	L	U	R	D	Steps
30600	19610s (+0.7s)	3204	3204	256	62	197	11	0	270
30601	19611s (+0.3s)	792	792	64	19	83	4	0	106
30602	19611s (+0.6s)	2568	2568	256	62	149	11	0	222
30603	19612s (+0.4s)	1368	1368	128	37	98	7	0	142
30604	19612s (+0.4s)	1284	1284	128	38	99	7	0	144
30605	19613s (+0.4s)	1072	1072	64	22	101	0	5	128
30606	19613s (+0.7s)	2828	2828	256	55	177	0	17	249
30607	19614s (+0.5s)	2168	2168	256	49	124	0	12	185
30608	19615s (+0.7s)	3108	3108	256	56	194	0	11	261
30609	19615s (+0.2s)	560	560	64	16	56	0	3	75
30610	19616s (+0.8s)	3456	3456	256	62	211	0	12	285
30611	19616s (+0.4s)	1212	1212	128	25	97	0	4	126
30612	19617s (+0.8s)	3480	3480	256	66	210	13	0	289
30613	19618s (+0.7s)	3192	3192	256	62	185	15	0	262
30614	19618s (+0.6s)	2656	2656	256	54	163	10	0	227
30615	19619s (+0.9s)	4004	4004	256	87	228	19	1	335
30616	19619s (+0.4s)	1172	1172	64	36	95	9	0	140
30617	19620s (+0.4s)	1180	1180	128	23	99	5	0	127
30618	19621s (+0.7s)	2792	2792	256	51	179	0	11	241
30619	19621s (+0.4s)	1364	1364	128	21	118	0	7	146
30620	19622s (+0.6s)	2232	2232	128	43	160	0	10	213
30621	19622s (+0.5s)	1692	1692	128	39	120	9	0	168
30622	19622s (+0.4s)	1280	1280	128	36	95	2	0	133
30623	19623s (+0.8s)	3540	3540	256	76	209	11	0	296
30624	19624s (+0.5s)	1816	1816	128	43	133	7	0	183
30625	19624s (+0.5s)	1652	1652	128	44	124	7	0	175
30626	19625s (+0.8s)	3212	3212	256	70	185	12	0	267
30627	19626s (+0.5s)	1716	1716	128	42	123	8	0	173
30628	19626s (+0.4s)	1004	1004	64	32	87	7	0	126
30629	19626s (+0.5s)	1800	1800	128	42	137	0	6	185
30630	19627s (+0.8s)	3224	3224	256	41	224	0	4	269
30631	19628s (+0.4s)	1288	1288	128	26	102	0	7	135
30632	19629s (+0.9s)	3804	3804	256	69	229	14	0	312
30633	19629s (+0.9s)	4700	4700	512	70	249	9	1	329
30634	19631s (+1.3s)	6624	6624	512	131	325	26	0	482
30635	19631s (+0.4s)	1308	1308	128	32	95	6	0	133
30636	19632s (+0.6s)	2496	2496	256	52	154	9	1	216
30637	19632s (+0.6s)	2348	2348	128	67	134	13	0	214
30638	19633s (+0.6s)	2456	2456	128	54	171	12	0	237
30639	19634s (+0.8s)	3544	3544	256	66	215	12	0	293
30640	19635s (+0.7s)	2756	2756	256	65	157	9	1	232
30641	19636s (+1.2s)	5768	5768	512	107	278	28	0	413
30642	19636s (+0.3s)	736	736	64	18	77	2	0	97
30643	19636s (+0.2s)	648	648	64	15	66	4	0	85
30644	19637s (+0.8s)	3364	3364	256	82	189	12	0	283
30645	19637s (+0.3s)	816	816	64	28	72	6	0	106
30646	19638s (+0.7s)	2908	2908	256	67	174	13	0	254
30647	19638s (+0.3s)	776	776	64	27	66	2	0	95
30648	19639s (+0.3s)	1076	1076	128	23	89	2	1	115
30649	19639s (+0.3s)	992	992	128	22	82	3	0	107
30650	19640s (+0.5s)	1800	1800	128	48	125	0	12	185
30651	19640s (+0.8s)	3388	3388	256	59	223	0	6	288
30652	19641s (+0.4s)	1388	1388	128	23	120	0	4	147
30653	19641s (+0.6s)	2620	2620	256	42	173	0	10	225
30654	19642s (+0.3s)	968	968	64	27	84	0	6	117
30655	19643s (+0.7s)	3464	3464	256	66	192	1	13	272
30656	19643s (+0.8s)	3388	3388	256	52	216	0	11	279
30657	19644s (+0.6s)	2560	2560	256	46	162	0	8	216
30658	19645s (+0.6s)	2692	2692	256	47	166	0	14	227
30659	19645s (+0.6s)	2132	2132	128	44	150	1	10	205
30660	19645s (+0.3s)	980	980	64	22	91	0	5	118
30661	19646s (+0.9s)	3572	3572	256	54	238	0	15	307
30662	19647s (+1.0s)	4228	4228	256	65	261	0	21	347
30663	19648s (+0.6s)	2688	2688	256	52	168	11	0	231
30664	19649s (+0.6s)	1972	1972	128	44	145	11	0	200
30665	19649s (+0.5s)	1808	1808	128	43	137	7	0	187
30666	19650s (+0.6s)	2608	2608	256	47	166	14	0	227
30667	19650s (+0.3s)	868	868	64	20	86	6	0	112
30668	19651s (+0.9s)	3972	3972	256	85	225	17	0	327
30669	19651s (+0.5s)	1564	1564	128	29	132	6	0	167
30670	19652s (+0.7s)	3092	3092	256	64	175	15	1	255
30671	19653s (+0.4s)	1568	1568	128	32	123	7	1	163
30672	19653s (+0.7s)	2976	2976	256	76	155	17	0	248
30673	19654s (+0.8s)	3244	3244	256	63	193	17	0	273
30674	19655s (+0.4s)	1344	1344	128	26	107	0	5	138
30675	19655s (+0.6s)	2632	2632	256	50	157	0	14	221
30676	19656s (+0.7s)	3084	3084	256	52	184	0	16	252
30677	19656s (+0.4s)	1552	1552	128	30	122	0	9	161
30678	19657s (+0.5s)	1908	1908	128	39	150	0	6	195
30679	19658s (+0.7s)	3072	3072	256	60	184	7	0	251
30680	19658s (+0.9s)	3768	3768	256	81	214	18	0	313
30681	19659s (+0.8s)	3472	3472	256	73	203	15	0	291
30682	19660s (+1.0s)	4148	4148	256	87	238	14	0	339
30683	19661s (+0.9s)	3560	3560	256	75	203	20	0	298
30684	19662s (+0.5s)	1808	1808	128	59	104	14	0	177
30685	19662s (+0.3s)	776	776	64	24	74	3	0	101
30686	19662s (+0.3s)	1160	1160	128	23	89	4	0	116
30687	19663s (+0.6s)	2472	2472	256	59	141	7	0	207
30688	19664s (+0.9s)	3628	3628	256	89	201	19	0	309
30689	19664s (+0.6s)	2500	2500	256	51	157	10	0	218
30690	19665s (+0.8s)	3348	3348	256	59	213	0	11	283
30691	19666s (+0.6s)	2540	2540	256	46	165	0	11	222
30692	19666s (+0.6s)	2516	2516	256	38	162	0	11	211
30693	19667s (+0.4s)	1152	1152	64	34	92	9	0	135
30694	19668s (+0.7s)	2288	2288	128	77	139	10	0	226
30695	19668s (+0.6s)	2684	2684	256	43	172	10	0	225
30696	19669s (+0.6s)	1980	1980	128	36	146	0	12	194
30697	19670s (+0.8s)	3560	3560	256	62	229	0	10	301
30698	19670s (+0.6s)	2744	2744	256	46	179	0	9	234
30699	19671s (+0.6s)	2716	2716	256	45	178	1	7	231
Episode	Time	Reward	Score	Highest	L	U	R	D	Steps
30700	19671s (+0.3s)	736	736	64	17	79	0	1	97
30701	19672s (+0.9s)	3508	3508	256	62	222	0	14	298
30702	19672s (+0.3s)	1100	1100	128	27	85	0	5	117
30703	19674s (+1.3s)	6584	6584	512	100	350	0	25	475
30704	19674s (+0.6s)	2452	2452	256	54	150	0	9	213
30705	19675s (+0.5s)	1740	1740	128	35	137	0	4	176
30706	19675s (+0.4s)	1496	1496	128	31	113	0	7	151
30707	19676s (+0.4s)	1316	1316	128	30	103	0	9	142
30708	19676s (+0.6s)	2576	2576	256	43	169	0	8	220
30709	19677s (+0.7s)	3116	3116	256	54	192	0	9	255
30710	19678s (+0.6s)	2716	2716	256	51	174	0	6	231
30711	19678s (+0.8s)	3264	3264	256	50	214	0	9	273
30712	19679s (+0.8s)	3652	3652	256	59	221	0	16	296
30713	19680s (+0.6s)	2564	2564	256	44	170	0	8	222
30714	19680s (+0.5s)	1788	1788	128	57	116	9	0	182
30715	19681s (+0.6s)	2528	2528	256	56	156	6	0	218
30716	19682s (+0.7s)	2744	2744	128	81	157	14	1	253
30717	19683s (+0.9s)	3600	3600	256	74	212	17	0	303
30718	19683s (+0.7s)	2632	2632	256	59	167	6	1	233
30719	19684s (+0.8s)	3276	3276	256	66	195	13	0	274
30720	19685s (+0.9s)	4056	4056	256	78	231	18	0	327
30721	19685s (+0.2s)	584	584	32	23	58	0	6	87
30722	19686s (+0.4s)	1492	1492	128	41	111	0	5	157
30723	19686s (+0.6s)	2576	2576	256	47	165	8	0	220
30724	19687s (+0.5s)	1952	1952	128	50	138	11	0	199
30725	19688s (+0.8s)	3432	3432	256	73	203	13	0	289
30726	19688s (+0.4s)	1328	1328	64	29	117	0	5	151
30727	19689s (+0.9s)	3952	3952	256	66	242	0	14	322
30728	19690s (+0.5s)	1848	1848	128	34	134	0	10	178
30729	19690s (+0.9s)	4684	4684	512	70	238	0	12	320
30730	19691s (+0.5s)	2404	2404	256	47	140	0	13	200
30731	19692s (+0.6s)	2584	2584	256	43	168	0	12	223
30732	19692s (+0.6s)	2640	2640	256	56	164	0	10	230
30733	19693s (+0.8s)	3408	3408	256	64	201	0	14	279
30734	19693s (+0.3s)	860	860	64	24	84	0	4	112
30735	19694s (+0.7s)	2568	2568	128	79	147	17	0	243
30736	19695s (+0.7s)	2872	2872	256	54	172	11	0	237
30737	19696s (+0.9s)	4048	4048	256	90	227	17	0	334
30738	19697s (+0.8s)	3440	3440	256	67	210	14	0	291
30739	19697s (+0.7s)	3068	3068	256	79	167	9	0	255
30740	19698s (+0.5s)	1904	1904	128	56	120	10	0	186
30741	19698s (+0.5s)	1796	1796	128	46	130	7	0	183
30742	19699s (+0.7s)	2956	2956	256	73	166	15	0	254
30743	19699s (+0.4s)	1212	1212	128	32	97	2	0	131
30744	19700s (+0.6s)	2416	2416	128	76	139	13	0	228
30745	19701s (+0.5s)	1872	1872	128	42	140	9	0	191
30746	19702s (+1.0s)	4228	4228	256	98	227	22	0	347
30747	19702s (+0.8s)	3508	3508	256	87	188	17	0	292
30748	19703s (+0.5s)	1780	1780	128	39	131	9	0	179
30749	19704s (+0.6s)	1916	1916	128	35	159	4	0	198
30750	19704s (+0.5s)	1800	1800	128	32	149	4	0	185
30751	19704s (+0.2s)	592	592	64	12	66	2	0	80
30752	19705s (+1.0s)	5184	5184	512	104	254	16	0	374
30753	19706s (+0.5s)	1620	1620	128	39	126	7	0	172
30754	19706s (+0.2s)	592	592	64	10	72	0	1	83
30755	19707s (+1.0s)	4152	4152	256	64	259	0	17	340
30756	19708s (+0.7s)	2896	2896	256	38	204	0	9	251
30757	19708s (+0.7s)	2748	2748	256	66	151	15	0	232
30758	19709s (+1.0s)	4228	4228	256	88	242	17	0	347
30759	19710s (+0.4s)	1464	1464	128	32	116	5	0	153
30760	19710s (+0.5s)	1556	1556	128	43	105	13	0	161
30761	19711s (+1.0s)	4100	4100	256	86	231	15	0	332
30762	19711s (+0.1s)	272	272	32	6	43	0	3	52
30763	19712s (+0.6s)	1940	1940	128	56	134	9	0	199
30764	19713s (+0.7s)	2760	2760	256	63	166	8	0	237
30765	19713s (+0.7s)	2876	2876	256	56	180	9	0	245
30766	19714s (+0.4s)	1216	1216	64	35	98	11	0	144
30767	19715s (+0.9s)	3932	3932	256	92	214	16	0	322
30768	19715s (+0.3s)	868	868	64	19	91	0	3	113
30769	19716s (+0.9s)	4100	4100	256	102	208	21	1	332
30770	19717s (+0.7s)	2984	2984	256	69	168	16	0	253
30771	19718s (+0.8s)	3560	3560	256	62	214	13	0	289
30772	19718s (+0.8s)	3548	3548	256	78	205	13	0	296
30773	19719s (+0.7s)	2728	2728	256	46	176	7	1	230
30774	19720s (+0.9s)	3628	3628	256	76	215	17	1	309
30775	19720s (+0.3s)	840	840	64	26	77	4	0	107
30776	19721s (+0.4s)	1168	1168	64	36	94	9	0	139
30777	19722s (+0.9s)	3832	3832	256	78	221	12	0	311
30778	19722s (+0.5s)	1604	1604	128	37	127	4	0	168
30779	19723s (+0.8s)	3580	3580	256	89	197	18	0	304
30780	19724s (+0.9s)	3972	3972	256	96	207	24	0	327
30781	19724s (+0.7s)	2756	2756	256	53	175	8	0	236
30782	19725s (+0.8s)	3204	3204	256	67	188	10	0	265
30783	19726s (+0.7s)	2984	2984	256	68	167	17	0	252
30784	19727s (+0.6s)	2524	2524	256	53	158	10	1	222
30785	19727s (+0.7s)	2904	2904	256	60	184	8	0	252
30786	19728s (+0.8s)	3540	3540	256	64	225	10	0	299
30787	19728s (+0.4s)	1360	1360	128	31	104	0	7	142
30788	19729s (+0.3s)	728	728	64	23	68	0	4	95
30789	19729s (+0.7s)	3140	3140	256	61	187	12	0	260
30790	19730s (+0.4s)	1260	1260	128	27	100	9	0	136
30791	19730s (+0.4s)	1408	1408	128	37	106	9	0	152
30792	19731s (+0.9s)	3872	3872	256	111	202	14	0	327
30793	19732s (+0.6s)	2608	2608	256	62	159	7	0	228
30794	19732s (+0.5s)	1724	1724	128	38	127	7	0	172
30795	19733s (+0.9s)	4000	4000	256	85	230	14	0	329
30796	19734s (+0.3s)	656	656	64	16	73	1	0	90
30797	19734s (+0.7s)	2708	2708	256	38	192	0	12	242
30798	19735s (+0.9s)	3740	3740	256	68	229	0	12	309
30799	19736s (+0.8s)	3308	3308	256	65	203	10	0	278
Episode	Time	Reward	Score	Highest	L	U	R	D	Steps
30800	19737s (+1.0s)	4336	4336	256	103	236	22	1	362
30801	19738s (+1.0s)	4320	4320	256	89	246	20	0	355
30802	19738s (+0.4s)	1340	1340	128	29	104	7	0	140
30803	19739s (+0.4s)	1484	1484	128	26	126	3	0	155
30804	19740s (+0.9s)	4020	4020	256	73	238	13	0	324
30805	19740s (+0.4s)	1332	1332	128	43	101	5	0	149
30806	19741s (+0.5s)	1828	1828	128	37	146	8	0	191
30807	19741s (+0.5s)	1612	1612	128	41	122	7	0	170
30808	19742s (+0.7s)	3044	3044	256	63	181	12	0	256
30809	19743s (+0.6s)	1928	1928	128	37	155	0	8	200
30810	19744s (+1.0s)	4112	4112	256	92	236	17	0	345
30811	19744s (+0.8s)	3476	3476	256	67	213	14	1	295
30812	19745s (+0.5s)	1588	1588	128	44	116	9	0	169
30813	19746s (+0.8s)	3484	3484	256	83	190	17	0	290
30814	19746s (+0.4s)	1168	1168	64	33	101	5	0	139
30815	19747s (+0.7s)	3220	3220	256	63	189	16	0	268
30816	19747s (+0.6s)	2516	2516	256	58	153	5	0	216
30817	19748s (+0.4s)	1620	1620	128	56	98	8	0	162
30818	19749s (+0.7s)	3128	3128	256	58	192	12	0	262
30819	19749s (+0.6s)	2764	2764	256	62	166	10	1	239
30820	19750s (+0.6s)	2700	2700	256	54	162	12	0	228
30821	19750s (+0.3s)	696	696	64	12	76	4	0	92
30822	19751s (+1.1s)	5456	5456	512	103	260	19	1	383
30823	19753s (+1.2s)	6228	6228	512	126	284	25	1	436
30824	19753s (+0.3s)	824	824	64	29	72	4	1	106
30825	19754s (+0.6s)	2764	2764	256	53	170	12	0	235
30826	19754s (+0.8s)	3268	3268	256	71	195	13	0	279
30827	19755s (+0.8s)	3556	3556	256	77	202	18	1	298
30828	19756s (+0.5s)	1824	1824	128	35	129	6	0	170
30829	19756s (+0.5s)	2212	2212	256	47	137	5	0	189
30830	19757s (+0.5s)	1764	1764	128	41	131	8	0	180
30831	19757s (+0.5s)	1608	1608	128	33	130	6	0	169
30832	19758s (+0.8s)	3308	3308	256	62	196	17	0	275
30833	19759s (+0.7s)	3064	3064	256	56	185	10	0	251
30834	19759s (+0.5s)	1784	1784	128	49	127	6	0	182
30835	19760s (+1.0s)	4276	4276	256	94	232	21	0	347
30836	19761s (+0.9s)	3892	3892	256	77	231	11	0	319
30837	19761s (+0.3s)	808	808	64	23	83	3	0	109
30838	19762s (+0.7s)	3108	3108	256	63	188	6	0	257
30839	19763s (+0.8s)	3244	3244	256	66	191	17	0	274
30840	19763s (+0.4s)	1400	1400	128	38	108	3	0	149
30841	19764s (+1.0s)	4400	4400	256	94	256	19	0	369
30842	19765s (+0.3s)	732	732	64	24	67	4	0	95
30843	19765s (+0.7s)	2768	2768	256	56	169	14	0	239
30844	19766s (+0.5s)	1592	1592	128	42	117	6	0	165
30845	19766s (+0.6s)	2184	2184	128	64	133	9	0	206
30846	19767s (+0.3s)	1084	1084	128	27	89	4	0	120
30847	19768s (+0.8s)	3316	3316	256	66	195	15	0	276
30848	19769s (+1.3s)	6264	6264	512	115	308	23	0	446
30849	19770s (+0.8s)	3216	3216	256	57	201	10	0	268
30850	19770s (+0.5s)	1808	1808	128	39	138	10	0	187
30851	19771s (+0.6s)	2596	2596	256	44	172	7	1	224
30852	19771s (+0.6s)	2128	2128	128	63	126	15	0	204
30853	19772s (+0.9s)	3840	3840	256	89	217	17	0	323
30854	19773s (+0.6s)	2540	2540	256	56	148	8	0	212
30855	19774s (+0.6s)	2484	2484	256	54	152	6	0	212
30856	19774s (+0.6s)	2340	2340	128	64	150	9	0	223
30857	19775s (+0.3s)	696	696	64	33	54	5	0	92
30858	19775s (+0.5s)	1808	1808	128	50	128	9	0	187
30859	19776s (+0.6s)	2620	2620	256	50	169	7	0	226
30860	19777s (+0.9s)	3952	3952	256	67	241	14	0	322
30861	19777s (+0.3s)	1000	1000	64	21	96	3	0	120
30862	19777s (+0.5s)	1600	1600	128	33	126	0	8	167
30863	19778s (+0.2s)	328	328	32	11	40	0	6	57
30864	19778s (+0.5s)	2276	2276	256	43	140	0	7	190
30865	19779s (+0.9s)	3624	3624	256	71	226	11	0	308
30866	19780s (+0.8s)	3228	3228	256	66	191	14	0	271
30867	19780s (+0.5s)	1916	1916	128	38	152	7	0	197
30868	19781s (+0.7s)	2788	2788	256	60	166	13	0	239
30869	19782s (+0.7s)	3060	3060	256	59	194	12	0	265
30870	19782s (+0.3s)	1108	1108	128	29	86	6	0	121
30871	19783s (+0.4s)	1484	1484	128	39	112	4	0	155
30872	19783s (+0.7s)	2828	2828	256	43	198	0	4	245
30873	19784s (+0.6s)	2464	2464	256	42	152	0	14	208
30874	19784s (+0.3s)	692	692	64	13	73	0	4	90
30875	19785s (+0.5s)	2164	2164	256	38	136	0	9	183
30876	19785s (+0.5s)	1720	1720	128	34	117	0	6	157
30877	19786s (+0.9s)	3936	3936	256	66	247	0	11	324
30878	19787s (+0.9s)	3668	3668	256	52	239	0	8	299
30879	19788s (+0.7s)	2764	2764	256	55	172	0	9	236
30880	19789s (+1.0s)	4148	4148	256	66	253	0	21	340
30881	19789s (+0.3s)	1140	1140	128	16	102	0	4	122
30882	19790s (+0.8s)	3300	3300	256	54	217	0	12	283
30883	19790s (+0.6s)	2588	2588	256	45	171	0	7	223
30884	19791s (+0.6s)	2072	2072	128	54	141	13	0	208
30885	19792s (+0.8s)	3132	3132	256	80	170	17	0	267
30886	19793s (+0.7s)	2868	2868	256	73	165	10	0	248
30887	19793s (+0.5s)	1540	1540	128	34	126	5	0	165
30888	19793s (+0.4s)	1384	1384	128	26	122	2	0	150
30889	19794s (+1.0s)	5068	5068	512	80	246	18	0	344
30890	19796s (+1.3s)	6492	6492	512	123	327	15	0	465
30891	19796s (+0.4s)	1260	1260	128	25	98	6	0	129
30892	19797s (+0.4s)	1180	1180	64	35	99	8	0	142
30893	19797s (+0.6s)	2648	2648	256	54	158	10	0	222
30894	19798s (+0.6s)	2424	2424	256	38	157	5	0	200
30895	19798s (+0.5s)	1744	1744	128	52	118	8	0	178
30896	19799s (+1.0s)	4208	4208	256	95	228	19	0	342
30897	19800s (+0.9s)	4044	4044	256	76	239	14	0	329
30898	19801s (+0.5s)	1896	1896	128	44	142	6	0	192
30899	19801s (+0.5s)	1700	1700	128	43	121	8	0	172
Episode	Time	Reward	Score	Highest	L	U	R	D	Steps
30900	19802s (+0.8s)	3312	3312	256	75	191	11	0	277
30901	19802s (+0.3s)	836	836	64	22	79	4	0	105
30902	19803s (+0.4s)	1188	1188	128	30	93	6	0	129
30903	19803s (+0.5s)	1788	1788	128	34	134	14	0	182
30904	19804s (+0.4s)	1228	1228	64	38	92	9	0	139
30905	19804s (+0.6s)	2600	2600	256	34	174	0	10	218
30906	19805s (+0.5s)	1824	1824	128	38	132	0	10	180
30907	19805s (+0.7s)	2644	2644	256	46	173	0	12	231
30908	19806s (+0.5s)	1952	1952	128	41	140	0	11	192
30909	19807s (+0.5s)	1804	1804	128	28	147	0	8	183
30910	19807s (+0.5s)	2212	2212	256	37	146	0	5	188
30911	19808s (+0.7s)	2824	2824	256	49	188	0	11	248
30912	19809s (+1.0s)	4428	4428	256	76	270	0	19	365
30913	19810s (+0.9s)	3740	3740	256	59	243	0	14	316
30914	19810s (+0.5s)	1736	1736	128	33	133	0	8	174
30915	19811s (+0.5s)	2380	2380	256	35	159	0	6	200
30916	19812s (+0.9s)	4012	4012	256	73	243	0	17	333
30917	19812s (+0.4s)	1420	1420	128	34	103	0	6	143
30918	19813s (+0.4s)	1456	1456	128	32	111	0	5	148
30919	19813s (+0.7s)	2620	2620	256	43	180	0	8	231
30920	19814s (+0.6s)	2560	2560	256	40	164	0	13	217
30921	19815s (+0.8s)	3276	3276	256	64	203	0	15	282
30922	19815s (+0.6s)	2360	2360	256	44	144	0	7	195
30923	19816s (+0.4s)	1284	1284	128	30	100	8	0	138
30924	19816s (+0.5s)	1812	1812	128	47	130	10	0	187
30925	19817s (+0.8s)	3232	3232	256	73	179	18	1	271
30926	19817s (+0.3s)	936	936	64	23	87	5	0	115
30927	19818s (+0.5s)	1632	1632	128	37	131	7	0	175
30928	19818s (+0.4s)	1192	1192	128	39	86	5	0	130
30929	19819s (+0.7s)	3132	3132	256	64	183	16	0	263
30930	19819s (+0.5s)	1576	1576	128	34	125	6	0	165
30931	19820s (+0.4s)	1208	1208	64	29	104	0	5	138
30932	19820s (+0.6s)	2812	2812	256	41	174	0	11	226
30933	19821s (+0.6s)	2108	2108	128	37	153	0	10	200
30934	19822s (+0.7s)	2772	2772	128	47	193	0	16	256
30935	19823s (+0.8s)	3304	3304	256	58	209	0	17	284
30936	19823s (+0.3s)	680	680	64	21	61	0	6	88
30937	19824s (+1.1s)	4520	4520	256	66	285	0	20	371
30938	19824s (+0.3s)	948	948	64	21	87	0	9	117
30939	19825s (+0.8s)	3272	3272	256	66	193	10	0	269
30940	19825s (+0.4s)	1444	1444	128	39	106	4	0	149
30941	19826s (+0.8s)	3216	3216	256	67	189	16	0	272
30942	19827s (+0.9s)	4824	4824	512	74	244	17	0	335
30943	19827s (+0.1s)	244	244	32	16	31	2	0	49
30944	19828s (+1.0s)	4380	4380	256	111	228	21	0	360
30945	19829s (+0.3s)	864	864	64	32	76	5	0	113
30946	19829s (+0.7s)	2796	2796	256	63	167	12	0	242
30947	19830s (+0.3s)	1136	1136	128	25	93	5	0	123
30948	19830s (+0.4s)	1256	1256	64	39	97	5	0	141
30949	19831s (+0.5s)	1680	1680	128	48	115	8	0	171
30950	19831s (+0.3s)	1072	1072	128	16	92	3	0	111
30951	19832s (+0.7s)	2772	2772	256	65	161	15	0	241
30952	19832s (+0.7s)	2932	2932	256	63	185	11	0	259
30953	19833s (+0.3s)	848	848	64	26	74	9	0	109
30954	19833s (+0.5s)	1748	1748	128	37	132	8	0	177
30955	19834s (+1.1s)	5696	5696	512	98	289	20	0	407
30956	19835s (+0.6s)	2464	2464	128	62	153	13	0	228
30957	19835s (+0.2s)	380	380	32	13	49	2	0	64
30958	19836s (+0.7s)	2504	2504	128	70	154	14	0	238
30959	19837s (+0.7s)	2912	2912	256	52	175	7	0	234
30960	19837s (+0.9s)	3588	3588	256	91	195	14	0	300
30961	19838s (+0.5s)	1792	1792	128	39	136	8	0	183
30962	19838s (+0.4s)	1376	1376	64	38	107	7	0	152
30963	19839s (+0.7s)	2812	2812	256	62	163	14	0	239
30964	19840s (+0.8s)	3368	3368	256	76	195	17	0	288
30965	19841s (+0.7s)	2792	2792	128	75	170	15	0	260
30966	19841s (+0.7s)	3160	3160	256	71	175	12	0	258
30967	19842s (+0.8s)	3440	3440	256	69	211	11	0	291
30968	19842s (+0.2s)	528	528	64	10	61	0	0	71
30969	19843s (+0.7s)	3168	3168	256	65	181	12	1	259
30970	19844s (+0.5s)	1836	1836	128	59	118	15	1	193
30971	19844s (+0.4s)	1652	1652	128	37	118	7	1	163
30972	19845s (+0.4s)	1156	1156	128	22	99	3	0	124
30973	19846s (+1.0s)	5224	5224	512	84	265	0	17	366
30974	19846s (+0.6s)	2528	2528	256	46	166	0	7	219
30975	19847s (+0.6s)	2436	2436	256	31	162	0	14	207
30976	19848s (+0.8s)	3644	3644	256	55	230	0	14	299
30977	19849s (+1.0s)	4180	4180	256	74	258	0	15	347
30978	19849s (+0.3s)	704	704	64	14	77	0	3	94
30979	19850s (+0.9s)	4020	4020	256	57	266	0	16	339
30980	19851s (+0.7s)	2988	2988	256	53	191	0	10	254
30981	19851s (+0.4s)	1368	1368	128	25	113	3	0	141
30982	19851s (+0.4s)	1316	1316	128	39	88	5	0	132
30983	19852s (+1.0s)	4092	4092	256	87	238	12	0	337
30984	19853s (+0.5s)	1596	1596	128	41	121	5	0	167
30985	19853s (+0.5s)	1544	1544	128	44	112	8	0	164
30986	19854s (+0.3s)	1016	1016	128	16	92	2	0	110
30987	19854s (+0.7s)	2932	2932	256	54	173	13	0	240
30988	19855s (+0.3s)	1136	1136	128	27	93	2	0	122
30989	19856s (+0.8s)	3328	3328	256	81	185	16	0	282
30990	19856s (+0.5s)	1676	1676	128	33	135	3	0	171
30991	19856s (+0.3s)	1144	1144	128	30	88	2	0	120
30992	19857s (+0.8s)	3460	3460	256	78	195	16	0	289
30993	19858s (+0.7s)	3028	3028	256	64	179	13	0	256
30994	19859s (+0.9s)	4736	4736	512	79	231	18	0	328
30995	19859s (+0.6s)	2520	2520	256	52	158	5	0	215
30996	19860s (+0.8s)	3544	3544	256	81	200	14	0	295
30997	19861s (+0.5s)	1720	1720	128	45	117	11	1	174
30998	19861s (+0.3s)	692	692	64	14	73	4	0	91
30999	19862s (+0.5s)	1584	1584	128	37	119	8	0	164
Episode	Time	Reward	Score	Highest	L	U	R	D	Steps
31000	19863s (+1.1s)	5564	5564	512	93	262	24	0	379
31001	19863s (+0.8s)	3216	3216	256	64	192	12	0	268
31002	19864s (+0.5s)	1504	1504	128	28	125	7	0	160
31003	19864s (+0.6s)	1872	1872	128	55	128	9	0	192
31004	19865s (+0.7s)	2916	2916	256	54	179	8	0	241
31005	19866s (+0.9s)	3576	3576	256	71	218	13	0	302
31006	19867s (+0.8s)	3204	3204	256	66	185	14	0	265
31007	19867s (+0.2s)	612	612	64	18	63	2	0	83
31008	19868s (+0.9s)	3472	3472	256	68	215	0	15	298
31009	19868s (+0.6s)	2600	2600	256	45	159	0	15	219
31010	19870s (+1.1s)	5512	5512	512	95	269	0	24	388
31011	19870s (+0.6s)	2272	2272	128	50	156	1	6	213
31012	19871s (+0.8s)	3772	3772	256	63	218	0	14	295
31013	19872s (+0.5s)	1800	1800	128	35	141	0	8	184
31014	19872s (+0.7s)	2784	2784	256	50	178	0	11	239
31015	19873s (+0.4s)	1088	1088	64	35	90	0	6	131
31016	19873s (+0.4s)	1168	1168	64	36	97	0	6	139
31017	19873s (+0.3s)	744	744	64	18	75	0	6	99
31018	19874s (+0.6s)	2380	2380	128	61	151	11	0	223
31019	19874s (+0.3s)	856	856	64	19	88	3	0	110
31020	19875s (+0.9s)	3700	3700	256	79	231	12	0	322
31021	19876s (+0.4s)	1236	1236	128	28	104	4	0	136
31022	19876s (+0.3s)	808	808	64	24	72	7	0	103
31023	19876s (+0.5s)	1792	1792	128	44	135	4	0	183
31024	19877s (+0.6s)	2092	2092	128	40	147	9	0	196
31025	19878s (+0.5s)	1620	1620	128	42	122	8	0	172
31026	19878s (+0.4s)	1324	1324	128	30	101	6	0	137
31027	19878s (+0.5s)	1780	1780	128	34	140	6	0	180
31028	19879s (+0.4s)	1308	1308	128	33	99	7	0	139
31029	19880s (+1.3s)	6364	6364	512	102	333	19	1	455
31030	19881s (+0.8s)	3236	3236	256	61	199	9	0	269
31031	19881s (+0.4s)	1512	1512	128	56	99	6	0	161
31032	19882s (+0.4s)	1076	1076	64	30	94	7	1	132
31033	19882s (+0.7s)	3072	3072	256	64	177	13	0	254
31034	19883s (+0.7s)	3084	3084	256	58	188	10	0	256
31035	19884s (+1.0s)	4640	4640	256	108	232	26	0	366
31036	19885s (+0.7s)	2528	2528	128	58	160	14	0	232
31037	19886s (+0.8s)	3288	3288	256	57	207	9	0	273
31038	19886s (+0.3s)	696	696	64	18	75	3	0	96
31039	19887s (+0.7s)	2964	2964	256	67	181	14	0	262
31040	19888s (+0.8s)	3420	3420	256	74	198	13	0	285
31041	19888s (+0.3s)	684	684	64	28	62	5	0	95
31042	19888s (+0.3s)	784	784	64	27	73	7	0	107
31043	19889s (+0.7s)	2876	2876	256	61	165	11	0	237
31044	19889s (+0.6s)	2508	2508	256	53	155	11	0	219
31045	19890s (+0.5s)	1620	1620	128	34	128	10	0	172
31046	19891s (+0.8s)	3716	3716	256	73	204	19	1	297
31047	19892s (+0.8s)	3492	3492	256	61	205	11	1	278
31048	19892s (+0.5s)	1656	1656	128	53	114	9	0	176
31049	19893s (+0.8s)	3344	3344	256	71	192	15	0	278
31050	19894s (+0.7s)	2920	2920	256	59	185	12	0	256
31051	19894s (+0.5s)	1552	1552	128	36	118	6	0	160
31052	19894s (+0.3s)	704	704	64	17	72	4	1	94
31053	19895s (+0.8s)	3344	3344	256	58	220	8	0	286
31054	19896s (+0.6s)	2136	2136	128	53	146	14	0	213
31055	19897s (+0.7s)	2936	2936	256	46	198	0	11	255
31056	19897s (+0.6s)	2328	2328	256	27	162	0	6	195
31057	19898s (+0.6s)	2536	2536	256	50	162	0	9	221
31058	19898s (+0.5s)	2036	2036	128	43	146	0	7	196
31059	19899s (+0.3s)	1000	1000	64	22	92	0	5	119
31060	19899s (+0.5s)	2156	2156	256	33	137	0	10	180
31061	19900s (+0.5s)	1764	1764	128	30	140	0	7	177
31062	19900s (+0.3s)	664	664	64	8	76	0	4	88
31063	19901s (+0.7s)	3048	3048	256	58	175	0	14	247
31064	19901s (+0.6s)	2616	2616	256	51	157	0	12	220
31065	19902s (+0.6s)	2244	2244	128	56	150	17	0	223
31066	19903s (+0.6s)	2120	2120	128	49	158	5	0	212
31067	19903s (+0.6s)	2256	2256	128	57	152	17	0	226
31068	19904s (+0.5s)	1556	1556	128	37	121	3	0	161
31069	19905s (+1.2s)	6432	6432	512	126	280	30	0	436
31070	19905s (+0.3s)	748	748	64	19	76	4	0	99
31071	19906s (+1.0s)	4240	4240	256	93	240	17	0	350
31072	19907s (+1.1s)	4620	4620	256	106	250	25	0	381
31073	19908s (+0.3s)	824	824	64	31	71	5	0	107
31074	19909s (+0.9s)	3536	3536	256	76	207	15	0	298
31075	19909s (+0.8s)	3504	3504	256	65	216	13	1	295
31076	19910s (+0.6s)	1904	1904	128	56	125	13	0	194
31077	19910s (+0.5s)	1620	1620	128	49	114	9	0	172
31078	19911s (+0.8s)	3436	3436	256	92	195	13	0	300
31079	19912s (+0.7s)	2856	2856	256	63	173	9	0	245
31080	19913s (+0.6s)	2424	2424	256	47	149	8	0	204
31081	19913s (+0.7s)	2600	2600	128	67	160	18	0	245
31082	19914s (+0.8s)	3252	3252	256	72	190	14	0	276
31083	19915s (+0.8s)	3652	3652	256	70	214	17	0	301
31084	19916s (+0.8s)	3440	3440	256	56	224	11	0	291
31085	19917s (+1.0s)	4348	4348	256	88	252	20	0	360
31086	19917s (+0.4s)	1324	1324	128	39	95	3	0	137
31087	19918s (+0.8s)	3460	3460	256	88	190	13	0	291
31088	19919s (+0.6s)	2500	2500	256	61	147	9	0	217
31089	19919s (+0.5s)	1656	1656	128	44	115	7	0	166
31090	19920s (+0.6s)	1904	1904	128	42	145	7	0	194
31091	19920s (+0.6s)	2160	2160	128	50	153	13	0	216
31092	19921s (+0.5s)	1780	1780	128	36	141	3	0	180
31093	19921s (+0.6s)	2676	2676	256	46	167	0	10	223
31094	19922s (+0.6s)	1908	1908	128	43	141	0	11	195
31095	19923s (+1.3s)	6632	6632	512	84	339	0	31	454
31096	19924s (+0.9s)	3780	3780	256	69	225	0	17	311
31097	19925s (+1.0s)	4256	4256	256	77	265	0	13	355
31098	19926s (+0.3s)	1144	1144	128	27	87	0	9	123
31099	19926s (+0.5s)	1548	1548	128	45	111	9	0	165
Episode	Time	Reward	Score	Highest	L	U	R	D	Steps
31100	19927s (+1.0s)	4444	4444	256	96	260	12	1	369
31101	19928s (+0.8s)	3168	3168	256	63	195	9	0	267
31102	19928s (+0.5s)	1604	1604	128	41	120	7	0	168
31103	19929s (+0.5s)	1848	1848	128	47	136	4	0	187
31104	19930s (+0.8s)	2816	2816	128	98	148	19	1	266
31105	19930s (+0.5s)	1692	1692	128	29	138	7	0	174
31106	19931s (+0.6s)	2540	2540	256	58	148	9	0	215
31107	19931s (+0.5s)	1960	1960	128	51	132	11	0	194
31108	19932s (+0.8s)	3392	3392	256	60	209	12	0	281
31109	19933s (+1.0s)	4168	4168	256	86	244	14	0	344
31110	19933s (+0.4s)	1172	1172	128	24	98	4	0	126
31111	19934s (+0.8s)	3484	3484	256	70	194	16	0	280
31112	19935s (+0.4s)	1496	1496	128	35	110	7	0	152
31113	19935s (+0.3s)	860	860	64	25	82	5	0	112
31114	19935s (+0.2s)	596	596	64	11	70	2	0	83
31115	19936s (+0.4s)	1252	1252	128	21	101	3	0	125
31116	19937s (+0.9s)	4036	4036	256	82	240	14	0	336
31117	19937s (+0.6s)	2808	2808	256	59	158	14	0	231
31118	19938s (+0.9s)	3604	3604	256	95	187	18	0	300
31119	19939s (+0.4s)	1256	1256	64	37	99	5	0	141
31120	19939s (+0.9s)	3836	3836	256	66	226	19	0	311
31121	19940s (+0.6s)	2484	2484	256	59	143	11	0	213
31122	19941s (+0.5s)	1820	1820	128	39	135	5	0	179
31123	19941s (+0.9s)	4072	4072	256	81	241	18	0	340
31124	19942s (+0.4s)	1492	1492	128	41	109	7	0	157
31125	19943s (+0.8s)	3332	3332	256	56	203	13	0	272
31126	19943s (+0.5s)	1812	1812	128	54	124	10	0	188
31127	19944s (+0.7s)	2468	2468	128	84	143	17	0	244
31128	19945s (+0.8s)	3416	3416	256	66	207	12	0	285
31129	19946s (+0.8s)	3324	3324	256	83	184	15	0	282
31130	19946s (+0.2s)	568	568	64	10	68	0	0	78
31131	19947s (+0.7s)	2804	2804	256	49	186	8	2	245
31132	19947s (+0.2s)	544	544	64	20	55	3	0	78
31133	19947s (+0.4s)	1476	1476	128	25	118	2	0	145
31134	19948s (+1.2s)	6080	6080	512	91	313	0	19	423
31135	19949s (+0.6s)	1928	1928	128	36	156	0	9	201
31136	19949s (+0.3s)	996	996	128	27	77	0	3	107
31137	19950s (+0.5s)	1796	1796	128	41	136	0	7	184
31138	19951s (+0.9s)	3956	3956	256	96	214	18	0	328
31139	19952s (+1.1s)	5632	5632	512	117	258	21	0	396
31140	19952s (+0.4s)	1476	1476	128	34	111	7	0	152
31141	19953s (+0.7s)	2996	2996	256	52	184	8	0	244
31142	19954s (+0.8s)	3504	3504	256	65	215	13	1	294
31143	19955s (+1.2s)	5732	5732	512	95	303	17	0	415
31144	19955s (+0.2s)	428	428	64	10	50	0	0	60
31145	19956s (+1.0s)	4012	4012	256	96	220	16	0	332
31146	19957s (+1.0s)	5184	5184	512	92	250	18	0	360
31147	19958s (+1.3s)	6220	6220	512	124	297	25	0	446
31148	19960s (+1.0s)	4304	4304	256	80	256	19	0	355
31149	19960s (+0.8s)	3148	3148	256	72	183	16	0	271
31150	19961s (+0.8s)	3224	3224	256	82	170	16	1	269
31151	19962s (+0.5s)	1668	1668	128	45	117	7	0	169
31152	19962s (+0.3s)	1032	1032	64	35	85	6	0	126
31153	19962s (+0.5s)	1820	1820	128	39	138	6	0	183
31154	19963s (+0.7s)	2756	2756	256	53	171	10	0	234
31155	19964s (+0.7s)	3140	3140	256	62	189	6	0	257
31156	19965s (+1.1s)	5484	5484	512	100	268	20	2	390
31157	19966s (+0.6s)	2544	2544	256	44	171	0	8	223
31158	19966s (+0.3s)	860	860	64	27	74	0	10	111
31159	19966s (+0.6s)	2040	2040	128	39	159	7	0	205
31160	19967s (+0.8s)	3344	3344	256	64	205	13	0	282
31161	19968s (+0.8s)	3508	3508	256	73	210	13	0	296
31162	19969s (+0.7s)	3064	3064	256	50	191	10	0	251
31163	19969s (+0.4s)	1448	1448	128	46	98	7	0	151
31164	19970s (+0.5s)	1668	1668	128	37	127	5	0	169
31165	19970s (+0.6s)	2728	2728	256	52	164	17	0	233
31166	19971s (+0.3s)	936	936	64	27	80	8	0	115
31167	19972s (+0.8s)	3216	3216	256	77	183	11	0	271
31168	19973s (+1.0s)	4268	4268	256	99	236	15	0	350
31169	19973s (+0.5s)	1804	1804	128	41	138	8	0	187
31170	19974s (+0.7s)	3048	3048	256	60	184	13	0	257
31171	19975s (+0.7s)	2908	2908	256	62	179	12	0	253
31172	19975s (+0.3s)	1060	1060	128	29	79	6	0	114
31173	19976s (+0.7s)	2916	2916	256	55	174	11	0	240
31174	19976s (+0.8s)	3368	3368	256	85	185	11	0	281
31175	19977s (+0.4s)	1432	1432	128	35	106	6	0	147
31176	19978s (+0.9s)	3904	3904	256	89	213	18	0	320
31177	19978s (+0.7s)	2776	2776	256	58	170	12	1	241
31178	19979s (+0.5s)	1788	1788	128	35	135	0	12	182
31179	19979s (+0.3s)	728	728	64	22	70	1	2	95
31180	19980s (+1.1s)	4612	4612	256	101	262	20	0	383
31181	19981s (+0.4s)	1108	1108	64	37	93	6	0	136
31182	19981s (+0.5s)	1648	1648	128	46	110	9	0	165
31183	19983s (+1.3s)	6468	6468	512	141	295	24	0	460
31184	19983s (+0.5s)	1612	1612	128	36	124	10	0	170
31185	19983s (+0.4s)	1376	1376	128	37	101	7	0	145
31186	19984s (+0.4s)	1040	1040	64	21	98	0	6	125
31187	19984s (+0.6s)	1964	1964	128	48	141	9	0	198
31188	19986s (+1.2s)	5756	5756	512	112	265	25	0	402
31189	19986s (+0.9s)	3568	3568	256	97	194	15	0	306
31190	19987s (+0.9s)	3528	3528	256	59	233	9	0	301
31191	19988s (+0.5s)	1792	1792	128	37	140	6	0	183
31192	19989s (+0.9s)	3596	3596	256	78	215	15	0	308
31193	19989s (+0.5s)	1720	1720	128	50	116	11	0	177
31194	19990s (+0.5s)	1608	1608	128	41	116	11	0	168
31195	19991s (+0.9s)	3604	3604	256	78	201	21	0	300
31196	19991s (+0.8s)	3388	3388	256	75	190	18	0	283
31197	19992s (+0.7s)	2940	2940	256	59	193	9	0	261
31198	19993s (+0.4s)	1360	1360	128	26	106	8	1	141
31199	19993s (+0.7s)	2916	2916	256	47	177	9	1	234
Episode	Time	Reward	Score	Highest	L	U	R	D	Steps
31200	19994s (+0.8s)	3200	3200	256	84	153	25	2	264
31201	19994s (+0.4s)	1344	1344	128	27	109	5	0	141
31202	19995s (+0.5s)	1772	1772	128	37	138	3	0	178
31203	19995s (+0.5s)	1724	1724	128	33	134	5	0	172
31204	19996s (+0.5s)	1736	1736	128	44	123	7	0	174
31205	19997s (+0.8s)	3528	3528	256	79	202	14	1	296
31206	19997s (+0.4s)	1168	1168	64	38	92	8	1	139
31207	19998s (+0.6s)	2600	2600	256	45	171	8	0	224
31208	19998s (+0.3s)	768	768	64	23	78	4	0	105
31209	19999s (+1.2s)	5992	5992	512	128	274	26	0	428
31210	20001s (+1.4s)	6724	6724	512	133	337	21	0	491
31211	20001s (+0.3s)	888	888	64	24	74	10	0	108
31212	20002s (+0.9s)	3744	3744	256	89	197	20	1	307
31213	20002s (+0.5s)	1800	1800	128	30	150	5	0	185
31214	20003s (+0.7s)	3212	3212	256	64	189	11	1	265
31215	20004s (+0.3s)	908	908	64	36	75	7	0	118
31216	20004s (+0.7s)	2964	2964	256	56	176	9	1	242
31217	20005s (+0.4s)	1108	1108	64	37	91	7	1	136
31218	20005s (+0.5s)	1764	1764	128	40	131	0	6	177
31219	20006s (+0.8s)	3512	3512	256	55	211	0	16	282
31220	20007s (+0.7s)	2632	2632	128	60	178	0	12	250
31221	20007s (+0.7s)	2752	2752	256	58	167	0	12	237
31222	20008s (+0.3s)	632	632	64	16	65	0	7	88
31223	20008s (+0.3s)	1168	1168	128	17	97	0	6	120
31224	20009s (+0.6s)	2360	2360	256	50	148	0	6	204
31225	20009s (+0.5s)	1804	1804	128	40	142	0	4	186
31226	20010s (+0.6s)	2448	2448	256	46	147	12	0	205
31227	20010s (+0.4s)	1304	1304	128	32	100	9	0	141
31228	20011s (+0.6s)	2220	2220	128	57	144	10	0	211
31229	20011s (+0.5s)	1828	1828	128	43	139	9	0	191
31230	20012s (+0.7s)	2824	2824	256	61	175	13	0	249
31231	20012s (+0.4s)	1272	1272	128	29	104	6	0	139
31232	20013s (+0.4s)	1352	1352	128	29	104	5	0	138
31233	20013s (+0.6s)	1900	1900	128	45	138	10	0	193
31234	20014s (+1.0s)	4232	4232	256	65	268	0	16	349
31235	20015s (+0.8s)	3212	3212	256	64	188	0	15	267
31236	20016s (+0.7s)	3256	3256	256	48	212	0	6	266
31237	20016s (+0.4s)	1364	1364	128	27	102	0	7	136
31238	20017s (+0.7s)	2516	2516	128	61	164	11	0	236
31239	20018s (+0.6s)	2472	2472	256	35	171	9	0	215
31240	20018s (+0.6s)	2260	2260	128	64	131	15	1	211
31241	20019s (+0.5s)	1560	1560	128	55	97	11	0	163
31242	20019s (+0.7s)	2948	2948	256	61	183	12	0	256
31243	20020s (+1.0s)	4320	4320	256	96	241	22	0	359
31244	20021s (+0.5s)	1568	1568	128	28	127	9	0	164
31245	20021s (+0.4s)	1428	1428	128	41	98	7	0	146
31246	20022s (+0.9s)	3864	3864	256	96	212	16	0	324
31247	20022s (+0.3s)	680	680	64	32	56	6	0	94
31248	20023s (+0.7s)	2908	2908	256	50	192	0	12	254
31249	20024s (+0.5s)	1724	1724	128	39	130	0	9	178
31250	20024s (+0.4s)	1488	1488	128	30	118	0	8	156
31251	20025s (+0.8s)	3384	3384	256	69	196	17	0	282
31252	20026s (+0.7s)	2660	2660	256	56	172	11	0	239
31253	20026s (+0.4s)	1152	1152	128	22	94	0	8	124
31254	20027s (+0.8s)	3224	3224	256	66	190	12	0	268
31255	20028s (+0.9s)	3756	3756	256	80	216	11	0	307
31256	20028s (+0.7s)	2800	2800	256	63	169	11	0	243
31257	20029s (+0.8s)	3276	3276	256	81	174	15	0	270
31258	20029s (+0.3s)	876	876	64	34	72	8	0	114
31259	20030s (+0.6s)	2460	2460	256	52	151	8	0	211
31260	20031s (+0.4s)	1236	1236	64	41	105	4	1	151
31261	20031s (+0.7s)	3112	3112	256	55	195	7	0	257
31262	20032s (+0.8s)	3364	3364	256	62	199	14	1	276
31263	20032s (+0.4s)	1148	1148	64	33	96	5	0	134
31264	20033s (+0.5s)	1604	1604	128	30	132	0	7	169
31265	20034s (+0.6s)	2756	2756	256	45	179	0	9	233
31266	20034s (+0.4s)	1292	1292	128	20	106	0	3	129
31267	20035s (+0.8s)	3484	3484	256	86	188	16	0	290
31268	20036s (+0.9s)	3944	3944	256	77	231	12	0	320
31269	20037s (+0.8s)	3348	3348	256	56	205	13	0	274
31270	20037s (+0.6s)	2388	2388	256	39	158	7	0	204
31271	20038s (+0.4s)	1468	1468	128	38	103	10	0	151
31272	20038s (+0.3s)	868	868	64	25	80	7	0	112
31273	20039s (+0.6s)	2324	2324	128	47	167	9	1	224
31274	20039s (+0.3s)	588	588	32	19	65	3	0	87
31275	20039s (+0.4s)	1512	1512	128	35	116	5	1	157
31276	20040s (+0.8s)	3312	3312	256	77	177	15	0	269
31277	20041s (+0.5s)	1548	1548	128	27	127	0	5	159
31278	20041s (+0.5s)	1708	1708	128	39	125	0	10	174
31279	20042s (+0.6s)	2304	2304	128	41	160	0	14	215
31280	20042s (+0.7s)	2896	2896	256	57	166	13	0	236
31281	20043s (+0.7s)	2612	2612	256	61	155	12	0	228
31282	20043s (+0.4s)	1412	1412	128	37	105	5	0	147
31283	20044s (+0.6s)	1908	1908	128	42	146	7	0	195
31284	20044s (+0.3s)	868	868	64	28	79	6	0	113
31285	20045s (+0.3s)	1000	1000	64	30	79	9	0	118
31286	20046s (+0.8s)	3488	3488	256	68	215	15	0	298
31287	20046s (+0.5s)	1724	1724	128	51	112	8	0	171
31288	20047s (+0.8s)	3292	3292	256	51	219	0	11	281
31289	20047s (+0.7s)	2744	2744	256	50	174	0	11	235
31290	20048s (+0.4s)	1372	1372	128	27	109	0	8	144
31291	20049s (+0.6s)	2540	2540	256	36	165	0	11	212
31292	20049s (+0.5s)	1948	1948	128	42	132	0	11	185
31293	20050s (+0.6s)	2332	2332	128	57	147	8	0	212
31294	20050s (+0.3s)	732	732	64	14	80	2	0	96
31295	20051s (+0.9s)	3728	3728	256	82	223	12	1	318
31296	20051s (+0.5s)	1700	1700	128	41	131	4	0	176
31297	20052s (+0.5s)	1520	1520	128	32	119	7	0	158
31298	20052s (+0.5s)	1744	1744	128	42	126	8	0	176
31299	20053s (+0.5s)	1748	1748	128	40	130	7	0	177
Episode	Time	Reward	Score	Highest	L	U	R	D	Steps
31300	20054s (+1.3s)	6372	6372	512	113	304	27	1	445
31301	20055s (+0.7s)	2780	2780	256	62	162	11	0	235
31302	20055s (+0.3s)	1124	1124	128	30	84	3	1	118
31303	20056s (+1.0s)	4348	4348	256	99	245	17	0	361
31304	20057s (+0.5s)	1796	1796	128	33	141	10	0	184
31305	20057s (+0.5s)	1800	1800	128	41	136	9	0	186
31306	20058s (+0.4s)	1480	1480	128	37	112	5	0	154
31307	20058s (+0.7s)	2868	2868	256	63	183	9	0	255
31308	20059s (+0.9s)	4188	4188	256	94	210	20	0	324
31309	20060s (+0.4s)	1208	1208	128	28	97	5	0	130
31310	20060s (+0.4s)	1052	1052	64	36	83	8	0	127
31311	20061s (+0.6s)	2440	2440	256	50	150	7	0	207
31312	20061s (+0.3s)	1024	1024	128	20	88	3	0	111
31313	20062s (+0.8s)	3208	3208	256	61	193	12	0	266
31314	20063s (+0.9s)	4004	4004	256	88	220	21	0	329
31315	20063s (+0.6s)	1924	1924	128	55	135	9	0	199
31316	20064s (+0.6s)	2668	2668	256	36	181	4	0	221
31317	20065s (+0.6s)	2192	2192	128	56	145	14	0	215
31318	20065s (+0.4s)	1172	1172	64	41	89	10	0	140
31319	20066s (+0.7s)	2556	2556	128	60	160	18	0	238
31320	20066s (+0.5s)	1488	1488	128	32	123	2	0	157
31321	20067s (+0.8s)	3608	3608	256	80	211	13	0	304
31322	20068s (+0.5s)	1864	1864	128	41	149	6	0	196
31323	20068s (+0.4s)	1488	1488	128	35	118	3	0	156
31324	20069s (+0.6s)	2112	2112	128	51	149	11	0	211
31325	20069s (+0.5s)	1632	1632	128	51	116	8	0	175
31326	20070s (+0.6s)	2516	2516	256	69	143	8	0	220
31327	20071s (+0.9s)	3676	3676	256	68	214	0	19	301
31328	20071s (+0.8s)	3468	3468	256	64	212	0	18	294
31329	20072s (+0.4s)	1536	1536	128	23	125	0	5	153
31330	20073s (+0.6s)	2652	2652	256	45	165	13	0	223
31331	20073s (+0.7s)	2936	2936	256	73	177	10	0	260
31332	20074s (+0.8s)	3432	3432	256	66	206	16	0	288
31333	20075s (+1.0s)	4372	4372	256	96	244	22	1	363
31334	20076s (+0.8s)	3424	3424	256	68	208	11	0	287
31335	20077s (+0.8s)	3228	3228	256	64	192	14	0	270
31336	20077s (+0.2s)	420	420	32	19	46	2	0	67
31337	20078s (+0.9s)	3668	3668	256	94	202	19	0	315
31338	20079s (+1.2s)	6208	6208	512	128	290	20	0	438
31339	20079s (+0.3s)	1004	1004	64	32	76	8	1	117
31340	20080s (+0.4s)	1044	1044	64	28	95	3	0	126
31341	20080s (+0.6s)	2040	2040	128	51	149	8	0	208
31342	20081s (+0.5s)	1656	1656	128	29	133	0	5	167
31343	20082s (+0.8s)	3244	3244	256	44	222	0	7	273
31344	20082s (+0.5s)	1668	1668	128	31	136	0	2	169
31345	20083s (+0.7s)	2820	2820	256	43	194	0	11	248
31346	20083s (+0.3s)	772	772	64	16	81	0	5	102
31347	20084s (+0.9s)	4144	4144	256	65	254	0	19	338
31348	20085s (+0.8s)	3240	3240	256	55	204	0	14	273
31349	20085s (+0.4s)	1084	1084	64	35	87	0	8	130
31350	20086s (+0.8s)	3264	3264	256	48	219	0	11	278
31351	20087s (+0.7s)	2880	2880	256	63	179	9	0	251
31352	20087s (+0.7s)	2956	2956	256	69	183	8	0	260
31353	20088s (+0.5s)	2256	2256	256	52	129	9	0	190
31354	20089s (+0.7s)	2888	2888	256	61	174	13	0	248
31355	20089s (+0.5s)	1844	1844	128	55	126	8	0	189
31356	20090s (+0.8s)	3212	3212	256	77	172	17	0	266
31357	20091s (+0.6s)	2412	2412	256	48	144	8	0	200
31358	20091s (+0.7s)	2900	2900	256	51	177	10	0	238
31359	20092s (+1.0s)	5488	5488	512	92	270	24	0	386
31360	20093s (+0.6s)	2696	2696	256	39	169	14	0	222
31361	20094s (+0.7s)	3080	3080	256	61	192	7	0	260
31362	20094s (+0.7s)	3160	3160	256	63	183	12	1	259
31363	20095s (+0.5s)	1796	1796	128	58	117	9	0	184
31364	20095s (+0.3s)	680	680	64	18	69	7	0	94
31365	20096s (+1.0s)	4344	4344	256	84	261	15	0	360
31366	20097s (+0.8s)	3492	3492	256	84	193	15	0	292
31367	20098s (+0.6s)	2032	2032	128	62	132	10	0	204
31368	20098s (+0.6s)	2352	2352	256	58	136	9	1	204
31369	20099s (+0.4s)	1496	1496	128	37	116	5	0	158
31370	20099s (+0.5s)	1864	1864	128	44	133	13	0	190
31371	20100s (+0.4s)	1296	1296	128	31	96	4	0	131
31372	20101s (+0.8s)	3492	3492	256	75	206	12	0	293
31373	20101s (+0.8s)	3496	3496	256	77	199	17	0	293
31374	20102s (+0.4s)	1432	1432	128	28	115	5	0	148
31375	20102s (+0.5s)	1688	1688	128	43	124	7	0	174
31376	20103s (+0.8s)	3424	3424	256	62	216	9	0	287
31377	20104s (+0.5s)	1764	1764	128	44	127	9	0	180
31378	20104s (+0.6s)	1924	1924	128	53	136	10	0	199
31379	20105s (+0.5s)	1804	1804	128	47	130	8	0	185
31380	20106s (+1.2s)	5752	5752	512	108	277	24	0	409
31381	20106s (+0.3s)	884	884	64	26	85	5	0	116
31382	20107s (+0.8s)	3372	3372	256	60	212	14	0	286
31383	20108s (+0.5s)	1708	1708	128	39	120	8	0	167
31384	20108s (+0.5s)	1488	1488	64	40	123	7	0	170
31385	20109s (+0.8s)	3312	3312	256	67	187	14	0	268
31386	20109s (+0.5s)	1732	1732	128	32	134	8	1	175
31387	20110s (+0.7s)	2836	2836	256	67	166	14	0	247
31388	20111s (+0.5s)	1740	1740	128	44	126	4	1	175
31389	20111s (+0.5s)	1732	1732	128	44	123	6	0	173
31390	20112s (+0.6s)	2084	2084	128	51	131	12	0	194
31391	20113s (+0.8s)	3544	3544	256	74	218	8	0	300
31392	20113s (+0.4s)	1252	1252	128	26	104	5	0	135
31393	20113s (+0.4s)	1228	1228	128	37	93	5	0	135
31394	20114s (+0.4s)	1552	1552	128	35	109	10	0	154
31395	20114s (+0.7s)	2676	2676	256	55	167	7	0	229
31396	20115s (+0.8s)	3352	3352	256	53	203	0	18	274
31397	20116s (+0.6s)	2380	2380	256	40	158	0	6	204
31398	20117s (+0.8s)	3608	3608	256	68	218	0	18	304
31399	20117s (+0.5s)	1792	1792	128	34	137	0	12	183
Episode	Time	Reward	Score	Highest	L	U	R	D	Steps
31400	20118s (+0.7s)	3160	3160	256	47	200	0	9	256
31401	20119s (+0.9s)	3500	3500	256	61	227	1	12	301
31402	20119s (+0.6s)	2360	2360	256	41	147	0	11	199
31403	20120s (+0.8s)	3364	3364	256	63	211	0	12	286
31404	20121s (+0.6s)	2624	2624	256	45	173	0	13	231
31405	20121s (+0.5s)	1548	1548	128	43	117	0	6	166
31406	20122s (+0.5s)	1820	1820	128	33	141	0	7	181
31407	20123s (+0.8s)	3492	3492	256	64	216	0	12	292
31408	20123s (+0.4s)	1120	1120	64	29	92	0	11	132
31409	20123s (+0.3s)	1100	1100	128	17	97	0	1	115
31410	20124s (+0.9s)	3936	3936	256	58	253	0	11	322
31411	20125s (+0.5s)	1508	1508	128	37	110	0	13	160
31412	20125s (+0.4s)	1200	1200	128	24	93	0	6	123
31413	20126s (+0.5s)	1652	1652	128	35	120	10	0	165
31414	20126s (+0.4s)	1420	1420	128	34	100	11	0	145
31415	20126s (+0.4s)	1436	1436	128	51	87	8	1	147
31416	20127s (+0.8s)	3340	3340	256	78	192	12	0	282
31417	20128s (+0.6s)	2752	2752	256	64	159	13	0	236
31418	20128s (+0.3s)	1104	1104	128	31	87	3	0	121
31419	20129s (+0.4s)	1048	1048	64	31	84	0	11	126
31420	20129s (+0.6s)	2752	2752	256	50	171	0	9	230
31421	20130s (+1.0s)	4224	4224	256	89	241	17	0	347
31422	20131s (+0.8s)	3228	3228	256	63	194	13	0	270
31423	20132s (+0.7s)	3188	3188	256	74	181	11	0	266
31424	20133s (+0.9s)	3572	3572	256	78	208	14	0	300
31425	20133s (+0.3s)	824	824	64	23	79	4	0	106
31426	20134s (+0.7s)	2904	2904	256	57	187	9	0	253
31427	20134s (+0.5s)	1624	1624	128	32	124	7	0	163
31428	20135s (+0.7s)	3128	3128	256	63	174	15	0	252
31429	20136s (+0.7s)	3016	3016	256	57	172	10	0	239
31430	20136s (+0.5s)	1596	1596	128	39	111	7	0	157
31431	20136s (+0.5s)	1776	1776	128	47	127	6	0	180
31432	20137s (+0.9s)	3756	3756	256	77	207	16	1	301
31433	20138s (+0.6s)	2152	2152	128	53	145	15	0	213
31434	20139s (+0.7s)	2908	2908	256	61	176	16	0	253
31435	20139s (+0.5s)	1644	1644	128	38	127	9	0	174
31436	20140s (+0.4s)	1400	1400	128	25	112	9	0	146
31437	20140s (+0.7s)	3064	3064	256	54	186	9	1	250
31438	20141s (+0.6s)	2576	2576	256	71	142	10	0	223
31439	20142s (+0.7s)	2924	2924	256	66	176	15	0	257
31440	20143s (+0.9s)	3700	3700	256	86	216	10	0	312
31441	20143s (+0.5s)	1688	1688	128	45	120	9	0	174
31442	20143s (+0.3s)	876	876	64	28	80	6	0	114
31443	20144s (+0.3s)	616	616	32	17	69	0	1	87
31444	20144s (+0.4s)	1368	1368	128	30	108	0	5	143
31445	20145s (+0.6s)	1920	1920	128	39	151	0	8	198
31446	20145s (+0.4s)	1472	1472	128	29	119	0	4	152
31447	20146s (+0.4s)	1364	1364	128	25	115	2	0	142
31448	20146s (+1.0s)	3920	3920	256	121	189	25	0	335
31449	20147s (+0.3s)	864	864	64	26	81	5	0	112
31450	20147s (+0.6s)	2580	2580	256	44	161	8	1	214
31451	20148s (+0.4s)	1460	1460	128	35	108	0	11	154
31452	20148s (+0.6s)	2636	2636	256	43	176	5	0	224
31453	20149s (+0.8s)	3444	3444	256	88	185	12	0	285
31454	20150s (+0.4s)	1328	1328	128	27	106	5	0	138
31455	20150s (+0.5s)	1576	1576	128	43	113	6	0	162
31456	20151s (+1.1s)	5488	5488	512	103	267	16	1	387
31457	20152s (+0.7s)	2904	2904	256	71	170	16	0	257
31458	20153s (+1.1s)	5976	5976	512	102	294	22	0	418
31459	20154s (+0.5s)	1936	1936	128	54	124	13	0	191
31460	20154s (+0.7s)	2528	2528	128	67	164	9	0	240
31461	20155s (+0.3s)	1020	1020	64	27	90	6	0	123
31462	20156s (+0.9s)	4616	4616	512	81	220	17	0	318
31463	20156s (+0.6s)	2476	2476	256	45	160	5	0	210
31464	20157s (+1.1s)	5404	5404	512	94	270	14	0	378
31465	20158s (+0.4s)	1184	1184	64	38	94	11	0	143
31466	20158s (+0.7s)	2948	2948	256	65	181	12	0	258
31467	20159s (+0.7s)	2460	2460	128	39	175	0	15	229
31468	20159s (+0.4s)	1076	1076	64	26	95	0	6	127
31469	20160s (+0.6s)	1972	1972	128	47	143	0	10	200
31470	20160s (+0.3s)	820	820	64	29	72	0	4	105
31471	20161s (+1.0s)	4192	4192	256	81	246	0	18	345
31472	20162s (+0.8s)	3252	3252	256	53	210	0	8	271
31473	20162s (+0.3s)	924	924	64	21	85	0	5	111
31474	20163s (+0.5s)	2172	2172	256	42	135	0	7	184
31475	20163s (+0.5s)	1796	1796	128	41	133	0	10	184
31476	20164s (+0.3s)	1004	1004	64	35	78	8	0	121
31477	20164s (+0.4s)	1168	1168	64	40	93	6	0	139
31478	20165s (+0.4s)	1168	1168	64	40	92	7	0	139
31479	20165s (+0.3s)	896	896	128	16	79	1	0	96
31480	20166s (+1.0s)	4320	4320	256	104	235	20	0	359
31481	20167s (+0.7s)	2908	2908	256	50	180	10	0	240
31482	20167s (+0.8s)	3328	3328	256	87	184	12	0	283
31483	20168s (+0.6s)	2208	2208	256	43	143	7	0	193
31484	20169s (+0.5s)	1812	1812	128	44	138	6	0	188
31485	20169s (+0.5s)	1584	1584	128	55	96	12	0	163
31486	20169s (+0.4s)	1172	1172	64	35	98	7	0	140
31487	20170s (+0.7s)	2764	2764	256	48	178	9	0	235
31488	20171s (+0.5s)	2216	2216	256	37	135	8	0	180
31489	20171s (+0.3s)	952	952	64	20	89	5	0	114
31490	20172s (+0.6s)	1912	1912	128	51	132	13	0	196
31491	20172s (+0.4s)	1248	1248	128	31	96	2	0	129
31492	20173s (+1.0s)	4208	4208	256	81	260	8	0	349
31493	20174s (+0.7s)	2844	2844	256	73	158	13	0	244
31494	20174s (+0.3s)	1180	1180	128	18	106	3	0	127
31495	20175s (+0.7s)	2664	2664	256	68	156	12	0	236
31496	20175s (+0.5s)	1880	1880	128	46	141	6	0	193
31497	20176s (+0.6s)	2704	2704	256	62	155	12	0	229
31498	20176s (+0.5s)	1612	1612	128	42	115	8	0	165
31499	20177s (+0.5s)	1588	1588	128	42	111	15	0	168
Episode	Time	Reward	Score	Highest	L	U	R	D	Steps
31500	20177s (+0.4s)	1308	1308	128	29	107	7	0	143
31501	20178s (+0.3s)	952	952	64	20	89	6	0	115
31502	20178s (+0.6s)	2688	2688	256	55	165	11	1	232
31503	20179s (+0.5s)	2408	2408	256	45	147	7	0	199
31504	20179s (+0.6s)	2108	2108	128	52	139	9	0	200
31505	20180s (+0.6s)	2304	2304	256	40	149	8	0	197
31506	20180s (+0.3s)	720	720	64	18	69	0	7	94
31507	20181s (+1.3s)	6300	6300	512	84	343	0	29	456
31508	20182s (+0.7s)	3136	3136	256	58	196	0	9	263
31509	20183s (+0.4s)	1300	1300	128	25	103	0	3	131
31510	20183s (+0.6s)	2484	2484	256	45	155	0	6	206
31511	20184s (+0.5s)	1816	1816	128	40	140	0	6	186
31512	20184s (+0.7s)	2312	2312	128	39	176	0	13	228
31513	20185s (+0.3s)	872	872	64	22	88	0	3	113
31514	20186s (+0.9s)	3648	3648	256	63	218	0	19	300
31515	20186s (+0.5s)	1596	1596	128	33	127	0	6	166
31516	20186s (+0.5s)	1736	1736	128	33	138	0	4	175
31517	20187s (+0.4s)	1436	1436	128	34	104	0	11	149
31518	20187s (+0.4s)	1284	1284	128	32	105	6	0	143
31519	20188s (+0.3s)	704	704	64	24	67	5	0	96
31520	20189s (+1.4s)	6868	6868	512	128	344	26	1	499
31521	20190s (+0.7s)	2516	2516	128	61	159	15	1	236
31522	20190s (+0.5s)	1740	1740	128	34	134	7	0	175
31523	20191s (+0.5s)	1660	1660	128	41	120	6	0	167
31524	20191s (+0.5s)	2012	2012	128	55	133	11	0	199
31525	20192s (+0.4s)	1444	1444	128	43	98	8	1	150
31526	20192s (+0.5s)	1808	1808	128	28	146	0	9	183
31527	20193s (+0.8s)	3328	3328	256	55	207	0	11	273
31528	20194s (+1.2s)	5956	5956	512	94	295	0	20	409
31529	20195s (+0.7s)	2944	2944	256	47	187	0	13	247
31530	20195s (+0.2s)	284	284	32	13	36	0	4	53
31531	20195s (+0.3s)	876	876	64	25	83	0	7	115
31532	20196s (+0.7s)	3144	3144	256	56	185	0	14	255
31533	20197s (+0.4s)	1460	1460	128	31	111	0	8	150
31534	20197s (+0.4s)	1328	1328	64	44	95	8	0	147
31535	20198s (+0.5s)	1812	1812	128	33	140	8	1	182
31536	20198s (+0.9s)	3756	3756	256	68	223	14	0	305
31537	20199s (+0.4s)	1260	1260	128	29	102	5	0	136
31538	20200s (+0.7s)	2768	2768	128	67	179	13	0	259
31539	20200s (+0.4s)	1448	1448	128	37	98	5	0	140
31540	20201s (+0.6s)	2528	2528	256	56	155	8	0	219
31541	20201s (+0.7s)	2784	2784	128	80	162	17	0	259
31542	20202s (+0.9s)	3568	3568	256	74	219	13	0	306
31543	20203s (+0.6s)	2232	2232	256	48	139	7	0	194
31544	20203s (+0.5s)	1608	1608	128	39	119	11	0	169
31545	20204s (+0.6s)	2716	2716	256	64	154	10	0	228
31546	20205s (+0.8s)	3228	3228	256	74	181	15	0	270
31547	20206s (+0.8s)	3404	3404	256	68	205	13	0	286
31548	20206s (+0.7s)	2784	2784	256	54	172	13	0	239
31549	20207s (+0.3s)	816	816	64	27	75	3	0	105
31550	20208s (+1.1s)	5716	5716	512	102	275	23	0	400
31551	20208s (+0.7s)	2856	2856	256	67	164	14	0	245
31552	20209s (+0.3s)	1020	1020	128	31	73	5	0	109
31553	20209s (+0.5s)	1596	1596	128	37	124	5	0	166
31554	20210s (+0.8s)	3244	3244	256	70	193	12	0	275
31555	20210s (+0.5s)	1500	1500	128	37	117	6	0	160
31556	20211s (+0.6s)	2524	2524	256	49	159	7	0	215
31557	20212s (+0.8s)	3272	3272	256	67	190	12	0	269
31558	20213s (+0.8s)	3240	3240	256	60	202	11	0	273
31559	20213s (+0.4s)	1488	1488	128	26	127	3	0	156
31560	20213s (+0.3s)	880	880	128	21	67	4	0	92
31561	20214s (+0.5s)	1848	1848	128	45	139	0	7	191
31562	20215s (+0.7s)	3064	3064	256	61	173	0	17	251
31563	20215s (+0.2s)	600	600	64	17	65	0	4	86
31564	20216s (+0.7s)	3168	3168	256	57	191	1	11	260
31565	20216s (+0.5s)	1592	1592	128	38	114	0	7	159
31566	20217s (+0.8s)	3316	3316	256	58	206	0	12	276
31567	20217s (+0.5s)	1744	1744	128	38	133	0	5	176
31568	20218s (+0.5s)	1768	1768	128	51	123	9	0	183
31569	20218s (+0.6s)	2392	2392	256	56	134	10	0	200
31570	20219s (+1.0s)	4992	4992	512	93	238	17	0	348
31571	20220s (+0.4s)	1352	1352	128	31	102	6	0	139
31572	20220s (+0.6s)	2468	2468	256	48	157	8	0	213
31573	20221s (+0.6s)	1924	1924	128	52	141	6	0	199
31574	20222s (+0.5s)	2244	2244	256	31	151	7	1	190
31575	20222s (+0.5s)	1592	1592	128	49	107	9	0	165
31576	20222s (+0.4s)	1476	1476	128	46	97	10	0	153
31577	20223s (+0.8s)	3376	3376	256	66	211	10	0	287
31578	20224s (+0.3s)	844	844	64	30	70	6	0	106
31579	20225s (+1.1s)	5828	5828	512	114	270	26	0	410
31580	20225s (+0.7s)	2700	2700	256	63	152	12	0	227
31581	20226s (+0.5s)	2320	2320	256	42	148	4	0	194
31582	20227s (+0.7s)	3052	3052	256	67	161	17	1	246
31583	20227s (+0.5s)	1680	1680	128	35	135	6	0	176
31584	20228s (+0.7s)	2940	2940	256	66	181	14	0	261
31585	20229s (+1.0s)	4232	4232	256	85	246	18	0	349
31586	20230s (+0.7s)	2800	2800	256	76	154	13	0	243
31587	20230s (+0.5s)	1732	1732	128	50	123	7	0	180
31588	20231s (+0.8s)	3408	3408	256	52	224	11	0	287
31589	20232s (+0.7s)	3012	3012	256	49	185	0	9	243
31590	20232s (+0.7s)	2768	2768	256	38	186	0	12	236
31591	20233s (+0.7s)	2904	2904	256	50	196	0	7	253
31592	20234s (+0.5s)	1604	1604	128	36	117	0	6	159
31593	20234s (+0.5s)	1808	1808	128	47	131	8	0	186
31594	20235s (+0.4s)	1496	1496	128	44	108	6	0	158
31595	20235s (+0.4s)	1228	1228	128	33	96	5	0	134
31596	20236s (+0.7s)	2512	2512	128	60	165	12	0	237
31597	20236s (+0.7s)	2796	2796	256	63	166	13	0	242
31598	20237s (+0.8s)	3328	3328	256	63	204	13	0	280
31599	20238s (+0.8s)	3516	3516	256	71	206	16	0	293
Episode	Time	Reward	Score	Highest	L	U	R	D	Steps
31600	20239s (+0.5s)	1836	1836	128	56	119	12	0	187
31601	20239s (+0.5s)	1732	1732	64	46	132	10	1	189
31602	20240s (+0.8s)	3588	3588	256	64	215	21	0	300
31603	20240s (+0.4s)	1216	1216	128	27	97	8	0	132
31604	20241s (+0.8s)	3372	3372	256	68	208	12	1	289
31605	20242s (+0.9s)	3960	3960	256	81	225	18	0	324
31606	20243s (+0.5s)	1712	1712	128	35	134	6	0	175
31607	20243s (+0.8s)	3324	3324	256	58	207	12	0	277
31608	20244s (+0.8s)	3360	3360	256	57	219	10	0	286
31609	20244s (+0.4s)	1224	1224	128	27	102	5	0	134
31610	20245s (+0.7s)	2496	2496	128	55	163	16	1	235
31611	20246s (+1.0s)	4224	4224	256	92	231	22	1	346
31612	20247s (+0.5s)	1792	1792	128	31	129	0	10	170
31613	20247s (+0.8s)	3248	3248	256	57	205	0	13	275
31614	20248s (+0.6s)	2544	2544	256	53	153	0	10	216
31615	20249s (+0.9s)	3952	3952	256	86	219	0	18	323
31616	20250s (+0.7s)	2960	2960	256	45	180	0	10	235
31617	20250s (+0.6s)	2604	2604	256	51	166	0	10	227
31618	20251s (+0.4s)	1260	1260	128	25	97	0	10	132
31619	20251s (+0.7s)	2768	2768	256	45	182	0	13	240
31620	20252s (+0.5s)	1796	1796	128	32	139	0	14	185
31621	20253s (+1.0s)	4236	4236	256	86	242	0	21	349
31622	20253s (+0.4s)	1420	1420	128	29	102	0	14	145
31623	20254s (+0.4s)	1140	1140	128	20	99	0	4	123
31624	20254s (+0.3s)	660	660	64	15	69	0	4	88
31625	20254s (+0.5s)	1624	1624	128	34	133	0	6	173
31626	20255s (+0.9s)	3600	3600	256	68	225	0	16	309
31627	20256s (+0.5s)	1744	1744	128	34	135	0	4	173
31628	20257s (+0.9s)	4068	4068	256	95	226	18	0	339
31629	20257s (+0.6s)	2616	2616	256	57	149	11	1	218
31630	20258s (+0.4s)	1088	1088	64	25	94	3	0	122
31631	20258s (+0.8s)	3344	3344	256	70	204	8	0	282
31632	20259s (+0.3s)	864	864	64	21	85	9	1	116
31633	20259s (+0.4s)	1452	1452	128	35	110	5	0	150
31634	20260s (+0.8s)	3548	3548	256	79	205	17	0	301
31635	20261s (+0.6s)	2600	2600	256	47	172	6	0	225
31636	20261s (+0.4s)	1488	1488	128	53	94	8	1	156
31637	20262s (+0.5s)	1788	1788	128	41	136	10	0	187
31638	20262s (+0.5s)	1636	1636	128	40	120	12	0	172
31639	20263s (+0.7s)	2936	2936	256	68	169	16	0	253
31640	20264s (+0.6s)	2332	2332	256	39	151	7	0	197
31641	20264s (+0.8s)	3308	3308	256	64	199	16	0	279
31642	20265s (+0.8s)	3408	3408	256	53	221	9	0	283
31643	20266s (+0.7s)	2704	2704	256	69	147	13	0	229
31644	20267s (+0.8s)	3468	3468	256	80	199	11	0	290
31645	20267s (+0.8s)	3380	3380	256	68	199	13	0	280
31646	20268s (+0.9s)	3980	3980	256	80	237	12	0	329
31647	20269s (+0.5s)	1528	1528	128	37	116	8	0	161
31648	20270s (+0.7s)	2948	2948	256	68	181	14	0	263
31649	20271s (+1.0s)	5264	5264	512	95	241	21	0	357
31650	20271s (+0.7s)	2584	2584	128	59	174	12	0	245
31651	20272s (+0.5s)	1616	1616	128	41	124	6	0	171
31652	20273s (+1.2s)	5968	5968	512	115	279	16	1	411
31653	20274s (+0.7s)	2940	2940	256	67	183	11	0	261
31654	20275s (+0.8s)	3576	3576	256	81	206	14	0	301
31655	20275s (+0.5s)	2196	2196	256	41	136	6	0	183
31656	20276s (+0.5s)	2232	2232	256	49	136	9	0	194
31657	20276s (+0.4s)	1212	1212	128	25	106	4	0	135
31658	20277s (+0.6s)	2444	2444	256	54	147	7	0	208
31659	20277s (+0.3s)	652	652	64	19	67	2	0	88
31660	20278s (+0.7s)	3160	3160	256	57	186	15	0	258
31661	20279s (+0.9s)	3816	3816	256	84	212	14	0	310
31662	20279s (+0.8s)	3260	3260	256	72	195	10	1	278
31663	20280s (+0.4s)	1476	1476	128	41	103	9	0	153
31664	20280s (+0.5s)	1796	1796	128	49	127	8	0	184
31665	20281s (+0.9s)	4036	4036	256	88	223	21	0	332
31666	20282s (+0.8s)	3524	3524	256	70	209	17	0	296
31667	20283s (+0.6s)	2116	2116	128	53	142	13	0	208
31668	20283s (+0.4s)	1412	1412	128	42	95	6	0	143
31669	20283s (+0.3s)	1172	1172	128	21	102	3	0	126
31670	20284s (+0.5s)	1692	1692	128	52	123	8	1	184
31671	20284s (+0.3s)	784	784	64	33	65	6	1	105
31672	20285s (+0.6s)	2292	2292	128	53	152	16	0	221
31673	20285s (+0.5s)	1760	1760	128	46	125	4	0	175
31674	20286s (+0.6s)	2412	2412	256	60	143	4	0	207
31675	20287s (+0.8s)	3228	3228	256	62	194	13	1	270
31676	20287s (+0.5s)	1764	1764	128	39	134	4	0	177
31677	20288s (+0.4s)	1384	1384	128	41	98	8	0	147
31678	20289s (+0.8s)	3608	3608	256	76	199	16	0	291
31679	20289s (+0.8s)	3208	3208	256	61	195	10	0	266
31680	20290s (+0.3s)	1068	1068	64	32	81	8	0	121
31681	20290s (+0.5s)	1688	1688	128	41	125	7	0	173
31682	20291s (+0.6s)	2860	2860	256	54	169	9	0	232
31683	20291s (+0.4s)	1160	1160	128	32	89	6	0	127
31684	20292s (+0.5s)	1508	1508	128	36	114	11	0	161
31685	20292s (+0.8s)	3268	3268	256	65	207	8	0	280
31686	20294s (+1.1s)	4512	4512	256	102	244	24	0	370
31687	20294s (+0.6s)	2324	2324	256	45	134	13	2	194
31688	20295s (+0.8s)	3428	3428	256	75	199	14	0	288
31689	20296s (+0.8s)	3864	3864	256	76	221	12	1	310
31690	20296s (+0.5s)	1896	1896	128	41	143	8	0	192
31691	20297s (+0.8s)	3476	3476	256	61	214	13	0	288
31692	20298s (+0.5s)	1528	1528	128	47	108	7	0	162
31693	20298s (+0.6s)	2464	2464	256	42	161	5	0	208
31694	20298s (+0.3s)	736	736	64	21	69	6	0	96
31695	20300s (+1.1s)	5432	5432	512	105	267	13	0	385
31696	20300s (+0.5s)	1708	1708	128	47	120	8	0	175
31697	20301s (+0.5s)	1920	1920	128	48	139	11	0	198
31698	20301s (+0.7s)	2736	2736	256	53	167	12	0	232
31699	20302s (+0.9s)	4856	4856	512	68	250	13	0	331
Episode	Time	Reward	Score	Highest	L	U	R	D	Steps
31700	20303s (+0.8s)	3252	3252	256	55	211	10	0	276
31701	20304s (+1.1s)	5676	5676	512	86	293	0	22	401
31702	20305s (+1.0s)	4320	4320	256	75	258	0	17	350
31703	20306s (+0.8s)	3492	3492	256	69	207	0	16	292
31704	20307s (+1.0s)	4296	4296	256	88	246	19	0	353
31705	20308s (+0.8s)	3232	3232	256	73	187	11	0	271
31706	20309s (+0.8s)	3480	3480	256	60	220	13	0	293
31707	20309s (+0.6s)	1932	1932	128	52	140	9	0	201
31708	20310s (+0.6s)	2304	2304	256	39	149	9	0	197
31709	20311s (+1.3s)	6452	6452	512	133	310	23	1	467
31710	20312s (+0.7s)	3204	3204	256	62	187	13	2	264
31711	20312s (+0.4s)	1328	1328	128	28	102	6	0	136
31712	20313s (+0.4s)	1452	1452	128	33	112	0	7	152
31713	20313s (+0.5s)	1788	1788	128	50	124	7	1	182
31714	20314s (+0.4s)	1184	1184	128	21	108	0	0	129
31715	20315s (+1.0s)	4388	4388	256	102	246	18	0	366
31716	20316s (+0.9s)	3676	3676	256	89	208	20	0	317
31717	20316s (+0.7s)	3048	3048	256	51	199	8	0	258
31718	20317s (+1.1s)	5160	5160	512	84	272	12	0	368
31719	20318s (+0.6s)	2428	2428	256	49	145	10	0	204
31720	20318s (+0.4s)	1308	1308	128	33	103	6	0	142
31721	20319s (+0.8s)	3236	3236	256	63	194	15	0	272
31722	20320s (+0.7s)	3036	3036	256	78	163	13	0	254
31723	20320s (+0.2s)	616	616	64	11	71	1	0	83
31724	20321s (+0.6s)	2192	2192	128	68	143	12	0	223
31725	20321s (+0.7s)	2904	2904	256	64	180	8	0	252
31726	20322s (+0.6s)	2204	2204	128	52	141	13	0	206
31727	20323s (+0.8s)	3492	3492	256	64	213	15	0	292
31728	20323s (+0.4s)	1488	1488	128	39	108	8	0	155
31729	20324s (+0.6s)	2084	2084	128	53	144	10	0	207
31730	20325s (+0.7s)	2816	2816	256	61	174	12	0	247
31731	20325s (+0.5s)	1640	1640	128	39	128	5	0	172
31732	20326s (+0.5s)	1872	1872	128	64	117	10	0	191
31733	20326s (+0.8s)	3364	3364	256	78	191	15	0	284
31734	20327s (+0.4s)	1548	1548	128	40	112	7	0	159
31735	20328s (+0.8s)	3212	3212	256	65	191	13	1	270
31736	20328s (+0.5s)	1584	1584	128	38	124	6	0	168
31737	20329s (+0.5s)	1608	1608	128	38	110	10	1	159
31738	20329s (+0.8s)	3240	3240	256	72	188	12	0	272
31739	20329s (+0.1s)	284	284	32	12	35	0	5	52
31740	20330s (+0.7s)	2804	2804	256	56	177	0	9	242
31741	20331s (+0.5s)	1768	1768	128	39	133	0	6	178
31742	20331s (+0.8s)	3260	3260	256	49	214	0	11	274
31743	20332s (+0.3s)	704	704	64	14	72	0	7	93
31744	20332s (+0.3s)	704	704	64	20	71	2	0	93
31745	20332s (+0.3s)	832	832	64	34	70	2	0	106
31746	20333s (+0.8s)	3572	3572	256	76	211	13	0	300
31747	20334s (+0.6s)	2672	2672	256	49	167	12	0	228
31748	20335s (+1.3s)	6272	6272	512	127	299	27	1	454
31749	20336s (+0.9s)	4008	4008	256	103	211	15	0	329
31750	20337s (+0.7s)	2740	2740	256	59	165	9	0	233
31751	20337s (+0.7s)	2620	2620	256	53	166	10	0	229
31752	20338s (+0.4s)	1108	1108	64	30	89	6	1	126
31753	20339s (+1.0s)	4256	4256	256	96	238	20	0	354
31754	20339s (+0.5s)	2304	2304	256	36	148	4	0	188
31755	20340s (+0.6s)	2172	2172	128	51	157	9	0	217
31756	20340s (+0.2s)	684	684	64	25	60	5	0	90
31757	20341s (+0.4s)	1416	1416	128	36	106	2	0	144
31758	20341s (+0.4s)	1112	1112	128	27	91	5	0	123
31759	20342s (+0.6s)	2724	2724	256	64	152	12	0	228
31760	20342s (+0.3s)	748	748	64	30	62	8	0	100
31761	20343s (+1.4s)	6624	6624	512	125	330	27	0	482
31762	20344s (+0.6s)	2496	2496	256	49	157	9	0	215
31763	20345s (+0.9s)	3652	3652	256	92	210	13	0	315
31764	20345s (+0.7s)	2996	2996	256	46	178	16	0	240
31765	20346s (+1.0s)	4040	4040	256	87	224	21	0	332
31766	20347s (+0.9s)	3932	3932	256	86	222	14	0	322
31767	20348s (+0.9s)	3980	3980	256	88	215	19	0	322
31768	20349s (+0.6s)	2168	2168	128	71	139	13	0	223
31769	20349s (+0.4s)	1300	1300	128	32	101	8	0	141
31770	20350s (+0.9s)	4108	4108	256	91	238	15	0	344
31771	20351s (+0.5s)	1780	1780	128	42	130	8	0	180
31772	20352s (+0.7s)	2916	2916	256	62	181	12	0	255
31773	20352s (+0.6s)	2056	2056	128	54	142	9	0	205
31774	20353s (+0.6s)	2436	2436	256	63	142	7	0	212
31775	20353s (+0.8s)	3248	3248	256	66	194	14	1	275
31776	20354s (+0.8s)	3280	3280	256	65	191	11	0	267
31777	20355s (+1.0s)	4160	4160	256	99	217	20	0	336
31778	20356s (+0.6s)	2492	2492	256	51	153	11	0	215
31779	20357s (+0.8s)	3436	3436	256	80	199	11	0	290
31780	20357s (+0.5s)	1872	1872	128	40	143	8	0	191
31781	20358s (+0.5s)	1676	1676	128	45	115	8	2	170
31782	20358s (+0.3s)	868	868	64	19	81	4	0	104
31783	20358s (+0.5s)	1512	1512	128	35	118	8	0	161
31784	20359s (+0.4s)	1172	1172	64	39	91	10	0	140
31785	20360s (+0.7s)	2928	2928	256	65	178	15	1	259
31786	20360s (+0.6s)	2256	2256	128	57	147	10	0	214
31787	20361s (+0.4s)	1476	1476	128	36	114	4	0	154
31788	20361s (+0.4s)	1488	1488	128	51	97	8	0	156
31789	20362s (+0.8s)	3332	3332	256	47	219	0	15	281
31790	20362s (+0.5s)	1804	1804	128	43	139	0	5	187
31791	20363s (+0.8s)	3428	3428	256	62	209	0	16	287
31792	20364s (+0.4s)	1420	1420	128	26	113	0	5	144
31793	20364s (+0.3s)	664	664	64	11	77	0	3	91
31794	20365s (+0.8s)	3400	3400	256	62	210	13	0	285
31795	20365s (+0.5s)	1596	1596	128	36	126	4	0	166
31796	20366s (+0.7s)	3104	3104	256	67	174	16	0	257
31797	20367s (+1.0s)	4228	4228	256	85	249	13	0	347
31798	20367s (+0.4s)	1180	1180	64	33	104	5	0	142
31799	20368s (+0.8s)	3532	3532	256	67	219	11	0	297
Episode	Time	Reward	Score	Highest	L	U	R	D	Steps
31800	20368s (+0.2s)	556	556	64	19	52	4	0	75
31801	20369s (+0.8s)	3424	3424	256	81	192	14	0	287
31802	20370s (+0.6s)	2000	2000	128	51	134	11	0	196
31803	20371s (+1.4s)	7296	7296	512	118	359	25	0	502
31804	20372s (+1.0s)	4264	4264	256	82	256	18	0	356
31805	20373s (+0.9s)	3824	3824	256	74	218	16	0	308
31806	20374s (+0.4s)	1244	1244	128	27	97	8	0	132
31807	20374s (+0.8s)	3272	3272	256	62	201	12	0	275
31808	20375s (+0.7s)	2908	2908	256	58	188	7	0	253
31809	20375s (+0.1s)	160	160	16	2	37	0	2	41
31810	20377s (+1.6s)	8172	8172	512	164	349	38	0	551
31811	20377s (+0.3s)	948	948	64	40	67	6	0	113
31812	20378s (+0.5s)	1756	1756	128	45	127	7	0	179
31813	20379s (+0.8s)	3304	3304	256	81	169	17	0	267
31814	20379s (+0.7s)	3104	3104	256	71	163	14	2	250
31815	20380s (+1.0s)	4160	4160	256	76	250	16	0	342
31816	20381s (+0.6s)	2408	2408	256	40	157	6	0	203
31817	20382s (+1.1s)	5436	5436	512	97	267	15	1	380
31818	20383s (+0.9s)	4076	4076	256	85	239	17	0	341
31819	20384s (+0.7s)	3060	3060	256	65	184	11	0	260
31820	20384s (+0.8s)	3236	3236	256	84	164	18	0	266
31821	20385s (+0.5s)	1612	1612	128	49	111	10	0	170
31822	20386s (+0.6s)	2264	2264	128	61	145	11	0	217
31823	20386s (+0.7s)	2844	2844	256	65	178	6	0	249
31824	20387s (+0.4s)	1124	1124	64	30	95	8	0	133
31825	20388s (+0.8s)	3496	3496	256	71	209	12	0	292
31826	20388s (+0.5s)	1772	1772	128	33	147	3	0	183
31827	20388s (+0.4s)	1492	1492	128	28	117	5	0	150
31828	20389s (+0.3s)	864	864	64	30	74	5	0	109
31829	20390s (+0.7s)	2908	2908	256	77	160	16	0	253
31830	20390s (+0.8s)	3544	3544	256	64	207	14	0	285
31831	20391s (+0.6s)	2460	2460	256	44	159	8	0	211
31832	20392s (+1.1s)	4568	4568	256	112	237	23	0	372
31833	20393s (+0.5s)	1532	1532	128	38	114	9	0	161
31834	20393s (+0.8s)	3532	3532	256	68	217	12	0	297
31835	20394s (+0.5s)	2324	2324	256	43	141	11	0	195
31836	20394s (+0.4s)	1460	1460	128	19	132	0	2	153
31837	20395s (+0.5s)	1652	1652	128	42	114	0	9	165
31838	20395s (+0.4s)	1056	1056	64	27	92	0	9	128
31839	20397s (+1.4s)	6660	6660	512	138	312	25	0	475
31840	20397s (+0.6s)	1912	1912	128	48	140	8	0	196
31841	20398s (+0.5s)	1488	1488	128	32	116	8	0	156
31842	20398s (+0.4s)	1440	1440	128	38	105	7	0	150
31843	20399s (+0.4s)	1480	1480	128	32	112	9	1	154
31844	20399s (+0.7s)	2820	2820	256	65	169	14	0	248
31845	20400s (+0.4s)	1348	1348	128	37	102	7	0	146
31846	20401s (+1.4s)	7196	7196	512	133	339	26	0	498
31847	20402s (+0.9s)	4020	4020	256	85	229	10	0	324
31848	20403s (+0.9s)	3524	3524	256	55	230	13	2	300
31849	20403s (+0.5s)	1728	1728	128	41	125	7	0	173
31850	20404s (+0.6s)	2500	2500	256	55	143	13	1	212
31851	20405s (+0.7s)	3128	3128	256	65	187	10	0	262
31852	20405s (+0.3s)	1156	1156	128	22	89	5	0	116
31853	20405s (+0.4s)	1468	1468	128	31	112	8	0	151
31854	20406s (+0.6s)	1948	1948	128	49	148	8	0	205
31855	20407s (+0.6s)	2440	2440	256	50	147	10	0	207
31856	20407s (+0.5s)	1584	1584	128	38	117	8	0	163
31857	20408s (+0.4s)	1448	1448	128	41	102	8	0	151
31858	20408s (+0.5s)	1748	1748	128	39	132	0	6	177
31859	20409s (+0.5s)	1792	1792	128	34	141	0	8	183
31860	20409s (+0.5s)	1908	1908	128	46	139	0	10	195
31861	20410s (+0.7s)	2856	2856	256	60	182	10	0	252
31862	20411s (+1.0s)	3992	3992	256	88	226	18	0	332
31863	20411s (+0.5s)	1768	1768	128	53	114	10	0	177
31864	20412s (+0.8s)	3240	3240	256	70	190	13	0	273
31865	20413s (+0.5s)	1764	1764	128	48	122	10	0	180
31866	20413s (+0.7s)	3188	3188	256	74	183	8	0	265
31867	20414s (+0.2s)	548	548	32	16	64	2	0	82
31868	20415s (+0.9s)	3988	3988	256	84	232	16	0	332
31869	20415s (+0.4s)	1164	1164	128	28	94	6	0	128
31870	20415s (+0.5s)	1688	1688	128	37	124	12	0	173
31871	20416s (+0.5s)	1652	1652	128	37	122	6	0	165
31872	20417s (+0.7s)	3152	3152	256	69	178	12	1	260
31873	20417s (+0.5s)	1596	1596	128	42	114	5	0	161
31874	20418s (+0.5s)	1944	1944	128	41	143	9	0	193
31875	20419s (+1.0s)	4292	4292	256	94	242	15	0	351
31876	20419s (+0.8s)	3312	3312	256	75	183	20	0	278
31877	20420s (+0.7s)	3024	3024	256	56	188	8	0	252
31878	20421s (+1.0s)	4060	4060	256	98	216	23	0	337
31879	20422s (+0.6s)	2736	2736	256	41	184	8	0	233
31880	20422s (+0.5s)	1652	1652	128	42	117	10	0	169
31881	20423s (+0.3s)	712	712	64	21	67	7	0	95
31882	20423s (+0.8s)	3612	3612	256	74	198	19	0	291
31883	20424s (+0.6s)	2552	2552	256	56	156	7	0	219
31884	20425s (+1.0s)	4076	4076	256	96	220	20	1	337
31885	20425s (+0.3s)	724	724	64	20	71	4	0	95
31886	20426s (+0.5s)	1736	1736	128	40	128	6	1	175
31887	20426s (+0.6s)	2080	2080	128	44	157	10	0	211
31888	20427s (+0.3s)	732	732	64	30	58	11	0	99
31889	20427s (+0.6s)	2232	2232	128	40	155	0	15	210
31890	20428s (+1.0s)	4172	4172	256	74	256	0	15	345
31891	20429s (+0.6s)	2528	2528	256	36	180	0	4	220
31892	20430s (+0.6s)	2552	2552	256	41	173	0	4	218
31893	20430s (+0.6s)	2596	2596	256	60	151	13	0	224
31894	20431s (+0.6s)	2592	2592	256	47	172	0	4	223
31895	20431s (+0.4s)	1404	1404	128	26	118	0	2	146
31896	20432s (+1.0s)	4316	4316	256	105	234	16	0	355
31897	20433s (+0.5s)	2024	2024	128	45	134	10	0	189
31898	20433s (+0.2s)	536	536	32	16	63	3	2	84
31899	20434s (+0.8s)	3224	3224	256	66	188	15	0	269
Episode	Time	Reward	Score	Highest	L	U	R	D	Steps
31900	20435s (+0.8s)	3276	3276	256	70	193	10	0	273
31901	20436s (+1.1s)	4652	4652	256	108	256	24	0	388
31902	20437s (+1.1s)	5476	5476	512	96	267	21	0	384
31903	20437s (+0.5s)	1608	1608	128	36	131	3	0	170
31904	20438s (+0.5s)	1920	1920	128	53	138	7	0	198
31905	20439s (+0.7s)	2768	2768	256	70	156	12	2	240
31906	20439s (+0.5s)	1708	1708	128	38	124	6	0	168
31907	20440s (+0.8s)	3408	3408	256	74	198	12	0	284
31908	20440s (+0.4s)	1400	1400	128	38	99	6	0	143
31909	20441s (+0.8s)	3532	3532	256	78	203	14	0	295
31910	20442s (+0.6s)	2460	2460	128	51	171	9	0	231
31911	20442s (+0.4s)	1420	1420	128	33	103	8	0	144
31912	20443s (+0.8s)	3304	3304	256	55	205	12	0	272
31913	20444s (+1.2s)	6212	6212	512	135	280	24	0	439
31914	20445s (+0.7s)	2968	2968	256	49	195	6	0	250
31915	20445s (+0.5s)	1816	1816	128	51	126	7	0	184
31916	20446s (+0.3s)	916	916	64	33	77	4	0	114
31917	20446s (+0.5s)	1632	1632	128	51	109	11	0	171
31918	20447s (+0.5s)	1712	1712	128	39	122	8	0	169
31919	20448s (+1.1s)	5408	5408	512	94	272	17	0	383
31920	20448s (+0.6s)	2296	2296	256	35	153	6	1	195
31921	20449s (+0.9s)	3796	3796	256	91	210	7	0	308
31922	20450s (+1.0s)	4248	4248	256	104	230	19	0	353
31923	20451s (+0.8s)	3264	3264	256	74	188	12	0	274
31924	20451s (+0.3s)	940	940	64	21	91	3	1	116
31925	20452s (+0.3s)	996	996	128	16	90	2	0	108
31926	20453s (+0.9s)	4740	4740	512	62	255	0	12	329
31927	20453s (+0.8s)	3184	3184	256	54	203	0	14	271
31928	20454s (+0.5s)	1684	1684	128	28	136	0	6	170
31929	20454s (+0.5s)	1752	1752	128	31	135	0	13	179
31930	20455s (+0.4s)	1356	1356	128	28	116	5	0	149
31931	20455s (+0.5s)	1768	1768	128	45	124	9	0	178
31932	20456s (+0.5s)	1860	1860	128	43	135	10	0	188
31933	20456s (+0.6s)	2016	2016	128	45	145	10	0	200
31934	20457s (+0.8s)	3244	3244	256	72	192	10	0	274
31935	20458s (+0.8s)	3152	3152	256	72	186	11	1	270
31936	20459s (+0.5s)	1804	1804	128	60	105	13	1	179
31937	20459s (+0.6s)	2412	2412	256	46	151	9	0	206
31938	20460s (+1.0s)	4060	4060	256	93	220	24	0	337
31939	20461s (+0.8s)	2952	2952	256	59	192	12	1	264
31940	20462s (+0.9s)	3624	3624	256	76	220	12	1	309
31941	20462s (+0.6s)	2688	2688	256	51	168	10	2	231
31942	20464s (+1.4s)	6580	6580	512	144	302	29	0	475
31943	20464s (+0.4s)	1344	1344	128	43	100	4	0	147
31944	20465s (+0.8s)	3208	3208	256	67	181	15	1	264
31945	20466s (+1.0s)	5060	5060	512	93	246	19	2	360
31946	20467s (+0.7s)	3176	3176	256	77	171	14	0	262
31947	20467s (+0.3s)	748	748	64	18	78	4	0	100
31948	20467s (+0.3s)	916	916	64	29	75	6	0	110
31949	20468s (+0.3s)	892	892	64	17	86	0	6	109
31950	20468s (+0.3s)	756	756	64	26	70	5	0	101
31951	20468s (+0.4s)	1152	1152	64	36	99	4	0	139
31952	20469s (+0.5s)	1616	1616	128	42	120	10	0	172
31953	20469s (+0.5s)	1812	1812	128	45	136	0	7	188
31954	20470s (+0.5s)	1672	1672	128	34	128	0	7	169
31955	20471s (+0.7s)	2836	2836	256	47	185	0	8	240
31956	20471s (+0.9s)	3876	3876	256	71	230	0	13	314
31957	20472s (+0.4s)	1300	1300	128	28	101	0	2	131
31958	20472s (+0.3s)	884	884	64	24	85	0	4	113
31959	20473s (+0.4s)	1368	1368	128	23	113	4	0	140
31960	20473s (+0.6s)	2024	2024	128	47	143	12	0	202
31961	20474s (+0.4s)	1112	1112	64	42	86	8	0	136
31962	20474s (+0.6s)	1912	1912	128	51	133	12	0	196
31963	20475s (+0.9s)	3944	3944	256	54	256	0	12	322
31964	20476s (+0.5s)	1728	1728	128	36	134	0	7	177
31965	20476s (+0.4s)	1396	1396	128	25	109	0	9	143
31966	20476s (+0.5s)	1764	1764	128	37	136	8	0	181
31967	20477s (+0.7s)	2948	2948	256	64	190	9	0	263
31968	20478s (+0.7s)	3024	3024	256	69	170	17	0	256
31969	20479s (+1.4s)	6780	6780	512	143	323	23	0	489
31970	20480s (+0.6s)	2112	2112	128	60	143	11	0	214
31971	20481s (+0.5s)	1684	1684	128	44	121	7	0	172
31972	20481s (+0.9s)	3740	3740	256	85	201	20	0	306
31973	20482s (+0.8s)	3488	3488	256	71	200	19	0	290
31974	20482s (+0.3s)	752	752	64	20	77	3	0	100
31975	20483s (+0.4s)	1208	1208	64	48	81	9	0	138
31976	20483s (+0.4s)	1360	1360	128	34	102	5	0	141
31977	20484s (+1.1s)	4680	4680	256	114	251	25	0	390
31978	20485s (+0.3s)	616	616	64	16	66	0	3	85
31979	20485s (+0.4s)	1480	1480	128	30	119	0	5	154
31980	20486s (+0.5s)	1800	1800	128	39	132	0	14	185
31981	20486s (+0.5s)	2216	2216	256	46	132	0	12	190
31982	20487s (+0.5s)	1528	1528	128	33	119	0	9	161
31983	20487s (+0.6s)	2020	2020	128	41	153	0	10	204
31984	20488s (+0.7s)	2928	2928	256	55	188	0	15	258
31985	20489s (+0.5s)	2308	2308	256	41	143	0	7	191
31986	20489s (+0.5s)	1756	1756	128	39	133	0	3	175
31987	20490s (+0.7s)	2916	2916	256	69	171	15	0	255
31988	20490s (+0.6s)	2476	2476	256	49	149	13	0	211
31989	20491s (+0.4s)	1052	1052	64	35	96	6	0	137
31990	20492s (+0.8s)	3372	3372	256	63	207	9	0	279
31991	20492s (+0.7s)	3240	3240	256	52	199	11	0	262
31992	20493s (+0.4s)	1600	1600	128	37	120	4	0	161
31993	20493s (+0.6s)	2012	2012	128	51	133	9	1	194
31994	20494s (+0.9s)	3684	3684	256	59	234	11	0	304
31995	20495s (+0.4s)	1168	1168	128	26	98	4	0	128
31996	20495s (+0.7s)	2852	2852	256	59	183	10	0	252
31997	20496s (+0.4s)	1492	1492	128	36	114	6	0	156
31998	20496s (+0.6s)	1920	1920	128	45	147	6	0	198
31999	20497s (+0.3s)	956	956	64	29	83	7	0	119
Episode	Time	Reward	Score	Highest	L	U	R	D	Steps
32000	20497s (+0.8s)	3176	3176	256	60	198	10	1	269
32001	20498s (+0.8s)	3232	3232	256	60	202	10	0	272
32002	20499s (+0.7s)	2836	2836	256	67	168	10	0	245
32003	20500s (+0.6s)	2616	2616	256	66	150	7	0	223
32004	20500s (+0.6s)	2224	2224	128	58	141	12	1	212
32005	20501s (+1.3s)	6668	6668	512	136	293	28	1	458
32006	20502s (+0.5s)	1616	1616	128	38	127	6	0	171
32007	20502s (+0.4s)	1372	1372	128	39	97	7	1	144
32008	20503s (+0.6s)	2236	2236	128	51	146	10	0	207
32009	20504s (+0.7s)	2844	2844	256	54	178	14	0	246
32010	20505s (+0.9s)	3704	3704	256	85	212	16	0	313
32011	20505s (+0.3s)	980	980	128	18	86	0	0	104
32012	20505s (+0.3s)	808	808	64	28	70	4	1	103
32013	20506s (+0.7s)	2892	2892	256	37	205	0	8	250
32014	20506s (+0.5s)	2208	2208	256	30	155	0	7	192
32015	20507s (+0.9s)	3668	3668	256	77	217	13	0	307
32016	20508s (+0.9s)	3904	3904	256	85	220	17	0	322
32017	20509s (+0.8s)	3484	3484	256	76	199	14	1	290
32018	20510s (+0.5s)	1640	1640	128	38	122	6	1	167
32019	20510s (+0.5s)	1876	1876	128	46	137	9	0	192
32020	20511s (+0.7s)	2900	2900	256	60	182	8	0	250
32021	20512s (+0.9s)	3624	3624	256	88	202	19	0	309
32022	20512s (+0.6s)	1900	1900	128	55	133	6	0	194
32023	20513s (+0.5s)	1688	1688	128	40	129	4	0	173
32024	20513s (+0.5s)	1664	1664	128	34	125	9	0	168
32025	20514s (+0.5s)	1740	1740	128	32	138	6	0	176
32026	20514s (+0.8s)	3432	3432	256	61	217	0	11	289
32027	20515s (+0.3s)	660	660	64	12	75	0	5	92
32028	20516s (+0.8s)	3448	3448	256	53	228	0	9	290
32029	20516s (+0.5s)	1812	1812	128	39	125	0	10	174
32030	20516s (+0.3s)	1012	1012	128	25	78	0	4	107
32031	20517s (+0.4s)	1472	1472	128	32	116	5	0	153
32032	20518s (+0.8s)	3464	3464	256	78	201	13	0	292
32033	20519s (+0.9s)	3732	3732	256	58	237	10	0	305
32034	20519s (+0.6s)	1908	1908	128	49	135	11	0	195
32035	20520s (+0.4s)	1476	1476	128	27	120	6	0	153
32036	20520s (+0.5s)	1528	1528	128	37	117	7	0	161
32037	20521s (+0.8s)	3508	3508	256	66	216	13	1	296
32038	20521s (+0.5s)	1800	1800	128	53	122	13	0	188
32039	20522s (+0.3s)	848	848	64	17	79	5	1	102
32040	20522s (+0.3s)	816	816	64	24	83	4	0	111
32041	20523s (+1.3s)	6848	6848	512	118	323	20	0	461
32042	20524s (+0.6s)	2604	2604	256	43	173	0	10	226
32043	20525s (+0.9s)	3660	3660	256	75	210	0	13	298
32044	20526s (+1.0s)	4096	4096	256	87	235	14	0	336
32045	20527s (+0.7s)	2720	2720	128	89	146	18	1	254
32046	20527s (+0.4s)	1496	1496	128	25	121	11	1	158
32047	20528s (+0.6s)	2588	2588	256	55	152	14	1	222
32048	20528s (+0.7s)	2488	2488	128	63	162	8	0	233
32049	20529s (+0.6s)	2864	2864	256	69	145	14	0	228
32050	20530s (+1.0s)	4268	4268	256	87	247	16	0	350
32051	20530s (+0.3s)	700	700	64	28	60	4	0	92
32052	20531s (+0.6s)	1924	1924	128	59	131	9	0	199
32053	20531s (+0.2s)	536	536	64	17	55	2	0	74
32054	20532s (+0.7s)	2796	2796	256	58	172	0	12	242
32055	20532s (+0.3s)	692	692	64	29	57	0	5	91
32056	20533s (+0.6s)	2552	2552	256	41	173	0	10	224
32057	20533s (+0.4s)	1372	1372	128	44	97	0	3	144
32058	20534s (+0.9s)	3884	3884	256	58	242	0	15	315
32059	20535s (+0.9s)	3924	3924	256	72	242	0	13	327
32060	20535s (+0.2s)	304	304	32	9	43	0	4	56
32061	20536s (+1.0s)	4340	4340	256	109	240	14	0	363
32062	20537s (+1.3s)	6444	6444	512	115	316	26	0	457
32063	20538s (+0.5s)	1840	1840	128	47	130	11	0	188
32064	20538s (+0.3s)	796	796	64	26	75	5	0	106
32065	20539s (+0.6s)	1980	1980	128	55	138	6	0	199
32066	20539s (+0.4s)	1452	1452	128	46	97	8	0	151
32067	20540s (+0.8s)	3360	3360	256	68	202	16	0	286
32068	20541s (+1.0s)	4352	4352	256	101	242	20	0	363
32069	20542s (+0.7s)	2624	2624	256	59	159	13	0	231
32070	20543s (+0.9s)	3560	3560	256	49	247	8	0	304
32071	20543s (+0.7s)	2936	2936	256	41	194	5	0	240
32072	20544s (+0.6s)	2700	2700	256	54	159	11	0	224
32073	20544s (+0.4s)	1468	1468	128	41	105	8	1	155
32074	20545s (+0.5s)	1760	1760	128	39	134	6	0	179
32075	20546s (+0.8s)	3236	3236	256	82	177	13	0	272
32076	20546s (+0.4s)	1324	1324	128	34	103	9	0	146
32077	20546s (+0.3s)	828	828	64	31	68	8	0	107
32078	20547s (+0.4s)	1296	1296	128	40	89	4	0	133
32079	20548s (+0.8s)	3232	3232	256	52	213	6	0	271
32080	20548s (+0.3s)	1132	1132	128	27	87	7	0	121
32081	20548s (+0.5s)	1732	1732	128	35	138	7	0	180
32082	20549s (+0.7s)	3016	3016	256	53	179	15	0	247
32083	20550s (+0.4s)	1544	1544	128	35	111	6	0	152
32084	20550s (+0.7s)	2908	2908	256	59	183	9	2	253
32085	20551s (+0.5s)	1704	1704	128	47	117	9	0	173
32086	20551s (+0.6s)	2384	2384	256	48	144	11	0	203
32087	20552s (+0.6s)	2468	2468	256	55	141	13	0	209
32088	20553s (+0.8s)	3448	3448	256	76	192	13	1	282
32089	20553s (+0.4s)	1484	1484	128	33	118	5	0	156
32090	20554s (+0.5s)	1916	1916	128	52	124	10	1	187
32091	20555s (+0.8s)	3320	3320	256	56	209	0	12	277
32092	20555s (+0.6s)	1904	1904	128	49	134	0	11	194
32093	20556s (+0.5s)	1604	1604	128	29	122	0	8	159
32094	20556s (+0.5s)	1536	1536	64	42	120	0	6	168
32095	20557s (+0.4s)	1300	1300	128	28	103	0	5	136
32096	20557s (+0.5s)	1796	1796	128	33	143	0	8	184
32097	20558s (+0.8s)	3408	3408	256	75	190	18	0	283
32098	20558s (+0.4s)	1484	1484	128	30	114	4	1	149
32099	20559s (+0.8s)	3360	3360	256	62	202	12	0	276
Episode	Time	Reward	Score	Highest	L	U	R	D	Steps
32100	20559s (+0.4s)	1148	1148	128	26	92	6	0	124
32101	20560s (+0.4s)	1324	1324	128	21	111	5	0	137
32102	20561s (+1.1s)	5508	5508	512	104	253	26	1	384
32103	20561s (+0.2s)	444	444	64	19	46	1	0	66
32104	20562s (+1.2s)	5828	5828	512	111	290	18	0	419
32105	20563s (+0.4s)	1280	1280	128	26	102	3	0	131
32106	20563s (+0.3s)	796	796	64	24	72	8	0	104
32107	20564s (+0.8s)	3468	3468	256	81	195	15	0	291
32108	20565s (+0.8s)	3352	3352	256	65	198	11	0	274
32109	20566s (+1.0s)	5012	5012	512	89	243	20	0	352
32110	20567s (+1.0s)	4368	4368	256	98	244	20	0	362
32111	20567s (+0.5s)	1868	1868	128	47	137	6	0	190
32112	20568s (+0.6s)	2172	2172	128	52	143	8	0	203
32113	20568s (+0.4s)	1244	1244	128	34	93	6	0	133
32114	20569s (+0.5s)	1836	1836	128	48	124	10	0	182
32115	20569s (+0.5s)	1760	1760	128	26	145	0	7	178
32116	20570s (+1.2s)	5644	5644	512	72	317	0	15	404
32117	20571s (+0.9s)	3788	3788	256	69	228	0	20	317
32118	20572s (+0.7s)	2716	2716	256	50	176	0	6	232
32119	20573s (+0.6s)	2576	2576	256	41	168	0	11	220
32120	20573s (+0.6s)	1860	1860	128	38	151	0	6	195
32121	20574s (+0.4s)	1528	1528	128	42	111	8	0	161
32122	20574s (+0.5s)	1816	1816	128	44	136	9	0	189
32123	20575s (+0.4s)	1308	1308	128	39	92	8	0	139
32124	20576s (+1.0s)	4052	4052	256	99	226	17	0	342
32125	20577s (+1.1s)	4516	4516	256	92	262	17	0	371
32126	20578s (+0.9s)	3756	3756	256	91	198	21	0	310
32127	20578s (+0.8s)	3352	3352	256	60	200	0	18	278
32128	20579s (+0.9s)	3988	3988	256	78	233	0	20	331
32129	20580s (+0.7s)	2896	2896	256	50	190	0	10	250
32130	20581s (+0.7s)	2732	2732	256	47	173	0	11	231
32131	20581s (+0.4s)	1512	1512	128	47	102	8	0	157
32132	20582s (+0.6s)	2612	2612	256	58	151	8	1	218
32133	20582s (+0.5s)	1924	1924	128	46	136	10	0	192
32134	20583s (+0.7s)	3012	3012	256	57	184	7	0	248
32135	20584s (+0.8s)	3232	3232	256	65	193	13	1	272
32136	20585s (+0.7s)	3100	3100	256	65	178	12	0	255
32137	20585s (+0.7s)	2976	2976	256	61	175	18	1	255
32138	20586s (+0.8s)	3520	3520	256	75	205	14	0	294
32139	20587s (+0.7s)	2480	2480	128	79	139	13	1	232
32140	20587s (+0.4s)	1344	1344	128	36	106	4	0	146
32141	20589s (+1.3s)	6544	6544	512	128	311	27	0	466
32142	20590s (+1.1s)	5388	5388	512	83	275	20	1	379
32143	20590s (+0.4s)	1336	1336	128	32	103	4	0	139
32144	20591s (+0.6s)	2048	2048	128	52	137	15	0	204
32145	20591s (+0.6s)	1916	1916	128	42	141	11	0	194
32146	20592s (+0.4s)	1184	1184	128	31	95	3	0	129
32147	20592s (+0.8s)	3384	3384	256	77	200	10	0	287
32148	20593s (+0.8s)	3256	3256	256	73	192	12	0	277
32149	20593s (+0.3s)	868	868	64	22	87	3	0	112
32150	20594s (+0.8s)	3404	3404	256	84	188	14	0	286
32151	20595s (+1.0s)	4060	4060	256	91	226	20	0	337
32152	20596s (+0.8s)	3236	3236	256	69	199	5	0	273
32153	20596s (+0.2s)	564	564	64	14	62	3	0	79
32154	20597s (+0.6s)	2460	2460	256	46	156	5	0	207
32155	20598s (+0.8s)	3368	3368	256	83	193	12	0	288
32156	20598s (+0.5s)	1608	1608	128	52	109	9	0	170
32157	20599s (+0.7s)	3184	3184	256	67	183	14	0	264
32158	20599s (+0.5s)	1820	1820	128	44	132	13	0	189
32159	20600s (+0.7s)	2880	2880	256	67	166	13	1	247
32160	20601s (+0.7s)	2712	2712	256	52	170	11	0	233
32161	20602s (+1.3s)	6212	6212	512	108	318	18	0	444
32162	20603s (+0.4s)	1364	1364	128	34	98	4	0	136
32163	20603s (+1.0s)	3996	3996	256	81	237	15	0	333
32164	20604s (+0.5s)	1760	1760	128	53	119	6	0	178
32165	20604s (+0.3s)	888	888	64	35	74	8	0	117
32166	20606s (+1.4s)	6852	6852	512	137	332	29	1	499
32167	20606s (+0.5s)	1696	1696	128	34	129	0	12	175
32168	20607s (+0.5s)	1772	1772	128	38	131	0	10	179
32169	20608s (+0.9s)	3584	3584	256	56	227	0	12	295
32170	20608s (+0.5s)	1788	1788	128	47	131	0	4	182
32171	20609s (+0.3s)	1124	1124	128	20	97	0	3	120
32172	20609s (+0.5s)	1780	1780	128	39	128	0	7	174
32173	20610s (+0.7s)	2824	2824	256	53	181	11	0	245
32174	20610s (+0.6s)	2484	2484	256	58	141	13	1	213
32175	20611s (+0.8s)	3448	3448	256	74	196	18	0	288
32176	20612s (+0.7s)	2572	2572	128	71	154	17	0	242
32177	20613s (+1.2s)	6192	6192	512	144	272	23	0	439
32178	20613s (+0.3s)	1044	1044	128	24	83	4	0	111
32179	20615s (+1.2s)	5776	5776	512	130	263	23	0	416
32180	20615s (+0.6s)	2176	2176	128	58	150	10	0	218
32181	20616s (+0.8s)	3492	3492	256	76	201	16	0	293
32182	20617s (+0.7s)	3032	3032	256	46	189	7	0	242
32183	20617s (+0.7s)	3012	3012	256	56	186	7	0	249
32184	20618s (+0.3s)	880	880	64	28	80	4	0	112
32185	20618s (+0.5s)	1668	1668	128	39	126	5	0	170
32186	20619s (+0.9s)	3964	3964	256	75	233	17	0	325
32187	20620s (+0.4s)	1504	1504	128	35	115	6	0	156
32188	20620s (+0.4s)	1476	1476	128	35	117	5	0	157
32189	20621s (+0.9s)	3644	3644	256	89	209	15	0	313
32190	20621s (+0.5s)	1836	1836	128	50	122	11	0	183
32191	20622s (+0.5s)	1608	1608	128	43	119	7	0	169
32192	20623s (+0.9s)	3900	3900	256	80	220	18	1	319
32193	20623s (+0.3s)	1032	1032	64	26	95	2	0	123
32194	20624s (+0.9s)	3672	3672	256	80	215	19	1	315
32195	20625s (+0.7s)	2860	2860	256	74	157	15	0	246
32196	20625s (+0.5s)	1900	1900	128	47	134	12	1	194
32197	20626s (+0.4s)	1288	1288	128	37	93	8	0	138
32198	20626s (+0.4s)	1180	1180	64	30	104	8	0	142
32199	20627s (+1.0s)	4288	4288	256	82	254	14	0	350
Episode	Time	Reward	Score	Highest	L	U	R	D	Steps
32200	20628s (+1.0s)	4076	4076	256	87	242	12	0	341
32201	20629s (+0.7s)	2892	2892	256	51	188	10	0	249
32202	20630s (+0.7s)	2732	2732	256	59	167	10	0	236
32203	20630s (+0.9s)	3804	3804	256	65	230	11	0	306
32204	20631s (+1.0s)	4832	4832	512	90	228	18	0	336
32205	20632s (+0.9s)	3616	3616	256	70	221	15	0	306
32206	20633s (+0.4s)	1496	1496	128	36	111	11	0	158
32207	20633s (+0.5s)	1784	1784	128	34	139	8	0	181
32208	20634s (+0.9s)	4128	4128	256	94	218	22	0	334
32209	20635s (+0.6s)	2568	2568	256	50	163	7	2	222
32210	20635s (+0.4s)	1480	1480	128	22	130	2	1	155
32211	20636s (+0.5s)	1604	1604	128	33	123	3	0	159
32212	20636s (+0.4s)	1264	1264	128	37	96	3	0	136
32213	20637s (+0.7s)	2744	2744	256	59	162	13	0	234
32214	20637s (+0.7s)	2812	2812	256	66	170	10	0	246
32215	20638s (+0.6s)	2400	2400	256	50	151	7	0	208
32216	20639s (+0.4s)	1492	1492	128	37	115	5	0	157
32217	20639s (+0.5s)	1812	1812	128	49	126	13	0	188
32218	20640s (+0.5s)	1796	1796	128	39	138	7	0	184
32219	20640s (+0.6s)	2064	2064	128	61	133	9	0	203
32220	20641s (+1.0s)	4232	4232	256	98	237	13	0	348
32221	20642s (+0.6s)	1916	1916	128	37	155	5	0	197
32222	20642s (+0.5s)	1636	1636	128	33	128	6	0	167
32223	20643s (+0.5s)	1632	1632	128	40	125	5	0	170
32224	20643s (+0.7s)	2780	2780	256	67	154	17	0	238
32225	20644s (+0.4s)	1264	1264	128	42	90	7	0	139
32226	20645s (+0.8s)	3452	3452	256	83	184	20	0	287
32227	20645s (+0.7s)	3052	3052	256	46	192	0	10	248
32228	20646s (+0.3s)	744	744	64	25	68	0	6	99
32229	20646s (+0.7s)	3216	3216	256	59	197	0	15	271
32230	20647s (+1.0s)	4148	4148	256	66	254	0	20	340
32231	20648s (+0.7s)	2928	2928	256	50	182	11	0	243
32232	20649s (+0.7s)	2728	2728	256	50	175	10	0	235
32233	20649s (+0.5s)	1896	1896	128	46	143	4	0	193
32234	20650s (+0.7s)	3168	3168	256	65	180	15	0	260
32235	20651s (+1.1s)	5392	5392	512	93	269	16	1	379
32236	20652s (+0.7s)	2496	2496	128	56	166	13	0	235
32237	20653s (+0.8s)	3484	3484	256	78	199	14	0	291
32238	20653s (+0.5s)	1904	1904	128	48	136	10	0	194
32239	20654s (+0.4s)	1124	1124	64	36	94	5	0	135
32240	20654s (+0.5s)	1920	1920	128	44	147	7	0	198
32241	20655s (+0.8s)	3424	3424	256	67	204	15	0	286
32242	20656s (+0.8s)	3476	3476	256	82	191	15	0	288
32243	20657s (+1.1s)	5384	5384	512	92	266	19	0	377
32244	20657s (+0.4s)	1172	1172	64	29	108	3	0	140
32245	20658s (+0.7s)	2816	2816	256	46	177	8	1	232
32246	20659s (+1.2s)	6160	6160	512	117	295	20	0	432
32247	20660s (+0.9s)	3540	3540	256	76	209	14	0	299
32248	20661s (+0.9s)	3800	3800	256	84	203	19	0	306
32249	20662s (+0.8s)	3492	3492	256	80	202	14	0	296
32250	20663s (+0.9s)	3920	3920	256	92	227	11	0	330
32251	20663s (+0.5s)	1696	1696	64	44	128	8	0	180
32252	20664s (+0.7s)	2840	2840	256	50	180	12	0	242
32253	20664s (+0.4s)	1476	1476	128	39	106	8	0	153
32254	20665s (+0.8s)	3376	3376	256	61	221	8	0	290
32255	20666s (+0.5s)	1540	1540	128	38	119	7	0	164
32256	20666s (+0.3s)	672	672	64	28	61	3	0	92
32257	20667s (+0.5s)	1816	1816	128	51	119	9	1	180
32258	20667s (+0.4s)	1240	1240	64	34	99	9	0	142
32259	20668s (+1.5s)	7640	7640	512	157	350	33	0	540
32260	20669s (+0.8s)	3396	3396	256	76	187	16	0	279
32261	20670s (+0.8s)	3376	3376	256	58	202	14	0	274
32262	20671s (+0.6s)	1992	1992	128	41	154	10	0	205
32263	20671s (+0.5s)	1604	1604	128	35	122	5	0	162
32264	20672s (+0.4s)	996	996	64	38	90	6	0	134
32265	20673s (+1.5s)	7476	7476	512	152	338	33	1	524
32266	20674s (+0.7s)	2592	2592	128	80	145	17	0	242
32267	20674s (+0.8s)	3396	3396	256	70	203	12	0	285
32268	20675s (+0.7s)	2908	2908	256	68	176	9	0	253
32269	20676s (+0.6s)	2072	2072	128	49	150	10	0	209
32270	20677s (+0.9s)	3660	3660	256	80	218	14	0	312
32271	20677s (+0.6s)	2624	2624	256	66	155	5	0	226
32272	20678s (+0.5s)	1864	1864	128	56	121	12	0	189
32273	20679s (+0.6s)	2332	2332	256	39	158	7	0	204
32274	20679s (+0.6s)	2628	2628	256	54	160	9	0	223
32275	20680s (+0.9s)	4012	4012	256	90	224	17	0	331
32276	20681s (+0.8s)	3248	3248	256	71	187	12	0	270
32277	20681s (+0.5s)	1748	1748	128	41	128	8	0	177
32278	20682s (+0.3s)	1112	1112	128	17	96	3	0	116
32279	20682s (+0.7s)	3044	3044	256	51	191	9	0	251
32280	20683s (+0.5s)	1676	1676	128	48	115	7	0	170
32281	20683s (+0.5s)	1984	1984	128	44	136	6	0	186
32282	20684s (+1.0s)	4288	4288	256	100	239	19	0	358
32283	20685s (+0.5s)	1768	1768	128	51	119	7	0	177
32284	20685s (+0.5s)	1544	1544	128	29	130	5	0	164
32285	20686s (+0.4s)	1560	1560	128	34	119	6	0	159
32286	20686s (+0.5s)	1632	1632	128	33	125	7	0	165
32287	20687s (+0.4s)	1452	1452	128	34	111	3	1	149
32288	20687s (+0.4s)	1236	1236	64	37	99	4	0	140
32289	20688s (+0.9s)	3552	3552	256	78	208	14	0	300
32290	20689s (+0.5s)	1604	1604	128	42	116	7	0	165
32291	20689s (+0.4s)	1060	1060	64	25	95	8	0	128
32292	20689s (+0.5s)	1928	1928	128	52	142	6	0	200
32293	20690s (+0.9s)	3696	3696	256	77	221	13	0	311
32294	20691s (+0.8s)	3332	3332	256	61	203	15	0	279
32295	20692s (+0.8s)	3520	3520	256	71	203	9	0	283
32296	20693s (+0.8s)	3332	3332	256	65	200	14	0	279
32297	20693s (+0.3s)	884	884	64	29	79	4	0	112
32298	20694s (+0.7s)	3032	3032	256	64	181	8	0	253
32299	20694s (+0.5s)	1676	1676	128	42	120	8	0	170
Episode	Time	Reward	Score	Highest	L	U	R	D	Steps
32300	20695s (+0.5s)	1596	1596	128	41	113	11	1	166
32301	20695s (+0.6s)	1944	1944	128	42	146	9	0	197
32302	20696s (+0.5s)	1676	1676	128	40	121	11	0	172
32303	20696s (+0.4s)	1436	1436	128	30	111	7	0	148
32304	20697s (+1.0s)	4320	4320	256	100	236	19	0	355
32305	20698s (+0.4s)	1472	1472	128	34	111	6	0	151
32306	20698s (+0.5s)	1652	1652	128	26	135	5	0	166
32307	20699s (+0.8s)	3216	3216	256	59	199	13	0	271
32308	20700s (+0.6s)	2472	2472	256	59	138	13	0	210
32309	20700s (+0.5s)	1728	1728	128	43	124	6	0	173
32310	20700s (+0.4s)	1248	1248	128	30	100	9	0	139
32311	20701s (+0.6s)	1940	1940	128	39	153	0	7	199
32312	20702s (+0.8s)	3208	3208	256	48	206	0	11	265
32313	20702s (+0.6s)	2236	2236	128	56	145	13	0	214
32314	20703s (+0.4s)	1416	1416	128	26	118	4	0	148
32315	20703s (+0.5s)	1760	1760	128	42	125	8	0	175
32316	20704s (+0.4s)	1468	1468	128	37	103	11	0	151
32317	20704s (+0.7s)	2968	2968	256	54	182	0	10	246
32318	20705s (+0.9s)	3932	3932	256	61	243	0	13	317
32319	20706s (+0.4s)	1456	1456	128	34	106	0	8	148
32320	20706s (+0.4s)	1420	1420	128	38	104	3	0	145
32321	20707s (+0.4s)	1304	1304	128	38	98	5	0	141
32322	20707s (+0.7s)	2836	2836	256	67	166	14	0	247
32323	20708s (+0.5s)	1836	1836	128	45	135	9	0	189
32324	20709s (+1.0s)	4244	4244	256	99	233	19	0	351
32325	20710s (+0.9s)	3552	3552	256	86	206	10	0	302
32326	20710s (+0.7s)	3188	3188	256	59	195	11	0	265
32327	20711s (+0.4s)	1516	1516	128	35	117	6	0	158
32328	20712s (+1.3s)	6400	6400	512	132	298	24	0	454
32329	20713s (+0.8s)	3384	3384	256	76	206	10	0	292
32330	20714s (+0.6s)	2260	2260	128	59	139	14	0	212
32331	20714s (+0.5s)	1900	1900	128	46	141	6	0	193
32332	20715s (+0.9s)	4508	4508	512	75	224	14	2	315
32333	20716s (+0.8s)	3404	3404	256	72	200	11	0	283
32334	20717s (+0.8s)	3532	3532	256	71	210	13	0	294
32335	20718s (+0.9s)	4100	4100	256	80	238	14	0	332
32336	20719s (+1.3s)	6824	6824	512	133	315	27	0	475
32337	20720s (+0.7s)	2940	2940	256	58	194	8	1	261
32338	20721s (+0.8s)	3464	3464	256	63	215	11	0	289
32339	20721s (+0.5s)	1656	1656	128	40	119	8	0	167
32340	20722s (+0.6s)	2712	2712	256	49	172	9	0	230
32341	20723s (+0.8s)	3748	3748	256	83	202	18	0	303
32342	20723s (+0.9s)	3608	3608	256	66	224	15	0	305
32343	20724s (+0.4s)	992	992	64	31	85	7	0	123
32344	20724s (+0.5s)	1596	1596	128	46	110	10	0	166
32345	20725s (+0.6s)	1964	1964	128	53	145	7	0	205
32346	20725s (+0.6s)	1876	1876	128	59	123	10	0	192
32347	20726s (+0.7s)	2804	2804	256	53	179	12	0	244
32348	20726s (+0.4s)	1148	1148	64	43	84	7	0	134
32349	20727s (+0.7s)	2788	2788	256	57	170	12	0	239
32350	20727s (+0.2s)	628	628	64	22	54	0	5	81
32351	20728s (+0.5s)	1792	1792	128	40	140	0	3	183
32352	20728s (+0.2s)	512	512	64	11	56	0	2	69
32353	20729s (+0.7s)	2904	2904	256	50	192	0	11	253
32354	20729s (+0.4s)	1612	1612	128	34	118	0	9	161
32355	20730s (+0.6s)	2040	2040	128	35	155	0	12	202
32356	20731s (+0.8s)	3356	3356	256	63	212	0	11	286
32357	20731s (+0.7s)	3076	3076	256	50	193	0	12	255
32358	20732s (+0.8s)	3328	3328	256	57	209	0	18	284
32359	20733s (+0.5s)	1612	1612	128	29	125	0	6	160
32360	20733s (+0.7s)	2876	2876	256	59	182	9	0	250
32361	20734s (+0.8s)	3536	3536	256	68	221	11	0	300
32362	20735s (+0.5s)	1840	1840	128	49	122	12	0	183
32363	20735s (+0.4s)	1416	1416	128	35	105	7	0	147
32364	20736s (+0.8s)	3420	3420	256	77	196	13	0	286
32365	20737s (+0.7s)	3028	3028	256	64	174	10	0	248
32366	20737s (+0.5s)	2272	2272	256	44	134	6	0	184
32367	20738s (+0.7s)	2820	2820	256	55	171	11	0	237
32368	20739s (+0.7s)	2852	2852	256	56	185	10	0	251
32369	20739s (+0.6s)	2500	2500	256	48	160	8	1	217
32370	20740s (+0.8s)	3356	3356	256	68	202	15	0	285
32371	20741s (+0.6s)	2572	2572	256	46	168	5	0	219
32372	20741s (+0.4s)	1448	1448	128	39	106	6	0	151
32373	20741s (+0.3s)	620	620	32	25	64	5	0	94
32374	20742s (+0.8s)	3460	3460	256	78	204	9	0	291
32375	20743s (+0.5s)	1888	1888	128	50	124	16	0	190
32376	20743s (+0.5s)	1616	1616	128	48	120	3	0	171
32377	20744s (+0.7s)	2716	2716	256	55	170	9	0	234
32378	20745s (+0.8s)	3548	3548	256	73	206	11	1	291
32379	20745s (+0.7s)	2940	2940	256	56	179	11	0	246
32380	20746s (+0.6s)	2720	2720	256	50	171	7	0	228
32381	20747s (+0.5s)	1784	1784	128	40	129	12	0	181
32382	20747s (+0.8s)	3368	3368	256	75	184	19	0	278
32383	20748s (+0.4s)	1408	1408	128	36	108	5	0	149
32384	20748s (+0.5s)	1512	1512	128	38	118	6	0	162
32385	20749s (+0.4s)	1136	1136	64	38	86	6	1	131
32386	20750s (+1.0s)	4416	4416	256	95	251	16	0	362
32387	20751s (+0.9s)	3552	3552	256	79	203	17	0	299
32388	20752s (+1.3s)	6144	6144	512	130	285	24	0	439
32389	20752s (+0.5s)	1632	1632	128	38	128	9	0	175
32390	20753s (+0.7s)	3116	3116	256	60	188	11	0	259
32391	20754s (+0.7s)	2736	2736	256	44	184	5	0	233
32392	20754s (+0.6s)	2224	2224	128	51	147	12	1	211
32393	20755s (+0.6s)	2048	2048	128	40	153	10	0	203
32394	20756s (+0.8s)	3692	3692	256	97	183	20	0	300
32395	20757s (+0.7s)	2752	2752	256	53	173	10	0	236
32396	20757s (+0.5s)	1740	1740	128	29	138	0	9	176
32397	20757s (+0.5s)	1608	1608	128	34	127	0	8	169
32398	20758s (+0.7s)	3116	3116	256	60	191	0	9	260
32399	20759s (+0.7s)	2624	2624	256	47	174	0	11	232
Episode	Time	Reward	Score	Highest	L	U	R	D	Steps
32400	20760s (+0.6s)	2452	2452	128	41	181	0	9	231
32401	20760s (+0.6s)	2600	2600	256	45	169	0	5	219
32402	20761s (+1.3s)	6416	6416	512	104	328	0	27	459
32403	20762s (+0.4s)	1292	1292	128	34	92	0	6	132
32404	20762s (+0.5s)	1680	1680	128	30	135	0	7	172
32405	20763s (+0.7s)	2644	2644	256	41	182	0	8	231
32406	20764s (+0.5s)	1796	1796	128	33	145	0	6	184
32407	20764s (+0.6s)	2396	2396	256	42	158	0	7	207
32408	20765s (+1.0s)	4920	4920	512	71	257	0	18	346
32409	20765s (+0.4s)	1184	1184	128	27	95	5	1	128
32410	20766s (+0.4s)	1288	1288	128	34	99	5	1	139
32411	20767s (+0.6s)	2220	2220	128	58	148	13	0	219
32412	20768s (+1.1s)	5612	5612	512	109	270	22	0	401
32413	20769s (+0.9s)	3636	3636	256	74	221	16	0	311
32414	20769s (+0.5s)	1752	1752	128	29	142	7	0	178
32415	20770s (+0.8s)	3108	3108	256	69	193	8	1	271
32416	20771s (+0.7s)	2916	2916	256	47	185	0	8	240
32417	20771s (+0.4s)	1320	1320	128	33	104	0	8	145
32418	20771s (+0.4s)	1464	1464	128	26	118	0	6	150
32419	20772s (+0.4s)	1056	1056	64	27	90	0	8	125
32420	20773s (+0.9s)	3852	3852	256	65	234	0	15	314
32421	20774s (+0.9s)	3552	3552	256	82	204	15	1	302
32422	20774s (+0.5s)	1864	1864	128	38	142	8	1	189
32423	20775s (+0.6s)	2452	2452	256	48	145	10	0	203
32424	20775s (+0.7s)	2508	2508	128	65	159	14	0	238
32425	20776s (+0.9s)	3688	3688	256	88	208	17	0	313
32426	20777s (+0.9s)	3708	3708	256	80	208	15	0	303
32427	20778s (+0.7s)	2712	2712	256	64	153	12	2	231
32428	20779s (+0.9s)	3964	3964	256	84	229	17	0	330
32429	20779s (+0.5s)	1704	1704	128	47	117	9	0	173
32430	20780s (+0.5s)	1716	1716	128	41	121	8	0	170
32431	20780s (+0.6s)	1916	1916	128	47	137	13	0	197
32432	20781s (+0.5s)	2024	2024	256	43	117	8	0	168
32433	20781s (+0.5s)	1696	1696	128	44	123	8	0	175
32434	20782s (+0.6s)	2532	2532	256	39	169	7	0	215
32435	20783s (+0.7s)	2928	2928	256	60	171	13	0	244
32436	20783s (+0.5s)	1904	1904	128	51	133	10	0	194
32437	20784s (+0.5s)	1784	1784	128	28	149	5	0	182
32438	20784s (+0.4s)	1384	1384	128	35	108	3	0	146
32439	20784s (+0.3s)	696	696	64	14	76	7	0	97
32440	20785s (+0.3s)	936	936	64	33	78	7	0	118
32441	20786s (+0.9s)	3880	3880	256	87	210	15	0	312
32442	20786s (+0.6s)	2120	2120	128	46	147	10	0	203
32443	20787s (+0.4s)	1296	1296	128	36	96	8	0	140
32444	20787s (+0.8s)	3820	3820	256	71	222	13	0	306
32445	20788s (+0.5s)	1768	1768	128	41	133	8	0	182
32446	20789s (+0.8s)	3460	3460	256	74	198	16	0	288
32447	20789s (+0.2s)	528	528	32	20	60	3	0	83
32448	20790s (+0.5s)	2116	2116	256	36	139	6	0	181
32449	20790s (+0.3s)	908	908	64	21	82	5	0	108
32450	20790s (+0.2s)	344	344	32	12	46	2	0	60
32451	20791s (+0.5s)	1792	1792	128	43	124	9	0	176
32452	20792s (+1.0s)	4032	4032	256	87	238	12	0	337
32453	20792s (+0.7s)	3048	3048	256	60	179	0	13	252
32454	20793s (+0.8s)	3212	3212	256	53	200	0	13	266
32455	20794s (+0.7s)	2440	2440	128	56	168	0	9	233
32456	20794s (+0.7s)	2908	2908	256	56	183	0	14	253
32457	20795s (+0.4s)	1476	1476	128	33	113	0	7	153
32458	20795s (+0.6s)	1884	1884	128	50	131	13	0	194
32459	20797s (+1.3s)	6576	6576	512	130	320	20	0	470
32460	20797s (+0.7s)	3068	3068	256	51	186	14	0	251
32461	20799s (+1.1s)	4444	4444	256	90	265	14	0	369
32462	20799s (+0.9s)	3644	3644	256	76	212	16	0	304
32463	20800s (+0.6s)	1892	1892	128	49	132	11	0	192
32464	20801s (+1.0s)	4200	4200	256	80	249	14	1	344
32465	20802s (+0.9s)	3836	3836	256	89	209	17	0	315
32466	20803s (+0.8s)	3236	3236	256	85	174	17	0	276
32467	20803s (+0.8s)	3300	3300	256	65	198	13	1	277
32468	20804s (+0.4s)	984	984	64	36	80	9	0	125
32469	20805s (+0.8s)	3480	3480	256	69	210	12	0	291
32470	20805s (+0.6s)	2140	2140	128	53	143	10	0	206
32471	20806s (+0.3s)	968	968	64	26	88	1	0	115
32472	20806s (+0.7s)	3200	3200	256	76	175	12	0	263
32473	20807s (+0.8s)	3304	3304	256	68	191	14	1	274
32474	20808s (+0.7s)	3072	3072	256	78	161	20	0	259
32475	20808s (+0.3s)	796	796	64	25	74	8	0	107
32476	20809s (+0.7s)	2832	2832	256	54	182	14	0	250
32477	20810s (+0.9s)	4024	4024	256	73	241	15	0	329
32478	20811s (+1.0s)	4300	4300	256	96	239	22	0	357
32479	20811s (+0.7s)	2804	2804	256	53	177	13	0	243
32480	20812s (+0.8s)	3436	3436	256	81	193	16	0	290
32481	20813s (+0.7s)	2920	2920	256	58	190	8	0	256
32482	20813s (+0.4s)	1604	1604	128	30	117	8	0	155
32483	20814s (+0.3s)	624	624	64	20	66	3	0	89
32484	20815s (+0.8s)	4556	4556	512	66	223	16	1	306
32485	20815s (+0.3s)	728	728	64	26	68	4	1	99
32486	20815s (+0.3s)	984	984	64	25	87	3	0	115
32487	20816s (+0.8s)	3372	3372	256	68	211	10	0	289
32488	20816s (+0.5s)	1796	1796	128	35	136	7	0	178
32489	20817s (+0.9s)	3828	3828	256	82	210	20	0	312
32490	20818s (+0.5s)	1596	1596	128	37	123	6	0	166
32491	20818s (+0.4s)	1312	1312	128	30	98	5	0	133
32492	20819s (+0.4s)	1048	1048	64	36	83	7	0	126
32493	20819s (+0.4s)	1060	1060	64	30	90	9	0	129
32494	20820s (+0.8s)	3428	3428	256	77	194	16	0	287
32495	20821s (+0.8s)	3728	3728	256	58	224	0	12	294
32496	20821s (+0.6s)	2616	2616	256	50	167	0	12	229
32497	20822s (+0.8s)	3448	3448	256	59	212	0	16	287
32498	20823s (+0.7s)	3008	3008	256	60	174	0	13	247
32499	20823s (+0.5s)	1936	1936	128	55	125	12	0	192
Episode	Time	Reward	Score	Highest	L	U	R	D	Steps
32500	20824s (+0.8s)	3220	3220	256	59	199	11	0	269
32501	20825s (+0.7s)	3176	3176	256	56	191	11	0	258
32502	20825s (+0.7s)	2472	2472	128	60	154	15	0	229
32503	20826s (+0.7s)	2948	2948	256	62	185	11	0	258
32504	20827s (+0.6s)	2028	2028	128	67	130	8	0	205
32505	20828s (+0.8s)	3504	3504	256	80	198	16	0	294
32506	20828s (+0.3s)	684	684	64	17	67	3	1	88
32507	20828s (+0.1s)	236	236	16	12	35	2	0	49
32508	20829s (+0.6s)	2484	2484	256	49	155	10	0	214
32509	20829s (+0.7s)	3176	3176	256	77	177	15	0	269
32510	20830s (+0.6s)	2528	2528	128	59	167	10	0	236
32511	20831s (+0.5s)	1612	1612	128	48	116	6	0	170
32512	20831s (+0.7s)	2916	2916	256	58	188	14	0	260
32513	20832s (+0.5s)	1548	1548	128	30	131	5	0	166
32514	20832s (+0.3s)	1080	1080	128	32	79	3	0	114
32515	20833s (+1.0s)	4244	4244	256	91	242	18	0	351
32516	20834s (+0.8s)	3520	3520	256	87	181	25	1	294
32517	20834s (+0.5s)	2152	2152	256	40	133	6	0	179
32518	20835s (+0.3s)	1068	1068	128	28	86	3	0	117
32519	20836s (+1.0s)	4532	4532	256	100	257	18	0	375
32520	20837s (+0.7s)	2784	2784	256	67	165	8	0	240
32521	20837s (+0.6s)	1912	1912	128	47	145	4	0	196
32522	20838s (+0.4s)	1480	1480	128	44	101	9	0	154
32523	20838s (+0.6s)	2688	2688	256	40	180	7	0	227
32524	20839s (+0.5s)	1768	1768	128	39	129	9	0	177
32525	20839s (+0.4s)	1128	1128	128	31	88	7	0	126
32526	20840s (+0.8s)	3588	3588	256	73	207	17	0	297
32527	20841s (+0.9s)	3732	3732	256	82	219	10	0	311
32528	20842s (+0.6s)	2384	2384	128	53	164	8	0	225
32529	20842s (+0.3s)	676	676	64	20	70	3	0	93
32530	20843s (+0.7s)	2948	2948	256	66	181	11	0	258
32531	20843s (+0.7s)	2984	2984	256	56	175	11	0	242
32532	20844s (+0.5s)	1772	1772	128	37	137	5	0	179
32533	20844s (+0.2s)	636	636	64	19	67	2	0	88
32534	20845s (+0.5s)	1904	1904	128	44	142	8	0	194
32535	20845s (+0.5s)	1524	1524	128	35	116	6	1	158
32536	20845s (+0.5s)	1564	1564	128	50	111	8	0	169
32537	20846s (+0.8s)	3276	3276	256	77	182	18	0	277
32538	20847s (+0.4s)	1524	1524	128	39	104	9	0	152
32539	20847s (+0.4s)	1488	1488	128	28	120	8	0	156
32540	20848s (+0.4s)	1480	1480	128	36	105	6	0	147
32541	20848s (+0.6s)	2736	2736	256	63	156	13	0	232
32542	20849s (+0.4s)	1328	1328	128	34	106	7	0	147
32543	20849s (+0.4s)	1444	1444	128	35	104	10	0	149
32544	20850s (+0.6s)	2468	2468	256	55	145	9	0	209
32545	20850s (+0.7s)	3216	3216	256	53	203	0	11	267
32546	20851s (+0.6s)	2500	2500	256	37	171	0	6	214
32547	20852s (+0.8s)	3480	3480	256	55	229	0	5	289
32548	20852s (+0.6s)	2152	2152	128	44	151	0	11	206
32549	20853s (+0.4s)	1304	1304	128	24	98	0	10	132
32550	20853s (+0.6s)	2436	2436	256	43	153	0	10	206
32551	20854s (+0.5s)	1808	1808	128	43	138	5	0	186
32552	20854s (+0.4s)	1476	1476	128	27	121	5	0	153
32553	20855s (+0.2s)	520	520	64	13	58	4	0	75
32554	20855s (+0.8s)	3484	3484	256	83	193	13	0	289
32555	20856s (+0.9s)	3596	3596	256	75	213	14	0	302
32556	20857s (+0.8s)	3476	3476	256	74	199	15	0	288
32557	20857s (+0.2s)	512	512	64	16	55	2	0	73
32558	20858s (+0.7s)	3008	3008	256	59	181	9	0	249
32559	20859s (+0.7s)	2800	2800	256	70	159	14	0	243
32560	20859s (+0.5s)	1908	1908	128	44	145	7	0	196
32561	20860s (+0.5s)	1624	1624	128	43	119	11	0	173
32562	20860s (+0.4s)	1152	1152	64	35	95	9	1	140
32563	20861s (+0.5s)	1560	1560	128	35	115	10	2	162
32564	20861s (+0.5s)	1808	1808	128	32	142	0	11	185
32565	20862s (+0.9s)	4012	4012	256	65	254	0	15	334
32566	20863s (+0.4s)	1160	1160	64	21	108	0	8	137
32567	20863s (+0.9s)	4120	4120	256	73	245	0	15	333
32568	20864s (+0.5s)	1864	1864	128	49	130	10	0	189
32569	20865s (+0.6s)	2504	2504	256	54	153	11	0	218
32570	20865s (+0.4s)	1164	1164	128	26	93	6	0	125
32571	20865s (+0.3s)	1032	1032	128	25	78	5	0	108
32572	20866s (+0.3s)	884	884	64	30	82	4	0	116
32573	20867s (+0.8s)	3436	3436	256	81	189	16	0	286
32574	20867s (+0.3s)	752	752	64	26	68	4	2	100
32575	20867s (+0.2s)	328	328	32	11	46	3	0	60
32576	20868s (+0.6s)	2504	2504	256	62	145	11	0	218
32577	20868s (+0.7s)	3048	3048	256	65	169	13	0	247
32578	20869s (+0.9s)	3744	3744	256	74	227	10	0	311
32579	20869s (+0.3s)	756	756	64	18	74	4	0	96
32580	20870s (+0.9s)	3548	3548	256	66	221	14	0	301
32581	20871s (+0.6s)	1920	1920	128	47	140	11	0	198
32582	20871s (+0.3s)	864	864	64	22	86	4	1	113
32583	20872s (+0.8s)	3276	3276	256	86	168	16	0	270
32584	20873s (+0.6s)	2536	2536	256	59	140	9	0	208
32585	20873s (+0.7s)	2780	2780	256	55	177	7	0	239
32586	20874s (+0.7s)	2940	2940	256	64	184	12	1	261
32587	20875s (+0.8s)	2892	2892	128	61	196	0	12	269
32588	20876s (+0.8s)	3264	3264	256	60	205	0	10	275
32589	20876s (+0.6s)	2488	2488	256	39	167	0	8	214
32590	20877s (+0.4s)	1232	1232	128	27	99	0	3	129
32591	20877s (+0.7s)	2804	2804	256	55	174	0	15	244
32592	20878s (+0.4s)	1108	1108	64	28	96	0	5	129
32593	20878s (+0.6s)	2648	2648	256	50	167	0	6	223
32594	20879s (+0.2s)	680	680	64	11	76	0	1	88
32595	20879s (+0.6s)	2716	2716	256	59	147	8	1	215
32596	20880s (+0.5s)	1780	1780	128	41	129	10	0	180
32597	20881s (+1.0s)	5272	5272	512	83	257	20	0	360
32598	20881s (+0.5s)	1616	1616	128	35	129	6	1	171
32599	20882s (+0.5s)	1876	1876	128	42	138	12	1	193
Episode	Time	Reward	Score	Highest	L	U	R	D	Steps
32600	20882s (+0.7s)	2644	2644	256	56	168	7	0	231
32601	20883s (+0.5s)	1612	1612	128	37	126	7	0	170
32602	20884s (+0.7s)	2792	2792	256	57	177	7	0	241
32603	20884s (+0.5s)	1812	1812	128	49	133	6	0	188
32604	20885s (+0.5s)	1904	1904	128	44	130	9	0	183
32605	20885s (+0.5s)	2200	2200	256	46	127	12	0	185
32606	20886s (+0.7s)	3064	3064	256	69	180	11	0	260
32607	20886s (+0.4s)	1404	1404	128	37	94	11	0	142
32608	20887s (+0.4s)	1428	1428	128	37	106	9	0	152
32609	20887s (+0.4s)	1404	1404	128	28	111	6	0	145
32610	20888s (+0.6s)	1860	1860	128	58	131	6	0	195
32611	20888s (+0.4s)	1348	1348	128	28	107	7	0	142
32612	20889s (+0.5s)	1596	1596	128	41	119	2	0	162
32613	20889s (+0.8s)	3560	3560	256	73	216	9	0	298
32614	20890s (+0.5s)	1552	1552	128	33	120	0	13	166
32615	20891s (+0.9s)	3960	3960	256	85	230	13	0	328
32616	20891s (+0.5s)	1508	1508	128	35	120	5	0	160
32617	20892s (+0.5s)	1608	1608	128	35	130	4	0	169
32618	20892s (+0.3s)	1044	1044	128	18	88	3	0	109
32619	20892s (+0.3s)	864	864	64	32	76	4	0	112
32620	20893s (+0.8s)	3568	3568	256	60	219	0	12	291
32621	20894s (+0.7s)	2820	2820	256	44	192	0	13	249
32622	20895s (+0.8s)	3416	3416	256	56	223	0	16	295
32623	20895s (+0.5s)	1816	1816	128	38	139	0	7	184
32624	20896s (+0.5s)	1784	1784	128	32	143	0	7	182
32625	20896s (+0.5s)	1880	1880	128	29	158	0	6	193
32626	20897s (+0.6s)	2472	2472	256	33	163	0	11	207
32627	20898s (+0.9s)	3968	3968	256	96	209	21	0	326
32628	20899s (+0.8s)	3412	3412	256	74	196	14	0	284
32629	20900s (+1.0s)	4776	4776	512	81	244	12	0	337
32630	20901s (+0.9s)	4004	4004	256	69	245	14	0	328
32631	20901s (+0.5s)	1792	1792	128	42	137	4	0	183
32632	20902s (+0.7s)	2892	2892	256	58	186	10	0	254
32633	20902s (+0.6s)	2476	2476	256	55	139	18	0	212
32634	20903s (+0.4s)	1296	1296	128	33	95	3	0	131
32635	20903s (+0.2s)	460	460	32	20	56	3	0	79
32636	20904s (+0.4s)	1476	1476	128	28	121	4	0	153
32637	20904s (+0.7s)	3036	3036	256	45	190	0	9	244
32638	20905s (+0.5s)	1772	1772	128	29	143	0	7	179
32639	20906s (+0.7s)	3180	3180	256	42	213	1	8	264
32640	20906s (+0.5s)	1844	1844	128	40	145	0	6	191
32641	20907s (+0.7s)	2956	2956	256	75	155	0	10	240
32642	20907s (+0.5s)	1560	1560	128	24	137	0	7	168
32643	20908s (+0.6s)	2176	2176	128	48	147	0	9	204
32644	20909s (+0.8s)	3652	3652	256	55	234	0	11	300
32645	20909s (+0.5s)	1492	1492	128	54	95	8	0	157
32646	20910s (+0.5s)	1892	1892	128	45	138	8	0	191
32647	20910s (+0.4s)	1296	1296	128	26	108	6	0	140
32648	20911s (+0.7s)	2788	2788	256	65	162	13	0	240
32649	20911s (+0.7s)	2956	2956	256	56	180	14	0	250
32650	20912s (+0.5s)	1564	1564	128	48	107	8	0	163
32651	20912s (+0.4s)	1200	1200	128	31	97	4	0	132
32652	20913s (+0.4s)	1508	1508	128	32	120	1	8	161
32653	20914s (+0.9s)	3716	3716	256	82	211	19	0	312
32654	20914s (+0.5s)	1708	1708	128	47	120	11	0	178
32655	20915s (+0.9s)	3992	3992	256	66	248	11	0	325
32656	20916s (+0.8s)	3360	3360	256	72	199	15	0	286
32657	20916s (+0.3s)	824	824	64	22	82	3	0	107
32658	20917s (+0.9s)	3968	3968	256	88	223	15	0	326
32659	20918s (+0.9s)	3796	3796	256	75	220	11	0	306
32660	20919s (+1.0s)	3992	3992	256	92	226	14	0	332
32661	20920s (+0.8s)	3500	3500	256	68	209	12	0	289
32662	20921s (+0.7s)	3184	3184	256	62	184	19	0	265
32663	20921s (+0.7s)	2824	2824	256	65	176	8	0	249
32664	20922s (+0.4s)	1392	1392	128	27	108	5	0	140
32665	20922s (+0.7s)	2928	2928	256	61	186	11	0	258
32666	20923s (+0.7s)	2640	2640	128	64	172	14	0	250
32667	20924s (+0.5s)	1664	1664	128	45	115	6	0	166
32668	20924s (+0.7s)	3072	3072	256	65	187	11	0	263
32669	20925s (+0.8s)	3536	3536	256	79	203	16	0	298
32670	20926s (+0.8s)	3316	3316	256	84	185	11	0	280
32671	20927s (+0.7s)	3248	3248	256	75	183	16	1	275
32672	20928s (+0.7s)	3192	3192	256	54	198	10	0	262
32673	20928s (+0.3s)	896	896	64	23	78	5	0	106
32674	20929s (+0.9s)	3936	3936	256	103	212	24	0	339
32675	20930s (+0.7s)	2948	2948	256	56	197	10	0	263
32676	20930s (+0.4s)	1544	1544	128	33	117	6	0	156
32677	20930s (+0.4s)	1480	1480	128	32	114	8	0	154
32678	20931s (+0.8s)	3564	3564	256	84	201	20	0	305
32679	20932s (+0.4s)	1472	1472	128	33	112	7	0	152
32680	20933s (+1.0s)	5304	5304	512	96	251	16	0	363
32681	20933s (+0.5s)	1468	1468	128	36	112	8	0	156
32682	20934s (+0.8s)	3256	3256	256	80	182	14	0	276
32683	20935s (+1.0s)	5184	5184	512	93	268	16	1	378
32684	20936s (+1.0s)	4152	4152	256	79	250	12	0	341
32685	20937s (+0.9s)	3604	3604	256	77	208	19	0	304
32686	20938s (+0.7s)	2740	2740	256	57	162	14	0	233
32687	20938s (+0.6s)	2756	2756	256	61	154	7	0	222
32688	20939s (+0.6s)	2192	2192	128	45	147	0	10	202
32689	20939s (+0.6s)	2448	2448	128	56	163	8	1	228
32690	20940s (+0.9s)	3956	3956	256	88	225	15	0	328
32691	20941s (+0.8s)	3292	3292	256	61	202	11	0	274
32692	20942s (+0.7s)	2792	2792	128	75	177	9	0	261
32693	20942s (+0.4s)	1388	1388	128	33	109	5	0	147
32694	20943s (+0.8s)	3496	3496	256	85	190	18	0	293
32695	20944s (+0.4s)	1420	1420	128	40	103	8	0	151
32696	20945s (+0.9s)	4156	4156	256	81	243	17	0	341
32697	20945s (+0.5s)	1644	1644	128	49	105	13	0	167
32698	20946s (+0.5s)	1592	1592	128	45	114	12	0	171
32699	20946s (+0.5s)	1784	1784	128	49	120	12	0	181
Episode	Time	Reward	Score	Highest	L	U	R	D	Steps
32700	20946s (+0.3s)	740	740	64	22	73	3	0	98
32701	20947s (+0.3s)	1076	1076	128	24	86	8	0	118
32702	20947s (+0.4s)	1572	1572	128	28	123	0	4	155
32703	20948s (+0.5s)	1748	1748	128	33	136	0	9	178
32704	20948s (+0.4s)	1172	1172	64	31	104	0	6	141
32705	20949s (+0.7s)	2952	2952	256	43	192	0	10	245
32706	20949s (+0.4s)	1432	1432	128	33	106	0	8	147
32707	20950s (+0.6s)	2476	2476	256	47	158	10	0	215
32708	20951s (+0.7s)	2776	2776	256	53	181	8	0	242
32709	20952s (+1.0s)	5496	5496	512	97	255	29	1	382
32710	20953s (+0.9s)	3892	3892	256	81	217	14	1	313
32711	20953s (+0.7s)	2980	2980	256	65	169	12	0	246
32712	20954s (+0.5s)	1600	1600	128	36	128	3	0	167
32713	20954s (+0.5s)	1496	1496	128	34	117	7	0	158
32714	20955s (+0.7s)	2760	2760	256	72	155	10	1	238
32715	20955s (+0.6s)	1936	1936	128	52	137	13	0	202
32716	20956s (+0.7s)	3112	3112	256	59	187	12	0	258
32717	20957s (+1.2s)	5884	5884	512	112	282	26	1	421
32718	20958s (+0.5s)	1548	1548	128	44	114	7	1	166
32719	20959s (+0.8s)	3292	3292	256	69	196	10	0	275
32720	20959s (+0.7s)	2804	2804	256	54	181	9	0	244
32721	20960s (+0.4s)	1320	1320	128	34	98	5	0	137
32722	20961s (+0.8s)	3492	3492	256	90	187	14	0	291
32723	20961s (+0.6s)	2460	2460	256	57	138	12	0	207
32724	20962s (+0.4s)	1452	1452	128	39	103	6	0	148
32725	20962s (+0.4s)	1492	1492	128	36	116	5	0	157
32726	20963s (+1.1s)	5348	5348	512	84	272	17	0	373
32727	20964s (+0.4s)	1404	1404	128	34	110	7	0	151
32728	20964s (+0.5s)	1680	1680	128	39	122	10	0	171
32729	20965s (+0.6s)	2520	2520	256	52	156	0	10	218
32730	20965s (+0.5s)	1800	1800	128	45	132	0	7	184
32731	20966s (+0.4s)	1520	1520	128	28	120	0	6	154
32732	20966s (+0.8s)	2960	2960	256	50	205	0	10	265
32733	20967s (+0.3s)	1008	1008	64	31	85	0	5	121
32734	20967s (+0.6s)	2724	2724	256	50	175	8	0	233
32735	20968s (+0.5s)	1984	1984	128	53	132	8	0	193
32736	20969s (+0.9s)	3812	3812	256	73	222	13	1	309
32737	20970s (+0.8s)	3432	3432	256	72	199	10	0	281
32738	20970s (+0.7s)	3172	3172	256	67	181	13	0	261
32739	20971s (+0.6s)	2484	2484	256	59	142	12	0	213
32740	20972s (+0.6s)	2560	2560	256	63	139	8	0	210
32741	20973s (+1.3s)	6396	6396	512	111	312	28	0	451
32742	20973s (+0.6s)	2468	2468	256	51	148	11	0	210
32743	20974s (+0.5s)	1660	1660	128	40	120	11	0	171
32744	20975s (+0.7s)	3060	3060	256	64	171	14	1	250
32745	20976s (+1.4s)	7176	7176	512	127	340	27	0	494
32746	20977s (+1.0s)	5108	5108	512	97	251	18	1	367
32747	20978s (+0.9s)	3640	3640	256	68	226	15	0	309
32748	20979s (+1.0s)	4152	4152	256	79	247	14	0	340
32749	20980s (+0.8s)	3288	3288	256	73	181	16	0	270
32750	20981s (+0.8s)	3268	3268	256	70	190	19	0	279
32751	20982s (+1.0s)	4516	4516	256	84	253	18	1	356
32752	20983s (+1.0s)	4300	4300	256	90	256	16	0	362
32753	20984s (+0.9s)	3576	3576	256	62	227	11	0	300
32754	20985s (+1.2s)	5720	5720	512	100	285	18	2	405
32755	20985s (+0.2s)	564	564	32	22	57	5	1	85
32756	20986s (+0.7s)	2996	2996	256	58	174	13	0	245
32757	20986s (+0.6s)	2232	2232	128	60	138	15	0	213
32758	20987s (+0.6s)	2716	2716	256	54	168	10	0	232
32759	20988s (+0.7s)	3120	3120	256	55	190	14	0	259
32760	20988s (+0.5s)	1736	1736	128	48	116	10	0	174
32761	20989s (+1.3s)	6872	6872	512	140	294	26	1	461
32762	20991s (+1.1s)	5244	5244	512	98	273	13	0	384
32763	20991s (+0.5s)	1752	1752	128	52	118	14	0	184
32764	20992s (+0.8s)	3432	3432	256	59	213	9	0	281
32765	20992s (+0.6s)	1940	1940	128	49	145	9	0	203
32766	20993s (+0.4s)	1440	1440	128	37	107	5	0	149
32767	20994s (+0.7s)	2704	2704	256	59	163	13	0	235
32768	20994s (+0.4s)	1332	1332	64	43	101	8	0	152
32769	20994s (+0.4s)	1392	1392	128	39	93	10	0	142
32770	20995s (+0.6s)	2652	2652	256	58	166	9	0	233
32771	20996s (+0.5s)	1540	1540	128	37	123	4	0	164
32772	20996s (+0.9s)	3940	3940	256	98	204	21	1	324
32773	20997s (+0.5s)	1640	1640	128	50	107	8	0	165
32774	20997s (+0.5s)	1636	1636	128	44	113	8	0	165
32775	20998s (+1.0s)	4444	4444	256	98	246	13	1	358
32776	20999s (+0.5s)	1704	1704	128	48	118	7	0	173
32777	21000s (+0.6s)	2652	2652	256	54	159	11	0	224
32778	21000s (+0.5s)	1700	1700	128	37	132	2	0	171
32779	21001s (+0.8s)	3428	3428	256	59	217	11	0	287
32780	21001s (+0.4s)	1328	1328	64	38	104	10	0	152
32781	21002s (+0.6s)	2600	2600	256	46	176	9	1	232
32782	21002s (+0.3s)	840	840	64	30	74	7	0	111
32783	21003s (+0.7s)	2488	2488	128	54	168	10	1	233
32784	21003s (+0.5s)	1748	1748	128	38	130	8	0	176
32785	21004s (+0.8s)	3328	3328	256	68	194	16	0	278
32786	21005s (+0.8s)	3196	3196	256	96	158	12	0	266
32787	21005s (+0.4s)	1436	1436	128	32	115	1	0	148
32788	21006s (+0.5s)	1840	1840	128	52	125	10	0	187
32789	21007s (+0.7s)	2688	2688	256	62	160	10	0	232
32790	21007s (+0.6s)	2404	2404	256	51	153	4	0	208
32791	21008s (+0.3s)	1048	1048	64	26	95	5	0	126
32792	21008s (+0.3s)	920	920	64	24	92	5	0	121
32793	21008s (+0.6s)	2400	2400	256	45	148	11	0	204
32794	21009s (+0.7s)	3132	3132	256	61	187	14	1	263
32795	21010s (+0.6s)	2312	2312	256	48	133	11	0	192
32796	21011s (+0.8s)	3472	3472	256	68	207	12	0	287
32797	21011s (+0.4s)	1124	1124	64	36	92	5	0	133
32798	21011s (+0.5s)	1584	1584	128	37	121	9	0	167
32799	21012s (+0.6s)	2132	2132	128	57	148	10	0	215
Episode	Time	Reward	Score	Highest	L	U	R	D	Steps
32800	21013s (+0.5s)	1640	1640	128	50	113	9	0	172
32801	21013s (+0.9s)	3936	3936	256	96	211	16	0	323
32802	21014s (+0.8s)	3472	3472	256	64	219	11	0	294
32803	21015s (+0.7s)	2892	2892	256	53	187	13	0	253
32804	21016s (+0.9s)	4024	4024	256	88	222	15	0	325
32805	21016s (+0.5s)	1788	1788	128	43	132	6	0	181
32806	21018s (+1.2s)	6228	6228	512	109	318	16	0	443
32807	21018s (+0.4s)	1356	1356	128	36	98	6	0	140
32808	21019s (+0.6s)	1948	1948	128	51	143	11	0	205
32809	21019s (+0.5s)	1752	1752	128	43	129	6	0	178
32810	21020s (+0.5s)	1860	1860	128	40	141	8	0	189
32811	21020s (+0.6s)	2236	2236	128	62	143	9	0	214
32812	21021s (+0.8s)	3436	3436	256	61	214	11	0	286
32813	21022s (+0.6s)	1904	1904	128	53	130	11	0	194
32814	21022s (+0.4s)	1096	1096	64	29	98	6	0	133
32815	21022s (+0.4s)	1320	1320	128	25	105	6	0	136
32816	21023s (+0.9s)	4008	4008	256	91	226	15	0	332
32817	21024s (+0.6s)	1996	1996	128	57	131	14	0	202
32818	21025s (+0.8s)	3472	3472	256	76	203	15	0	294
32819	21026s (+0.7s)	2748	2748	256	61	164	11	0	236
32820	21026s (+0.4s)	1188	1188	64	32	108	4	0	144
32821	21027s (+1.3s)	6476	6476	512	117	318	26	0	461
32822	21028s (+0.4s)	1260	1260	128	30	98	7	0	135
32823	21028s (+0.8s)	3292	3292	256	90	164	20	0	274
32824	21029s (+0.5s)	1792	1792	128	41	127	15	0	183
32825	21030s (+0.9s)	3828	3828	256	82	215	16	0	313
32826	21030s (+0.5s)	1628	1628	128	37	132	4	0	173
32827	21031s (+0.4s)	1496	1496	128	42	111	5	0	158
32828	21031s (+0.5s)	1636	1636	128	46	119	6	0	171
32829	21032s (+0.4s)	1284	1284	128	37	93	7	0	137
32830	21032s (+0.6s)	2392	2392	256	50	141	9	1	201
32831	21033s (+0.6s)	2388	2388	128	58	151	15	0	224
32832	21034s (+1.0s)	5020	5020	512	78	258	0	18	354
32833	21035s (+0.6s)	2428	2428	256	33	159	0	13	205
32834	21035s (+0.5s)	1804	1804	128	38	140	0	8	186
32835	21036s (+0.5s)	1608	1608	128	42	120	0	4	166
32836	21036s (+0.7s)	3012	3012	256	53	193	7	0	253
32837	21037s (+0.9s)	4880	4880	512	99	229	18	0	346
32838	21038s (+0.4s)	1192	1192	128	25	101	5	0	131
32839	21038s (+0.7s)	2788	2788	256	49	185	6	0	240
32840	21039s (+0.8s)	3508	3508	256	61	224	11	0	296
32841	21040s (+0.7s)	2932	2932	256	58	188	13	0	259
32842	21041s (+0.9s)	3880	3880	256	87	221	5	0	313
32843	21041s (+0.6s)	2156	2156	128	44	145	9	2	200
32844	21042s (+0.3s)	932	932	64	22	87	4	0	113
32845	21043s (+0.8s)	3372	3372	256	68	202	9	0	279
32846	21043s (+0.4s)	1112	1112	128	24	98	1	0	123
32847	21044s (+0.9s)	3912	3912	256	80	227	15	0	322
32848	21044s (+0.5s)	1756	1756	128	47	130	5	0	182
32849	21045s (+1.0s)	4308	4308	256	89	254	16	0	359
32850	21046s (+0.5s)	1600	1600	128	30	129	2	0	161
32851	21046s (+0.4s)	1336	1336	128	29	102	5	0	136
32852	21047s (+0.3s)	752	752	64	24	73	4	0	101
32853	21047s (+0.6s)	2180	2180	128	66	126	13	0	205
32854	21048s (+0.5s)	2196	2196	256	40	144	5	0	189
32855	21049s (+0.8s)	3492	3492	256	49	228	0	14	291
32856	21049s (+0.5s)	1796	1796	128	31	143	0	10	184
32857	21050s (+0.7s)	3168	3168	256	52	200	0	9	261
32858	21051s (+1.1s)	4544	4544	256	82	277	0	19	378
32859	21051s (+0.5s)	1756	1756	128	38	131	10	0	179
32860	21052s (+1.0s)	5236	5236	512	105	238	19	0	362
32861	21053s (+0.5s)	1920	1920	128	49	130	9	0	188
32862	21054s (+0.8s)	3480	3480	256	77	198	14	0	289
32863	21055s (+0.9s)	3908	3908	256	88	219	10	0	317
32864	21055s (+0.5s)	1748	1748	128	53	116	8	0	177
32865	21056s (+1.0s)	4872	4872	512	73	256	10	1	340
32866	21057s (+0.8s)	3476	3476	256	72	206	14	0	292
32867	21057s (+0.3s)	644	644	32	32	59	4	0	95
32868	21058s (+0.4s)	1292	1292	128	27	109	4	0	140
32869	21058s (+0.6s)	2812	2812	256	62	164	6	0	232
32870	21059s (+0.8s)	3224	3224	256	57	200	11	0	268
32871	21060s (+0.4s)	1488	1488	128	34	116	6	0	156
32872	21060s (+0.5s)	2084	2084	256	43	129	5	0	177
32873	21061s (+0.6s)	1904	1904	128	48	138	8	0	194
32874	21061s (+0.6s)	2764	2764	256	50	164	10	1	225
32875	21062s (+0.3s)	660	660	64	19	65	6	0	90
32876	21062s (+0.4s)	1564	1564	128	40	111	9	0	160
32877	21063s (+0.5s)	1848	1848	128	47	141	0	4	192
32878	21063s (+0.8s)	3236	3236	256	61	199	0	11	271
32879	21064s (+0.8s)	2836	2836	128	52	204	0	11	267
32880	21065s (+1.1s)	4456	4456	256	78	275	0	15	368
32881	21066s (+0.7s)	2928	2928	256	56	175	0	18	249
32882	21067s (+0.8s)	3360	3360	256	52	222	0	12	286
32883	21067s (+0.5s)	1616	1616	128	26	136	0	5	167
32884	21068s (+0.6s)	1888	1888	128	37	146	0	12	195
32885	21068s (+0.6s)	2592	2592	256	56	149	12	0	217
32886	21069s (+0.9s)	3868	3868	256	74	230	14	0	318
32887	21070s (+0.5s)	1608	1608	128	35	119	5	0	159
32888	21071s (+0.9s)	4104	4104	256	74	244	15	0	333
32889	21071s (+0.6s)	2532	2532	256	57	144	12	1	214
32890	21072s (+0.6s)	2256	2256	128	48	160	7	0	215
32891	21072s (+0.3s)	868	868	64	26	82	4	1	113
32892	21073s (+0.8s)	3620	3620	256	71	201	17	1	290
32893	21074s (+0.8s)	3268	3268	256	58	209	13	0	280
32894	21075s (+0.5s)	1856	1856	128	43	136	9	0	188
32895	21075s (+0.5s)	1792	1792	128	44	127	12	0	183
32896	21076s (+0.8s)	3512	3512	256	76	203	18	0	297
32897	21076s (+0.6s)	2352	2352	256	51	137	8	0	196
32898	21077s (+0.7s)	2944	2944	256	65	174	11	1	251
32899	21078s (+1.0s)	5128	5128	512	90	256	14	0	360
Episode	Time	Reward	Score	Highest	L	U	R	D	Steps
32900	21079s (+0.5s)	1668	1668	128	48	109	12	1	170
32901	21080s (+0.8s)	3416	3416	256	62	219	7	1	289
32902	21080s (+0.3s)	744	744	64	18	76	5	0	99
32903	21080s (+0.4s)	1396	1396	128	29	110	7	0	146
32904	21081s (+1.0s)	4216	4216	256	79	263	14	0	356
32905	21082s (+0.5s)	1756	1756	128	33	129	10	0	172
32906	21082s (+0.4s)	1444	1444	128	40	102	9	0	151
32907	21083s (+0.6s)	2388	2388	128	59	157	9	0	225
32908	21084s (+0.7s)	2892	2892	256	54	177	8	0	239
32909	21084s (+0.5s)	1980	1980	256	37	122	3	0	162
32910	21084s (+0.5s)	1584	1584	128	43	110	10	0	163
32911	21085s (+0.7s)	2876	2876	256	48	181	7	0	236
32912	21087s (+1.4s)	7236	7236	512	146	334	24	0	504
32913	21087s (+0.4s)	1268	1268	64	43	93	5	0	141
32914	21088s (+0.8s)	3416	3416	256	68	194	16	0	278
32915	21088s (+0.3s)	864	864	64	27	83	2	0	112
32916	21089s (+0.8s)	3484	3484	256	64	213	13	0	290
32917	21089s (+0.6s)	2400	2400	256	52	142	10	0	204
32918	21090s (+0.7s)	3036	3036	256	49	188	0	12	249
32919	21091s (+0.4s)	1420	1420	128	32	108	0	5	145
32920	21091s (+0.5s)	1584	1584	128	36	114	0	13	163
32921	21092s (+0.8s)	3252	3252	256	68	194	14	0	276
32922	21092s (+0.4s)	1496	1496	128	35	116	7	0	158
32923	21093s (+0.5s)	1852	1852	128	40	137	9	0	186
32924	21093s (+0.5s)	1528	1528	128	31	124	6	0	161
32925	21094s (+0.8s)	3352	3352	256	68	199	17	0	284
32926	21095s (+0.7s)	3020	3020	256	75	158	17	0	250
32927	21096s (+0.6s)	2276	2276	128	59	156	12	0	227
32928	21096s (+0.5s)	1780	1780	128	33	142	6	0	181
32929	21097s (+0.7s)	3040	3040	256	60	188	8	0	256
32930	21097s (+0.5s)	1792	1792	128	53	125	5	0	183
32931	21098s (+0.8s)	3644	3644	256	70	212	18	0	300
32932	21098s (+0.3s)	808	808	64	24	79	6	0	109
32933	21099s (+0.7s)	2824	2824	128	76	170	15	0	261
32934	21100s (+0.5s)	1828	1828	128	42	136	4	0	182
32935	21100s (+0.7s)	3032	3032	256	60	184	9	0	253
32936	21101s (+0.6s)	2440	2440	256	44	155	8	0	207
32937	21102s (+0.9s)	3864	3864	256	97	214	16	0	327
32938	21103s (+0.9s)	3680	3680	256	80	214	9	0	303
32939	21103s (+0.4s)	1240	1240	128	30	102	5	0	137
32940	21104s (+0.5s)	1536	1536	128	49	109	5	0	163
32941	21104s (+0.5s)	1500	1500	128	35	115	8	1	159
32942	21105s (+0.5s)	1608	1608	128	34	133	3	0	170
32943	21106s (+0.9s)	3656	3656	256	83	207	16	0	306
32944	21106s (+0.6s)	2576	2576	256	54	157	12	0	223
32945	21107s (+0.5s)	1796	1796	128	38	141	5	0	184
32946	21108s (+0.9s)	3596	3596	256	81	207	14	0	302
32947	21108s (+0.5s)	1600	1600	128	43	118	8	0	169
32948	21108s (+0.3s)	768	768	64	33	67	4	0	104
32949	21109s (+0.8s)	3328	3328	256	80	184	16	0	280
32950	21110s (+0.5s)	1904	1904	128	47	139	8	0	194
32951	21111s (+0.9s)	3572	3572	256	71	225	10	1	307
32952	21111s (+0.6s)	2216	2216	128	54	145	1	9	209
32953	21112s (+0.3s)	888	888	64	26	88	3	0	117
32954	21112s (+0.4s)	1232	1232	128	32	98	5	0	135
32955	21113s (+0.7s)	2872	2872	256	57	166	17	0	240
32956	21113s (+0.5s)	1804	1804	128	53	124	7	0	184
32957	21114s (+0.5s)	1728	1728	128	49	121	9	0	179
32958	21114s (+0.5s)	2040	2040	128	50	139	8	0	197
32959	21115s (+0.4s)	1196	1196	128	31	96	0	5	132
32960	21115s (+0.4s)	1340	1340	128	29	105	0	6	140
32961	21116s (+0.5s)	1868	1868	128	46	120	8	2	176
32962	21116s (+0.5s)	1580	1580	128	39	117	7	0	163
32963	21117s (+1.3s)	6608	6608	512	118	341	19	0	478
32964	21118s (+1.0s)	4112	4112	256	72	249	10	0	331
32965	21119s (+0.6s)	2388	2388	256	44	150	7	0	201
32966	21119s (+0.3s)	808	808	64	31	73	5	0	109
32967	21120s (+0.7s)	2656	2656	256	67	157	10	0	234
32968	21120s (+0.5s)	1904	1904	128	44	144	7	0	195
32969	21121s (+0.6s)	2740	2740	256	62	159	10	0	231
32970	21122s (+0.5s)	1852	1852	128	46	133	7	0	186
32971	21122s (+0.5s)	1660	1660	128	32	125	0	10	167
32972	21123s (+0.7s)	2952	2952	256	53	179	0	17	249
32973	21124s (+0.9s)	3528	3528	256	78	209	13	0	300
32974	21124s (+0.5s)	1684	1684	128	44	122	7	0	173
32975	21125s (+0.5s)	1664	1664	128	52	115	8	0	175
32976	21125s (+0.3s)	664	664	64	33	51	4	0	88
32977	21126s (+0.7s)	2792	2792	256	55	172	12	0	239
32978	21126s (+0.5s)	1868	1868	128	56	123	11	0	190
32979	21127s (+0.7s)	3044	3044	256	54	185	8	0	247
32980	21128s (+0.9s)	3916	3916	256	59	246	9	0	314
32981	21128s (+0.5s)	1660	1660	128	40	123	4	0	167
32982	21129s (+0.5s)	1804	1804	128	52	128	6	0	186
32983	21130s (+1.6s)	8028	8028	512	150	388	32	0	570
32984	21131s (+0.4s)	1260	1260	128	25	100	7	0	132
32985	21132s (+0.7s)	2916	2916	256	62	185	8	0	255
32986	21133s (+0.7s)	2756	2756	256	59	165	12	0	236
32987	21133s (+0.4s)	1236	1236	128	31	96	7	2	136
32988	21134s (+0.8s)	3352	3352	256	59	216	0	9	284
32989	21134s (+0.5s)	1608	1608	128	35	124	0	10	169
32990	21135s (+0.6s)	2496	2496	256	45	161	0	9	215
32991	21135s (+0.5s)	1856	1856	128	33	149	0	5	187
32992	21136s (+0.6s)	2616	2616	256	50	167	0	12	229
32993	21136s (+0.4s)	1360	1360	128	27	106	0	7	140
32994	21137s (+0.4s)	1236	1236	64	39	95	7	0	141
32995	21138s (+1.0s)	4368	4368	256	90	254	21	0	365
32996	21139s (+0.7s)	2792	2792	256	70	152	12	0	234
32997	21139s (+0.6s)	2724	2724	256	50	170	9	0	229
32998	21140s (+0.5s)	1696	1696	128	52	114	9	0	175
32999	21140s (+0.4s)	1256	1256	128	29	102	4	0	135
Episode	Time	Reward	Score	Highest	L	U	R	D	Steps
33000	21141s (+0.5s)	1568	1568	128	42	116	6	0	164
33001	21141s (+0.4s)	1164	1164	64	32	100	6	0	138
33002	21141s (+0.4s)	1416	1416	128	41	98	10	1	150
33003	21142s (+0.5s)	1560	1560	128	40	111	7	0	158
33004	21142s (+0.3s)	1080	1080	128	21	92	4	0	117
33005	21143s (+0.5s)	1728	1728	128	39	128	9	1	177
33006	21144s (+1.0s)	4164	4164	256	80	244	13	0	337
33007	21145s (+0.8s)	3236	3236	256	69	185	15	0	269
33008	21145s (+0.9s)	3648	3648	256	79	216	14	0	309
33009	21146s (+0.8s)	3488	3488	256	71	211	13	0	295
33010	21147s (+0.4s)	1384	1384	128	34	106	6	0	146
33011	21147s (+0.8s)	3324	3324	256	74	196	12	0	282
33012	21148s (+0.7s)	2560	2560	128	60	161	18	0	239
33013	21149s (+0.5s)	1788	1788	128	47	128	7	0	182
33014	21150s (+1.0s)	4252	4252	256	87	252	14	0	353
33015	21150s (+0.7s)	2948	2948	256	63	176	13	0	252
33016	21151s (+0.8s)	3380	3380	256	67	210	0	14	291
33017	21152s (+0.5s)	1784	1784	128	39	134	0	9	182
33018	21152s (+0.4s)	1472	1472	128	35	109	0	8	152
33019	21153s (+0.7s)	3136	3136	256	51	201	0	11	263
33020	21153s (+0.2s)	400	400	32	6	53	0	5	64
33021	21154s (+0.5s)	1780	1780	128	30	148	0	6	184
33022	21154s (+0.5s)	1608	1608	128	42	123	4	0	169
33023	21155s (+0.9s)	4056	4056	256	95	210	20	1	326
33024	21156s (+0.5s)	1548	1548	128	44	116	6	0	166
33025	21156s (+0.4s)	1056	1056	64	34	88	6	0	128
33026	21157s (+0.7s)	2660	2660	256	61	157	11	0	229
33027	21157s (+0.7s)	2924	2924	256	68	176	13	0	257
33028	21158s (+0.8s)	3408	3408	256	62	206	15	0	283
33029	21159s (+0.3s)	792	792	64	30	74	2	0	106
33030	21160s (+1.0s)	5252	5252	512	81	260	13	1	355
33031	21160s (+0.4s)	1276	1276	128	35	94	7	0	136
33032	21161s (+0.6s)	2332	2332	128	64	144	14	0	222
33033	21161s (+0.4s)	1500	1500	128	41	105	6	0	152
33034	21161s (+0.3s)	844	844	64	31	71	5	0	107
33035	21162s (+0.5s)	1980	1980	128	52	117	13	1	183
33036	21162s (+0.5s)	1568	1568	128	42	116	6	0	164
33037	21163s (+1.0s)	4328	4328	256	100	236	21	0	357
33038	21165s (+1.2s)	6056	6056	512	118	293	21	0	432
33039	21165s (+0.5s)	1660	1660	128	50	102	11	0	163
33040	21165s (+0.3s)	868	868	64	19	85	3	0	107
33041	21166s (+0.6s)	2312	2312	256	43	147	8	0	198
33042	21167s (+0.6s)	2600	2600	256	59	151	14	0	224
33043	21168s (+0.9s)	3868	3868	256	87	222	16	0	325
33044	21168s (+0.5s)	1668	1668	128	42	114	13	0	169
33045	21169s (+0.7s)	2820	2820	256	55	175	17	1	248
33046	21169s (+0.3s)	1040	1040	128	26	84	3	0	113
33047	21170s (+0.5s)	1680	1680	128	37	126	9	0	172
33048	21170s (+0.9s)	3728	3728	256	94	204	16	0	314
33049	21171s (+0.4s)	1488	1488	128	37	113	6	0	156
33050	21172s (+0.7s)	2988	2988	256	86	148	13	0	247
33051	21173s (+0.9s)	3988	3988	256	82	234	16	0	332
33052	21174s (+1.0s)	4312	4312	256	137	198	25	0	360
33053	21174s (+0.6s)	1976	1976	128	49	151	0	7	207
33054	21175s (+0.8s)	3288	3288	256	51	205	0	18	274
33055	21176s (+0.5s)	1820	1820	128	33	133	0	6	172
33056	21176s (+1.0s)	4004	4004	256	58	260	0	17	335
33057	21177s (+0.5s)	1900	1900	128	38	150	0	7	195
33058	21178s (+0.7s)	2924	2924	256	49	180	14	0	243
33059	21178s (+0.5s)	1780	1780	128	36	140	4	0	180
33060	21179s (+0.5s)	1792	1792	128	43	132	9	0	184
33061	21180s (+1.0s)	4252	4252	256	85	247	21	0	353
33062	21181s (+0.9s)	3956	3956	256	79	232	12	0	323
33063	21181s (+0.6s)	2592	2592	256	53	164	6	0	223
33064	21182s (+0.6s)	2160	2160	128	53	155	7	0	215
33065	21183s (+0.8s)	3340	3340	256	66	195	20	0	281
33066	21184s (+0.7s)	3176	3176	256	63	185	13	1	262
33067	21184s (+0.4s)	1408	1408	128	36	105	6	0	147
33068	21185s (+0.6s)	1996	1996	128	52	141	8	1	202
33069	21185s (+0.8s)	3260	3260	256	70	190	11	0	271
33070	21186s (+0.6s)	2660	2660	256	54	162	10	0	226
33071	21186s (+0.3s)	968	968	64	40	70	7	0	117
33072	21187s (+0.5s)	2280	2280	256	43	133	8	0	184
33073	21187s (+0.3s)	620	620	32	24	65	5	0	94
33074	21188s (+1.0s)	4224	4224	256	97	237	16	0	350
33075	21189s (+0.6s)	2508	2508	256	51	152	15	0	218
33076	21189s (+0.5s)	1608	1608	128	41	118	10	0	169
33077	21190s (+0.5s)	1636	1636	128	46	123	7	0	176
33078	21191s (+0.8s)	3168	3168	256	67	198	10	0	275
33079	21191s (+0.8s)	3520	3520	256	88	195	12	0	295
33080	21192s (+0.6s)	2220	2220	128	66	151	8	0	225
33081	21193s (+0.8s)	3420	3420	256	63	211	12	0	286
33082	21194s (+1.0s)	4328	4328	256	96	248	16	0	360
33083	21194s (+0.3s)	640	640	64	19	63	5	1	88
33084	21195s (+0.5s)	1724	1724	128	40	120	12	0	172
33085	21195s (+0.6s)	2648	2648	256	59	150	13	0	222
33086	21196s (+0.5s)	1784	1784	128	50	123	8	0	181
33087	21196s (+0.6s)	2052	2052	128	51	141	13	0	205
33088	21197s (+0.2s)	592	592	64	14	67	0	1	82
33089	21197s (+0.4s)	1500	1500	128	28	118	0	6	152
33090	21198s (+0.5s)	1548	1548	128	39	122	4	0	165
33091	21199s (+1.0s)	5036	5036	512	92	245	20	1	358
33092	21200s (+1.1s)	5416	5416	512	99	259	22	1	381
33093	21200s (+0.8s)	3376	3376	256	63	203	13	0	279
33094	21201s (+0.8s)	3456	3456	256	73	199	15	0	287
33095	21202s (+0.8s)	3064	3064	256	69	181	15	0	265
33096	21202s (+0.3s)	1180	1180	128	20	95	3	0	118
33097	21203s (+0.6s)	1924	1924	128	55	137	7	0	199
33098	21203s (+0.3s)	1076	1076	128	24	85	4	0	113
33099	21204s (+0.4s)	1308	1308	64	27	113	7	0	147
Episode	Time	Reward	Score	Highest	L	U	R	D	Steps
33100	21204s (+0.5s)	1684	1684	128	40	129	5	0	174
33101	21205s (+0.4s)	980	980	64	28	85	8	0	121
33102	21205s (+0.7s)	2764	2764	256	61	158	15	0	234
33103	21206s (+1.0s)	4192	4192	256	89	238	11	0	338
33104	21207s (+0.7s)	2808	2808	256	59	174	0	12	245
33105	21207s (+0.3s)	948	948	64	23	81	0	7	111
33106	21208s (+0.5s)	1728	1728	128	45	123	7	0	175
33107	21208s (+0.4s)	1360	1360	128	43	100	7	0	150
33108	21209s (+1.1s)	5488	5488	512	99	267	21	0	387
33109	21210s (+0.4s)	1180	1180	64	37	102	3	0	142
33110	21210s (+0.5s)	1604	1604	128	35	128	5	0	168
33111	21211s (+0.7s)	2740	2740	256	54	172	8	0	234
33112	21212s (+1.0s)	4164	4164	256	99	217	21	0	337
33113	21212s (+0.5s)	2368	2368	256	46	139	7	0	192
33114	21213s (+0.5s)	1804	1804	128	40	139	7	0	186
33115	21213s (+0.3s)	852	852	64	23	80	5	0	108
33116	21214s (+0.9s)	3536	3536	256	68	217	0	14	299
33117	21215s (+0.6s)	2460	2460	256	49	152	0	10	211
33118	21216s (+0.7s)	3080	3080	256	54	192	0	9	255
33119	21216s (+0.5s)	1860	1860	128	45	132	0	7	184
33120	21217s (+0.6s)	1940	1940	128	40	151	0	12	203
33121	21217s (+0.6s)	2568	2568	256	42	157	0	15	214
33122	21218s (+0.6s)	2436	2436	256	48	148	0	10	206
33123	21219s (+1.0s)	5348	5348	512	86	265	18	0	369
33124	21220s (+0.6s)	2540	2540	256	49	165	8	0	222
33125	21220s (+0.6s)	2492	2492	256	43	160	11	0	214
33126	21221s (+1.0s)	4332	4332	256	100	243	18	0	361
33127	21222s (+0.5s)	1648	1648	128	38	125	2	0	165
33128	21222s (+0.6s)	2340	2340	256	52	135	10	1	198
33129	21222s (+0.2s)	424	424	64	17	43	2	0	62
33130	21223s (+0.8s)	3472	3472	256	70	207	15	0	292
33131	21224s (+0.4s)	1232	1232	128	42	83	4	0	129
33132	21224s (+0.5s)	1636	1636	128	39	120	9	1	169
33133	21225s (+0.8s)	3248	3248	256	64	199	12	0	275
33134	21225s (+0.5s)	1560	1560	128	35	127	6	0	168
33135	21226s (+0.8s)	3560	3560	256	88	190	20	0	298
33136	21227s (+0.5s)	1492	1492	64	50	99	15	0	164
33137	21228s (+1.3s)	6648	6648	512	120	323	28	1	472
33138	21229s (+1.2s)	5736	5736	512	111	272	26	1	410
33139	21230s (+0.4s)	1432	1432	128	37	105	6	0	148
33140	21230s (+0.5s)	1744	1744	128	51	117	8	0	176
33141	21231s (+0.4s)	1240	1240	64	44	104	4	0	152
33142	21232s (+0.8s)	3368	3368	256	83	183	16	0	282
33143	21232s (+0.6s)	1856	1856	128	37	145	9	0	191
33144	21233s (+0.7s)	2852	2852	256	65	179	7	0	251
33145	21233s (+0.3s)	864	864	64	33	75	4	0	112
33146	21234s (+0.7s)	3168	3168	256	66	180	14	0	260
33147	21234s (+0.5s)	1484	1484	128	32	116	7	0	155
33148	21235s (+0.6s)	2196	2196	128	57	134	13	0	204
33149	21236s (+1.1s)	5200	5200	512	88	274	16	0	378
33150	21237s (+0.5s)	1556	1556	128	39	116	7	0	162
33151	21238s (+1.2s)	5888	5888	512	97	306	20	0	423
33152	21238s (+0.6s)	2564	2564	256	55	156	6	0	217
33153	21239s (+0.8s)	3200	3200	256	71	189	8	0	268
33154	21240s (+0.7s)	2760	2760	256	67	162	9	0	238
33155	21241s (+0.8s)	2968	2968	256	82	170	11	0	263
33156	21241s (+0.5s)	1900	1900	128	48	137	8	0	193
33157	21242s (+0.5s)	1560	1560	128	46	118	4	0	168
33158	21243s (+0.9s)	4004	4004	256	82	222	20	0	324
33159	21243s (+0.5s)	1576	1576	128	46	112	9	0	167
33160	21244s (+0.7s)	3084	3084	256	54	194	8	0	256
33161	21244s (+0.4s)	1188	1188	64	37	100	6	1	144
33162	21245s (+1.1s)	4548	4548	256	106	258	19	0	383
33163	21246s (+0.7s)	2676	2676	256	68	149	12	0	229
33164	21247s (+0.7s)	3180	3180	256	54	198	11	0	263
33165	21247s (+0.5s)	1660	1660	128	43	128	6	0	177
33166	21248s (+0.4s)	1432	1432	128	43	100	4	0	147
33167	21248s (+0.4s)	1580	1580	128	40	111	5	0	156
33168	21249s (+0.9s)	3980	3980	256	88	224	17	0	329
33169	21250s (+0.6s)	2600	2600	256	65	145	11	0	221
33170	21250s (+0.5s)	1824	1824	128	48	134	4	0	186
33171	21251s (+0.5s)	1672	1672	128	29	136	5	0	170
33172	21252s (+0.8s)	3212	3212	256	65	202	15	0	282
33173	21252s (+0.4s)	1332	1332	64	40	102	10	0	152
33174	21252s (+0.4s)	1352	1352	128	40	99	10	0	149
33175	21253s (+0.7s)	3176	3176	256	56	193	13	0	262
33176	21254s (+0.9s)	3872	3872	256	83	212	17	0	312
33177	21255s (+1.2s)	6368	6368	512	122	291	18	1	432
33178	21256s (+0.5s)	1584	1584	128	53	105	5	0	163
33179	21257s (+0.9s)	4016	4016	256	80	232	13	0	325
33180	21257s (+0.8s)	3260	3260	256	73	188	11	0	272
33181	21258s (+0.4s)	1228	1228	128	27	106	5	0	138
33182	21258s (+0.3s)	1024	1024	64	29	84	8	0	121
33183	21259s (+1.0s)	4336	4336	256	68	266	0	21	355
33184	21260s (+0.6s)	1964	1964	128	44	150	0	10	204
33185	21260s (+0.5s)	1716	1716	128	26	143	0	6	175
33186	21261s (+0.7s)	2896	2896	256	67	177	0	7	251
33187	21262s (+0.6s)	2632	2632	256	60	157	0	12	229
33188	21262s (+0.6s)	2524	2524	256	42	171	0	6	219
33189	21263s (+0.5s)	1632	1632	128	38	132	0	4	174
33190	21264s (+0.8s)	3348	3348	256	55	212	0	17	284
33191	21264s (+0.7s)	2424	2424	128	52	168	0	9	229
33192	21265s (+0.7s)	2796	2796	256	42	188	0	9	239
33193	21265s (+0.4s)	1120	1120	128	28	89	0	7	124
33194	21266s (+0.6s)	1852	1852	128	44	139	0	10	193
33195	21267s (+0.6s)	2536	2536	256	47	159	0	8	214
33196	21267s (+0.8s)	3408	3408	256	51	214	0	17	282
33197	21268s (+0.6s)	2432	2432	256	45	152	0	11	208
33198	21269s (+0.7s)	3040	3040	256	51	188	0	10	249
33199	21269s (+0.5s)	1904	1904	128	47	141	0	6	194
Episode	Time	Reward	Score	Highest	L	U	R	D	Steps
33200	21270s (+0.4s)	1336	1336	128	30	113	0	6	149
33201	21270s (+0.3s)	672	672	64	16	69	0	5	90
33202	21270s (+0.3s)	1080	1080	128	23	88	0	3	114
33203	21271s (+0.4s)	1400	1400	128	25	113	0	6	144
33204	21271s (+0.4s)	1440	1440	128	33	107	9	0	149
33205	21272s (+0.7s)	2816	2816	256	64	169	14	0	247
33206	21273s (+0.8s)	3256	3256	256	76	182	15	0	273
33207	21273s (+0.8s)	3316	3316	256	77	189	14	0	280
33208	21274s (+0.7s)	3192	3192	256	78	175	13	0	266
33209	21275s (+0.5s)	1792	1792	128	52	121	10	0	183
33210	21275s (+0.5s)	1612	1612	128	45	113	11	1	170
33211	21276s (+0.7s)	2860	2860	256	67	168	11	0	246
33212	21276s (+0.5s)	1880	1880	128	49	135	9	0	193
33213	21277s (+0.6s)	2668	2668	256	50	161	11	0	222
33214	21278s (+0.8s)	3204	3204	256	71	182	11	0	264
33215	21278s (+0.6s)	2440	2440	256	43	160	4	0	207
33216	21279s (+0.8s)	3380	3380	256	77	187	13	0	277
33217	21280s (+0.9s)	3832	3832	256	75	222	20	0	317
33218	21281s (+0.8s)	3416	3416	256	62	204	13	0	279
33219	21281s (+0.6s)	2028	2028	128	53	136	9	0	198
33220	21282s (+0.9s)	3732	3732	256	76	224	11	0	311
33221	21283s (+0.6s)	2680	2680	256	46	173	10	1	230
33222	21283s (+0.5s)	1584	1584	128	43	121	6	0	170
33223	21284s (+0.6s)	2452	2452	256	56	146	8	0	210
33224	21285s (+0.6s)	2060	2060	128	54	143	9	0	206
33225	21286s (+0.9s)	3844	3844	256	84	217	19	0	320
33226	21287s (+1.0s)	5220	5220	512	84	259	16	0	359
33227	21287s (+0.8s)	3160	3160	256	64	189	11	0	264
33228	21288s (+0.7s)	3108	3108	256	60	180	11	0	251
33229	21289s (+0.7s)	2848	2848	256	64	165	14	0	243
33230	21289s (+0.6s)	2544	2544	256	48	155	10	0	213
33231	21290s (+0.5s)	1744	1744	128	37	131	8	0	176
33232	21291s (+0.9s)	3728	3728	256	85	211	14	0	310
33233	21292s (+1.0s)	4480	4480	256	101	238	27	0	366
33234	21293s (+1.0s)	4208	4208	256	77	250	15	0	342
33235	21294s (+0.8s)	3476	3476	256	76	196	15	1	288
33236	21294s (+0.4s)	1368	1368	128	25	124	4	0	153
33237	21294s (+0.4s)	1448	1448	128	30	110	6	0	146
33238	21295s (+0.5s)	2404	2404	256	43	149	7	0	199
33239	21296s (+0.7s)	3160	3160	256	55	197	7	0	259
33240	21297s (+0.8s)	3340	3340	256	65	206	10	0	281
33241	21297s (+0.3s)	888	888	64	24	77	6	0	107
33242	21297s (+0.6s)	2412	2412	256	54	138	12	0	204
33243	21298s (+0.6s)	2364	2364	256	33	161	6	0	200
33244	21299s (+0.7s)	2488	2488	128	62	160	11	0	233
33245	21299s (+0.5s)	1532	1532	128	38	120	4	0	162
33246	21300s (+0.7s)	2672	2672	256	53	162	12	0	227
33247	21300s (+0.6s)	2400	2400	128	54	151	12	0	217
33248	21301s (+0.3s)	908	908	64	30	81	7	0	118
33249	21301s (+0.5s)	1440	1440	128	35	113	8	0	156
33250	21302s (+0.6s)	2636	2636	256	49	175	5	0	229
33251	21302s (+0.5s)	1852	1852	128	57	128	8	0	193
33252	21303s (+0.3s)	836	836	64	29	79	4	0	112
33253	21303s (+0.6s)	2452	2452	128	71	142	12	0	225
33254	21305s (+1.2s)	5856	5856	512	106	290	23	0	419
33255	21305s (+0.8s)	3248	3248	256	76	182	16	0	274
33256	21306s (+0.5s)	1748	1748	128	46	124	6	1	177
33257	21307s (+0.7s)	3008	3008	256	73	165	17	1	256
33258	21307s (+0.5s)	1852	1852	128	60	121	9	0	190
33259	21308s (+0.3s)	812	812	64	21	84	4	1	110
33260	21308s (+0.4s)	1112	1112	64	33	97	6	0	136
33261	21309s (+0.7s)	3000	3000	256	59	183	10	0	252
33262	21309s (+0.5s)	1604	1604	128	49	112	7	0	168
33263	21310s (+0.7s)	3048	3048	256	71	163	13	0	247
33264	21311s (+0.8s)	3392	3392	256	67	207	10	0	284
33265	21311s (+0.3s)	800	800	64	24	77	7	0	108
33266	21311s (+0.5s)	1680	1680	128	40	125	7	0	172
33267	21312s (+0.8s)	3280	3280	256	67	195	13	0	275
33268	21313s (+0.6s)	2068	2068	128	53	142	10	0	205
33269	21313s (+0.4s)	1320	1320	64	46	98	6	0	150
33270	21314s (+0.4s)	1304	1304	64	35	103	7	0	145
33271	21314s (+0.8s)	3204	3204	256	80	172	14	0	266
33272	21315s (+0.5s)	1820	1820	128	40	141	8	0	189
33273	21315s (+0.4s)	1108	1108	64	28	93	8	0	129
33274	21316s (+1.0s)	4272	4272	256	72	270	0	15	357
33275	21317s (+0.5s)	1928	1928	128	42	133	0	10	185
33276	21318s (+0.7s)	2840	2840	256	39	183	0	9	231
33277	21318s (+0.8s)	3528	3528	256	68	212	0	16	296
33278	21319s (+0.3s)	1128	1128	128	19	98	0	3	120
33279	21319s (+0.7s)	2676	2676	256	52	170	0	7	229
33280	21320s (+0.6s)	1936	1936	128	38	156	0	8	202
33281	21320s (+0.5s)	1520	1520	128	25	124	0	8	157
33282	21321s (+0.8s)	3464	3464	256	58	217	0	17	292
33283	21322s (+0.6s)	2656	2656	256	57	157	0	14	228
33284	21323s (+0.7s)	2976	2976	256	49	182	0	13	244
33285	21323s (+0.8s)	3180	3180	256	70	191	8	0	269
33286	21324s (+0.8s)	3224	3224	256	67	189	14	0	270
33287	21325s (+0.8s)	3548	3548	256	81	206	14	0	301
33288	21326s (+0.9s)	3788	3788	256	93	208	16	0	317
33289	21327s (+0.7s)	2788	2788	256	46	186	7	0	239
33290	21327s (+0.5s)	1856	1856	128	41	143	4	0	188
33291	21328s (+0.5s)	1644	1644	128	40	118	5	0	163
33292	21328s (+0.5s)	2120	2120	256	40	131	11	0	182
33293	21329s (+0.6s)	2304	2304	128	51	153	11	1	216
33294	21329s (+0.7s)	2460	2460	128	60	154	15	1	230
33295	21330s (+0.7s)	3120	3120	256	69	178	12	0	259
33296	21331s (+0.4s)	1108	1108	64	32	97	5	1	135
33297	21331s (+0.9s)	3760	3760	256	91	207	16	0	314
33298	21332s (+0.8s)	3252	3252	256	76	188	12	0	276
33299	21333s (+0.5s)	2220	2220	256	55	125	11	0	191
Episode	Time	Reward	Score	Highest	L	U	R	D	Steps
33300	21334s (+0.8s)	3536	3536	256	68	209	14	0	291
33301	21334s (+0.7s)	2948	2948	256	61	189	13	0	263
33302	21335s (+0.6s)	2520	2520	256	55	142	10	0	207
33303	21335s (+0.5s)	1520	1520	128	29	126	4	0	159
33304	21337s (+1.1s)	5644	5644	512	94	287	14	0	395
33305	21337s (+0.6s)	1868	1868	128	51	129	10	0	190
33306	21338s (+0.5s)	1840	1840	128	45	133	5	0	183
33307	21338s (+0.5s)	1856	1856	128	53	128	6	0	187
33308	21339s (+0.8s)	3484	3484	256	67	211	12	0	290
33309	21340s (+0.6s)	2104	2104	128	45	144	9	0	198
33310	21340s (+0.4s)	1040	1040	64	35	80	8	1	124
33311	21340s (+0.4s)	1472	1472	128	38	108	7	0	153
33312	21341s (+0.6s)	1936	1936	128	44	152	6	0	202
33313	21342s (+0.9s)	3556	3556	256	92	195	16	0	303
33314	21343s (+0.8s)	3248	3248	256	61	202	12	0	275
33315	21343s (+0.9s)	3616	3616	256	78	205	18	2	303
33316	21344s (+0.6s)	2728	2728	256	65	155	9	0	229
33317	21345s (+0.5s)	1916	1916	128	48	141	8	0	197
33318	21345s (+0.5s)	2040	2040	128	49	137	11	0	197
33319	21346s (+0.6s)	2104	2104	128	62	139	12	0	213
33320	21347s (+0.8s)	3368	3368	256	64	200	14	0	278
33321	21347s (+0.6s)	1992	1992	128	52	138	14	0	204
33322	21348s (+1.1s)	4660	4660	256	120	248	23	0	391
33323	21349s (+0.7s)	3092	3092	256	54	186	12	1	253
33324	21350s (+0.8s)	3264	3264	256	69	201	8	0	278
33325	21351s (+0.9s)	3616	3616	256	76	219	12	0	307
33326	21351s (+0.5s)	1788	1788	128	40	136	4	0	180
33327	21352s (+0.8s)	3164	3164	256	71	179	13	0	263
33328	21353s (+0.7s)	2884	2884	256	61	184	7	0	252
33329	21354s (+0.7s)	3156	3156	256	67	178	11	0	256
33330	21354s (+0.9s)	3768	3768	256	77	217	14	0	308
33331	21355s (+0.6s)	2196	2196	128	61	145	14	0	220
33332	21355s (+0.2s)	604	604	64	15	67	3	0	85
33333	21356s (+0.3s)	1028	1028	64	25	94	3	0	122
33334	21356s (+0.6s)	1944	1944	128	51	143	5	0	199
33335	21357s (+0.4s)	1160	1160	64	33	99	5	0	137
33336	21357s (+0.4s)	1360	1360	128	30	108	3	0	141
33337	21357s (+0.4s)	1520	1520	128	33	116	5	0	154
33338	21358s (+0.3s)	792	792	64	24	78	4	0	106
33339	21359s (+1.2s)	5960	5960	512	114	287	23	0	424
33340	21360s (+1.0s)	4968	4968	512	86	246	11	0	343
33341	21361s (+0.5s)	1812	1812	128	41	141	6	0	188
33342	21362s (+1.1s)	4652	4652	256	114	259	16	0	389
33343	21362s (+0.7s)	2880	2880	256	59	178	10	0	247
33344	21363s (+0.5s)	2192	2192	256	48	138	2	0	188
33345	21364s (+0.8s)	3040	3040	256	59	195	10	0	264
33346	21364s (+0.4s)	1244	1244	128	25	105	8	0	138
33347	21365s (+0.9s)	3744	3744	256	90	204	17	0	311
33348	21366s (+0.8s)	3280	3280	256	51	200	16	0	267
33349	21366s (+0.6s)	2348	2348	256	46	148	6	0	200
33350	21367s (+0.8s)	3476	3476	256	88	185	14	1	288
33351	21368s (+0.5s)	1940	1940	128	49	126	14	0	189
33352	21368s (+0.6s)	2100	2100	128	44	143	0	10	197
33353	21369s (+0.5s)	1808	1808	128	36	143	0	8	187
33354	21370s (+0.8s)	3284	3284	256	69	195	13	0	277
33355	21370s (+0.7s)	2792	2792	256	62	165	14	0	241
33356	21371s (+0.3s)	1028	1028	128	21	87	3	1	112
33357	21371s (+0.9s)	4176	4176	256	88	234	16	0	338
33358	21372s (+0.7s)	2808	2808	256	46	188	9	1	244
33359	21372s (+0.2s)	468	468	32	17	53	3	0	73
33360	21373s (+0.3s)	1120	1120	128	27	89	2	0	118
33361	21373s (+0.7s)	2992	2992	256	60	178	8	1	247
33362	21374s (+0.4s)	1328	1328	128	30	102	5	0	137
33363	21374s (+0.4s)	1052	1052	64	33	91	3	0	127
33364	21375s (+0.5s)	1924	1924	128	47	135	7	0	189
33365	21375s (+0.6s)	1916	1916	128	46	144	7	0	197
33366	21377s (+1.1s)	5648	5648	512	117	257	26	0	400
33367	21377s (+0.5s)	1836	1836	128	56	115	11	0	182
33368	21378s (+0.5s)	1520	1520	128	30	124	6	0	160
33369	21378s (+0.3s)	740	740	64	25	69	3	0	97
33370	21378s (+0.5s)	1680	1680	128	39	125	8	0	172
33371	21379s (+0.4s)	1444	1444	128	28	116	0	5	149
33372	21379s (+0.5s)	2228	2228	256	37	138	0	11	186
33373	21380s (+1.0s)	5060	5060	512	79	264	0	14	357
33374	21381s (+0.4s)	1388	1388	128	22	112	0	4	138
33375	21381s (+0.6s)	2464	2464	256	45	159	0	4	208
33376	21382s (+0.8s)	3152	3152	256	57	199	0	11	267
33377	21383s (+0.5s)	1788	1788	128	35	137	0	10	182
33378	21384s (+1.1s)	5620	5620	512	83	295	0	15	393
33379	21385s (+0.8s)	3440	3440	256	67	210	0	13	290
33380	21385s (+0.5s)	1768	1768	128	38	132	0	9	179
33381	21386s (+1.0s)	4400	4400	256	81	252	0	21	354
33382	21387s (+0.9s)	3784	3784	256	60	241	0	11	312
33383	21388s (+0.8s)	3460	3460	256	68	206	15	0	289
33384	21389s (+0.9s)	3912	3912	256	87	216	19	0	322
33385	21389s (+0.6s)	2232	2232	128	48	147	11	0	206
33386	21390s (+0.7s)	3196	3196	256	73	181	8	0	262
33387	21391s (+0.6s)	2580	2580	256	49	165	10	1	225
33388	21391s (+0.4s)	1180	1180	64	35	103	4	0	142
33389	21392s (+0.5s)	1768	1768	128	41	131	10	0	182
33390	21392s (+0.7s)	2844	2844	256	59	170	13	0	242
33391	21393s (+0.5s)	1712	1712	128	40	131	8	0	179
33392	21394s (+0.8s)	3480	3480	256	78	198	13	0	289
33393	21394s (+0.8s)	3168	3168	256	59	197	8	0	264
33394	21395s (+0.6s)	2516	2516	256	54	153	13	0	220
33395	21396s (+0.7s)	3152	3152	256	61	193	7	0	261
33396	21397s (+1.0s)	5120	5120	512	90	259	14	0	363
33397	21397s (+0.4s)	968	968	64	28	88	5	0	121
33398	21398s (+0.6s)	2524	2524	256	54	157	7	0	218
33399	21399s (+0.8s)	3484	3484	256	72	206	12	0	290
Episode	Time	Reward	Score	Highest	L	U	R	D	Steps
33400	21399s (+0.8s)	3288	3288	256	67	196	10	0	273
33401	21400s (+0.8s)	3460	3460	256	66	213	16	0	295
33402	21401s (+0.8s)	3380	3380	256	74	196	10	0	280
33403	21402s (+0.6s)	2672	2672	256	63	157	7	1	228
33404	21402s (+0.4s)	1432	1432	128	40	104	3	0	147
33405	21403s (+1.3s)	6700	6700	512	103	343	21	0	467
33406	21404s (+0.7s)	2964	2964	256	58	183	7	0	248
33407	21405s (+0.6s)	2188	2188	128	59	129	14	0	202
33408	21406s (+0.9s)	3784	3784	256	91	217	19	0	327
33409	21406s (+0.5s)	1812	1812	128	44	134	6	0	184
33410	21407s (+0.7s)	2784	2784	256	57	172	11	0	240
33411	21407s (+0.4s)	1400	1400	128	47	103	6	0	156
33412	21408s (+0.5s)	1896	1896	128	38	147	7	0	192
33413	21409s (+0.9s)	3876	3876	256	89	216	18	0	323
33414	21410s (+0.9s)	4140	4140	256	88	224	19	0	331
33415	21410s (+0.4s)	1408	1408	128	32	113	6	0	151
33416	21411s (+0.5s)	1636	1636	128	44	127	5	0	176
33417	21411s (+0.4s)	1468	1468	128	36	112	3	0	151
33418	21412s (+0.5s)	1676	1676	128	49	115	7	0	171
33419	21412s (+0.3s)	772	772	64	21	82	2	0	105
33420	21412s (+0.4s)	1212	1212	64	38	98	8	0	144
33421	21413s (+0.5s)	1616	1616	128	34	130	7	0	171
33422	21413s (+0.4s)	1344	1344	128	29	117	2	0	148
33423	21414s (+0.5s)	1624	1624	128	50	114	8	0	172
33424	21415s (+0.8s)	3456	3456	256	70	213	12	0	295
33425	21415s (+0.8s)	3540	3540	256	63	221	15	0	299
33426	21416s (+0.5s)	1516	1516	128	43	106	9	0	158
33427	21417s (+1.0s)	4112	4112	256	89	231	15	0	335
33428	21417s (+0.4s)	1540	1540	128	33	114	8	0	155
33429	21418s (+0.6s)	2620	2620	256	52	157	12	0	221
33430	21418s (+0.5s)	1528	1528	128	48	95	11	1	155
33431	21419s (+0.5s)	1860	1860	128	52	121	15	0	188
33432	21419s (+0.5s)	1848	1848	128	50	125	10	1	186
33433	21420s (+0.9s)	3552	3552	256	68	222	12	0	302
33434	21421s (+0.4s)	1204	1204	128	30	98	5	0	133
33435	21421s (+0.2s)	560	560	64	20	57	4	0	81
33436	21421s (+0.4s)	1264	1264	128	33	102	6	1	142
33437	21422s (+0.8s)	3512	3512	256	80	202	14	0	296
33438	21423s (+0.5s)	1528	1528	128	39	118	4	0	161
33439	21423s (+0.3s)	684	684	64	22	64	3	0	89
33440	21424s (+0.8s)	3512	3512	256	69	211	17	0	297
33441	21424s (+0.3s)	1148	1148	128	18	98	4	0	120
33442	21424s (+0.2s)	368	368	32	11	45	0	3	59
33443	21425s (+0.7s)	3256	3256	256	61	191	0	11	263
33444	21425s (+0.4s)	1524	1524	128	26	123	0	7	156
33445	21426s (+0.6s)	2656	2656	256	48	166	0	11	225
33446	21427s (+0.5s)	1612	1612	128	41	115	0	10	166
33447	21427s (+0.7s)	3068	3068	256	61	174	0	15	250
33448	21428s (+0.4s)	1340	1340	128	27	109	0	5	141
33449	21428s (+0.3s)	696	696	64	28	63	0	5	96
33450	21429s (+0.8s)	3360	3360	256	60	206	14	0	280
33451	21430s (+1.1s)	5620	5620	512	107	277	19	0	403
33452	21431s (+1.0s)	4132	4132	256	86	237	11	0	334
33453	21431s (+0.4s)	1384	1384	128	25	120	2	0	147
33454	21432s (+0.8s)	3216	3216	256	62	198	11	1	272
33455	21433s (+0.6s)	2536	2536	256	48	165	7	0	220
33456	21433s (+0.3s)	836	836	64	19	86	1	0	106
33457	21434s (+0.9s)	4036	4036	256	76	236	15	1	328
33458	21435s (+0.7s)	3108	3108	256	58	187	9	0	254
33459	21435s (+0.5s)	1500	1500	128	41	111	5	1	158
33460	21436s (+0.7s)	2876	2876	256	54	190	4	0	248
33461	21436s (+0.5s)	1780	1780	128	43	127	11	0	181
33462	21437s (+0.6s)	2744	2744	256	62	157	15	0	234
33463	21438s (+1.0s)	4268	4268	256	103	232	22	0	357
33464	21439s (+0.6s)	2200	2200	128	47	147	11	1	206
33465	21439s (+0.6s)	2604	2604	256	64	150	9	0	223
33466	21440s (+0.8s)	3412	3412	256	66	207	10	0	283
33467	21441s (+0.6s)	2680	2680	256	49	170	4	0	223
33468	21442s (+0.9s)	4168	4168	256	86	242	15	1	344
33469	21442s (+0.5s)	1740	1740	128	43	119	12	0	174
33470	21443s (+0.7s)	2908	2908	256	62	180	11	0	253
33471	21443s (+0.6s)	1972	1972	128	57	141	8	0	206
33472	21444s (+0.5s)	1660	1660	128	44	119	5	0	168
33473	21445s (+0.8s)	3548	3548	256	76	210	10	0	296
33474	21446s (+0.7s)	2916	2916	256	59	185	11	0	255
33475	21446s (+0.3s)	904	904	64	31	81	3	0	115
33476	21446s (+0.6s)	2520	2520	256	55	152	12	0	219
33477	21448s (+1.1s)	5296	5296	512	90	257	24	0	371
33478	21448s (+0.6s)	2472	2472	256	54	141	7	0	202
33479	21449s (+0.4s)	1472	1472	128	34	111	7	2	154
33480	21449s (+0.7s)	2528	2528	128	61	159	11	0	231
33481	21450s (+0.5s)	1668	1668	128	36	126	8	0	170
33482	21450s (+0.7s)	2904	2904	256	61	184	7	0	252
33483	21451s (+0.8s)	3452	3452	256	68	205	8	2	283
33484	21452s (+0.9s)	3948	3948	256	83	218	20	0	321
33485	21453s (+0.8s)	3196	3196	256	69	184	14	0	267
33486	21454s (+0.8s)	3228	3228	256	63	195	12	0	270
33487	21454s (+0.4s)	1656	1656	128	45	110	5	0	160
33488	21454s (+0.2s)	420	420	32	23	43	4	0	70
33489	21455s (+0.9s)	3732	3732	256	87	213	14	0	314
33490	21456s (+0.5s)	1860	1860	128	52	130	12	0	194
33491	21457s (+0.8s)	3280	3280	256	57	191	19	1	268
33492	21457s (+0.5s)	1592	1592	128	45	112	7	1	165
33493	21458s (+1.3s)	6644	6644	512	112	317	22	0	451
33494	21459s (+0.7s)	2820	2820	256	56	184	7	0	247
33495	21460s (+0.6s)	2708	2708	256	53	163	10	0	226
33496	21461s (+0.8s)	3480	3480	256	83	192	18	1	294
33497	21461s (+0.6s)	1884	1884	128	40	148	6	0	194
33498	21462s (+0.8s)	3504	3504	256	60	224	11	0	295
33499	21462s (+0.4s)	1172	1172	64	37	95	8	0	140
Episode	Time	Reward	Score	Highest	L	U	R	D	Steps
33500	21463s (+0.3s)	788	788	64	21	78	5	1	105
33501	21464s (+0.8s)	3476	3476	256	84	185	19	0	288
33502	21464s (+0.5s)	1640	1640	128	41	131	4	1	177
33503	21465s (+0.5s)	1600	1600	128	38	122	7	0	167
33504	21465s (+0.8s)	3204	3204	256	67	189	14	0	270
33505	21466s (+0.7s)	3140	3140	256	52	194	0	12	258
33506	21467s (+0.6s)	2820	2820	256	52	168	0	13	233
33507	21467s (+0.3s)	956	956	64	26	83	0	5	114
33508	21468s (+0.7s)	3072	3072	256	63	174	0	16	253
33509	21468s (+0.3s)	740	740	64	18	71	0	4	93
33510	21468s (+0.3s)	988	988	64	19	93	0	5	117
33511	21469s (+0.6s)	2564	2564	256	38	174	0	5	217
33512	21469s (+0.5s)	1744	1744	128	36	135	5	0	176
33513	21470s (+1.0s)	4172	4172	256	91	238	16	0	345
33514	21471s (+0.3s)	856	856	64	19	83	5	0	107
33515	21472s (+1.0s)	4272	4272	256	95	237	19	0	351
33516	21472s (+0.4s)	1396	1396	128	42	103	4	0	149
33517	21473s (+1.1s)	5752	5752	512	115	271	19	0	405
33518	21474s (+0.9s)	3684	3684	256	79	220	12	0	311
33519	21475s (+0.4s)	1104	1104	64	38	92	4	0	134
33520	21475s (+0.4s)	1400	1400	64	43	102	8	0	153
33521	21476s (+0.6s)	2444	2444	256	52	145	11	0	208
33522	21476s (+0.7s)	2904	2904	256	75	167	11	0	253
33523	21477s (+0.5s)	1616	1616	128	34	127	10	0	171
33524	21477s (+0.5s)	1656	1656	128	39	120	7	0	166
33525	21478s (+0.4s)	1180	1180	64	31	109	2	0	142
33526	21479s (+0.9s)	4012	4012	256	81	230	13	0	324
33527	21479s (+0.3s)	884	884	64	19	83	4	0	106
33528	21480s (+0.9s)	4156	4156	256	107	214	20	0	341
33529	21481s (+0.6s)	1884	1884	128	40	147	8	0	195
33530	21481s (+0.8s)	3544	3544	256	57	226	0	17	300
33531	21482s (+0.6s)	2380	2380	256	38	157	0	9	204
33532	21482s (+0.2s)	452	452	32	18	51	0	5	74
33533	21483s (+0.7s)	2740	2740	256	36	188	0	10	234
33534	21484s (+0.9s)	4596	4596	512	68	228	1	18	315
33535	21485s (+0.8s)	3280	3280	256	56	214	0	7	277
33536	21485s (+0.8s)	3304	3304	256	52	212	0	12	276
33537	21486s (+0.3s)	692	692	64	12	79	0	1	92
33538	21486s (+0.5s)	1704	1704	128	29	136	0	6	171
33539	21487s (+0.6s)	2508	2508	256	40	167	0	9	216
33540	21487s (+0.4s)	1448	1448	128	33	113	0	7	153
33541	21488s (+0.5s)	1672	1672	128	28	139	0	3	170
33542	21488s (+0.8s)	3508	3508	256	46	236	0	9	291
33543	21489s (+0.4s)	1504	1504	128	32	119	1	8	160
33544	21490s (+0.7s)	2832	2832	256	47	195	0	5	247
33545	21490s (+0.3s)	624	624	32	17	65	0	7	89
33546	21490s (+0.5s)	1800	1800	128	40	136	1	8	185
33547	21491s (+0.9s)	3712	3712	256	81	209	20	0	310
33548	21492s (+0.7s)	2768	2768	256	48	183	8	0	239
33549	21493s (+0.9s)	4016	4016	256	78	250	4	1	333
33550	21494s (+0.9s)	4824	4824	512	89	226	23	0	338
33551	21494s (+0.5s)	2312	2312	256	59	123	9	0	191
33552	21495s (+0.7s)	3076	3076	256	56	186	11	0	253
33553	21496s (+0.7s)	3156	3156	256	67	184	11	0	262
33554	21497s (+0.7s)	2840	2840	256	59	171	15	0	245
33555	21497s (+0.4s)	1552	1552	128	36	122	3	0	161
33556	21497s (+0.4s)	1364	1364	64	37	105	7	1	150
33557	21498s (+0.5s)	1704	1704	128	44	124	5	0	173
33558	21499s (+0.9s)	3580	3580	256	66	234	9	0	309
33559	21499s (+0.3s)	672	672	64	22	65	5	0	92
33560	21500s (+0.4s)	1336	1336	128	31	110	8	0	149
33561	21500s (+0.7s)	3144	3144	256	66	188	12	0	266
33562	21501s (+0.5s)	1656	1656	128	54	107	5	0	166
33563	21501s (+0.6s)	2504	2504	256	47	166	4	0	217
33564	21502s (+0.4s)	1448	1448	128	39	102	10	0	151
33565	21503s (+0.6s)	2628	2628	256	60	148	13	0	221
33566	21503s (+0.9s)	3676	3676	256	74	233	9	0	316
33567	21504s (+0.5s)	1852	1852	128	57	121	13	0	191
33568	21505s (+0.9s)	3996	3996	256	76	239	12	0	327
33569	21505s (+0.5s)	1740	1740	128	38	125	9	0	172
33570	21506s (+0.7s)	2792	2792	256	63	167	11	0	241
33571	21507s (+0.9s)	3976	3976	256	82	224	11	0	317
33572	21508s (+0.7s)	3232	3232	256	61	200	10	0	271
33573	21508s (+0.7s)	3192	3192	256	67	183	15	0	265
33574	21509s (+1.0s)	4368	4368	256	98	250	17	0	365
33575	21510s (+0.4s)	1460	1460	128	37	104	6	1	148
33576	21510s (+0.5s)	1840	1840	128	49	126	12	0	187
33577	21511s (+0.5s)	1724	1724	128	56	114	8	0	178
33578	21511s (+0.4s)	1328	1328	128	26	115	6	0	147
33579	21512s (+0.6s)	1932	1932	128	57	129	12	0	198
33580	21513s (+1.0s)	4308	4308	256	81	251	21	2	355
33581	21514s (+0.6s)	1924	1924	128	38	155	6	0	199
33582	21514s (+0.5s)	1724	1724	128	47	122	9	0	178
33583	21515s (+0.7s)	2444	2444	128	63	161	10	0	234
33584	21515s (+0.7s)	2860	2860	256	78	152	16	0	246
33585	21516s (+0.5s)	1920	1920	128	41	146	11	0	198
33586	21516s (+0.4s)	1372	1372	128	34	101	8	0	143
33587	21517s (+0.3s)	1004	1004	64	29	84	6	0	119
33588	21517s (+0.5s)	1724	1724	128	38	139	5	0	182
33589	21518s (+0.4s)	1432	1432	128	37	104	6	0	147
33590	21518s (+0.5s)	1920	1920	128	41	153	4	0	198
33591	21519s (+0.6s)	2048	2048	128	44	147	12	0	203
33592	21519s (+0.6s)	1880	1880	128	58	122	13	0	193
33593	21520s (+0.4s)	1156	1156	128	20	101	0	6	127
33594	21520s (+0.3s)	760	760	64	16	82	0	4	102
33595	21521s (+0.5s)	1660	1660	128	31	128	0	8	167
33596	21521s (+0.4s)	1108	1108	64	31	89	0	10	130
33597	21521s (+0.4s)	1316	1316	128	21	110	0	5	136
33598	21522s (+0.4s)	1184	1184	128	18	108	0	3	129
33599	21522s (+0.6s)	1956	1956	128	55	141	6	0	202
Episode	Time	Reward	Score	Highest	L	U	R	D	Steps
33600	21523s (+0.8s)	3480	3480	256	71	205	13	0	289
33601	21524s (+0.5s)	1828	1828	128	45	138	8	0	191
33602	21524s (+0.5s)	1552	1552	128	37	118	5	0	160
33603	21524s (+0.2s)	456	456	32	20	52	3	0	75
33604	21525s (+0.4s)	1312	1312	64	36	108	8	0	152
33605	21526s (+0.6s)	2600	2600	256	58	150	9	0	217
33606	21526s (+0.3s)	804	804	64	20	83	6	0	109
33607	21527s (+1.1s)	5724	5724	512	116	261	24	1	402
33608	21528s (+0.6s)	2424	2424	256	60	145	5	0	210
33609	21528s (+0.3s)	1140	1140	128	35	80	4	0	119
33610	21528s (+0.5s)	1628	1628	128	47	115	7	0	169
33611	21529s (+0.6s)	2412	2412	256	41	160	8	1	210
33612	21530s (+0.7s)	3092	3092	256	62	179	12	0	253
33613	21531s (+0.9s)	3600	3600	256	67	218	16	1	302
33614	21531s (+0.8s)	3508	3508	256	85	193	13	0	291
33615	21532s (+0.6s)	2256	2256	256	48	141	9	1	199
33616	21533s (+1.1s)	4568	4568	256	107	239	25	1	372
33617	21534s (+0.8s)	3220	3220	256	68	185	14	1	268
33618	21534s (+0.4s)	1316	1316	128	38	93	9	0	140
33619	21535s (+0.9s)	3580	3580	256	73	217	12	0	302
33620	21536s (+0.9s)	3884	3884	256	83	229	14	0	326
33621	21537s (+0.7s)	2904	2904	256	54	188	0	10	252
33622	21537s (+0.4s)	1192	1192	128	27	93	0	6	126
33623	21538s (+0.4s)	1208	1208	128	29	101	4	0	134
33624	21538s (+0.5s)	1612	1612	128	52	109	9	0	170
33625	21539s (+0.8s)	3308	3308	256	70	194	15	0	279
33626	21539s (+0.5s)	1700	1700	128	43	118	11	0	172
33627	21540s (+0.6s)	1996	1996	128	57	139	9	0	205
33628	21540s (+0.5s)	1748	1748	128	46	120	10	0	176
33629	21541s (+0.5s)	2188	2188	256	39	128	10	1	178
33630	21541s (+0.4s)	1308	1308	128	25	104	0	5	134
33631	21542s (+0.5s)	1752	1752	128	37	137	0	4	178
33632	21542s (+0.7s)	2824	2824	256	40	184	0	10	234
33633	21543s (+0.3s)	1048	1048	128	18	92	0	3	113
33634	21544s (+0.8s)	3220	3220	256	69	186	13	1	269
33635	21545s (+1.0s)	4272	4272	256	90	251	17	0	358
33636	21546s (+1.4s)	7480	7480	512	143	335	32	0	510
33637	21547s (+1.0s)	4204	4204	256	87	235	24	0	346
33638	21548s (+1.1s)	4948	4948	256	115	249	18	2	384
33639	21549s (+0.5s)	1756	1756	128	36	137	6	0	179
33640	21550s (+0.9s)	3804	3804	256	86	221	15	0	322
33641	21551s (+1.1s)	5376	5376	512	97	251	25	0	373
33642	21551s (+0.5s)	1784	1784	128	40	136	5	0	181
33643	21552s (+0.6s)	2304	2304	128	53	154	12	0	219
33644	21553s (+1.0s)	4288	4288	256	98	229	22	1	350
33645	21553s (+0.6s)	2436	2436	128	60	163	12	0	235
33646	21554s (+0.4s)	1288	1288	128	36	100	6	0	142
33647	21554s (+0.5s)	1672	1672	128	43	120	7	0	170
33648	21555s (+0.9s)	3568	3568	256	80	207	13	0	300
33649	21556s (+0.6s)	2444	2444	128	62	152	13	0	227
33650	21556s (+0.4s)	1492	1492	128	42	110	5	0	157
33651	21557s (+0.5s)	1816	1816	128	47	134	8	0	189
33652	21557s (+0.5s)	1668	1668	128	48	125	6	0	179
33653	21558s (+0.7s)	3024	3024	256	58	184	6	0	248
33654	21558s (+0.4s)	1404	1404	128	30	110	7	0	147
33655	21559s (+0.7s)	3200	3200	256	59	198	7	0	264
33656	21560s (+1.1s)	5660	5660	512	83	301	0	14	398
33657	21561s (+0.9s)	3588	3588	256	60	231	0	16	307
33658	21562s (+0.5s)	1816	1816	128	42	135	0	11	188
33659	21563s (+1.3s)	6228	6228	512	79	338	0	26	443
33660	21564s (+0.8s)	3536	3536	256	59	225	0	14	298
33661	21564s (+0.5s)	1740	1740	128	36	130	0	10	176
33662	21565s (+1.0s)	5172	5172	512	78	266	0	13	357
33663	21566s (+0.7s)	2964	2964	256	48	188	0	7	243
33664	21567s (+0.7s)	2784	2784	256	43	185	0	12	240
33665	21567s (+0.2s)	644	644	64	12	70	0	3	85
33666	21567s (+0.3s)	1076	1076	64	25	94	0	7	126
33667	21568s (+0.9s)	3916	3916	256	60	245	0	13	318
33668	21569s (+0.9s)	3716	3716	256	68	216	0	20	304
33669	21570s (+0.5s)	1860	1860	128	41	142	0	6	189
33670	21570s (+0.7s)	2840	2840	256	57	180	0	11	248
33671	21571s (+0.3s)	740	740	64	17	77	4	0	98
33672	21571s (+0.7s)	2832	2832	256	60	170	13	0	243
33673	21572s (+1.0s)	4316	4316	256	100	235	17	0	352
33674	21573s (+0.7s)	3192	3192	256	64	191	7	0	262
33675	21574s (+0.5s)	1844	1844	128	51	127	7	0	185
33676	21574s (+0.5s)	1508	1508	128	43	108	9	0	160
33677	21575s (+0.9s)	4024	4024	256	90	225	18	0	333
33678	21576s (+0.7s)	2792	2792	256	51	181	8	0	240
33679	21576s (+0.5s)	2132	2132	256	34	142	0	9	185
33680	21578s (+1.2s)	5780	5780	512	82	309	0	20	411
33681	21578s (+0.9s)	4016	4016	256	69	248	0	16	333
33682	21579s (+0.9s)	4836	4836	512	73	250	0	13	336
33683	21580s (+0.6s)	2612	2612	256	38	183	0	7	228
33684	21581s (+0.5s)	1728	1728	128	36	124	0	12	172
33685	21581s (+0.4s)	1460	1460	128	36	106	0	8	150
33686	21581s (+0.3s)	848	848	64	25	81	0	2	108
33687	21582s (+0.6s)	2572	2572	256	51	160	0	8	219
33688	21583s (+0.6s)	2208	2208	128	33	166	0	13	212
33689	21583s (+0.7s)	2912	2912	256	48	197	1	9	255
33690	21584s (+0.5s)	1876	1876	128	45	136	0	7	188
33691	21584s (+0.5s)	1632	1632	128	33	127	0	5	165
33692	21585s (+0.4s)	1392	1392	128	28	110	0	4	142
33693	21586s (+0.8s)	3236	3236	256	44	213	0	15	272
33694	21586s (+0.4s)	1368	1368	64	31	111	0	10	152
33695	21587s (+0.6s)	2612	2612	256	42	175	0	7	224
33696	21587s (+0.8s)	3248	3248	256	55	200	0	14	269
33697	21588s (+0.3s)	892	892	64	35	73	6	0	114
33698	21588s (+0.5s)	1508	1508	128	44	109	6	1	160
33699	21589s (+0.7s)	2872	2872	256	72	165	12	0	249
Episode	Time	Reward	Score	Highest	L	U	R	D	Steps
33700	21590s (+0.9s)	4028	4028	256	84	231	15	0	330
33701	21590s (+0.6s)	1976	1976	128	49	152	6	0	207
33702	21591s (+0.5s)	1808	1808	128	52	123	11	0	186
33703	21592s (+0.9s)	3876	3876	256	85	215	20	0	320
33704	21593s (+1.3s)	6436	6436	512	124	310	23	0	457
33705	21594s (+0.5s)	1768	1768	128	40	132	7	0	179
33706	21594s (+0.5s)	1752	1752	128	40	129	9	0	178
33707	21595s (+0.4s)	1348	1348	128	42	91	5	0	138
33708	21595s (+0.5s)	1604	1604	128	37	113	9	0	159
33709	21595s (+0.3s)	832	832	64	31	75	4	1	111
33710	21596s (+0.9s)	4144	4144	256	71	248	13	0	332
33711	21597s (+0.5s)	1596	1596	128	45	114	8	0	167
33712	21598s (+0.7s)	2616	2616	256	64	153	12	0	229
33713	21599s (+1.0s)	4256	4256	256	92	232	26	0	350
33714	21599s (+0.8s)	3416	3416	256	63	205	10	1	279
33715	21600s (+0.5s)	1544	1544	128	34	125	6	0	165
33716	21600s (+0.6s)	2360	2360	128	58	154	10	0	222
33717	21601s (+0.4s)	1340	1340	128	30	107	7	0	144
33718	21601s (+0.4s)	992	992	64	31	90	6	0	127
33719	21602s (+0.9s)	3560	3560	256	69	226	9	0	304
33720	21603s (+0.8s)	3320	3320	256	68	199	9	0	276
33721	21603s (+0.4s)	1200	1200	128	26	101	6	0	133
33722	21604s (+0.4s)	1492	1492	128	28	122	0	7	157
33723	21604s (+0.5s)	1812	1812	128	44	135	0	8	187
33724	21605s (+0.6s)	1920	1920	128	49	139	0	10	198
33725	21605s (+0.3s)	1200	1200	128	20	98	0	5	123
33726	21607s (+1.5s)	7356	7356	512	123	358	0	25	506
33727	21608s (+0.8s)	3516	3516	256	56	218	0	20	294
33728	21608s (+0.5s)	2212	2212	256	49	133	0	8	190
33729	21609s (+0.5s)	1528	1528	128	36	119	0	7	162
33730	21609s (+0.1s)	156	156	16	10	25	0	5	40
33731	21609s (+0.6s)	2412	2412	128	63	142	14	0	219
33732	21610s (+0.5s)	1608	1608	128	42	121	6	0	169
33733	21611s (+0.7s)	3264	3264	256	71	185	13	0	269
33734	21611s (+0.7s)	2748	2748	256	61	166	8	0	235
33735	21612s (+0.6s)	2372	2372	256	48	143	11	0	202
33736	21613s (+0.7s)	3072	3072	256	56	186	11	0	253
33737	21613s (+0.8s)	3228	3228	256	78	177	15	0	270
33738	21614s (+0.6s)	2180	2180	128	57	147	15	0	219
33739	21615s (+0.8s)	3140	3140	256	76	176	16	0	268
33740	21615s (+0.5s)	1656	1656	128	50	105	11	0	166
33741	21616s (+0.9s)	3592	3592	256	63	227	10	0	300
33742	21617s (+0.8s)	3388	3388	256	58	209	11	0	278
33743	21618s (+0.9s)	3536	3536	256	76	211	12	0	299
33744	21618s (+0.6s)	2448	2448	256	47	156	11	0	214
33745	21619s (+0.8s)	3164	3164	256	61	190	11	1	263
33746	21620s (+0.5s)	1716	1716	128	41	131	4	0	176
33747	21621s (+1.4s)	7400	7400	512	157	325	34	0	516
33748	21622s (+0.4s)	1556	1556	128	36	119	6	0	161
33749	21622s (+0.4s)	1256	1256	128	43	93	5	0	141
33750	21622s (+0.3s)	1248	1248	128	24	94	7	0	125
33751	21623s (+0.6s)	2756	2756	256	56	167	9	0	232
33752	21624s (+0.5s)	1780	1780	128	42	134	9	0	185
33753	21625s (+1.1s)	5500	5500	512	111	248	19	2	380
33754	21625s (+0.3s)	1052	1052	128	16	95	2	0	113
33755	21626s (+0.4s)	1192	1192	64	30	111	4	0	145
33756	21626s (+1.0s)	4168	4168	256	94	231	12	1	338
33757	21627s (+0.9s)	3960	3960	256	69	233	18	0	320
33758	21628s (+0.5s)	1804	1804	128	43	135	7	0	185
33759	21629s (+0.8s)	3408	3408	256	69	199	13	1	282
33760	21630s (+0.9s)	4028	4028	256	89	223	16	1	329
33761	21630s (+0.3s)	736	736	64	22	71	3	0	96
33762	21631s (+1.2s)	5836	5836	512	119	275	21	0	415
33763	21632s (+0.9s)	3792	3792	256	70	227	17	0	314
33764	21633s (+0.7s)	2776	2776	256	43	183	0	11	237
33765	21633s (+0.6s)	2392	2392	256	38	150	0	12	200
33766	21634s (+0.7s)	2796	2796	256	40	193	0	9	242
33767	21635s (+0.9s)	3828	3828	256	61	255	0	16	332
33768	21636s (+0.7s)	2640	2640	256	47	179	0	8	234
33769	21636s (+0.8s)	3396	3396	256	68	201	0	11	280
33770	21637s (+0.6s)	2484	2484	256	44	160	0	10	214
33771	21638s (+0.9s)	3928	3928	256	62	242	0	13	317
33772	21639s (+0.7s)	2616	2616	256	63	156	0	10	229
33773	21639s (+0.5s)	1768	1768	128	41	128	0	8	177
33774	21640s (+0.5s)	1852	1852	128	47	139	7	0	193
33775	21640s (+0.3s)	728	728	64	20	72	7	0	99
33776	21641s (+0.6s)	1948	1948	128	44	143	12	0	199
33777	21641s (+0.9s)	3832	3832	256	95	204	14	0	313
33778	21642s (+0.8s)	3564	3564	256	67	220	10	0	297
33779	21643s (+0.4s)	1300	1300	128	39	97	0	5	141
33780	21643s (+0.5s)	1852	1852	128	37	141	0	9	187
33781	21644s (+0.9s)	3976	3976	256	73	241	14	0	328
33782	21645s (+0.9s)	3796	3796	256	79	222	14	0	315
33783	21646s (+1.0s)	4216	4216	256	91	238	15	0	344
33784	21647s (+0.6s)	2252	2252	128	65	149	11	0	225
33785	21647s (+0.6s)	2556	2556	256	61	149	9	0	219
33786	21648s (+0.8s)	3496	3496	256	77	205	10	0	292
33787	21649s (+0.7s)	2912	2912	256	75	169	14	0	258
33788	21649s (+0.2s)	588	588	64	14	59	4	0	77
33789	21650s (+0.3s)	1152	1152	128	35	84	2	0	121
33790	21650s (+0.6s)	2756	2756	256	51	162	10	0	223
33791	21651s (+0.5s)	1836	1836	128	41	138	8	0	187
33792	21651s (+0.7s)	2992	2992	256	69	172	17	0	258
33793	21652s (+0.8s)	3516	3516	256	84	195	14	0	293
33794	21653s (+0.3s)	936	936	64	30	79	5	0	114
33795	21653s (+0.8s)	3612	3612	256	64	231	10	0	305
33796	21654s (+0.5s)	2024	2024	256	36	126	7	0	169
33797	21655s (+0.6s)	2668	2668	256	55	162	10	0	227
33798	21655s (+0.7s)	2888	2888	256	48	183	9	0	240
33799	21656s (+1.1s)	5476	5476	512	89	282	14	0	385
Episode	Time	Reward	Score	Highest	L	U	R	D	Steps
33800	21657s (+0.4s)	1280	1280	128	28	102	2	0	132
33801	21657s (+0.4s)	1424	1424	128	35	109	2	0	146
33802	21658s (+0.8s)	3496	3496	256	62	195	16	0	273
33803	21658s (+0.5s)	2124	2124	256	34	131	12	0	177
33804	21659s (+0.8s)	3512	3512	256	86	196	15	0	297
33805	21660s (+1.0s)	4260	4260	256	90	250	15	0	355
33806	21661s (+0.4s)	1180	1180	128	21	101	7	0	129
33807	21662s (+0.9s)	3592	3592	256	68	222	14	0	304
33808	21662s (+0.7s)	2588	2588	128	73	160	10	0	243
33809	21663s (+0.5s)	1964	1964	128	56	120	10	1	187
33810	21663s (+0.6s)	1976	1976	128	51	143	8	0	202
33811	21664s (+0.8s)	3196	3196	256	70	173	23	0	266
33812	21665s (+0.8s)	3528	3528	256	76	194	20	0	290
33813	21665s (+0.5s)	2132	2132	256	33	145	0	8	186
33814	21666s (+0.6s)	2604	2604	256	44	173	0	9	226
33815	21666s (+0.4s)	1068	1068	64	24	98	0	6	128
33816	21667s (+0.7s)	3200	3200	256	63	191	0	10	264
33817	21668s (+0.7s)	2620	2620	128	60	171	0	15	246
33818	21669s (+0.6s)	2360	2360	256	58	131	11	0	200
33819	21669s (+0.3s)	1216	1216	128	21	98	2	0	121
33820	21669s (+0.5s)	1500	1500	128	30	122	5	2	159
33821	21670s (+0.5s)	1668	1668	128	43	119	7	0	169
33822	21671s (+0.8s)	3344	3344	256	68	210	5	0	283
33823	21671s (+0.8s)	3072	3072	256	56	195	16	0	267
33824	21672s (+0.7s)	2684	2684	256	57	164	10	0	231
33825	21673s (+0.6s)	2740	2740	256	60	170	7	0	237
33826	21673s (+0.7s)	2928	2928	256	57	192	10	0	259
33827	21674s (+0.6s)	2108	2108	128	47	150	9	0	206
33828	21674s (+0.4s)	1080	1080	64	29	99	5	0	133
33829	21675s (+0.5s)	1756	1756	128	43	129	7	0	179
33830	21675s (+0.5s)	1704	1704	128	34	129	4	0	167
33831	21676s (+0.8s)	3540	3540	256	69	201	15	0	285
33832	21677s (+1.2s)	5640	5640	512	106	284	18	0	408
33833	21678s (+0.5s)	2196	2196	256	41	139	6	0	186
33834	21679s (+0.8s)	3232	3232	256	71	193	7	0	271
33835	21679s (+0.3s)	748	748	64	23	76	1	0	100
33836	21680s (+1.0s)	4216	4216	256	101	228	22	0	351
33837	21681s (+0.8s)	3288	3288	256	71	188	14	1	274
33838	21681s (+0.3s)	768	768	64	22	74	4	0	100
33839	21682s (+0.5s)	1628	1628	128	60	99	9	0	168
33840	21682s (+0.3s)	928	928	64	23	86	4	0	113
33841	21683s (+0.6s)	2452	2452	256	46	148	12	0	206
33842	21683s (+0.4s)	1192	1192	128	17	109	3	0	129
33843	21684s (+0.6s)	2644	2644	256	72	144	9	1	226
33844	21684s (+0.3s)	608	608	32	32	54	5	0	91
33845	21685s (+0.8s)	3288	3288	256	63	197	14	0	274
33846	21685s (+0.8s)	3272	3272	256	64	199	10	0	273
33847	21686s (+0.6s)	2584	2584	256	55	147	13	0	215
33848	21687s (+1.1s)	4652	4652	256	114	253	21	0	388
33849	21687s (+0.3s)	876	876	64	31	77	6	0	114
33850	21688s (+0.4s)	1444	1444	128	34	108	7	1	150
33851	21689s (+0.8s)	3464	3464	256	81	189	19	0	289
33852	21689s (+0.4s)	1484	1484	128	41	107	7	0	155
33853	21690s (+0.5s)	1832	1832	128	46	128	11	0	185
33854	21690s (+0.2s)	440	440	32	20	50	1	1	72
33855	21690s (+0.5s)	1516	1516	128	43	111	8	0	162
33856	21691s (+0.6s)	2496	2496	256	50	153	7	0	210
33857	21692s (+0.8s)	3220	3220	256	76	181	11	0	268
33858	21693s (+0.8s)	3220	3220	256	67	191	10	0	268
33859	21693s (+0.6s)	2080	2080	128	45	138	10	0	193
33860	21694s (+0.5s)	1780	1780	128	37	138	5	0	180
33861	21694s (+0.5s)	1756	1756	128	38	135	7	0	180
33862	21694s (+0.3s)	1088	1088	128	30	84	1	0	115
33863	21695s (+0.5s)	1788	1788	128	50	119	13	0	182
33864	21695s (+0.4s)	1312	1312	128	34	104	6	0	144
33865	21696s (+0.8s)	3380	3380	256	71	199	11	0	281
33866	21697s (+0.5s)	1892	1892	128	44	139	0	8	191
33867	21698s (+0.8s)	3408	3408	256	59	211	0	13	283
33868	21698s (+0.7s)	2904	2904	256	69	168	0	15	252
33869	21699s (+0.9s)	3792	3792	256	75	219	0	20	314
33870	21700s (+0.7s)	2772	2772	256	49	174	0	14	237
33871	21700s (+0.5s)	2136	2136	256	34	139	0	6	179
33872	21701s (+0.3s)	940	940	64	21	85	0	3	109
33873	21702s (+0.8s)	3256	3256	256	55	211	0	11	277
33874	21702s (+0.7s)	2812	2812	256	42	179	1	10	232
33875	21703s (+0.7s)	2912	2912	256	43	200	0	11	254
33876	21703s (+0.3s)	772	772	64	16	81	4	0	101
33877	21704s (+0.4s)	1324	1324	128	28	100	8	0	136
33878	21705s (+1.1s)	5596	5596	512	91	286	20	0	397
33879	21706s (+1.4s)	6772	6772	512	152	312	27	0	491
33880	21707s (+0.6s)	2696	2696	256	60	159	13	1	233
33881	21707s (+0.5s)	1528	1528	128	24	133	4	0	161
33882	21708s (+0.8s)	3560	3560	256	62	229	13	0	304
33883	21709s (+0.6s)	2160	2160	128	64	140	11	0	215
33884	21709s (+0.4s)	1316	1316	128	27	107	1	0	135
33885	21710s (+0.9s)	3592	3592	256	73	210	17	0	300
33886	21710s (+0.4s)	1176	1176	128	26	91	4	0	121
33887	21711s (+0.7s)	2976	2976	256	59	185	0	13	257
33888	21712s (+0.5s)	1912	1912	128	44	143	0	9	196
33889	21712s (+0.7s)	2968	2968	256	42	213	0	8	263
33890	21713s (+0.8s)	3424	3424	256	63	211	0	13	287
33891	21714s (+0.5s)	1540	1540	128	30	126	0	8	164
33892	21714s (+0.5s)	1728	1728	128	35	129	0	13	177
33893	21715s (+0.5s)	1736	1736	128	39	130	0	5	174
33894	21715s (+0.3s)	884	884	128	8	81	0	5	94
33895	21715s (+0.3s)	1188	1188	128	21	93	0	6	120
33896	21716s (+0.4s)	1316	1316	128	36	102	6	0	144
33897	21716s (+0.5s)	1616	1616	128	36	129	6	0	171
33898	21717s (+0.8s)	3264	3264	256	63	200	11	0	274
33899	21718s (+0.9s)	3744	3744	256	87	205	13	0	305
Episode	Time	Reward	Score	Highest	L	U	R	D	Steps
33900	21718s (+0.5s)	1796	1796	128	43	131	10	0	184
33901	21719s (+0.6s)	2224	2224	128	50	150	10	0	210
33902	21720s (+0.7s)	2656	2656	256	52	164	12	0	228
33903	21720s (+0.7s)	2752	2752	256	58	171	12	1	242
33904	21722s (+1.2s)	6364	6364	512	126	285	24	0	435
33905	21722s (+0.9s)	3544	3544	256	72	210	18	0	300
33906	21723s (+0.8s)	3596	3596	256	68	213	13	0	294
33907	21724s (+0.4s)	1332	1332	128	28	114	3	0	145
33908	21725s (+0.8s)	3360	3360	256	73	198	15	0	286
33909	21725s (+0.5s)	1540	1540	128	39	117	8	0	164
33910	21725s (+0.4s)	1300	1300	64	37	97	11	0	145
33911	21726s (+0.5s)	1728	1728	128	62	98	12	0	172
33912	21727s (+0.6s)	2516	2516	256	58	145	11	1	215
33913	21727s (+0.3s)	1096	1096	128	28	86	5	0	119
33914	21727s (+0.4s)	1216	1216	128	33	92	7	0	132
33915	21728s (+0.7s)	2868	2868	256	62	176	10	0	248
33916	21729s (+0.5s)	1844	1844	128	47	129	5	0	181
33917	21729s (+0.7s)	3268	3268	256	68	186	9	0	263
33918	21730s (+0.6s)	2112	2112	128	51	139	6	0	196
33919	21730s (+0.5s)	1868	1868	128	33	149	8	0	190
33920	21731s (+0.4s)	1404	1404	128	34	103	8	0	145
33921	21732s (+0.8s)	3376	3376	256	71	194	14	1	280
33922	21733s (+1.3s)	6100	6100	512	129	289	22	0	440
33923	21734s (+1.0s)	5000	5000	512	98	231	20	1	350
33924	21735s (+0.7s)	2736	2736	256	50	173	10	0	233
33925	21735s (+0.8s)	3372	3372	256	70	203	16	0	289
33926	21736s (+0.5s)	1804	1804	128	46	122	14	1	183
33927	21736s (+0.6s)	1888	1888	128	49	135	10	0	194
33928	21737s (+0.8s)	3476	3476	256	75	189	11	0	275
33929	21738s (+0.4s)	1296	1296	128	25	110	5	0	140
33930	21738s (+0.5s)	1728	1728	128	34	130	7	0	171
33931	21739s (+0.4s)	1164	1164	64	36	93	9	0	138
33932	21739s (+0.7s)	2812	2812	256	63	169	14	0	246
33933	21740s (+0.3s)	776	776	64	16	78	5	1	100
33934	21740s (+0.7s)	3192	3192	256	48	202	6	0	256
33935	21741s (+0.8s)	3512	3512	256	86	197	14	0	297
33936	21742s (+1.2s)	5864	5864	512	101	286	29	0	416
33937	21743s (+0.5s)	1612	1612	128	47	113	6	0	166
33938	21743s (+0.5s)	1988	1988	128	53	133	12	0	198
33939	21744s (+1.0s)	5040	5040	512	98	237	20	0	355
33940	21745s (+0.7s)	2908	2908	256	57	168	14	0	239
33941	21746s (+0.6s)	2228	2228	128	58	152	13	0	223
33942	21746s (+0.6s)	1908	1908	128	37	156	2	0	195
33943	21747s (+1.0s)	4192	4192	256	93	231	18	0	342
33944	21748s (+0.9s)	3548	3548	256	65	222	14	0	301
33945	21749s (+0.6s)	2360	2360	256	32	163	7	0	202
33946	21749s (+0.6s)	2484	2484	256	50	154	8	1	213
33947	21750s (+0.7s)	2836	2836	256	51	190	9	1	251
33948	21750s (+0.4s)	1324	1324	128	33	103	7	0	143
33949	21751s (+0.7s)	2924	2924	256	52	178	12	0	242
33950	21752s (+0.8s)	3252	3252	256	73	191	12	0	276
33951	21752s (+0.5s)	1828	1828	128	40	138	0	13	191
33952	21753s (+0.8s)	3452	3452	256	51	225	0	12	288
33953	21754s (+0.8s)	3232	3232	256	51	210	0	10	271
33954	21754s (+0.3s)	744	744	64	20	73	0	5	98
33955	21755s (+0.3s)	768	768	64	27	70	0	3	100
33956	21755s (+0.3s)	952	952	64	19	92	0	8	119
33957	21756s (+0.8s)	3456	3456	256	71	202	0	18	291
33958	21756s (+0.4s)	1412	1412	128	36	104	8	1	149
33959	21757s (+1.0s)	4244	4244	256	90	239	22	0	351
33960	21758s (+0.4s)	1520	1520	128	25	122	1	0	148
33961	21758s (+0.7s)	3184	3184	256	61	186	17	1	265
33962	21759s (+0.5s)	1808	1808	128	34	146	7	0	187
33963	21760s (+1.0s)	4224	4224	256	97	228	21	0	346
33964	21761s (+0.7s)	2972	2972	256	59	178	13	0	250
33965	21761s (+0.8s)	3496	3496	256	75	200	17	1	293
33966	21762s (+0.7s)	2496	2496	128	75	147	13	0	235
33967	21763s (+0.7s)	2784	2784	256	47	182	10	0	239
33968	21763s (+0.6s)	2124	2124	128	40	148	13	1	202
33969	21764s (+0.5s)	1600	1600	128	41	118	8	0	167
33970	21765s (+1.0s)	4128	4128	256	80	245	14	0	339
33971	21765s (+0.5s)	1812	1812	128	43	136	8	0	187
33972	21766s (+0.5s)	1604	1604	128	55	103	10	0	168
33973	21767s (+1.0s)	5084	5084	512	88	255	17	1	361
33974	21768s (+0.7s)	2396	2396	128	60	150	16	0	226
33975	21768s (+0.9s)	3972	3972	256	101	210	16	0	327
33976	21769s (+1.0s)	4272	4272	256	85	242	17	2	346
33977	21770s (+0.3s)	984	984	64	28	81	6	0	115
33978	21771s (+0.8s)	3400	3400	256	53	216	12	0	281
33979	21771s (+0.7s)	3036	3036	256	69	176	11	1	257
33980	21772s (+0.5s)	1736	1736	128	33	137	3	0	173
33981	21773s (+0.9s)	3708	3708	256	85	206	11	0	302
33982	21773s (+0.6s)	2464	2464	256	49	149	9	1	208
33983	21774s (+0.8s)	2896	2896	128	75	185	14	1	275
33984	21775s (+0.5s)	1680	1680	128	34	130	4	0	168
33985	21775s (+0.5s)	1808	1808	128	50	130	7	0	187
33986	21776s (+0.4s)	1340	1340	128	30	103	6	0	139
33987	21776s (+0.9s)	4052	4052	256	97	219	19	0	335
33988	21777s (+0.3s)	1036	1036	128	21	90	0	0	111
33989	21778s (+0.7s)	2980	2980	256	59	177	10	0	246
33990	21778s (+0.6s)	2648	2648	256	44	176	0	6	226
33991	21779s (+1.0s)	4844	4844	512	77	248	0	14	339
33992	21780s (+0.5s)	1860	1860	128	38	146	0	4	188
33993	21780s (+0.4s)	1584	1584	128	33	112	0	8	153
33994	21781s (+0.4s)	1496	1496	128	28	119	0	5	152
33995	21781s (+0.4s)	1404	1404	128	25	117	0	3	145
33996	21781s (+0.5s)	1592	1592	128	44	113	0	8	165
33997	21782s (+0.6s)	1900	1900	128	37	152	0	4	193
33998	21783s (+0.7s)	2880	2880	256	62	170	19	0	251
33999	21784s (+0.8s)	2924	2924	128	78	177	18	0	273
Episode	Time	Reward	Score	Highest	L	U	R	D	Steps
34000	21784s (+0.5s)	1904	1904	128	53	121	9	0	183
34001	21785s (+0.8s)	3240	3240	256	71	185	17	0	273
34002	21786s (+0.7s)	3188	3188	256	54	195	16	1	266
34003	21786s (+0.7s)	3068	3068	256	61	176	12	0	249
34004	21787s (+0.7s)	3092	3092	256	74	169	11	0	254
34005	21788s (+0.7s)	2916	2916	256	62	183	10	0	255
34006	21789s (+0.9s)	3672	3672	256	67	221	13	0	301
34007	21789s (+0.4s)	1492	1492	128	45	105	7	0	157
34008	21790s (+0.5s)	1664	1664	128	41	123	5	0	169
34009	21790s (+0.7s)	2876	2876	256	58	165	12	1	236
34010	21791s (+0.6s)	2308	2308	256	37	148	8	0	193
34011	21791s (+0.7s)	2932	2932	256	62	171	10	0	243
34012	21792s (+0.2s)	568	568	64	23	55	6	0	84
34013	21792s (+0.6s)	2468	2468	256	49	159	5	0	213
34014	21793s (+0.7s)	2944	2944	256	66	169	8	0	243
34015	21794s (+1.2s)	5824	5824	512	100	301	21	0	422
34016	21795s (+1.0s)	4128	4128	256	81	239	18	0	338
34017	21796s (+0.5s)	1768	1768	128	39	138	5	0	182
34018	21796s (+0.6s)	1916	1916	128	46	138	13	0	197
34019	21797s (+0.5s)	1780	1780	128	41	130	12	1	184
34020	21798s (+1.0s)	4280	4280	256	90	253	17	0	360
34021	21799s (+0.7s)	2768	2768	256	55	169	11	0	235
34022	21799s (+0.8s)	3128	3128	256	75	178	9	0	262
34023	21800s (+0.7s)	2760	2760	256	47	177	0	11	235
34024	21800s (+0.3s)	1168	1168	128	24	99	0	3	126
34025	21801s (+0.5s)	1612	1612	128	46	117	0	7	170
34026	21801s (+0.5s)	1640	1640	128	48	111	9	0	168
34027	21802s (+0.9s)	4284	4284	256	80	257	13	0	350
34028	21803s (+0.8s)	3504	3504	256	67	213	15	0	295
34029	21804s (+0.8s)	3404	3404	256	46	233	7	0	286
34030	21804s (+0.5s)	1688	1688	128	33	132	4	0	169
34031	21805s (+0.5s)	1796	1796	128	35	140	10	0	185
34032	21805s (+0.5s)	1548	1548	128	35	129	3	0	167
34033	21806s (+0.2s)	668	668	64	16	71	0	0	87
34034	21806s (+0.7s)	2780	2780	256	62	168	13	0	243
34035	21807s (+0.6s)	1976	1976	128	66	130	11	0	207
34036	21808s (+0.6s)	1920	1920	128	47	143	8	0	198
34037	21808s (+0.9s)	3988	3988	256	87	228	16	0	331
34038	21809s (+0.6s)	1960	1960	128	51	144	8	0	203
34039	21810s (+0.7s)	2516	2516	128	53	176	10	1	240
34040	21810s (+0.6s)	2456	2456	256	52	150	9	0	211
34041	21811s (+0.6s)	2564	2564	256	47	154	8	1	210
34042	21811s (+0.5s)	1676	1676	128	40	128	6	0	174
34043	21812s (+0.9s)	3728	3728	256	77	215	11	0	303
34044	21813s (+0.5s)	1512	1512	128	40	114	7	0	161
34045	21813s (+0.5s)	1876	1876	128	52	119	6	1	178
34046	21814s (+1.0s)	4660	4660	256	99	271	17	0	387
34047	21815s (+0.5s)	1788	1788	128	49	123	9	1	182
34048	21816s (+0.9s)	4736	4736	512	79	235	14	0	328
34049	21817s (+0.7s)	2864	2864	256	54	184	9	0	247
34050	21817s (+0.8s)	3172	3172	256	67	185	12	1	265
34051	21818s (+0.4s)	1320	1320	128	20	112	2	0	134
34052	21818s (+0.7s)	2900	2900	256	56	172	13	1	242
34053	21819s (+0.5s)	1728	1728	128	49	117	6	0	172
34054	21819s (+0.5s)	1692	1692	128	43	115	10	0	168
34055	21821s (+1.4s)	7276	7276	512	137	343	26	1	507
34056	21821s (+0.3s)	696	696	64	32	56	5	0	93
34057	21822s (+0.8s)	3452	3452	256	67	211	15	0	293
34058	21823s (+1.3s)	6244	6244	512	118	299	21	0	438
34059	21824s (+0.5s)	1796	1796	128	44	133	6	1	184
34060	21824s (+0.5s)	1740	1740	128	37	131	7	0	175
34061	21825s (+0.9s)	3868	3868	256	93	214	15	0	322
34062	21826s (+0.4s)	1428	1428	128	39	102	10	1	152
34063	21826s (+0.8s)	3444	3444	256	78	183	20	1	282
34064	21827s (+0.7s)	2964	2964	256	66	189	7	0	262
34065	21828s (+0.7s)	3040	3040	256	60	172	0	12	244
34066	21828s (+0.5s)	1688	1688	128	27	137	0	9	173
34067	21829s (+0.2s)	588	588	64	13	64	0	4	81
34068	21829s (+0.7s)	2936	2936	256	50	184	0	11	245
34069	21830s (+0.6s)	1912	1912	128	44	146	0	7	197
34070	21831s (+0.8s)	3292	3292	256	57	207	10	1	275
34071	21831s (+0.4s)	1416	1416	128	39	106	6	0	151
34072	21832s (+0.5s)	1800	1800	128	45	129	10	1	185
34073	21832s (+0.5s)	1784	1784	128	39	134	8	0	181
34074	21833s (+0.7s)	3032	3032	256	64	168	17	0	249
34075	21834s (+0.8s)	3268	3268	256	75	197	8	0	280
34076	21835s (+0.9s)	3980	3980	256	84	229	16	0	329
34077	21835s (+0.4s)	1416	1416	128	42	95	6	0	143
34078	21836s (+0.7s)	2688	2688	128	61	170	20	0	251
34079	21836s (+0.4s)	1124	1124	64	35	88	9	0	132
34080	21837s (+0.5s)	1804	1804	128	35	148	3	0	186
34081	21837s (+0.4s)	1240	1240	128	20	106	5	0	131
34082	21838s (+0.6s)	2284	2284	128	63	146	10	0	219
34083	21838s (+0.5s)	1544	1544	128	40	119	6	0	165
34084	21839s (+0.4s)	1360	1360	128	21	117	0	3	141
34085	21839s (+0.4s)	1196	1196	128	25	94	0	7	126
34086	21839s (+0.3s)	832	832	64	19	86	0	4	109
34087	21840s (+0.7s)	3160	3160	256	54	193	0	11	258
34088	21841s (+0.7s)	2604	2604	128	65	171	9	0	245
34089	21841s (+0.3s)	752	752	64	24	73	3	0	100
34090	21842s (+0.6s)	2376	2376	128	64	146	12	0	222
34091	21842s (+0.6s)	1916	1916	128	46	145	6	0	197
34092	21843s (+0.9s)	3624	3624	256	81	213	14	0	308
34093	21844s (+0.7s)	2968	2968	256	67	184	10	0	261
34094	21845s (+0.8s)	3276	3276	256	72	197	8	0	277
34095	21845s (+0.7s)	3088	3088	256	58	182	12	0	252
34096	21846s (+1.0s)	4296	4296	256	87	256	16	0	359
34097	21847s (+0.4s)	1036	1036	64	30	85	8	0	123
34098	21847s (+0.6s)	1884	1884	128	38	154	2	0	194
34099	21848s (+0.4s)	1384	1384	128	28	112	6	0	146
Episode	Time	Reward	Score	Highest	L	U	R	D	Steps
34100	21848s (+0.4s)	1252	1252	128	28	106	6	0	140
34101	21849s (+0.4s)	1136	1136	64	24	104	0	9	137
34102	21849s (+0.8s)	3124	3124	256	63	187	10	1	261
34103	21850s (+0.3s)	1016	1016	64	33	77	10	2	122
34104	21850s (+0.5s)	1792	1792	128	38	139	6	0	183
34105	21851s (+0.8s)	3076	3076	256	64	183	0	17	264
34106	21852s (+0.7s)	2912	2912	256	49	197	0	8	254
34107	21853s (+0.9s)	3808	3808	256	64	247	0	13	324
34108	21853s (+0.4s)	1056	1056	64	23	98	0	6	127
34109	21854s (+0.8s)	3204	3204	256	62	195	0	12	269
34110	21855s (+0.7s)	3128	3128	256	56	196	0	9	261
34111	21855s (+0.4s)	1396	1396	128	33	105	0	11	149
34112	21855s (+0.5s)	1756	1756	128	35	136	0	8	179
34113	21856s (+1.0s)	4164	4164	256	76	252	0	15	343
34114	21857s (+0.6s)	2408	2408	256	37	160	0	10	207
34115	21858s (+0.9s)	3708	3708	256	54	237	0	18	309
34116	21858s (+0.5s)	1552	1552	128	29	135	0	3	167
34117	21859s (+0.7s)	3096	3096	256	68	176	10	0	254
34118	21860s (+0.8s)	3468	3468	256	68	205	15	0	288
34119	21860s (+0.4s)	1144	1144	64	33	94	6	0	133
34120	21861s (+0.6s)	1844	1844	128	47	141	7	0	195
34121	21862s (+0.8s)	3252	3252	256	64	199	12	1	276
34122	21862s (+0.7s)	2848	2848	256	62	167	15	0	244
34123	21863s (+0.4s)	1224	1224	64	42	98	8	0	148
34124	21864s (+0.7s)	3024	3024	256	66	174	11	0	251
34125	21864s (+0.6s)	2416	2416	256	44	152	5	0	201
34126	21865s (+0.7s)	3068	3068	256	60	181	11	0	252
34127	21865s (+0.6s)	1848	1848	128	44	142	6	0	192
34128	21866s (+1.0s)	4256	4256	256	93	243	19	0	355
34129	21867s (+0.6s)	2572	2572	256	53	159	11	0	223
34130	21868s (+1.0s)	5016	5016	512	78	256	20	0	354
34131	21869s (+0.8s)	3636	3636	256	78	202	16	0	296
34132	21870s (+1.1s)	5204	5204	512	83	283	13	0	379
34133	21871s (+0.9s)	4048	4048	256	89	227	18	0	334
34134	21872s (+0.7s)	2812	2812	256	54	174	17	0	245
34135	21872s (+0.7s)	2856	2856	256	72	173	7	0	252
34136	21873s (+0.5s)	1880	1880	128	43	143	7	0	193
34137	21874s (+0.7s)	2900	2900	256	62	179	10	0	251
34138	21875s (+0.9s)	3956	3956	256	77	233	13	0	323
34139	21875s (+0.4s)	1548	1548	128	33	118	5	0	156
34140	21875s (+0.4s)	1180	1180	64	31	109	2	0	142
34141	21876s (+0.6s)	2340	2340	256	51	140	7	0	198
34142	21877s (+0.8s)	3612	3612	256	74	217	14	0	305
34143	21877s (+0.5s)	1816	1816	128	35	147	6	0	188
34144	21879s (+1.3s)	6276	6276	512	121	297	24	1	443
34145	21880s (+1.1s)	5496	5496	512	104	264	18	0	386
34146	21880s (+0.5s)	1520	1520	128	32	126	4	0	162
34147	21880s (+0.3s)	688	688	64	23	61	6	0	90
34148	21881s (+1.0s)	4152	4152	256	71	261	13	0	345
34149	21882s (+0.7s)	2792	2792	256	58	170	13	0	241
34150	21883s (+0.9s)	3956	3956	256	78	232	13	0	323
34151	21883s (+0.3s)	872	872	64	27	81	6	0	114
34152	21884s (+0.8s)	3332	3332	256	63	204	13	0	280
34153	21885s (+0.8s)	3516	3516	256	58	228	11	0	297
34154	21886s (+0.6s)	1900	1900	128	42	145	7	0	194
34155	21887s (+1.0s)	4216	4216	256	85	247	0	17	349
34156	21887s (+0.3s)	856	856	64	34	73	0	4	111
34157	21888s (+0.5s)	1576	1576	128	33	122	0	8	163
34158	21888s (+0.4s)	1436	1436	128	24	122	0	3	149
34159	21889s (+0.7s)	2792	2792	256	64	164	12	1	241
34160	21890s (+1.0s)	4116	4116	256	99	210	22	0	331
34161	21890s (+0.5s)	1832	1832	128	45	133	7	0	185
34162	21891s (+0.8s)	3448	3448	256	90	188	14	0	292
34163	21892s (+0.8s)	3408	3408	256	77	204	12	0	293
34164	21893s (+1.3s)	6588	6588	512	141	311	26	0	478
34165	21894s (+0.9s)	3800	3800	256	93	214	13	0	320
34166	21895s (+0.7s)	2756	2756	256	60	174	10	0	244
34167	21896s (+0.7s)	2936	2936	256	72	168	10	0	250
34168	21896s (+0.5s)	1764	1764	128	35	136	5	0	176
34169	21897s (+0.7s)	3184	3184	256	57	198	9	0	264
34170	21898s (+0.9s)	5004	5004	512	92	243	10	1	346
34171	21898s (+0.8s)	3132	3132	256	62	191	11	0	264
34172	21899s (+0.8s)	3252	3252	256	74	188	9	0	271
34173	21900s (+0.8s)	3196	3196	256	72	176	12	0	260
34174	21901s (+0.5s)	1848	1848	128	49	130	5	1	185
34175	21901s (+0.7s)	2828	2828	256	54	178	11	0	243
34176	21902s (+0.6s)	1908	1908	128	52	127	13	0	192
34177	21903s (+0.8s)	3404	3404	256	70	205	12	0	287
34178	21904s (+1.2s)	6232	6232	512	116	278	27	1	422
34179	21904s (+0.4s)	1136	1136	64	24	103	8	0	135
34180	21905s (+0.3s)	968	968	64	30	81	4	0	115
34181	21905s (+0.7s)	2760	2760	256	47	184	7	0	238
34182	21906s (+0.6s)	2760	2760	256	37	181	6	0	224
34183	21907s (+0.6s)	2520	2520	256	56	151	15	0	222
34184	21907s (+0.8s)	3196	3196	256	67	188	13	0	268
34185	21908s (+0.7s)	2992	2992	256	51	194	9	0	254
34186	21909s (+1.1s)	5684	5684	512	98	275	24	0	397
34187	21910s (+0.8s)	3420	3420	256	79	196	11	0	286
34188	21911s (+0.8s)	3480	3480	256	69	208	12	0	289
34189	21911s (+0.4s)	1288	1288	128	31	101	3	0	135
34190	21912s (+0.5s)	1672	1672	128	42	118	9	0	169
34191	21913s (+1.1s)	5560	5560	512	98	273	22	0	393
34192	21914s (+0.7s)	3276	3276	256	61	189	11	1	262
34193	21914s (+0.5s)	1712	1712	128	37	132	6	0	175
34194	21915s (+0.9s)	3552	3552	256	77	206	19	0	302
34195	21916s (+0.8s)	3492	3492	256	86	193	12	0	291
34196	21916s (+0.5s)	1672	1672	128	48	117	5	0	170
34197	21917s (+0.4s)	1444	1444	128	29	115	6	0	150
34198	21917s (+0.7s)	2876	2876	256	51	191	0	15	257
34199	21918s (+0.8s)	3516	3516	256	72	215	0	11	298
Episode	Time	Reward	Score	Highest	L	U	R	D	Steps
34200	21919s (+0.5s)	1788	1788	128	38	134	0	9	181
34201	21919s (+0.4s)	1304	1304	128	30	97	0	6	133
34202	21920s (+0.9s)	3776	3776	256	58	237	0	15	310
34203	21921s (+0.9s)	3936	3936	256	76	219	18	0	313
34204	21922s (+0.9s)	3580	3580	256	73	216	13	0	302
34205	21923s (+0.7s)	2880	2880	256	63	163	11	0	237
34206	21923s (+0.7s)	2916	2916	256	60	173	7	0	240
34207	21924s (+0.9s)	4020	4020	256	87	225	16	1	329
34208	21925s (+0.5s)	1824	1824	128	45	129	9	0	183
34209	21925s (+0.6s)	2320	2320	128	51	159	9	1	220
34210	21926s (+0.8s)	3336	3336	256	64	204	9	0	277
34211	21927s (+0.7s)	3028	3028	256	67	166	13	0	246
34212	21928s (+0.8s)	2928	2928	128	81	179	14	0	274
34213	21928s (+0.7s)	2744	2744	256	52	171	11	0	234
34214	21929s (+0.4s)	1364	1364	128	30	109	12	0	151
34215	21930s (+0.9s)	3932	3932	256	82	223	17	0	322
34216	21930s (+0.5s)	1656	1656	128	32	131	0	4	167
34217	21931s (+0.5s)	1792	1792	128	36	139	0	9	184
34218	21931s (+0.5s)	1864	1864	128	37	153	0	6	196
34219	21932s (+0.5s)	1800	1800	128	38	133	0	14	185
34220	21932s (+0.5s)	1828	1828	128	39	139	7	0	185
34221	21933s (+0.4s)	1240	1240	64	27	115	7	0	149
34222	21934s (+0.9s)	3876	3876	256	79	227	13	0	319
34223	21934s (+0.7s)	2884	2884	256	72	162	18	0	252
34224	21935s (+0.8s)	3456	3456	256	66	211	10	0	287
34225	21936s (+0.8s)	3528	3528	256	71	206	13	0	290
34226	21937s (+0.5s)	1524	1524	128	53	100	7	0	160
34227	21937s (+0.8s)	3388	3388	256	69	197	12	0	278
34228	21938s (+0.9s)	3836	3836	256	78	215	14	0	307
34229	21939s (+0.4s)	1500	1500	128	35	112	9	0	156
34230	21939s (+0.5s)	1576	1576	128	40	116	6	0	162
34231	21940s (+1.0s)	4324	4324	256	94	240	22	0	356
34232	21941s (+0.9s)	3556	3556	256	73	204	17	1	295
34233	21941s (+0.5s)	1804	1804	128	41	138	2	0	181
34234	21943s (+1.0s)	4276	4276	256	85	258	16	0	359
34235	21943s (+0.2s)	320	320	32	12	44	2	0	58
34236	21943s (+0.6s)	2600	2600	256	65	143	17	0	225
34237	21944s (+0.3s)	884	884	64	22	89	5	0	116
34238	21944s (+0.5s)	1772	1772	128	47	125	6	0	178
34239	21945s (+0.5s)	1680	1680	128	38	127	0	8	173
34240	21945s (+0.7s)	3088	3088	256	55	184	0	13	252
34241	21946s (+0.7s)	2872	2872	256	53	186	0	10	249
34242	21947s (+0.7s)	3208	3208	256	58	192	0	16	266
34243	21947s (+0.3s)	1052	1052	64	25	93	0	4	122
34244	21948s (+0.7s)	2456	2456	128	43	175	0	14	232
34245	21949s (+0.7s)	2940	2940	256	57	173	1	12	243
34246	21949s (+0.2s)	520	520	64	12	58	0	3	73
34247	21949s (+0.3s)	852	852	64	20	84	0	5	109
34248	21950s (+1.2s)	6164	6164	512	87	309	0	18	414
34249	21951s (+0.4s)	1148	1148	128	19	100	0	4	123
34250	21951s (+0.3s)	704	704	64	24	69	0	4	97
34251	21952s (+0.8s)	2804	2804	128	63	191	0	10	264
34252	21952s (+0.5s)	1596	1596	128	36	122	0	9	167
34253	21953s (+0.5s)	1564	1564	128	39	117	7	0	163
34254	21953s (+0.6s)	2568	2568	256	48	159	9	0	216
34255	21954s (+0.4s)	1260	1260	128	39	88	8	0	135
34256	21954s (+0.3s)	720	720	64	31	59	6	1	97
34257	21955s (+0.7s)	2804	2804	256	58	171	9	0	238
34258	21955s (+0.4s)	1480	1480	128	32	119	4	0	155
34259	21956s (+0.4s)	1536	1536	128	35	117	4	0	156
34260	21956s (+0.6s)	2596	2596	256	55	159	11	0	225
34261	21957s (+0.6s)	2112	2112	128	58	137	16	0	211
34262	21958s (+1.0s)	4232	4232	256	91	237	20	0	348
34263	21959s (+0.8s)	3424	3424	256	73	196	12	0	281
34264	21959s (+0.7s)	2964	2964	256	56	188	12	0	256
34265	21960s (+0.3s)	908	908	64	31	71	6	1	109
34266	21960s (+0.3s)	792	792	64	29	66	4	0	99
34267	21961s (+0.8s)	3348	3348	256	44	223	0	16	283
34268	21961s (+0.6s)	2248	2248	128	42	164	0	11	217
34269	21962s (+0.2s)	444	444	64	12	51	0	0	63
34270	21962s (+0.5s)	1692	1692	128	34	133	0	7	174
34271	21963s (+0.7s)	2640	2640	256	46	173	0	11	230
34272	21964s (+0.9s)	3964	3964	256	66	246	0	13	325
34273	21964s (+0.4s)	1520	1520	128	34	118	0	5	157
34274	21965s (+0.8s)	3380	3380	256	75	189	16	0	280
34275	21966s (+1.0s)	4248	4248	256	89	250	14	0	353
34276	21967s (+0.9s)	3956	3956	256	90	216	17	0	323
34277	21968s (+0.7s)	3156	3156	256	66	186	12	0	264
34278	21969s (+0.9s)	3988	3988	256	85	217	23	0	325
34279	21969s (+0.6s)	2568	2568	256	55	154	13	0	222
34280	21970s (+0.4s)	1512	1512	128	40	112	5	0	157
34281	21971s (+0.9s)	3756	3756	256	66	228	11	0	305
34282	21971s (+0.6s)	2352	2352	128	44	160	12	0	216
34283	21972s (+0.8s)	3540	3540	256	73	210	15	1	299
34284	21973s (+0.5s)	1608	1608	128	44	115	10	0	169
34285	21974s (+1.2s)	5788	5788	512	111	286	21	0	418
34286	21974s (+0.5s)	2092	2092	256	42	129	8	0	179
34287	21975s (+0.8s)	3520	3520	256	81	204	11	0	296
34288	21976s (+0.9s)	3936	3936	256	92	216	15	0	323
34289	21977s (+0.6s)	2668	2668	256	61	153	11	2	227
34290	21977s (+0.5s)	1652	1652	128	32	131	6	0	169
34291	21977s (+0.3s)	1076	1076	128	24	87	7	0	118
34292	21978s (+0.4s)	1296	1296	128	30	108	6	0	144
34293	21979s (+0.8s)	3364	3364	256	71	204	12	0	287
34294	21979s (+0.5s)	1708	1708	128	53	108	11	1	173
34295	21980s (+0.7s)	2724	2724	256	60	155	14	0	229
34296	21981s (+1.0s)	4020	4020	256	76	240	16	0	332
34297	21981s (+0.5s)	1596	1596	128	36	124	6	0	166
34298	21982s (+0.5s)	1500	1500	128	42	104	12	0	158
34299	21982s (+0.4s)	1456	1456	128	51	97	7	0	155
Episode	Time	Reward	Score	Highest	L	U	R	D	Steps
34300	21983s (+0.8s)	3460	3460	256	82	196	13	0	291
34301	21983s (+0.4s)	1296	1296	128	39	93	8	0	140
34302	21984s (+0.3s)	768	768	64	31	62	5	0	98
34303	21984s (+0.8s)	3160	3160	256	60	196	12	1	269
34304	21985s (+0.4s)	1488	1488	128	41	108	7	0	156
34305	21986s (+0.9s)	3804	3804	256	71	231	14	1	317
34306	21987s (+0.8s)	3416	3416	256	65	209	11	0	285
34307	21987s (+0.5s)	1672	1672	128	34	127	5	0	166
34308	21988s (+0.8s)	3292	3292	256	76	185	13	0	274
34309	21989s (+0.6s)	2276	2276	128	53	155	9	0	217
34310	21989s (+0.3s)	704	704	64	20	70	3	1	94
34311	21990s (+1.0s)	4364	4364	256	89	256	20	0	365
34312	21991s (+0.8s)	3480	3480	256	88	184	17	0	289
34313	21991s (+0.5s)	1840	1840	128	44	130	10	0	184
34314	21992s (+0.6s)	2552	2552	256	53	156	15	0	224
34315	21992s (+0.5s)	1872	1872	128	60	119	12	1	192
34316	21993s (+0.3s)	876	876	64	23	90	2	0	115
34317	21994s (+0.9s)	4860	4860	512	68	251	0	14	333
34318	21995s (+0.9s)	3776	3776	256	70	216	0	14	300
34319	21995s (+0.5s)	1692	1692	128	31	136	0	8	175
34320	21996s (+0.5s)	1640	1640	128	34	134	0	4	172
34321	21996s (+0.8s)	3436	3436	256	63	215	0	12	290
34322	21997s (+0.4s)	1484	1484	128	33	116	0	6	155
34323	21998s (+0.8s)	3292	3292	256	60	202	0	14	276
34324	21998s (+0.6s)	2604	2604	256	40	169	0	14	223
34325	21999s (+0.4s)	1176	1176	64	28	105	0	8	141
34326	21999s (+0.5s)	1748	1748	128	30	139	0	8	177
34327	22000s (+0.9s)	3544	3544	256	64	219	17	0	300
34328	22001s (+1.0s)	4488	4488	256	103	243	22	0	368
34329	22002s (+0.4s)	1400	1400	128	36	103	7	0	146
34330	22002s (+0.4s)	1228	1228	128	28	101	6	0	135
34331	22003s (+0.9s)	4124	4124	256	86	237	16	0	339
34332	22003s (+0.6s)	1904	1904	128	41	144	9	0	194
34333	22004s (+0.6s)	2112	2112	128	57	146	11	0	214
34334	22005s (+0.5s)	1844	1844	128	44	140	7	0	191
34335	22005s (+0.5s)	1616	1616	128	43	123	5	0	171
34336	22006s (+1.0s)	5576	5576	512	91	258	20	0	369
34337	22007s (+0.9s)	3756	3756	256	78	211	17	0	306
34338	22007s (+0.3s)	992	992	64	27	81	7	0	115
34339	22008s (+0.6s)	2076	2076	128	56	140	14	0	210
34340	22009s (+0.6s)	2308	2308	128	71	134	12	0	217
34341	22010s (+1.0s)	4352	4352	256	95	246	21	0	362
34342	22010s (+0.5s)	1484	1484	64	44	107	12	0	163
34343	22011s (+0.6s)	1908	1908	128	44	144	7	0	195
34344	22011s (+0.8s)	3192	3192	256	72	184	10	0	266
34345	22012s (+0.6s)	2280	2280	256	47	146	8	0	201
34346	22013s (+0.7s)	2432	2432	128	55	166	9	0	230
34347	22013s (+0.5s)	1900	1900	128	55	113	12	0	180
34348	22014s (+0.5s)	1784	1784	128	40	136	6	0	182
34349	22014s (+0.6s)	2280	2280	128	61	139	10	0	210
34350	22015s (+1.0s)	4380	4380	256	111	241	17	0	369
34351	22016s (+0.8s)	3476	3476	256	77	196	15	0	288
34352	22017s (+0.8s)	3260	3260	256	64	199	15	0	278
34353	22018s (+0.7s)	2776	2776	256	65	160	12	0	237
34354	22018s (+0.6s)	2516	2516	256	48	162	6	0	216
34355	22019s (+0.5s)	1840	1840	128	43	134	6	0	183
34356	22020s (+0.8s)	3396	3396	256	69	202	0	10	281
34357	22020s (+0.6s)	2392	2392	256	39	158	0	10	207
34358	22021s (+0.5s)	1740	1740	128	38	138	0	5	181
34359	22021s (+0.4s)	1404	1404	128	27	109	0	6	142
34360	22022s (+0.6s)	2412	2412	128	45	168	0	12	225
34361	22022s (+0.3s)	588	588	32	17	67	0	7	91
34362	22023s (+0.5s)	1892	1892	128	58	118	9	0	185
34363	22023s (+0.7s)	2616	2616	128	69	161	15	0	245
34364	22024s (+0.8s)	3272	3272	256	66	186	14	0	266
34365	22025s (+0.6s)	2724	2724	256	53	166	10	0	229
34366	22025s (+0.6s)	2488	2488	256	64	141	9	0	214
34367	22026s (+0.4s)	1436	1436	128	37	105	6	0	148
34368	22027s (+0.7s)	2640	2640	256	55	170	10	0	235
34369	22027s (+0.7s)	3144	3144	256	53	185	16	0	254
34370	22028s (+0.8s)	3312	3312	256	64	197	18	0	279
34371	22028s (+0.2s)	432	432	32	17	52	1	0	70
34372	22029s (+0.7s)	2808	2808	256	57	173	14	0	244
34373	22029s (+0.3s)	748	748	64	20	72	7	0	99
34374	22030s (+0.8s)	2952	2952	256	63	186	15	0	264
34375	22031s (+1.0s)	4200	4200	256	114	212	16	0	342
34376	22031s (+0.4s)	1488	1488	128	44	103	8	0	155
34377	22032s (+0.5s)	1640	1640	128	50	103	10	0	163
34378	22032s (+0.5s)	1540	1540	128	43	113	6	0	162
34379	22033s (+0.7s)	2964	2964	256	66	174	5	0	245
34380	22034s (+0.9s)	3792	3792	256	90	210	17	1	318
34381	22035s (+0.7s)	2832	2832	256	46	186	0	14	246
34382	22035s (+0.6s)	2248	2248	256	38	148	0	11	197
34383	22036s (+0.9s)	3844	3844	256	62	238	0	14	314
34384	22037s (+0.6s)	2360	2360	256	43	145	0	10	198
34385	22037s (+0.7s)	3056	3056	256	51	185	0	13	249
34386	22038s (+0.5s)	1552	1552	128	21	137	1	2	161
34387	22038s (+0.5s)	2300	2300	256	31	158	0	7	196
34388	22039s (+0.9s)	3560	3560	256	59	236	0	9	304
34389	22040s (+0.5s)	1676	1676	128	37	127	0	7	171
34390	22041s (+0.9s)	3784	3784	256	70	233	0	14	317
34391	22041s (+0.4s)	1372	1372	128	28	112	0	5	145
34392	22041s (+0.2s)	432	432	32	10	56	0	4	70
34393	22042s (+0.5s)	1804	1804	128	36	141	0	10	187
34394	22042s (+0.4s)	1156	1156	128	23	94	0	6	123
34395	22043s (+0.6s)	2496	2496	256	43	161	0	9	213
34396	22043s (+0.5s)	1824	1824	128	42	141	0	7	190
34397	22044s (+0.4s)	1172	1172	64	35	96	0	9	140
34398	22044s (+0.4s)	1528	1528	128	30	117	0	9	156
34399	22045s (+0.5s)	1900	1900	128	39	150	4	0	193
Episode	Time	Reward	Score	Highest	L	U	R	D	Steps
34400	22046s (+0.6s)	2532	2532	256	49	160	11	0	220
34401	22046s (+0.7s)	3156	3156	256	58	191	13	0	262
34402	22047s (+1.1s)	5632	5632	512	96	275	20	0	391
34403	22048s (+0.5s)	1800	1800	128	48	130	8	0	186
34404	22048s (+0.4s)	1024	1024	64	28	91	5	0	124
34405	22049s (+0.5s)	1680	1680	128	53	110	8	1	172
34406	22049s (+0.4s)	1492	1492	128	44	102	10	0	156
34407	22050s (+0.5s)	1748	1748	128	42	125	9	0	176
34408	22051s (+0.8s)	3588	3588	256	100	185	13	1	299
34409	22051s (+0.8s)	3576	3576	256	71	197	18	0	286
34410	22052s (+1.0s)	4428	4428	256	106	239	20	0	365
34411	22053s (+0.5s)	1440	1440	64	47	109	7	0	163
34412	22053s (+0.3s)	668	668	64	18	71	1	0	90
34413	22054s (+0.7s)	3036	3036	256	72	171	11	0	254
34414	22055s (+0.7s)	2856	2856	256	56	180	9	0	245
34415	22055s (+0.4s)	1376	1376	128	28	111	5	0	144
34416	22056s (+1.0s)	4260	4260	256	92	242	17	0	351
34417	22056s (+0.3s)	1180	1180	128	27	96	2	0	125
34418	22057s (+0.6s)	1928	1928	128	47	145	8	0	200
34419	22058s (+1.0s)	4148	4148	256	74	254	11	0	339
34420	22059s (+1.1s)	4652	4652	256	117	249	22	0	388
34421	22060s (+0.6s)	2292	2292	128	71	131	10	0	212
34422	22061s (+0.9s)	3928	3928	256	63	247	10	1	321
34423	22061s (+0.4s)	1448	1448	128	31	113	6	0	150
34424	22061s (+0.4s)	1448	1448	128	45	96	10	0	151
34425	22062s (+0.5s)	1836	1836	128	52	131	6	0	189
34426	22063s (+0.7s)	2964	2964	256	69	168	16	0	253
34427	22064s (+1.3s)	6212	6212	512	108	312	20	0	440
34428	22064s (+0.3s)	860	860	64	23	81	4	0	108
34429	22065s (+0.5s)	1504	1504	128	38	113	4	0	155
34430	22065s (+0.6s)	2424	2424	256	45	152	10	0	207
34431	22066s (+0.7s)	2920	2920	256	53	191	12	0	256
34432	22067s (+1.3s)	6500	6500	512	122	324	21	0	467
34433	22068s (+0.9s)	3636	3636	256	82	211	14	0	307
34434	22069s (+0.3s)	740	740	64	20	76	2	0	98
34435	22070s (+1.0s)	3912	3912	256	92	225	15	0	332
34436	22070s (+0.5s)	1804	1804	128	43	137	6	0	186
34437	22071s (+0.6s)	2404	2404	256	47	146	12	0	205
34438	22071s (+0.6s)	2504	2504	256	47	159	9	0	215
34439	22072s (+0.9s)	3736	3736	256	71	222	12	1	306
34440	22073s (+0.3s)	1132	1132	128	24	93	0	2	119
34441	22073s (+0.7s)	3200	3200	256	53	196	0	15	264
34442	22074s (+0.5s)	1556	1556	128	26	128	0	7	161
34443	22074s (+0.4s)	1452	1452	128	30	112	0	6	148
34444	22075s (+0.8s)	3672	3672	256	69	218	0	14	301
34445	22076s (+0.6s)	2540	2540	256	44	168	0	10	222
34446	22076s (+0.4s)	1172	1172	64	28	103	0	6	137
34447	22077s (+1.0s)	5000	5000	512	65	259	0	13	337
34448	22077s (+0.3s)	1128	1128	128	23	94	0	4	121
34449	22078s (+0.3s)	760	760	64	17	79	0	6	102
34450	22078s (+0.7s)	2516	2516	128	50	169	0	18	237
34451	22079s (+0.7s)	2756	2756	256	51	179	6	1	237
34452	22080s (+0.6s)	2484	2484	256	40	165	9	0	214
34453	22080s (+0.8s)	3216	3216	256	68	184	15	0	267
34454	22081s (+0.7s)	2792	2792	128	77	167	16	1	261
34455	22082s (+0.7s)	2904	2904	256	65	174	13	0	252
34456	22082s (+0.5s)	1648	1648	128	56	102	10	0	168
34457	22083s (+0.3s)	648	648	32	26	67	4	0	97
34458	22083s (+0.7s)	2832	2832	256	50	182	7	0	239
34459	22084s (+0.9s)	4012	4012	256	83	237	12	0	332
34460	22085s (+0.4s)	1036	1036	64	33	84	6	0	123
34461	22085s (+0.6s)	2552	2552	256	47	160	11	0	218
34462	22087s (+1.2s)	5940	5940	512	130	279	18	0	427
34463	22087s (+0.4s)	1480	1480	128	33	116	5	0	154
34464	22088s (+0.5s)	1604	1604	128	35	123	10	0	168
34465	22089s (+1.0s)	5100	5100	512	97	251	15	0	363
34466	22089s (+0.4s)	1404	1404	128	35	104	6	1	146
34467	22089s (+0.3s)	1216	1216	128	33	86	4	0	123
34468	22090s (+0.4s)	1372	1372	128	30	104	9	0	143
34469	22091s (+0.8s)	3548	3548	256	81	195	23	0	299
34470	22091s (+0.5s)	1616	1616	128	51	99	11	0	161
34471	22092s (+0.9s)	3740	3740	256	72	222	12	0	306
34472	22093s (+1.1s)	5544	5544	512	95	261	22	1	379
34473	22094s (+0.5s)	1888	1888	128	55	127	13	0	195
34474	22094s (+0.4s)	1460	1460	128	28	117	0	5	150
34475	22095s (+0.9s)	3988	3988	256	70	242	0	20	332
34476	22095s (+0.5s)	1736	1736	128	27	144	0	4	175
34477	22096s (+0.8s)	3344	3344	256	65	202	15	0	282
34478	22097s (+0.8s)	3116	3116	256	66	178	15	0	259
34479	22097s (+0.4s)	1180	1180	64	39	99	4	0	142
34480	22098s (+0.7s)	2804	2804	256	77	155	12	0	244
34481	22099s (+1.1s)	5512	5512	512	112	255	26	0	393
34482	22100s (+0.6s)	1936	1936	128	50	144	3	0	197
34483	22101s (+0.8s)	3588	3588	256	82	185	18	0	285
34484	22102s (+1.3s)	6300	6300	512	116	303	29	1	449
34485	22103s (+0.6s)	2036	2036	128	67	134	9	1	211
34486	22103s (+0.4s)	1484	1484	128	31	113	11	0	155
34487	22104s (+0.9s)	4012	4012	256	91	211	23	0	325
34488	22104s (+0.2s)	504	504	32	18	58	3	0	79
34489	22105s (+0.4s)	1396	1396	128	32	109	3	0	144
34490	22105s (+0.5s)	1760	1760	128	43	127	9	0	179
34491	22106s (+0.5s)	1772	1772	128	43	129	10	0	182
34492	22106s (+0.7s)	2792	2792	256	49	181	0	11	241
34493	22107s (+0.6s)	2404	2404	128	48	163	0	13	224
34494	22108s (+0.7s)	3112	3112	256	53	199	1	5	258
34495	22108s (+0.5s)	1784	1784	128	39	132	0	10	181
34496	22109s (+0.8s)	3448	3448	256	52	223	0	14	289
34497	22110s (+0.8s)	3348	3348	256	67	202	0	14	283
34498	22110s (+0.4s)	1216	1216	64	32	109	0	5	146
34499	22111s (+0.4s)	1332	1332	128	33	109	6	0	148
Episode	Time	Reward	Score	Highest	L	U	R	D	Steps
34500	22111s (+0.7s)	2776	2776	256	51	182	6	0	239
34501	22112s (+0.3s)	700	700	64	29	61	3	0	93
34502	22112s (+0.3s)	804	804	64	22	79	6	1	108
34503	22112s (+0.4s)	1212	1212	128	26	101	4	0	131
34504	22113s (+0.9s)	4032	4032	256	84	230	17	0	331
34505	22114s (+0.3s)	760	760	64	23	74	4	1	102
34506	22114s (+0.3s)	780	780	64	19	75	0	9	103
34507	22115s (+0.7s)	3224	3224	256	57	199	0	12	268
34508	22116s (+0.9s)	3824	3824	256	74	234	0	14	322
34509	22116s (+0.4s)	1296	1296	128	28	100	0	5	133
34510	22116s (+0.3s)	684	684	64	25	63	4	0	92
34511	22117s (+0.5s)	1676	1676	128	49	112	9	1	171
34512	22118s (+1.1s)	4600	4600	256	117	243	24	0	384
34513	22119s (+0.8s)	3252	3252	256	59	209	8	0	276
34514	22120s (+0.9s)	3612	3612	256	79	214	11	1	305
34515	22120s (+0.5s)	1576	1576	128	39	123	6	0	168
34516	22120s (+0.3s)	964	964	128	27	72	5	0	104
34517	22121s (+0.5s)	1624	1624	128	41	124	8	0	173
34518	22121s (+0.5s)	1584	1584	128	52	105	6	0	163
34519	22122s (+0.7s)	2892	2892	256	59	177	9	1	246
34520	22123s (+0.6s)	1928	1928	128	50	143	7	0	200
34521	22123s (+0.4s)	1136	1136	64	30	101	5	0	136
34522	22124s (+1.2s)	5740	5740	512	82	316	0	15	413
34523	22125s (+0.5s)	1652	1652	128	34	137	0	4	175
34524	22125s (+0.3s)	712	712	64	16	75	0	4	95
34525	22126s (+0.5s)	1572	1572	128	27	127	0	7	161
34526	22126s (+0.7s)	2692	2692	256	47	176	0	10	233
34527	22127s (+0.8s)	3196	3196	256	57	195	0	15	267
34528	22128s (+0.8s)	3372	3372	256	73	188	0	17	278
34529	22128s (+0.2s)	572	572	64	22	56	0	5	83
34530	22129s (+0.7s)	2928	2928	256	59	172	0	13	244
34531	22129s (+0.6s)	2444	2444	256	34	166	0	10	210
34532	22130s (+0.7s)	2808	2808	256	46	193	0	6	245
34533	22130s (+0.4s)	1312	1312	128	28	98	0	6	132
34534	22131s (+0.7s)	3064	3064	256	59	176	0	12	247
34535	22132s (+0.8s)	3296	3296	256	54	208	0	14	276
34536	22132s (+0.5s)	1576	1576	128	35	118	0	9	162
34537	22133s (+0.4s)	1620	1620	128	44	107	7	0	158
34538	22133s (+0.6s)	2032	2032	128	49	133	13	0	195
34539	22134s (+0.9s)	3856	3856	256	95	208	16	0	319
34540	22135s (+0.8s)	3296	3296	256	57	203	13	0	273
34541	22136s (+1.0s)	4176	4176	256	91	230	18	0	339
34542	22137s (+0.9s)	3448	3448	256	62	221	15	0	298
34543	22138s (+0.7s)	2788	2788	256	50	185	6	0	241
34544	22138s (+0.8s)	3476	3476	256	80	193	15	0	288
34545	22139s (+0.8s)	3516	3516	256	71	203	19	0	293
34546	22140s (+0.7s)	2608	2608	128	65	170	11	0	246
34547	22141s (+0.6s)	2468	2468	256	56	145	9	0	210
34548	22141s (+0.6s)	1932	1932	128	47	138	9	0	194
34549	22142s (+0.6s)	1964	1964	128	52	149	3	0	204
34550	22142s (+0.7s)	2812	2812	256	56	168	7	0	231
34551	22143s (+0.5s)	1820	1820	128	37	147	6	0	190
34552	22144s (+0.5s)	1756	1756	128	45	123	11	0	179
34553	22144s (+0.7s)	2948	2948	256	53	189	7	0	249
34554	22145s (+0.8s)	3508	3508	256	66	212	13	0	291
34555	22146s (+0.5s)	1608	1608	128	46	110	12	0	168
34556	22146s (+0.9s)	3776	3776	256	84	211	15	0	310
34557	22147s (+0.5s)	1552	1552	128	37	124	6	0	167
34558	22148s (+0.6s)	2544	2544	256	54	154	9	0	217
34559	22148s (+0.3s)	1004	1004	64	25	88	7	0	120
34560	22149s (+1.0s)	3908	3908	256	95	219	22	0	336
34561	22150s (+0.8s)	3272	3272	256	60	196	13	0	269
34562	22150s (+0.5s)	1500	1500	128	40	116	3	0	159
34563	22150s (+0.3s)	852	852	64	26	74	6	1	107
34564	22151s (+0.8s)	3208	3208	256	72	184	14	0	270
34565	22152s (+0.9s)	3728	3728	256	88	202	18	0	308
34566	22153s (+0.4s)	1208	1208	128	37	87	6	0	130
34567	22154s (+1.3s)	6668	6668	512	140	289	33	0	462
34568	22155s (+0.9s)	3872	3872	256	64	239	16	0	319
34569	22156s (+1.5s)	7428	7428	512	142	351	26	0	519
34570	22157s (+0.5s)	1728	1728	128	41	129	9	0	179
34571	22157s (+0.6s)	1928	1928	128	48	144	8	0	200
34572	22158s (+0.4s)	1228	1228	128	32	91	5	0	128
34573	22158s (+0.5s)	1892	1892	128	48	134	7	0	189
34574	22159s (+0.5s)	1608	1608	128	42	122	5	0	169
34575	22159s (+0.6s)	1908	1908	128	39	149	6	1	195
34576	22160s (+0.6s)	2700	2700	256	61	159	9	0	229
34577	22161s (+0.5s)	1756	1756	128	50	120	9	0	179
34578	22161s (+0.9s)	3872	3872	256	86	221	15	0	322
34579	22162s (+0.8s)	3284	3284	256	71	188	11	0	270
34580	22163s (+0.7s)	3228	3228	256	61	191	0	14	266
34581	22163s (+0.5s)	2040	2040	256	44	116	0	8	168
34582	22164s (+0.4s)	1300	1300	128	21	109	0	2	132
34583	22164s (+0.5s)	1836	1836	128	37	134	0	9	180
34584	22165s (+0.5s)	1524	1524	128	32	121	0	8	161
34585	22166s (+0.9s)	3800	3800	256	69	229	13	0	311
34586	22166s (+0.5s)	1900	1900	128	40	147	6	0	193
34587	22167s (+0.4s)	1376	1376	128	22	119	4	0	145
34588	22167s (+0.7s)	2620	2620	256	52	169	9	0	230
34589	22168s (+0.4s)	1440	1440	128	32	107	6	0	145
34590	22168s (+0.5s)	1732	1732	128	36	129	8	0	173
34591	22169s (+0.2s)	544	544	32	25	53	3	0	81
34592	22169s (+0.4s)	1500	1500	128	31	125	3	0	159
34593	22170s (+0.6s)	2468	2468	128	60	157	11	0	228
34594	22170s (+0.7s)	3156	3156	256	57	200	7	0	264
34595	22171s (+0.5s)	2168	2168	256	50	119	13	0	182
34596	22172s (+0.7s)	2684	2684	256	53	168	9	1	231
34597	22172s (+0.4s)	1084	1084	64	37	81	6	0	124
34598	22172s (+0.4s)	1300	1300	128	33	99	0	8	140
34599	22173s (+0.4s)	1236	1236	128	18	108	0	2	128
Episode	Time	Reward	Score	Highest	L	U	R	D	Steps
34600	22173s (+0.7s)	2816	2816	256	42	190	0	14	246
34601	22174s (+0.4s)	1056	1056	64	25	97	5	1	128
34602	22174s (+0.7s)	2868	2868	256	62	178	8	0	248
34603	22175s (+0.5s)	1636	1636	128	39	122	4	0	165
34604	22176s (+0.8s)	3588	3588	256	65	226	0	9	300
34605	22177s (+0.8s)	3512	3512	256	55	236	0	3	294
34606	22177s (+0.3s)	692	692	64	14	74	0	4	92
34607	22177s (+0.5s)	1532	1532	128	43	119	4	0	166
34608	22178s (+0.5s)	1852	1852	128	61	123	9	0	193
34609	22178s (+0.5s)	1724	1724	128	51	116	11	0	178
34610	22179s (+0.5s)	1592	1592	128	43	116	6	0	165
34611	22180s (+1.3s)	6532	6532	512	129	316	25	0	470
34612	22181s (+0.4s)	1296	1296	128	29	106	5	0	140
34613	22181s (+0.8s)	3576	3576	256	73	213	11	0	297
34614	22182s (+0.7s)	2924	2924	256	54	178	11	0	243
34615	22183s (+0.5s)	1676	1676	128	52	112	6	0	170
34616	22183s (+0.7s)	3204	3204	256	62	197	10	0	269
34617	22184s (+0.8s)	3232	3232	256	68	188	15	0	271
34618	22185s (+0.4s)	1376	1376	128	31	103	7	0	141
34619	22185s (+0.4s)	1252	1252	128	25	108	5	0	138
34620	22186s (+0.8s)	3272	3272	256	73	183	14	0	270
34621	22186s (+0.5s)	2160	2160	256	34	138	3	0	175
34622	22187s (+0.8s)	3248	3248	256	55	211	9	0	275
34623	22188s (+0.7s)	2940	2940	256	66	187	8	0	261
34624	22188s (+0.5s)	1884	1884	128	44	142	5	0	191
34625	22189s (+0.4s)	1072	1072	64	30	93	7	0	130
34626	22190s (+1.0s)	4268	4268	256	90	250	17	0	357
34627	22191s (+0.7s)	2820	2820	256	62	173	12	0	247
34628	22191s (+0.9s)	3604	3604	256	83	207	14	0	304
34629	22192s (+0.8s)	3404	3404	256	66	200	16	0	282
34630	22193s (+0.9s)	3404	3404	256	63	224	10	0	297
34631	22194s (+0.5s)	1896	1896	128	39	146	5	0	190
34632	22194s (+0.9s)	3584	3584	256	51	243	13	0	307
34633	22196s (+1.0s)	4312	4312	256	99	239	19	0	357
34634	22196s (+0.5s)	1556	1556	128	44	106	11	0	161
34635	22196s (+0.4s)	1100	1100	64	26	107	1	0	134
34636	22197s (+0.3s)	900	900	64	38	76	6	0	120
34637	22197s (+0.5s)	1764	1764	128	53	118	10	0	181
34638	22198s (+0.6s)	2508	2508	256	57	150	13	0	220
34639	22199s (+0.8s)	3500	3500	256	98	177	19	0	294
34640	22199s (+0.4s)	1400	1400	128	41	96	8	0	145
34641	22200s (+0.8s)	3500	3500	256	72	208	14	0	294
34642	22201s (+0.7s)	3124	3124	256	46	200	7	0	253
34643	22201s (+0.3s)	884	884	64	29	67	7	0	103
34644	22202s (+0.5s)	1596	1596	128	42	120	4	0	166
34645	22202s (+0.9s)	4648	4648	512	75	236	11	0	322
34646	22203s (+0.5s)	2228	2228	256	50	138	5	0	193
34647	22204s (+0.8s)	3248	3248	256	73	186	9	0	268
34648	22204s (+0.4s)	1460	1460	128	33	115	5	0	153
34649	22205s (+0.4s)	1340	1340	128	26	105	5	0	136
34650	22205s (+0.8s)	3232	3232	256	78	181	12	0	271
34651	22206s (+0.4s)	1384	1384	128	28	107	2	0	137
34652	22207s (+0.8s)	3384	3384	256	72	199	11	0	282
34653	22208s (+1.0s)	4968	4968	512	94	226	22	0	342
34654	22208s (+0.9s)	3652	3652	256	79	212	9	0	300
34655	22209s (+1.0s)	4276	4276	256	100	237	17	0	354
34656	22210s (+0.8s)	3224	3224	256	53	204	12	0	269
34657	22211s (+0.6s)	2216	2216	128	42	159	12	1	214
34658	22211s (+0.6s)	1896	1896	128	45	142	5	0	192
34659	22212s (+0.6s)	1912	1912	128	52	136	8	0	196
34660	22213s (+0.8s)	3512	3512	256	73	205	14	0	292
34661	22213s (+0.5s)	1684	1684	128	43	122	8	0	173
34662	22214s (+0.6s)	2608	2608	256	48	172	7	0	227
34663	22214s (+0.5s)	1796	1796	128	47	128	9	0	184
34664	22215s (+0.6s)	1940	1940	128	54	130	12	0	196
34665	22216s (+0.5s)	1856	1856	128	44	138	6	0	188
34666	22216s (+0.9s)	3536	3536	256	77	201	20	0	298
34667	22217s (+0.8s)	3236	3236	256	81	178	13	0	272
34668	22218s (+0.6s)	1884	1884	128	46	136	12	0	194
34669	22218s (+0.4s)	1428	1428	128	51	98	7	0	156
34670	22219s (+0.5s)	1868	1868	128	48	132	8	1	189
34671	22219s (+0.6s)	2740	2740	256	50	173	6	0	229
34672	22220s (+0.5s)	2044	2044	128	43	135	0	10	188
34673	22221s (+0.8s)	3288	3288	256	60	204	0	15	279
34674	22222s (+0.8s)	3232	3232	256	62	194	0	15	271
34675	22222s (+0.3s)	1152	1152	128	20	95	0	7	122
34676	22222s (+0.4s)	1300	1300	128	21	108	0	3	132
34677	22223s (+0.7s)	3232	3232	256	65	194	12	0	271
34678	22223s (+0.3s)	1104	1104	64	40	81	7	0	128
34679	22224s (+0.7s)	2932	2932	256	67	176	16	0	259
34680	22225s (+0.6s)	2240	2240	128	62	146	6	1	215
34681	22226s (+1.2s)	5708	5708	512	117	260	25	0	402
34682	22227s (+0.5s)	1800	1800	128	49	125	10	1	185
34683	22227s (+0.9s)	3596	3596	256	113	169	24	0	306
34684	22228s (+0.8s)	3460	3460	256	72	207	11	1	291
34685	22229s (+0.5s)	1748	1748	128	37	128	12	0	177
34686	22229s (+0.6s)	2304	2304	128	57	149	13	0	219
34687	22231s (+1.4s)	6848	6848	512	146	316	31	1	494
34688	22232s (+0.9s)	3628	3628	256	77	202	15	0	294
34689	22232s (+0.5s)	1800	1800	128	40	137	8	0	185
34690	22233s (+1.1s)	5440	5440	512	97	272	17	0	386
34691	22234s (+0.8s)	3324	3324	256	70	201	11	0	282
34692	22235s (+0.7s)	3044	3044	256	56	189	11	0	256
34693	22235s (+0.4s)	1192	1192	64	38	92	6	0	136
34694	22236s (+0.7s)	2672	2672	128	60	186	11	0	257
34695	22237s (+0.9s)	3656	3656	256	79	207	15	0	301
34696	22237s (+0.6s)	2496	2496	256	50	151	11	0	212
34697	22238s (+1.0s)	4376	4376	256	96	254	13	1	364
34698	22239s (+0.7s)	2692	2692	256	59	158	11	1	229
34699	22240s (+0.9s)	3604	3604	256	80	209	13	1	303
Episode	Time	Reward	Score	Highest	L	U	R	D	Steps
34700	22240s (+0.4s)	988	988	64	34	76	10	2	122
34701	22241s (+0.5s)	1740	1740	128	41	124	9	1	175
34702	22242s (+0.8s)	3356	3356	256	69	202	14	0	285
34703	22242s (+0.3s)	704	704	64	23	63	7	0	93
34704	22242s (+0.3s)	616	616	32	26	64	4	0	94
34705	22243s (+0.5s)	1652	1652	128	37	122	6	0	165
34706	22244s (+0.8s)	3484	3484	256	74	204	13	0	291
34707	22244s (+0.9s)	3692	3692	256	70	221	15	0	306
34708	22245s (+0.9s)	3512	3512	256	86	193	18	0	297
34709	22246s (+0.8s)	3608	3608	256	69	215	8	0	292
34710	22247s (+1.0s)	5248	5248	512	75	274	15	0	364
34711	22248s (+0.9s)	3628	3628	256	83	212	15	0	310
34712	22249s (+0.7s)	2660	2660	256	47	180	0	9	236
34713	22249s (+0.6s)	2672	2672	256	53	164	0	9	226
34714	22250s (+0.9s)	3628	3628	256	68	223	0	17	308
34715	22252s (+1.3s)	6476	6476	512	122	315	24	0	461
34716	22252s (+0.7s)	3128	3128	256	62	178	15	0	255
34717	22253s (+0.6s)	1912	1912	128	56	132	8	0	196
34718	22254s (+0.7s)	2768	2768	256	64	165	11	0	240
34719	22254s (+0.6s)	2400	2400	256	66	135	7	0	208
34720	22255s (+0.6s)	2400	2400	128	50	166	7	0	223
34721	22255s (+0.4s)	1432	1432	128	33	108	5	1	147
34722	22256s (+0.3s)	676	676	64	21	64	4	0	89
34723	22256s (+0.5s)	2068	2068	256	40	126	8	0	174
34724	22257s (+0.5s)	2240	2240	256	40	138	5	0	183
34725	22257s (+0.8s)	3488	3488	256	89	186	20	0	295
34726	22258s (+0.4s)	1176	1176	64	34	100	7	0	141
34727	22258s (+0.6s)	2144	2144	128	73	126	13	0	212
34728	22259s (+0.4s)	1536	1536	128	31	120	9	1	161
34729	22260s (+0.8s)	3568	3568	256	83	204	12	0	299
34730	22260s (+0.2s)	604	604	64	16	64	4	1	85
34731	22261s (+0.6s)	1960	1960	128	61	134	8	0	203
34732	22261s (+0.2s)	468	468	64	11	52	0	4	67
34733	22261s (+0.4s)	1488	1488	128	41	107	8	0	156
34734	22262s (+0.9s)	3956	3956	256	88	217	16	0	321
34735	22263s (+0.7s)	2504	2504	128	64	161	11	1	237
34736	22263s (+0.6s)	2628	2628	256	58	154	9	0	221
34737	22264s (+0.7s)	2452	2452	128	66	159	14	0	239
34738	22265s (+0.6s)	2168	2168	128	54	136	11	1	202
34739	22265s (+0.7s)	3080	3080	256	62	178	0	14	254
34740	22266s (+0.4s)	1280	1280	128	28	106	0	6	140
34741	22267s (+0.8s)	3468	3468	256	59	214	0	14	287
34742	22267s (+0.7s)	2928	2928	256	56	177	1	10	244
34743	22268s (+0.2s)	564	564	64	11	67	0	2	80
34744	22268s (+0.5s)	1744	1744	128	30	139	0	7	176
34745	22269s (+0.7s)	2912	2912	256	78	150	11	1	240
34746	22269s (+0.6s)	1868	1868	128	43	148	6	0	197
34747	22270s (+0.5s)	1660	1660	128	47	117	8	0	172
34748	22270s (+0.6s)	1944	1944	128	50	133	10	0	193
34749	22271s (+0.6s)	2380	2380	128	67	141	14	1	223
34750	22272s (+1.0s)	4216	4216	256	100	232	13	0	345
34751	22273s (+1.0s)	4012	4012	256	80	241	16	0	337
34752	22274s (+0.6s)	1972	1972	128	51	141	8	0	200
34753	22274s (+0.5s)	1896	1896	128	50	134	7	1	192
34754	22275s (+0.8s)	3688	3688	256	62	210	0	22	294
34755	22276s (+0.9s)	3796	3796	256	60	243	0	12	315
34756	22277s (+0.6s)	2308	2308	128	39	177	0	11	227
34757	22277s (+0.5s)	1928	1928	128	43	148	0	9	200
34758	22278s (+0.6s)	2504	2504	256	60	142	15	0	217
34759	22279s (+1.1s)	5508	5508	512	99	278	15	0	392
34760	22280s (+0.7s)	2800	2800	256	75	157	11	0	243
34761	22280s (+0.6s)	2544	2544	256	44	172	7	0	223
34762	22281s (+0.9s)	3608	3608	256	69	219	16	0	304
34763	22282s (+0.9s)	3624	3624	256	79	217	12	0	308
34764	22283s (+1.0s)	4340	4340	256	91	241	16	0	348
34765	22283s (+0.4s)	1080	1080	64	36	86	8	0	130
34766	22284s (+0.4s)	1188	1188	128	19	106	4	0	129
34767	22284s (+0.4s)	1836	1836	256	24	112	4	0	140
34768	22285s (+0.8s)	3320	3320	256	56	209	11	0	276
34769	22285s (+0.5s)	1688	1688	128	43	125	6	0	174
34770	22286s (+0.6s)	1988	1988	128	51	140	9	0	200
34771	22287s (+0.5s)	1544	1544	128	38	113	13	0	164
34772	22287s (+0.4s)	1512	1512	128	36	113	8	0	157
34773	22288s (+0.7s)	3116	3116	256	48	203	6	1	258
34774	22288s (+0.7s)	2888	2888	256	52	177	10	0	239
34775	22289s (+0.4s)	1200	1200	128	28	99	5	0	132
34776	22290s (+0.8s)	3336	3336	256	71	193	0	16	280
34777	22290s (+0.2s)	612	612	64	13	67	0	4	84
34778	22291s (+0.7s)	2660	2660	256	44	180	0	11	235
34779	22291s (+0.6s)	2504	2504	256	48	152	0	11	211
34780	22291s (+0.2s)	484	484	64	12	54	3	0	69
34781	22292s (+0.5s)	1588	1588	128	41	119	8	0	168
34782	22292s (+0.6s)	2228	2228	128	62	140	10	0	212
34783	22293s (+0.8s)	3584	3584	256	75	212	15	0	302
34784	22294s (+0.5s)	1784	1784	128	54	118	9	0	181
34785	22295s (+0.9s)	3540	3540	256	80	204	15	0	299
34786	22295s (+0.5s)	2192	2192	256	28	157	3	0	188
34787	22296s (+0.9s)	3588	3588	256	73	213	18	0	304
34788	22297s (+0.5s)	1740	1740	128	43	124	9	0	176
34789	22297s (+0.5s)	1812	1812	128	49	130	9	0	188
34790	22298s (+0.4s)	1608	1608	128	40	113	5	0	158
34791	22298s (+0.9s)	4008	4008	256	78	243	15	0	336
34792	22299s (+0.9s)	3956	3956	256	77	236	15	0	328
34793	22300s (+0.8s)	3508	3508	256	75	209	12	0	296
34794	22301s (+0.6s)	2444	2444	256	47	154	6	0	207
34795	22301s (+0.5s)	1596	1596	128	30	124	7	0	161
34796	22302s (+0.4s)	1236	1236	128	29	101	7	0	137
34797	22302s (+0.5s)	1728	1728	128	46	117	9	0	172
34798	22303s (+0.4s)	1400	1400	128	24	113	0	9	146
34799	22303s (+0.3s)	960	960	128	24	78	4	0	106
Episode	Time	Reward	Score	Highest	L	U	R	D	Steps
34800	22303s (+0.4s)	1488	1488	128	37	103	7	0	147
34801	22304s (+0.7s)	2728	2728	256	36	189	0	6	231
34802	22305s (+0.7s)	3192	3192	256	84	166	16	0	266
34803	22306s (+1.5s)	7492	7492	512	141	354	29	0	524
34804	22307s (+0.5s)	1932	1932	128	47	130	12	1	190
34805	22308s (+1.1s)	5512	5512	512	95	278	20	1	394
34806	22309s (+1.0s)	5168	5168	512	88	263	18	1	370
34807	22309s (+0.2s)	576	576	64	14	64	2	0	80
34808	22310s (+1.0s)	4216	4216	256	97	233	15	0	345
34809	22311s (+0.8s)	3348	3348	256	67	204	12	0	283
34810	22311s (+0.5s)	1700	1700	128	50	112	8	0	170
34811	22312s (+0.3s)	772	772	64	22	71	6	1	100
34812	22312s (+0.6s)	2496	2496	256	54	151	11	0	216
34813	22313s (+0.4s)	1420	1420	128	38	106	6	1	151
34814	22314s (+0.7s)	2768	2768	256	61	163	15	0	239
34815	22314s (+0.6s)	1920	1920	128	45	146	7	0	198
34816	22314s (+0.3s)	704	704	64	18	70	6	0	94
34817	22315s (+0.7s)	2952	2952	256	60	172	15	2	249
34818	22316s (+0.5s)	1840	1840	128	61	119	10	0	190
34819	22317s (+1.0s)	5240	5240	512	86	250	16	0	352
34820	22317s (+0.6s)	2480	2480	256	44	157	0	11	212
34821	22318s (+0.7s)	2676	2676	256	59	163	0	12	234
34822	22318s (+0.2s)	580	580	64	11	68	0	1	80
34823	22319s (+0.6s)	1924	1924	128	41	149	0	9	199
34824	22319s (+0.4s)	1376	1376	128	31	109	0	5	145
34825	22320s (+0.6s)	2628	2628	256	58	161	6	0	225
34826	22320s (+0.5s)	1656	1656	128	40	124	10	0	174
34827	22321s (+0.8s)	3628	3628	256	88	208	13	0	309
34828	22322s (+0.8s)	3172	3172	256	72	186	9	0	267
34829	22322s (+0.6s)	2332	2332	256	49	135	12	0	196
34830	22323s (+0.6s)	2552	2552	256	69	140	8	0	217
34831	22324s (+0.4s)	1296	1296	128	25	116	3	0	144
34832	22324s (+0.4s)	1304	1304	128	39	96	7	0	142
34833	22324s (+0.4s)	1408	1408	128	32	109	7	0	148
34834	22325s (+0.3s)	732	732	64	24	64	7	0	95
34835	22325s (+0.4s)	1164	1164	128	28	92	5	0	125
34836	22326s (+0.5s)	1652	1652	128	39	130	0	6	175
34837	22326s (+0.1s)	260	260	32	11	36	0	2	49
34838	22326s (+0.6s)	2216	2216	128	41	155	0	14	210
34839	22327s (+0.7s)	2800	2800	256	44	186	0	14	244
34840	22328s (+0.8s)	3440	3440	256	64	210	0	17	291
34841	22328s (+0.3s)	600	600	32	21	66	0	3	90
34842	22329s (+0.5s)	1816	1816	128	28	146	0	8	182
34843	22329s (+0.5s)	1624	1624	128	31	122	0	10	163
34844	22330s (+0.5s)	1656	1656	128	34	130	0	3	167
34845	22331s (+1.0s)	4496	4496	256	97	252	17	0	366
34846	22331s (+0.8s)	3344	3344	256	66	203	8	0	277
34847	22332s (+0.8s)	3260	3260	256	75	183	13	0	271
34848	22333s (+0.3s)	892	892	64	36	63	9	0	108
34849	22333s (+0.7s)	2896	2896	256	59	181	10	0	250
34850	22334s (+0.9s)	3836	3836	256	88	202	19	0	309
34851	22335s (+0.8s)	3484	3484	256	79	199	13	0	291
34852	22336s (+0.7s)	3216	3216	256	61	191	15	0	267
34853	22337s (+1.0s)	4284	4284	256	104	233	19	0	356
34854	22338s (+0.9s)	3524	3524	256	78	206	15	0	299
34855	22338s (+0.8s)	3392	3392	256	69	199	16	0	284
34856	22339s (+0.5s)	1712	1712	128	54	117	9	0	180
34857	22339s (+0.4s)	1420	1420	128	34	104	7	0	145
34858	22341s (+1.3s)	6548	6548	512	125	304	26	0	455
34859	22342s (+1.3s)	6340	6340	512	112	321	20	1	454
34860	22343s (+0.6s)	1892	1892	128	34	155	7	0	196
34861	22343s (+0.8s)	3364	3364	256	71	204	12	0	287
34862	22344s (+0.4s)	1352	1352	128	27	105	6	0	138
34863	22344s (+0.4s)	1100	1100	64	28	94	6	0	128
34864	22345s (+0.7s)	3164	3164	256	62	187	11	0	260
34865	22345s (+0.6s)	2288	2288	128	60	144	12	0	216
34866	22346s (+0.8s)	3484	3484	256	67	209	14	0	290
34867	22347s (+0.7s)	2912	2912	256	57	189	8	0	254
34868	22348s (+0.5s)	2188	2188	256	38	139	7	1	185
34869	22348s (+0.7s)	2928	2928	256	63	186	9	0	258
34870	22349s (+0.7s)	3244	3244	256	64	199	11	0	274
34871	22349s (+0.5s)	1592	1592	128	38	125	3	1	167
34872	22350s (+0.7s)	2944	2944	256	59	191	12	0	262
34873	22351s (+0.5s)	1844	1844	128	46	139	7	0	192
34874	22351s (+0.4s)	1128	1128	128	31	90	4	1	126
34875	22352s (+0.5s)	1512	1512	128	39	118	4	0	161
34876	22352s (+0.5s)	1776	1776	128	42	130	7	0	179
34877	22353s (+0.9s)	3700	3700	256	60	233	0	14	307
34878	22354s (+0.5s)	1988	1988	128	32	140	0	12	184
34879	22354s (+0.5s)	1808	1808	128	39	135	0	12	186
34880	22354s (+0.2s)	500	500	32	11	59	0	5	75
34881	22355s (+0.7s)	3036	3036	256	61	184	9	0	254
34882	22356s (+0.9s)	3780	3780	256	92	208	16	0	316
34883	22356s (+0.5s)	1688	1688	128	40	130	4	0	174
34884	22357s (+0.9s)	3692	3692	256	83	207	20	0	310
34885	22358s (+0.3s)	652	652	64	25	63	3	0	91
34886	22358s (+0.3s)	708	708	64	25	67	3	0	95
34887	22358s (+0.4s)	1200	1200	128	28	99	5	0	132
34888	22359s (+0.5s)	1624	1624	128	48	108	10	0	166
34889	22359s (+0.6s)	2148	2148	128	55	138	11	0	204
34890	22360s (+0.7s)	3092	3092	256	61	184	10	0	255
34891	22361s (+0.7s)	3064	3064	256	59	190	11	0	260
34892	22361s (+0.7s)	2528	2528	128	66	161	11	0	238
34893	22362s (+0.9s)	4004	4004	256	94	204	25	2	325
34894	22363s (+0.3s)	960	960	64	24	86	7	0	117
34895	22363s (+0.4s)	1464	1464	128	47	100	6	1	154
34896	22364s (+0.8s)	3312	3312	256	57	205	14	0	276
34897	22365s (+0.6s)	2584	2584	256	63	149	13	1	226
34898	22365s (+0.8s)	3604	3604	256	74	213	13	0	300
34899	22366s (+0.5s)	1616	1616	128	40	117	7	0	164
Episode	Time	Reward	Score	Highest	L	U	R	D	Steps
34900	22366s (+0.5s)	1584	1584	128	44	114	5	0	163
34901	22367s (+0.6s)	2632	2632	256	38	179	7	0	224
34902	22368s (+0.9s)	3956	3956	256	68	244	11	0	323
34903	22368s (+0.5s)	1568	1568	128	39	119	6	0	164
34904	22369s (+0.8s)	3360	3360	256	74	200	12	0	286
34905	22370s (+0.7s)	2780	2780	256	64	163	11	0	238
34906	22370s (+0.5s)	1752	1752	128	51	118	9	1	179
34907	22372s (+1.1s)	4624	4624	256	112	252	18	0	382
34908	22372s (+0.4s)	1380	1380	128	22	117	6	0	145
34909	22373s (+0.8s)	3304	3304	256	62	206	4	0	272
34910	22373s (+0.7s)	2732	2732	256	54	164	13	0	231
34911	22374s (+0.5s)	1912	1912	128	49	141	6	0	196
34912	22374s (+0.5s)	1776	1776	128	50	119	10	0	179
34913	22375s (+0.7s)	2784	2784	256	66	157	15	1	239
34914	22376s (+0.5s)	1788	1788	128	40	135	7	0	182
34915	22376s (+0.5s)	1788	1788	128	38	136	8	0	182
34916	22377s (+0.8s)	3364	3364	256	79	196	17	0	292
34917	22377s (+0.5s)	1516	1516	128	29	124	9	0	162
34918	22378s (+0.3s)	748	748	64	25	70	5	0	100
34919	22378s (+0.4s)	1352	1352	128	35	100	4	0	139
34920	22379s (+0.5s)	1792	1792	128	44	134	0	6	184
34921	22379s (+0.5s)	1900	1900	128	38	153	0	3	194
34922	22380s (+0.7s)	2804	2804	256	42	192	0	10	244
34923	22381s (+0.8s)	3444	3444	256	54	225	0	13	292
34924	22381s (+0.6s)	2256	2256	128	46	162	0	11	219
34925	22382s (+0.7s)	3152	3152	256	42	213	0	8	263
34926	22383s (+0.7s)	2588	2588	256	46	171	0	10	227
34927	22383s (+0.5s)	1688	1688	128	36	127	0	9	172
34928	22384s (+0.6s)	2552	2552	256	48	167	0	10	225
34929	22384s (+0.3s)	980	980	64	18	89	0	8	115
34930	22385s (+0.3s)	768	768	64	20	78	0	5	103
34931	22385s (+0.3s)	1056	1056	128	27	81	0	6	114
34932	22385s (+0.5s)	2128	2128	256	44	129	5	0	178
34933	22386s (+0.9s)	3888	3888	256	71	234	9	0	314
34934	22387s (+0.8s)	3444	3444	256	53	220	12	0	285
34935	22388s (+0.4s)	1284	1284	128	21	114	3	0	138
34936	22389s (+1.0s)	4160	4160	256	76	245	14	0	335
34937	22389s (+0.3s)	1020	1020	64	25	94	5	0	124
34938	22390s (+0.8s)	3484	3484	256	59	222	13	0	294
34939	22391s (+1.0s)	4044	4044	256	98	222	20	0	340
34940	22391s (+0.3s)	668	668	32	24	64	6	1	95
34941	22392s (+0.6s)	1924	1924	128	47	142	10	0	199
34942	22392s (+0.8s)	3480	3480	256	85	192	12	0	289
34943	22393s (+0.3s)	832	832	64	20	79	5	0	104
34944	22393s (+0.6s)	2632	2632	256	66	154	12	0	232
34945	22394s (+0.4s)	1336	1336	128	28	108	9	0	145
34946	22394s (+0.4s)	1404	1404	128	47	103	7	0	157
34947	22394s (+0.3s)	876	876	64	26	83	5	0	114
34948	22395s (+0.6s)	2076	2076	128	57	142	10	0	209
34949	22396s (+0.8s)	3228	3228	256	70	184	15	0	269
34950	22396s (+0.6s)	1912	1912	128	46	144	6	0	196
34951	22397s (+0.8s)	3552	3552	256	56	228	11	0	295
34952	22398s (+0.8s)	3376	3376	256	63	204	12	0	279
34953	22398s (+0.3s)	808	808	64	19	76	4	0	99
34954	22399s (+0.5s)	2084	2084	256	30	136	6	0	172
34955	22400s (+0.8s)	3356	3356	256	70	206	9	0	285
34956	22400s (+0.3s)	600	600	32	30	56	4	0	90
34957	22401s (+1.1s)	4564	4564	256	113	248	17	0	378
34958	22401s (+0.3s)	996	996	128	18	78	5	0	101
34959	22402s (+0.4s)	1128	1128	64	28	94	11	1	134
34960	22402s (+0.8s)	3252	3252	256	50	219	7	0	276
34961	22403s (+0.6s)	1908	1908	128	51	137	7	0	195
34962	22404s (+0.5s)	1684	1684	128	52	107	14	0	173
34963	22404s (+0.3s)	1092	1092	128	26	88	0	5	119
34964	22405s (+0.7s)	2912	2912	256	46	201	0	7	254
34965	22406s (+1.0s)	4420	4420	256	67	276	0	20	363
34966	22406s (+0.3s)	1020	1020	128	15	92	0	3	110
34967	22407s (+0.6s)	2508	2508	256	48	165	0	6	219
34968	22407s (+0.6s)	2584	2584	256	50	155	0	16	221
34969	22408s (+0.6s)	2460	2460	256	42	159	0	7	208
34970	22409s (+0.7s)	2760	2760	256	51	177	0	6	234
34971	22409s (+0.4s)	1292	1292	128	31	96	0	12	139
34972	22409s (+0.4s)	1600	1600	128	30	121	0	6	157
34973	22410s (+0.3s)	1068	1068	128	26	87	0	3	116
34974	22410s (+0.6s)	2176	2176	128	44	152	0	10	206
34975	22411s (+0.3s)	1104	1104	128	27	90	0	1	118
34976	22411s (+0.6s)	2556	2556	256	44	161	10	0	215
34977	22412s (+0.6s)	1952	1952	128	50	138	11	0	199
34978	22413s (+0.8s)	3408	3408	256	77	199	12	0	288
34979	22413s (+0.7s)	2968	2968	256	61	184	15	0	260
34980	22415s (+1.1s)	5268	5268	512	105	248	18	0	371
34981	22415s (+1.0s)	4096	4096	256	84	239	13	0	336
34982	22416s (+0.5s)	1612	1612	128	51	110	9	0	170
34983	22416s (+0.4s)	1276	1276	128	31	100	5	0	136
34984	22417s (+0.5s)	1716	1716	128	31	135	6	1	173
34985	22417s (+0.5s)	1612	1612	128	45	120	5	0	170
34986	22418s (+0.9s)	3776	3776	256	72	213	17	0	302
34987	22419s (+1.1s)	5680	5680	512	108	270	20	1	399
34988	22420s (+0.4s)	1120	1120	64	32	93	6	1	132
34989	22421s (+0.9s)	3712	3712	256	59	220	20	0	299
34990	22421s (+0.7s)	2916	2916	256	53	181	0	14	248
34991	22422s (+0.8s)	3252	3252	256	49	215	0	9	273
34992	22423s (+0.8s)	3348	3348	256	64	194	0	16	274
34993	22423s (+0.2s)	560	560	32	16	59	0	7	82
34994	22424s (+0.4s)	1312	1312	128	26	100	0	8	134
34995	22424s (+0.9s)	3940	3940	256	88	212	19	0	319
34996	22425s (+0.4s)	1608	1608	128	36	118	6	1	161
34997	22426s (+0.6s)	2728	2728	256	55	166	9	0	230
34998	22426s (+0.4s)	1304	1304	128	31	97	4	0	132
34999	22427s (+0.6s)	2288	2288	128	59	145	16	0	220
Episode	Time	Reward	Score	Highest	L	U	R	D	Steps
35000	22428s (+1.0s)	4132	4132	256	76	252	11	0	339
35001	22428s (+0.8s)	3252	3252	256	55	208	13	0	276
35002	22429s (+0.3s)	852	852	64	28	72	6	0	106
35003	22429s (+0.5s)	2052	2052	128	56	125	10	0	191
35004	22430s (+0.5s)	1864	1864	128	44	135	11	0	190
35005	22430s (+0.7s)	3124	3124	256	58	207	6	0	271
35006	22431s (+0.4s)	1532	1532	128	36	122	4	0	162
35007	22432s (+0.8s)	3364	3364	256	62	206	10	0	278
35008	22432s (+0.2s)	564	564	64	15	61	1	0	77
35009	22433s (+0.7s)	3068	3068	256	53	194	6	0	253
35010	22433s (+0.6s)	2240	2240	128	55	148	15	1	219
35011	22434s (+0.4s)	1408	1408	128	31	108	8	0	147
35012	22434s (+0.5s)	1828	1828	128	40	139	5	0	184
35013	22435s (+0.7s)	2920	2920	256	63	173	16	0	252
35014	22436s (+0.8s)	3320	3320	256	57	208	0	12	277
35015	22437s (+0.8s)	3296	3296	256	59	210	0	13	282
35016	22437s (+0.4s)	1936	1936	256	31	119	0	5	155
35017	22438s (+0.8s)	3536	3536	256	63	216	0	20	299
35018	22438s (+0.6s)	2516	2516	128	43	178	0	9	230
35019	22439s (+0.6s)	2636	2636	256	61	146	0	13	220
35020	22440s (+0.8s)	3224	3224	256	53	206	0	10	269
35021	22440s (+0.3s)	700	700	64	15	75	0	2	92
35022	22441s (+0.7s)	3052	3052	256	43	204	0	11	258
35023	22441s (+0.6s)	1964	1964	128	36	148	0	10	194
35024	22442s (+0.9s)	3720	3720	256	72	222	17	1	312
35025	22443s (+0.9s)	3620	3620	256	88	199	16	0	303
35026	22444s (+0.7s)	2836	2836	256	48	182	10	1	241
35027	22445s (+1.0s)	4228	4228	256	101	225	21	0	347
35028	22445s (+0.5s)	1620	1620	128	46	118	6	1	171
35029	22447s (+1.5s)	7416	7416	512	148	340	33	0	521
35030	22448s (+0.7s)	2936	2936	256	51	181	12	1	245
35031	22449s (+1.0s)	4320	4320	256	76	263	19	0	358
35032	22449s (+0.2s)	524	524	64	17	57	2	0	76
35033	22449s (+0.2s)	604	604	64	18	62	1	0	81
35034	22450s (+0.6s)	2556	2556	256	56	153	10	0	219
35035	22451s (+0.6s)	2120	2120	128	58	140	11	0	209
35036	22451s (+0.8s)	3396	3396	256	78	193	13	0	284
35037	22452s (+0.6s)	2056	2056	128	43	148	9	0	200
35038	22453s (+0.5s)	2128	2128	256	40	133	11	0	184
35039	22453s (+0.6s)	2504	2504	256	51	152	11	0	214
35040	22454s (+0.7s)	3084	3084	256	61	172	16	0	249
35041	22455s (+0.8s)	3220	3220	256	67	191	9	0	267
35042	22455s (+0.6s)	2640	2640	256	55	164	9	0	228
35043	22456s (+0.5s)	2020	2020	128	50	140	6	0	196
35044	22456s (+0.4s)	1488	1488	128	39	97	10	0	146
35045	22457s (+0.6s)	2564	2564	256	55	152	10	0	217
35046	22457s (+0.6s)	2028	2028	128	45	152	6	0	203
35047	22458s (+0.3s)	980	980	64	39	75	7	0	121
35048	22458s (+0.7s)	2504	2504	128	61	165	11	0	237
35049	22459s (+0.5s)	1604	1604	128	35	125	7	0	167
35050	22459s (+0.5s)	1640	1640	128	44	122	4	0	170
35051	22460s (+0.5s)	1740	1740	128	35	135	5	0	175
35052	22460s (+0.5s)	1772	1772	128	49	120	9	0	178
35053	22461s (+0.6s)	2748	2748	256	59	161	14	0	234
35054	22462s (+1.0s)	5276	5276	512	91	258	19	0	368
35055	22463s (+0.4s)	1272	1272	128	34	104	3	0	141
35056	22464s (+1.0s)	4324	4324	256	110	223	22	0	355
35057	22464s (+0.8s)	3408	3408	256	69	198	16	0	283
35058	22465s (+0.5s)	1836	1836	128	56	119	8	0	183
35059	22466s (+0.6s)	2364	2364	128	65	144	11	0	220
35060	22466s (+0.8s)	3428	3428	256	88	199	11	0	298
35061	22467s (+0.3s)	732	732	64	16	76	5	0	97
35062	22467s (+0.5s)	1576	1576	128	44	116	8	0	168
35063	22468s (+0.4s)	1008	1008	64	36	87	8	0	131
35064	22468s (+0.6s)	2628	2628	256	44	160	0	11	215
35065	22469s (+0.7s)	3224	3224	256	53	201	0	15	269
35066	22470s (+0.6s)	2468	2468	256	41	162	0	7	210
35067	22470s (+0.5s)	1924	1924	128	41	132	0	11	184
35068	22471s (+0.9s)	3896	3896	256	66	241	0	13	320
35069	22472s (+0.8s)	3352	3352	256	62	208	0	14	284
35070	22472s (+0.4s)	1316	1316	128	27	101	0	7	135
35071	22473s (+0.6s)	2420	2420	256	44	153	0	12	209
35072	22473s (+0.5s)	1708	1708	128	37	131	0	10	178
35073	22474s (+0.7s)	2652	2652	256	47	174	0	16	237
35074	22474s (+0.5s)	1856	1856	128	34	145	0	9	188
35075	22475s (+0.8s)	3576	3576	256	63	215	0	16	294
35076	22476s (+0.3s)	616	616	32	17	64	0	7	88
35077	22476s (+0.7s)	2776	2776	256	41	185	0	12	238
35078	22477s (+0.8s)	3272	3272	256	48	216	0	12	276
35079	22478s (+0.5s)	1776	1776	128	31	143	0	5	179
35080	22479s (+1.1s)	4608	4608	256	113	247	18	0	378
35081	22479s (+0.8s)	3304	3304	256	68	194	11	0	273
35082	22480s (+0.5s)	1752	1752	128	45	127	5	0	177
35083	22480s (+0.4s)	1048	1048	64	24	98	4	0	126
35084	22481s (+0.8s)	3328	3328	256	62	213	8	0	283
35085	22482s (+0.6s)	1912	1912	128	49	140	7	0	196
35086	22482s (+0.4s)	1012	1012	64	33	83	6	0	122
35087	22483s (+0.5s)	1608	1608	128	40	123	6	0	169
35088	22483s (+0.6s)	1944	1944	128	49	141	4	0	194
35089	22483s (+0.3s)	904	904	64	32	80	4	0	116
35090	22484s (+0.9s)	3880	3880	256	66	251	12	0	329
35091	22485s (+0.5s)	2068	2068	256	30	128	6	0	164
35092	22485s (+0.5s)	1892	1892	128	41	133	17	0	191
35093	22486s (+0.5s)	2344	2344	256	38	153	8	0	199
35094	22487s (+0.7s)	3116	3116	256	71	173	15	0	259
35095	22487s (+0.7s)	2956	2956	256	60	191	9	0	260
35096	22488s (+1.0s)	4252	4252	256	92	243	18	0	353
35097	22489s (+0.3s)	884	884	64	29	82	5	0	116
35098	22489s (+0.3s)	1096	1096	128	34	79	4	0	117
35099	22490s (+0.5s)	1704	1704	128	45	128	4	0	177
Episode	Time	Reward	Score	Highest	L	U	R	D	Steps
35100	22490s (+0.8s)	3392	3392	256	76	190	14	0	280
35101	22491s (+0.5s)	1592	1592	128	33	120	6	1	160
35102	22492s (+0.7s)	2860	2860	256	68	171	9	0	248
35103	22492s (+0.8s)	3228	3228	256	74	189	13	1	277
35104	22493s (+0.5s)	1840	1840	128	40	138	9	0	187
35105	22494s (+1.3s)	6252	6252	512	112	310	28	0	450
35106	22495s (+0.5s)	1584	1584	128	35	116	5	0	156
35107	22495s (+0.6s)	2664	2664	256	57	152	7	0	216
35108	22496s (+0.7s)	2752	2752	256	70	153	13	0	236
35109	22497s (+0.9s)	4036	4036	256	102	211	20	0	333
35110	22497s (+0.4s)	1488	1488	128	35	115	6	0	156
35111	22498s (+0.8s)	3504	3504	256	71	209	16	0	296
35112	22499s (+0.3s)	832	832	64	30	76	5	0	111
35113	22499s (+0.5s)	1884	1884	128	48	126	5	0	179
35114	22500s (+0.5s)	1788	1788	128	43	132	7	0	182
35115	22500s (+0.3s)	804	804	64	21	67	5	0	93
35116	22500s (+0.5s)	1564	1564	128	43	111	9	0	163
35117	22501s (+0.9s)	3792	3792	256	96	207	16	0	319
35118	22502s (+0.8s)	3204	3204	256	76	175	13	0	264
35119	22503s (+0.6s)	2236	2236	128	51	153	0	10	214
35120	22503s (+0.4s)	1048	1048	64	31	90	0	5	126
35121	22504s (+0.6s)	2436	2436	256	65	136	0	12	213
35122	22504s (+0.6s)	2316	2316	256	39	147	0	8	194
35123	22505s (+0.5s)	1504	1504	128	33	119	0	7	159
35124	22505s (+0.5s)	1516	1516	128	30	122	0	10	162
35125	22505s (+0.3s)	848	848	64	29	76	3	0	108
35126	22506s (+0.5s)	1624	1624	128	34	126	10	0	170
35127	22507s (+0.7s)	2872	2872	256	64	169	16	0	249
35128	22507s (+0.4s)	1144	1144	64	37	96	7	0	140
35129	22508s (+0.8s)	3228	3228	256	64	194	12	0	270
35130	22508s (+0.6s)	2372	2372	256	39	156	7	0	202
35131	22509s (+0.5s)	1796	1796	128	38	143	4	0	185
35132	22509s (+0.5s)	1892	1892	128	46	139	6	0	191
35133	22510s (+0.4s)	1408	1408	128	36	100	6	0	142
35134	22511s (+0.7s)	2788	2788	256	50	181	11	1	243
35135	22511s (+0.7s)	3288	3288	256	58	199	14	2	273
35136	22512s (+0.4s)	1392	1392	128	34	108	4	0	146
35137	22513s (+0.8s)	3224	3224	256	76	178	15	0	269
35138	22514s (+1.0s)	4216	4216	256	90	233	22	0	345
35139	22514s (+0.4s)	1192	1192	128	25	92	7	0	124
35140	22515s (+1.1s)	5700	5700	512	101	270	24	1	396
35141	22516s (+0.6s)	2452	2452	256	48	153	8	0	209
35142	22516s (+0.5s)	1748	1748	128	34	137	6	0	177
35143	22517s (+0.7s)	3016	3016	256	68	164	14	0	246
35144	22517s (+0.5s)	1932	1932	128	45	130	10	2	187
35145	22518s (+0.5s)	1756	1756	128	29	144	5	0	178
35146	22518s (+0.5s)	1896	1896	128	54	125	11	0	190
35147	22519s (+0.4s)	1300	1300	128	22	110	6	0	138
35148	22519s (+0.3s)	1144	1144	64	27	95	3	0	125
35149	22520s (+0.5s)	1792	1792	128	51	125	7	0	183
35150	22521s (+0.8s)	3684	3684	256	73	222	9	0	304
35151	22521s (+0.4s)	1532	1532	128	43	113	6	0	162
35152	22522s (+1.0s)	4172	4172	256	82	241	15	0	338
35153	22522s (+0.4s)	1448	1448	128	35	113	3	0	151
35154	22523s (+0.7s)	2768	2768	256	58	164	18	0	240
35155	22524s (+0.9s)	3804	3804	256	68	227	11	0	306
35156	22524s (+0.5s)	1764	1764	128	51	116	9	0	176
35157	22525s (+0.5s)	1692	1692	128	50	112	12	0	174
35158	22525s (+0.4s)	1488	1488	128	34	114	7	0	155
35159	22526s (+0.5s)	1840	1840	128	42	140	8	0	190
35160	22526s (+0.3s)	772	772	64	22	80	1	0	103
35161	22527s (+0.6s)	2708	2708	256	57	157	11	0	225
35162	22528s (+1.0s)	4104	4104	256	84	244	15	0	343
35163	22529s (+1.0s)	4160	4160	256	79	251	0	13	343
35164	22530s (+0.8s)	3316	3316	256	63	199	0	13	275
35165	22530s (+0.5s)	1768	1768	128	37	133	0	11	181
35166	22531s (+0.5s)	1608	1608	128	36	121	0	6	163
35167	22531s (+0.5s)	1740	1740	128	33	137	0	6	176
35168	22531s (+0.3s)	788	788	64	20	74	5	0	99
35169	22532s (+0.5s)	1852	1852	128	51	132	8	1	192
35170	22533s (+0.8s)	3472	3472	256	73	200	13	2	288
35171	22533s (+0.4s)	1424	1424	128	34	104	6	1	145
35172	22534s (+0.6s)	2320	2320	128	58	158	7	0	223
35173	22534s (+0.3s)	676	676	64	12	75	1	0	88
35174	22535s (+0.7s)	2884	2884	256	59	165	9	0	233
35175	22536s (+0.8s)	2984	2984	256	72	186	9	0	267
35176	22536s (+0.5s)	1616	1616	128	40	111	9	1	161
35177	22537s (+0.5s)	1788	1788	128	40	135	7	0	182
35178	22537s (+0.7s)	3184	3184	256	71	176	12	0	259
35179	22538s (+0.7s)	3056	3056	256	62	176	11	1	250
35180	22538s (+0.4s)	1348	1348	128	26	112	6	0	144
35181	22539s (+0.6s)	2332	2332	256	48	135	10	0	193
35182	22540s (+0.7s)	3000	3000	256	47	194	9	0	250
35183	22541s (+0.8s)	3488	3488	256	66	215	10	0	291
35184	22541s (+0.4s)	1360	1360	128	36	98	7	0	141
35185	22542s (+1.0s)	4108	4108	256	93	226	22	0	341
35186	22543s (+0.8s)	3544	3544	256	69	218	11	0	298
35187	22543s (+0.7s)	2764	2764	256	49	185	6	0	240
35188	22544s (+0.5s)	2328	2328	256	37	144	5	0	186
35189	22544s (+0.4s)	1408	1408	128	37	103	8	0	148
35190	22545s (+0.5s)	1700	1700	128	42	122	12	0	176
35191	22546s (+0.6s)	2052	2052	128	47	148	9	0	204
35192	22546s (+0.8s)	3456	3456	256	73	197	17	1	288
35193	22547s (+0.5s)	1836	1836	128	55	119	13	0	187
35194	22547s (+0.4s)	1368	1368	128	36	100	6	0	142
35195	22548s (+0.6s)	2688	2688	256	58	158	9	0	225
35196	22548s (+0.5s)	1500	1500	128	57	96	6	0	159
35197	22549s (+0.5s)	1868	1868	128	42	129	6	0	177
35198	22549s (+0.3s)	820	820	64	35	63	8	0	106
35199	22550s (+0.6s)	2328	2328	128	62	144	18	0	224
Episode	Time	Reward	Score	Highest	L	U	R	D	Steps
35200	22550s (+0.5s)	1648	1648	128	50	120	4	0	174
35201	22551s (+0.8s)	3184	3184	256	61	195	9	0	265
35202	22552s (+0.4s)	1480	1480	128	40	100	8	0	148
35203	22552s (+0.7s)	3120	3120	256	60	188	7	0	255
35204	22553s (+0.3s)	972	972	64	24	77	5	0	106
35205	22553s (+0.3s)	1188	1188	128	25	93	3	0	121
35206	22554s (+0.8s)	3476	3476	256	80	198	15	0	293
35207	22555s (+1.0s)	4268	4268	256	94	241	22	0	357
35208	22556s (+0.7s)	2736	2736	256	76	144	13	0	233
35209	22556s (+0.5s)	1516	1516	128	40	117	5	0	162
35210	22557s (+0.6s)	2308	2308	128	52	158	10	0	220
35211	22557s (+0.5s)	1884	1884	128	41	141	1	8	191
35212	22558s (+0.5s)	1684	1684	128	38	132	0	3	173
35213	22559s (+0.9s)	4008	4008	256	88	228	12	2	330
35214	22559s (+0.6s)	1928	1928	128	39	155	6	0	200
35215	22560s (+0.4s)	1476	1476	128	30	121	3	0	154
35216	22560s (+0.4s)	1100	1100	64	37	94	3	0	134
35217	22561s (+1.3s)	6384	6384	512	133	298	24	0	455
35218	22562s (+0.5s)	1580	1580	128	35	124	8	0	167
35219	22563s (+1.0s)	4108	4108	256	99	217	17	0	333
35220	22563s (+0.6s)	2264	2264	128	53	150	11	0	214
35221	22564s (+0.7s)	2984	2984	256	71	164	11	0	246
35222	22565s (+0.8s)	3536	3536	256	94	188	16	0	298
35223	22566s (+0.8s)	3476	3476	256	85	184	19	1	289
35224	22566s (+0.3s)	904	904	64	21	88	6	2	117
35225	22567s (+0.9s)	3920	3920	256	102	202	19	0	323
35226	22568s (+0.6s)	2416	2416	256	59	139	10	0	208
35227	22568s (+0.8s)	3540	3540	256	78	194	17	0	289
35228	22569s (+0.7s)	3016	3016	256	67	172	14	1	254
35229	22570s (+0.7s)	3044	3044	256	55	192	9	0	256
35230	22571s (+0.9s)	4016	4016	256	69	240	17	0	326
35231	22571s (+0.5s)	1680	1680	128	51	108	13	0	172
35232	22572s (+0.7s)	3040	3040	256	77	175	7	0	259
35233	22573s (+1.0s)	5352	5352	512	78	273	17	0	368
35234	22574s (+0.6s)	1908	1908	128	48	139	8	0	195
35235	22574s (+0.5s)	1612	1612	128	45	115	10	0	170
35236	22575s (+0.7s)	2820	2820	256	63	170	12	2	247
35237	22576s (+0.8s)	3360	3360	256	49	221	0	16	286
35238	22576s (+0.5s)	1624	1624	128	28	130	0	4	162
35239	22576s (+0.3s)	700	700	64	16	75	0	2	93
35240	22577s (+0.5s)	1728	1728	128	30	135	0	7	172
35241	22578s (+0.7s)	3072	3072	256	44	201	0	7	252
35242	22578s (+0.4s)	1308	1308	128	28	102	0	4	134
35243	22579s (+0.5s)	1756	1756	128	46	122	10	0	178
35244	22579s (+0.7s)	2808	2808	256	66	168	10	0	244
35245	22580s (+0.5s)	1648	1648	128	35	119	9	0	163
35246	22581s (+0.8s)	3432	3432	256	80	193	15	0	288
35247	22582s (+1.0s)	4224	4224	256	79	256	16	0	351
35248	22582s (+1.0s)	4428	4428	256	97	256	8	0	361
35249	22583s (+0.6s)	2784	2784	256	68	155	16	0	239
35250	22584s (+0.9s)	3836	3836	256	86	216	12	0	314
35251	22584s (+0.3s)	820	820	64	23	74	4	1	102
35252	22585s (+0.6s)	2588	2588	256	56	159	7	0	222
35253	22586s (+0.7s)	3120	3120	256	59	192	9	0	260
35254	22586s (+0.5s)	1780	1780	128	34	142	4	0	180
35255	22587s (+0.7s)	3160	3160	256	69	178	13	1	261
35256	22588s (+0.5s)	1760	1760	128	47	121	9	0	177
35257	22588s (+0.7s)	3156	3156	256	57	191	11	0	259
35258	22589s (+0.4s)	1060	1060	64	32	92	4	0	128
35259	22589s (+0.8s)	3624	3624	256	81	208	19	0	308
35260	22590s (+0.8s)	3416	3416	256	62	210	13	0	285
35261	22591s (+0.7s)	2792	2792	256	43	186	11	1	241
35262	22592s (+1.0s)	4300	4300	256	87	249	18	0	354
35263	22593s (+0.7s)	3192	3192	256	82	168	16	0	266
35264	22593s (+0.3s)	716	716	64	22	75	2	0	99
35265	22594s (+0.7s)	2976	2976	256	81	165	13	0	259
35266	22594s (+0.4s)	1324	1324	64	41	103	7	0	151
35267	22595s (+0.8s)	3368	3368	256	58	211	9	0	278
35268	22596s (+0.7s)	3204	3204	256	61	191	12	0	264
35269	22596s (+0.8s)	3200	3200	256	72	186	9	0	267
35270	22597s (+0.8s)	3152	3152	256	74	176	18	0	268
35271	22598s (+0.6s)	2616	2616	256	53	162	10	0	225
35272	22599s (+0.6s)	2548	2548	256	50	156	9	1	216
35273	22599s (+0.4s)	1176	1176	128	32	92	3	0	127
35274	22600s (+0.7s)	3056	3056	256	69	181	13	0	263
35275	22600s (+0.8s)	3632	3632	256	70	188	24	0	282
35276	22601s (+0.8s)	3364	3364	256	68	200	15	0	283
35277	22602s (+0.3s)	1124	1124	128	25	91	3	0	119
35278	22602s (+0.9s)	3880	3880	256	100	204	13	0	317
35279	22603s (+0.7s)	2760	2760	256	56	171	11	0	238
35280	22603s (+0.2s)	552	552	64	9	67	2	0	78
35281	22604s (+0.5s)	2064	2064	256	40	126	6	0	172
35282	22605s (+0.6s)	2228	2228	128	60	148	15	0	223
35283	22605s (+0.4s)	1416	1416	128	47	92	5	0	144
35284	22606s (+0.8s)	3236	3236	256	93	162	17	0	272
35285	22606s (+0.5s)	1616	1616	128	38	126	8	0	172
35286	22607s (+0.7s)	2892	2892	256	68	173	13	0	254
35287	22607s (+0.5s)	1676	1676	128	33	130	7	0	170
35288	22608s (+0.9s)	3628	3628	256	95	198	16	0	309
35289	22609s (+0.5s)	1668	1668	128	46	116	7	0	169
35290	22610s (+0.9s)	3788	3788	256	92	219	10	1	322
35291	22611s (+0.8s)	3352	3352	256	83	185	12	0	280
35292	22612s (+1.3s)	6276	6276	512	108	306	27	0	441
35293	22612s (+0.5s)	1532	1532	128	40	119	7	0	166
35294	22613s (+0.6s)	2288	2288	128	48	158	9	0	215
35295	22613s (+0.6s)	1952	1952	128	43	151	12	0	206
35296	22614s (+0.5s)	1744	1744	128	35	120	7	0	162
35297	22614s (+0.3s)	1132	1132	128	21	94	0	6	121
35298	22615s (+0.4s)	1028	1028	64	25	91	0	7	123
35299	22615s (+0.6s)	2396	2396	256	55	139	0	6	200
Episode	Time	Reward	Score	Highest	L	U	R	D	Steps
35300	22616s (+0.4s)	1536	1536	128	28	120	0	5	153
35301	22616s (+0.4s)	1348	1348	128	30	103	0	9	142
35302	22617s (+0.4s)	1528	1528	128	36	109	0	7	152
35303	22617s (+0.9s)	3968	3968	256	94	215	17	0	326
35304	22618s (+0.9s)	3968	3968	256	69	245	12	0	326
35305	22619s (+0.4s)	1224	1224	128	35	95	4	0	134
35306	22620s (+1.2s)	5820	5820	512	91	309	21	0	421
35307	22621s (+0.5s)	1832	1832	128	41	144	3	0	188
35308	22621s (+0.7s)	3164	3164	256	56	190	11	2	259
35309	22621s (+0.2s)	528	528	64	11	63	1	0	75
35310	22622s (+0.5s)	1808	1808	128	36	147	4	0	187
35311	22623s (+0.7s)	2928	2928	256	60	176	15	0	251
35312	22623s (+0.5s)	1624	1624	128	42	113	9	0	164
35313	22624s (+0.6s)	2760	2760	256	40	186	6	1	233
35314	22624s (+0.4s)	1552	1552	128	33	124	7	0	164
35315	22625s (+0.6s)	2620	2620	256	57	163	6	0	226
35316	22626s (+0.9s)	4008	4008	256	69	244	16	0	329
35317	22626s (+0.4s)	1508	1508	128	32	118	6	0	156
35318	22627s (+0.6s)	2356	2356	256	45	148	6	0	199
35319	22627s (+0.5s)	1800	1800	128	43	133	9	0	185
35320	22628s (+0.8s)	3196	3196	256	77	174	11	0	262
35321	22629s (+0.3s)	940	940	64	29	78	8	0	115
35322	22629s (+0.4s)	1452	1452	128	34	107	6	0	147
35323	22630s (+0.8s)	3404	3404	256	73	198	11	0	282
35324	22631s (+1.0s)	4072	4072	256	107	208	20	1	336
35325	22631s (+0.5s)	1720	1720	128	41	127	7	0	175
35326	22632s (+0.7s)	2812	2812	256	64	166	16	0	246
35327	22632s (+0.4s)	1076	1076	64	28	95	4	1	128
35328	22633s (+0.9s)	3636	3636	256	82	216	14	0	312
35329	22634s (+1.2s)	5708	5708	512	109	275	22	1	407
35330	22635s (+0.6s)	1928	1928	128	49	142	9	0	200
35331	22635s (+0.3s)	800	800	64	26	76	6	0	108
35332	22636s (+1.0s)	4256	4256	256	82	247	14	0	343
35333	22637s (+0.3s)	868	868	64	24	85	4	0	113
35334	22637s (+0.5s)	1868	1868	128	42	144	5	0	191
35335	22638s (+1.0s)	4268	4268	256	91	246	20	0	357
35336	22639s (+0.4s)	1172	1172	128	33	90	6	0	129
35337	22640s (+1.1s)	5504	5504	512	89	283	19	0	391
35338	22640s (+0.8s)	3112	3112	256	76	178	12	0	266
35339	22642s (+1.3s)	6264	6264	512	132	295	25	0	452
35340	22642s (+0.4s)	1488	1488	128	46	103	6	0	155
35341	22643s (+1.1s)	5736	5736	512	91	297	16	1	405
35342	22644s (+1.0s)	4256	4256	256	85	255	15	0	355
35343	22645s (+0.6s)	2300	2300	128	70	136	12	0	218
35344	22645s (+0.5s)	1720	1720	128	32	129	8	0	169
35345	22646s (+0.3s)	988	988	64	30	80	6	0	116
35346	22646s (+0.7s)	2720	2720	256	55	166	14	0	235
35347	22647s (+0.6s)	2616	2616	256	44	174	10	0	228
35348	22648s (+0.5s)	1896	1896	128	38	151	4	0	193
35349	22648s (+0.3s)	656	656	32	24	64	4	0	92
35350	22648s (+0.5s)	1600	1600	128	42	120	5	1	168
35351	22649s (+0.8s)	3196	3196	256	65	189	13	0	267
35352	22650s (+0.7s)	2828	2828	256	52	190	7	0	249
35353	22650s (+0.6s)	1920	1920	128	53	137	8	0	198
35354	22651s (+0.4s)	1380	1380	128	24	118	3	0	145
35355	22651s (+0.5s)	1792	1792	128	49	121	11	0	181
35356	22652s (+0.6s)	2352	2352	256	44	149	8	0	201
35357	22653s (+0.8s)	3408	3408	256	71	198	11	0	280
35358	22654s (+0.8s)	3484	3484	256	64	216	0	9	289
35359	22654s (+0.6s)	2424	2424	128	43	171	0	12	226
35360	22655s (+0.4s)	1424	1424	128	26	109	0	10	145
35361	22655s (+0.6s)	2584	2584	256	52	158	0	12	222
35362	22656s (+0.2s)	608	608	64	13	64	0	2	79
35363	22656s (+0.8s)	3528	3528	256	75	214	0	8	297
35364	22657s (+0.5s)	1852	1852	128	32	149	0	7	188
35365	22657s (+0.5s)	1592	1592	128	36	122	0	8	166
35366	22658s (+0.9s)	3540	3540	256	60	227	0	12	299
35367	22659s (+0.8s)	3332	3332	256	54	213	0	12	279
35368	22660s (+0.6s)	2500	2500	256	41	168	0	7	216
35369	22661s (+0.9s)	3968	3968	256	65	249	0	17	331
35370	22661s (+0.4s)	1332	1332	128	24	105	0	6	135
35371	22661s (+0.3s)	944	944	64	24	93	0	5	122
35372	22662s (+0.9s)	3604	3604	256	83	209	15	0	307
35373	22663s (+0.4s)	1492	1492	128	37	114	6	0	157
35374	22664s (+1.3s)	6264	6264	512	119	291	30	1	441
35375	22664s (+0.5s)	1872	1872	128	45	140	5	1	191
35376	22665s (+0.4s)	1416	1416	128	43	96	7	1	147
35377	22665s (+0.6s)	2680	2680	256	49	149	10	0	208
35378	22666s (+0.3s)	900	900	64	22	80	4	0	106
35379	22666s (+0.6s)	2472	2472	256	47	155	9	0	211
35380	22667s (+0.8s)	3392	3392	256	62	205	12	0	279
35381	22668s (+0.7s)	2812	2812	256	55	166	10	0	231
35382	22668s (+0.5s)	1696	1696	128	38	125	8	0	171
35383	22669s (+0.9s)	3644	3644	256	82	211	17	0	310
35384	22670s (+0.9s)	3968	3968	256	95	214	16	1	326
35385	22671s (+0.7s)	2908	2908	256	65	177	12	0	254
35386	22672s (+0.8s)	3504	3504	256	89	188	17	1	295
35387	22672s (+0.5s)	2188	2188	256	49	129	11	0	189
35388	22673s (+0.6s)	2412	2412	256	60	138	9	0	207
35389	22673s (+0.6s)	2412	2412	256	44	156	7	0	207
35390	22674s (+0.8s)	3236	3236	256	53	208	11	0	272
35391	22675s (+0.6s)	2600	2600	256	53	153	13	0	219
35392	22676s (+0.9s)	3948	3948	256	77	235	13	0	325
35393	22676s (+0.4s)	1432	1432	128	26	115	6	0	147
35394	22677s (+0.6s)	2616	2616	256	58	160	11	0	229
35395	22677s (+0.4s)	1344	1344	64	43	103	8	0	154
35396	22679s (+1.2s)	5928	5928	512	112	283	22	0	417
35397	22680s (+1.2s)	5660	5660	512	103	283	20	0	406
35398	22681s (+0.9s)	3720	3720	256	78	205	18	0	301
35399	22681s (+0.4s)	1308	1308	128	20	116	3	0	139
Episode	Time	Reward	Score	Highest	L	U	R	D	Steps
35400	22681s (+0.5s)	1788	1788	128	38	128	9	0	175
35401	22682s (+0.5s)	1728	1728	128	44	131	4	0	179
35402	22683s (+0.6s)	2184	2184	128	55	150	11	0	216
35403	22683s (+0.7s)	2920	2920	256	60	183	12	1	256
35404	22684s (+0.4s)	1008	1008	64	33	89	5	0	127
35405	22684s (+0.2s)	664	664	64	16	67	3	0	86
35406	22685s (+0.8s)	3292	3292	256	68	202	0	5	275
35407	22685s (+0.7s)	2896	2896	256	57	180	0	14	251
35408	22686s (+0.7s)	2760	2760	256	43	179	0	11	233
35409	22686s (+0.2s)	432	432	32	10	56	0	4	70
35410	22687s (+0.5s)	1828	1828	128	42	137	0	8	187
35411	22687s (+0.5s)	1832	1832	128	36	147	0	5	188
35412	22688s (+0.8s)	3256	3256	256	56	205	0	16	277
35413	22689s (+0.7s)	2824	2824	256	42	194	0	13	249
35414	22689s (+0.5s)	1644	1644	128	44	111	8	0	163
35415	22690s (+0.5s)	1856	1856	128	52	130	9	1	192
35416	22691s (+0.6s)	2244	2244	128	60	145	11	0	216
35417	22691s (+0.4s)	1420	1420	128	36	103	11	0	150
35418	22691s (+0.4s)	1324	1324	128	33	96	7	0	136
35419	22692s (+0.8s)	3396	3396	256	61	207	12	0	280
35420	22693s (+0.6s)	2728	2728	256	46	163	7	0	216
35421	22694s (+1.0s)	4404	4404	256	86	258	15	0	359
35422	22694s (+0.6s)	2452	2452	128	64	147	17	1	229
35423	22695s (+0.3s)	736	736	64	22	71	3	0	96
35424	22696s (+0.9s)	4800	4800	512	76	243	14	0	333
35425	22697s (+0.9s)	4776	4776	512	86	232	12	1	331
35426	22698s (+0.9s)	3940	3940	256	90	212	18	0	320
35427	22698s (+0.4s)	1300	1300	128	27	102	3	0	132
35428	22699s (+0.7s)	2664	2664	256	56	166	8	0	230
35429	22699s (+0.7s)	2792	2792	256	61	164	10	0	235
35430	22700s (+0.9s)	4140	4140	256	82	231	23	1	337
35431	22701s (+0.5s)	1648	1648	128	39	129	6	0	174
35432	22701s (+0.5s)	1492	1492	128	29	122	5	0	156
35433	22702s (+0.8s)	3152	3152	256	94	164	11	1	270
35434	22703s (+0.6s)	1920	1920	128	41	147	10	0	198
35435	22703s (+0.7s)	2556	2556	128	65	166	13	1	245
35436	22704s (+0.4s)	1484	1484	128	46	103	5	0	154
35437	22704s (+0.4s)	1308	1308	128	35	88	4	0	127
35438	22705s (+0.4s)	1512	1512	128	40	119	3	0	162
35439	22705s (+0.8s)	3556	3556	256	75	213	15	0	303
35440	22706s (+0.4s)	1468	1468	128	40	101	11	0	152
35441	22706s (+0.5s)	1780	1780	128	51	124	5	0	180
35442	22707s (+0.8s)	3216	3216	256	62	193	13	0	268
35443	22708s (+0.5s)	1708	1708	128	34	136	4	0	174
35444	22708s (+0.9s)	3748	3748	256	85	212	12	1	310
35445	22709s (+0.4s)	1364	1364	128	45	98	9	0	152
35446	22710s (+0.7s)	2872	2872	256	65	174	10	0	249
35447	22710s (+0.5s)	1780	1780	128	45	128	7	0	180
35448	22710s (+0.3s)	876	876	64	40	66	9	0	115
35449	22711s (+0.6s)	2404	2404	256	42	150	8	0	200
35450	22712s (+0.4s)	1388	1388	128	38	107	3	0	148
35451	22712s (+0.5s)	1536	1536	128	38	119	5	0	162
35452	22713s (+0.6s)	2108	2108	128	60	128	11	0	199
35453	22713s (+0.7s)	2996	2996	256	72	167	14	0	253
35454	22714s (+0.5s)	1764	1764	128	59	120	12	0	191
35455	22715s (+0.6s)	2720	2720	256	61	155	12	0	228
35456	22715s (+0.6s)	2056	2056	128	54	144	7	0	205
35457	22716s (+0.5s)	1772	1772	128	38	135	8	0	181
35458	22716s (+0.8s)	3304	3304	256	64	195	18	0	277
35459	22718s (+1.1s)	5548	5548	512	105	265	20	0	390
35460	22718s (+0.8s)	3240	3240	256	75	179	19	0	273
35461	22719s (+0.8s)	3412	3412	256	73	195	15	1	284
35462	22720s (+0.8s)	3604	3604	256	62	210	0	16	288
35463	22721s (+0.6s)	2604	2604	256	47	168	0	11	226
35464	22721s (+0.5s)	1800	1800	128	35	142	0	8	185
35465	22722s (+0.4s)	1472	1472	128	28	117	0	8	153
35466	22722s (+0.8s)	3536	3536	256	61	204	1	18	284
35467	22723s (+1.1s)	5452	5452	512	97	262	23	0	382
35468	22724s (+0.4s)	1272	1272	128	27	102	6	0	135
35469	22725s (+0.7s)	2924	2924	256	73	155	15	0	243
35470	22725s (+0.6s)	1944	1944	128	43	149	7	0	199
35471	22725s (+0.3s)	664	664	64	18	73	3	0	94
35472	22726s (+0.6s)	2104	2104	128	50	149	10	0	209
35473	22727s (+0.9s)	3664	3664	256	86	215	13	0	314
35474	22728s (+1.1s)	4624	4624	256	113	254	19	0	386
35475	22729s (+0.5s)	1836	1836	128	43	136	10	0	189
35476	22730s (+1.0s)	4340	4340	256	101	241	17	0	359
35477	22731s (+1.2s)	5992	5992	512	109	298	21	0	428
35478	22732s (+0.8s)	3200	3200	256	56	200	12	0	268
35479	22733s (+0.9s)	3984	3984	256	80	240	10	0	330
35480	22733s (+0.6s)	2528	2528	256	49	161	9	0	219
35481	22734s (+0.4s)	1420	1420	128	31	107	5	1	144
35482	22734s (+0.6s)	2212	2212	128	48	152	12	0	212
35483	22735s (+0.5s)	1608	1608	128	36	116	7	0	159
35484	22735s (+0.4s)	1040	1040	64	29	93	2	0	124
35485	22736s (+0.8s)	3380	3380	256	62	206	12	1	281
35486	22737s (+0.6s)	2640	2640	256	53	161	9	1	224
35487	22737s (+0.4s)	1360	1360	128	30	104	6	0	140
35488	22738s (+0.5s)	2212	2212	256	39	140	11	0	190
35489	22738s (+0.8s)	3496	3496	256	73	209	11	0	293
35490	22739s (+0.3s)	1088	1088	128	27	86	7	1	121
35491	22739s (+0.5s)	1632	1632	128	42	116	11	0	169
35492	22740s (+0.8s)	3080	3080	256	46	206	0	12	264
35493	22740s (+0.3s)	1000	1000	64	27	86	0	6	119
35494	22741s (+0.7s)	3116	3116	256	59	184	0	16	259
35495	22742s (+0.7s)	3208	3208	256	57	195	0	13	265
35496	22742s (+0.3s)	676	676	64	21	68	0	5	94
35497	22743s (+0.8s)	3468	3468	256	57	221	0	14	292
35498	22743s (+0.6s)	2332	2332	256	49	136	8	0	193
35499	22744s (+0.8s)	3364	3364	256	71	193	13	0	277
Episode	Time	Reward	Score	Highest	L	U	R	D	Steps
35500	22745s (+0.4s)	1452	1452	128	36	106	9	1	152
35501	22745s (+0.4s)	1472	1472	128	30	114	8	0	152
35502	22746s (+0.5s)	1768	1768	128	37	132	6	0	175
35503	22746s (+0.4s)	1444	1444	128	29	114	7	0	150
35504	22747s (+0.4s)	1324	1324	128	33	99	5	0	137
35505	22747s (+0.4s)	1412	1412	128	39	103	7	0	149
35506	22748s (+0.5s)	1908	1908	128	38	150	7	0	195
35507	22748s (+0.6s)	2364	2364	256	39	164	0	7	210
35508	22748s (+0.2s)	600	600	64	22	59	0	2	83
35509	22749s (+0.5s)	1708	1708	128	32	129	0	10	171
35510	22750s (+0.8s)	3244	3244	256	77	178	19	0	274
35511	22750s (+0.6s)	1912	1912	128	42	138	11	0	191
35512	22751s (+0.7s)	2824	2824	256	73	160	15	0	248
35513	22751s (+0.5s)	1816	1816	128	54	119	15	0	188
35514	22752s (+0.7s)	3020	3020	256	78	152	16	0	246
35515	22753s (+0.7s)	2776	2776	256	49	175	14	0	238
35516	22754s (+0.9s)	3448	3448	256	67	222	14	0	303
35517	22754s (+0.4s)	1424	1424	128	32	109	4	0	145
35518	22755s (+0.5s)	1568	1568	128	33	123	8	1	165
35519	22755s (+0.4s)	1252	1252	128	33	103	4	0	140
35520	22756s (+0.5s)	1844	1844	128	48	121	14	1	184
35521	22756s (+0.7s)	2800	2800	256	62	170	11	0	243
35522	22757s (+0.5s)	1784	1784	128	46	125	10	0	181
35523	22758s (+1.0s)	4264	4264	256	82	246	21	0	349
35524	22759s (+1.0s)	4552	4552	256	108	224	21	0	353
35525	22759s (+0.5s)	1764	1764	128	47	121	12	0	180
35526	22760s (+0.7s)	2784	2784	256	54	172	13	0	239
35527	22761s (+0.5s)	1872	1872	128	46	133	12	0	191
35528	22761s (+0.4s)	1360	1360	128	31	108	2	0	141
35529	22762s (+0.9s)	4004	4004	256	84	222	17	0	323
35530	22763s (+0.7s)	2808	2808	256	59	165	12	1	237
35531	22763s (+0.6s)	2344	2344	256	43	147	8	0	198
35532	22764s (+0.9s)	4000	4000	256	88	222	17	0	327
35533	22765s (+1.1s)	4536	4536	256	103	253	19	1	376
35534	22766s (+0.4s)	1468	1468	128	39	106	7	0	152
35535	22766s (+0.8s)	3356	3356	256	68	204	10	0	282
35536	22767s (+0.4s)	1336	1336	128	26	107	4	0	137
35537	22767s (+0.4s)	1148	1148	64	36	99	3	0	138
35538	22769s (+1.3s)	6508	6508	512	137	306	26	0	469
35539	22769s (+0.6s)	2292	2292	128	41	159	0	13	213
35540	22770s (+0.7s)	2956	2956	256	42	185	0	11	238
35541	22771s (+0.9s)	3552	3552	256	63	233	0	6	302
35542	22772s (+0.8s)	3248	3248	256	66	197	0	12	275
35543	22772s (+0.6s)	2332	2332	128	53	148	0	11	212
35544	22772s (+0.3s)	1072	1072	128	28	83	0	6	117
35545	22773s (+0.5s)	1592	1592	128	26	126	0	7	159
35546	22774s (+0.7s)	2888	2888	256	53	186	0	7	246
35547	22774s (+0.5s)	1800	1800	128	36	140	0	9	185
35548	22774s (+0.2s)	600	600	64	17	57	0	5	79
35549	22775s (+0.8s)	3184	3184	256	59	191	0	15	265
35550	22775s (+0.2s)	436	436	32	9	56	0	7	72
35551	22776s (+0.4s)	1440	1440	128	24	120	0	5	149
35552	22776s (+0.3s)	920	920	64	27	85	3	0	115
35553	22777s (+0.6s)	2064	2064	128	60	132	11	0	203
35554	22777s (+0.3s)	684	684	64	17	69	3	0	89
35555	22777s (+0.3s)	680	680	64	31	59	4	0	94
35556	22778s (+0.4s)	1284	1284	128	28	98	4	0	130
35557	22778s (+0.5s)	1792	1792	128	49	128	6	0	183
35558	22779s (+1.0s)	4136	4136	256	85	241	15	0	341
35559	22780s (+0.6s)	2084	2084	128	55	131	7	0	193
35560	22781s (+0.9s)	3784	3784	256	84	201	17	0	302
35561	22782s (+1.1s)	5320	5320	512	92	271	14	0	377
35562	22783s (+1.0s)	4276	4276	256	84	255	12	0	351
35563	22783s (+0.6s)	1976	1976	128	54	147	6	0	207
35564	22784s (+0.5s)	1864	1864	128	41	139	8	2	190
35565	22784s (+0.5s)	1624	1624	128	42	123	7	1	173
35566	22785s (+0.4s)	1180	1180	128	27	93	7	0	127
35567	22786s (+0.8s)	3488	3488	256	61	214	16	0	291
35568	22786s (+0.7s)	2716	2716	256	57	164	10	0	231
35569	22787s (+0.6s)	2568	2568	256	62	147	13	0	222
35570	22787s (+0.4s)	1112	1112	64	31	101	4	0	136
35571	22788s (+1.0s)	4296	4296	256	89	245	18	0	352
35572	22789s (+0.4s)	1128	1128	64	31	94	8	1	134
35573	22789s (+0.6s)	2184	2184	128	61	148	11	0	220
35574	22790s (+0.5s)	1680	1680	128	32	122	9	1	164
35575	22791s (+0.7s)	3152	3152	256	71	181	10	1	263
35576	22791s (+0.6s)	2772	2772	256	48	166	8	0	222
35577	22792s (+0.6s)	1896	1896	128	50	132	11	0	193
35578	22792s (+0.5s)	1788	1788	128	40	139	3	0	182
35579	22793s (+0.5s)	2328	2328	256	48	139	5	0	192
35580	22793s (+0.5s)	1724	1724	128	51	121	6	0	178
35581	22794s (+0.6s)	2476	2476	256	49	158	4	1	212
35582	22795s (+0.8s)	3604	3604	256	70	213	16	1	300
35583	22796s (+0.8s)	3400	3400	256	69	199	0	14	282
35584	22796s (+0.3s)	856	856	64	17	80	0	4	101
35585	22797s (+0.6s)	2564	2564	256	47	160	0	10	217
35586	22797s (+0.7s)	2824	2824	256	43	190	0	11	244
35587	22798s (+0.5s)	1596	1596	128	36	128	0	8	172
35588	22798s (+0.3s)	728	728	64	24	64	0	8	96
35589	22799s (+0.4s)	1604	1604	128	37	116	0	6	159
35590	22799s (+0.5s)	1764	1764	128	33	137	0	6	176
35591	22800s (+0.5s)	1588	1588	128	35	123	0	8	166
35592	22800s (+0.5s)	1784	1784	128	31	145	0	6	182
35593	22801s (+0.7s)	2924	2924	256	48	198	0	11	257
35594	22801s (+0.4s)	1020	1020	64	20	96	0	7	123
35595	22801s (+0.3s)	676	676	64	13	73	0	5	91
35596	22802s (+0.8s)	3504	3504	256	79	199	17	0	295
35597	22803s (+0.5s)	1768	1768	128	46	127	9	0	182
35598	22804s (+0.7s)	3128	3128	256	54	187	14	0	255
35599	22804s (+0.5s)	1668	1668	128	37	137	4	0	178
Episode	Time	Reward	Score	Highest	L	U	R	D	Steps
35600	22804s (+0.4s)	1292	1292	128	43	86	10	0	139
35601	22805s (+0.7s)	2800	2800	256	48	188	7	0	243
35602	22806s (+0.5s)	1892	1892	128	54	128	9	0	191
35603	22807s (+0.8s)	3340	3340	256	71	199	11	0	281
35604	22807s (+0.3s)	840	840	64	28	77	5	0	110
35605	22808s (+0.8s)	3336	3336	256	70	202	9	0	281
35606	22808s (+0.6s)	2316	2316	256	46	140	7	0	193
35607	22809s (+0.7s)	3196	3196	256	60	187	17	0	264
35608	22810s (+0.8s)	3484	3484	256	65	212	14	0	291
35609	22811s (+0.9s)	3864	3864	256	75	222	15	0	312
35610	22811s (+0.7s)	3252	3252	256	70	175	15	1	261
35611	22812s (+0.6s)	2504	2504	128	66	156	14	0	236
35612	22813s (+0.5s)	1828	1828	128	53	131	7	0	191
35613	22813s (+0.6s)	2524	2524	256	47	168	7	0	222
35614	22814s (+0.4s)	1412	1412	128	30	114	8	0	152
35615	22814s (+0.7s)	2712	2712	256	53	164	8	1	226
35616	22815s (+0.4s)	1316	1316	128	35	95	5	0	135
35617	22816s (+1.2s)	5780	5780	512	106	280	15	0	401
35618	22817s (+0.7s)	2968	2968	256	66	192	10	0	268
35619	22817s (+0.5s)	1684	1684	128	36	131	5	0	172
35620	22818s (+0.4s)	1424	1424	128	35	109	7	0	151
35621	22818s (+0.7s)	2792	2792	256	58	170	13	0	241
35622	22819s (+0.4s)	1156	1156	128	18	101	4	0	123
35623	22819s (+0.6s)	2800	2800	256	56	162	10	0	228
35624	22820s (+0.8s)	3212	3212	256	75	188	18	0	281
35625	22821s (+0.6s)	2496	2496	128	78	142	15	0	235
35626	22821s (+0.5s)	1684	1684	128	44	119	5	1	169
35627	22822s (+0.4s)	1252	1252	64	29	106	0	10	145
35628	22822s (+0.8s)	3332	3332	256	61	212	0	7	280
35629	22823s (+0.7s)	3060	3060	256	44	199	0	11	254
35630	22824s (+0.8s)	3240	3240	256	62	196	0	14	272
35631	22825s (+0.9s)	3960	3960	256	70	242	0	13	325
35632	22826s (+0.9s)	3924	3924	256	85	230	0	11	326
35633	22826s (+0.4s)	1304	1304	128	37	84	0	11	132
35634	22827s (+0.7s)	2468	2468	128	65	158	16	1	240
35635	22827s (+0.3s)	748	748	64	31	65	4	0	100
35636	22828s (+0.6s)	2420	2420	128	59	160	9	0	228
35637	22828s (+0.5s)	1636	1636	128	39	124	6	0	169
35638	22829s (+0.5s)	1584	1584	128	46	109	8	0	163
35639	22829s (+0.5s)	1732	1732	128	31	137	6	0	174
35640	22830s (+0.7s)	2660	2660	256	48	183	0	8	239
35641	22831s (+0.5s)	1816	1816	128	39	141	0	8	188
35642	22831s (+0.8s)	3132	3132	256	47	202	0	14	263
35643	22832s (+0.4s)	1476	1476	128	38	107	0	7	152
35644	22832s (+0.7s)	3088	3088	256	60	182	0	12	254
35645	22833s (+0.7s)	3036	3036	256	48	194	0	12	254
35646	22834s (+0.7s)	2812	2812	256	59	178	0	9	246
35647	22834s (+0.3s)	792	792	64	21	77	0	8	106
35648	22835s (+0.7s)	2812	2812	256	49	186	0	11	246
35649	22835s (+0.6s)	2176	2176	128	41	152	0	11	204
35650	22837s (+1.2s)	5800	5800	512	71	329	0	17	417
35651	22837s (+0.4s)	1168	1168	64	32	98	0	9	139
35652	22838s (+0.5s)	1928	1928	128	32	141	0	13	186
35653	22838s (+0.9s)	3680	3680	256	74	214	0	16	304
35654	22839s (+0.3s)	796	796	64	29	71	7	0	107
35655	22840s (+0.7s)	2984	2984	256	74	166	19	1	260
35656	22840s (+0.9s)	4052	4052	256	86	235	14	0	335
35657	22841s (+0.4s)	1432	1432	128	37	110	10	0	157
35658	22842s (+0.8s)	3464	3464	256	75	193	17	0	285
35659	22843s (+0.7s)	3288	3288	256	79	178	17	0	274
35660	22843s (+0.5s)	1904	1904	128	48	140	6	0	194
35661	22844s (+0.8s)	3788	3788	256	76	215	12	0	303
35662	22844s (+0.5s)	1608	1608	128	43	121	5	0	169
35663	22845s (+0.6s)	2496	2496	256	62	143	11	0	216
35664	22845s (+0.3s)	832	832	64	23	81	4	0	108
35665	22846s (+0.8s)	3480	3480	256	70	196	15	2	283
35666	22847s (+1.0s)	4316	4316	256	101	235	17	0	353
35667	22848s (+0.9s)	3724	3724	256	80	206	17	0	303
35668	22848s (+0.5s)	1696	1696	128	34	127	9	0	170
35669	22849s (+0.5s)	1604	1604	128	32	128	0	9	169
35670	22850s (+0.7s)	2636	2636	256	46	177	0	8	231
35671	22850s (+0.5s)	2092	2092	128	40	143	0	12	195
35672	22851s (+0.4s)	1212	1212	64	32	110	0	3	145
35673	22851s (+0.7s)	2640	2640	256	44	177	0	9	230
35674	22852s (+0.6s)	1992	1992	128	32	165	0	4	201
35675	22853s (+0.8s)	3244	3244	256	55	206	0	12	273
35676	22853s (+0.7s)	2608	2608	256	55	160	0	13	228
35677	22854s (+0.7s)	2772	2772	256	60	171	0	9	240
35678	22855s (+0.5s)	1788	1788	128	34	142	0	6	182
35679	22855s (+0.4s)	1280	1280	128	26	100	0	7	133
35680	22855s (+0.4s)	1116	1116	64	39	92	6	0	137
35681	22856s (+0.5s)	1572	1572	128	39	116	5	0	160
35682	22857s (+1.0s)	4268	4268	256	95	242	16	0	353
35683	22858s (+0.8s)	3720	3720	256	63	218	12	0	293
35684	22858s (+0.7s)	2920	2920	256	57	184	15	0	256
35685	22859s (+0.4s)	1320	1320	128	25	106	4	0	135
35686	22859s (+0.4s)	1196	1196	64	34	101	4	0	139
35687	22860s (+0.8s)	3324	3324	256	80	184	15	0	279
35688	22861s (+0.8s)	3300	3300	256	75	184	13	0	272
35689	22861s (+0.4s)	1048	1048	64	38	92	6	0	136
35690	22862s (+0.7s)	2732	2732	256	50	176	9	0	235
35691	22862s (+0.5s)	1676	1676	128	49	113	8	1	171
35692	22863s (+0.4s)	1416	1416	128	28	110	4	0	142
35693	22863s (+0.5s)	1608	1608	128	39	121	9	0	169
35694	22864s (+0.9s)	3968	3968	256	79	233	14	0	326
35695	22865s (+0.4s)	1480	1480	128	41	108	5	0	154
35696	22865s (+0.5s)	1584	1584	128	33	126	4	0	163
35697	22866s (+0.9s)	4100	4100	256	82	234	16	0	332
35698	22866s (+0.4s)	1160	1160	128	30	89	7	0	126
35699	22867s (+0.7s)	2932	2932	256	57	193	9	0	259
Episode	Time	Reward	Score	Highest	L	U	R	D	Steps
35700	22868s (+0.5s)	1852	1852	128	41	140	5	0	186
35701	22868s (+0.7s)	2908	2908	256	59	189	5	1	254
35702	22869s (+0.6s)	1912	1912	128	45	144	8	0	197
35703	22870s (+0.7s)	2888	2888	256	53	182	13	0	248
35704	22870s (+0.6s)	1932	1932	128	56	135	10	0	201
35705	22871s (+0.7s)	2776	2776	256	60	170	12	0	242
35706	22872s (+0.6s)	2444	2444	256	52	150	9	0	211
35707	22872s (+0.7s)	2780	2780	256	54	176	9	0	239
35708	22873s (+0.3s)	888	888	64	25	85	7	0	117
35709	22873s (+0.9s)	3808	3808	256	51	237	0	20	308
35710	22874s (+0.4s)	1188	1188	64	34	94	0	6	134
35711	22874s (+0.6s)	2464	2464	256	39	163	0	8	210
35712	22875s (+0.5s)	1868	1868	128	42	143	0	5	190
35713	22876s (+0.6s)	2644	2644	256	45	171	0	10	226
35714	22876s (+0.7s)	3080	3080	256	48	197	0	8	253
35715	22877s (+0.7s)	3076	3076	256	53	187	0	13	253
35716	22877s (+0.4s)	1356	1356	128	38	93	0	9	140
35717	22878s (+0.3s)	1128	1128	128	23	94	0	3	120
35718	22879s (+0.8s)	3396	3396	256	60	213	0	17	290
35719	22879s (+0.6s)	2656	2656	256	48	161	0	14	223
35720	22880s (+0.6s)	2496	2496	256	44	158	0	5	207
35721	22881s (+0.8s)	3356	3356	256	63	207	0	11	281
35722	22882s (+1.2s)	5760	5760	512	76	313	0	22	411
35723	22882s (+0.4s)	1452	1452	128	24	123	0	5	152
35724	22883s (+0.9s)	3972	3972	256	78	233	0	16	327
35725	22884s (+0.6s)	2628	2628	256	50	160	0	11	221
35726	22884s (+0.5s)	2256	2256	256	51	134	0	7	192
35727	22885s (+0.3s)	1144	1144	128	23	96	0	4	123
35728	22885s (+0.5s)	1804	1804	128	46	130	0	10	186
35729	22886s (+0.4s)	992	992	64	24	94	0	6	124
35730	22887s (+0.9s)	3880	3880	256	65	235	0	16	316
35731	22887s (+0.5s)	1828	1828	128	45	138	4	0	187
35732	22888s (+0.5s)	2068	2068	128	53	128	12	0	193
35733	22888s (+0.5s)	1748	1748	128	42	127	7	0	176
35734	22889s (+0.3s)	1136	1136	128	27	88	5	0	120
35735	22890s (+1.4s)	6596	6596	512	125	328	25	1	479
35736	22891s (+0.8s)	3244	3244	256	64	201	9	0	274
35737	22891s (+0.7s)	3136	3136	256	61	186	10	0	257
35738	22892s (+0.8s)	3296	3296	256	61	203	11	0	275
35739	22893s (+0.9s)	3784	3784	256	89	215	17	0	321
35740	22894s (+0.5s)	1548	1548	128	32	121	6	0	159
35741	22894s (+0.6s)	2348	2348	256	52	140	8	0	200
35742	22895s (+0.5s)	1796	1796	128	45	125	13	1	184
35743	22895s (+0.4s)	1476	1476	128	38	110	6	0	154
35744	22896s (+0.7s)	2936	2936	256	57	193	10	0	260
35745	22896s (+0.4s)	1208	1208	64	42	96	6	0	144
35746	22897s (+0.6s)	2392	2392	256	43	153	0	11	207
35747	22897s (+0.5s)	1788	1788	128	44	135	0	3	182
35748	22898s (+0.4s)	1348	1348	128	23	111	0	6	140
35749	22899s (+0.6s)	2548	2548	256	50	157	0	10	217
35750	22899s (+0.6s)	2540	2540	256	58	147	0	10	215
35751	22900s (+0.5s)	1880	1880	128	46	134	0	9	189
35752	22900s (+0.6s)	2624	2624	256	41	178	0	11	230
35753	22901s (+1.1s)	4540	4540	256	76	280	0	21	377
35754	22902s (+0.5s)	1792	1792	128	44	128	0	11	183
35755	22903s (+0.7s)	2756	2756	256	52	177	0	8	237
35756	22903s (+0.2s)	500	500	64	17	46	0	5	68
35757	22903s (+0.4s)	1392	1392	128	25	112	0	10	147
35758	22904s (+0.4s)	1180	1180	128	32	91	5	0	128
35759	22904s (+0.8s)	3184	3184	256	78	175	11	0	264
35760	22905s (+0.7s)	3212	3212	256	53	196	10	0	259
35761	22906s (+0.5s)	1924	1924	128	39	132	5	0	176
35762	22906s (+0.5s)	1576	1576	128	47	108	7	0	162
35763	22907s (+1.3s)	6456	6456	512	116	316	24	0	456
35764	22908s (+0.5s)	1852	1852	128	47	130	9	0	186
35765	22908s (+0.5s)	1520	1520	128	38	115	10	0	163
35766	22909s (+1.0s)	4200	4200	256	83	244	17	0	344
35767	22910s (+0.5s)	1596	1596	128	26	132	3	0	161
35768	22910s (+0.6s)	2000	2000	128	52	137	11	0	200
35769	22911s (+0.8s)	3368	3368	256	81	192	15	0	288
35770	22912s (+0.3s)	688	688	64	15	76	2	0	93
35771	22912s (+0.5s)	1484	1484	128	32	119	4	0	155
35772	22913s (+0.5s)	1664	1664	128	33	133	2	0	168
35773	22913s (+0.4s)	1448	1448	128	34	108	9	0	151
35774	22914s (+0.6s)	2044	2044	128	53	149	7	0	209
35775	22914s (+0.8s)	3200	3200	256	65	193	10	0	268
35776	22915s (+0.4s)	1340	1340	128	26	111	6	0	143
35777	22915s (+0.4s)	1480	1480	128	38	105	11	0	154
35778	22916s (+0.6s)	2296	2296	128	53	153	8	0	214
35779	22916s (+0.7s)	2472	2472	128	48	172	0	14	234
35780	22917s (+0.4s)	1400	1400	128	23	114	0	6	143
35781	22917s (+0.5s)	1908	1908	128	37	129	0	15	181
35782	22918s (+0.6s)	2460	2460	256	55	148	0	7	210
35783	22918s (+0.2s)	632	632	64	19	62	0	6	87
35784	22919s (+0.5s)	1892	1892	128	44	141	0	6	191
35785	22919s (+0.7s)	2760	2760	256	45	181	0	8	234
35786	22921s (+1.1s)	5412	5412	512	82	272	16	0	370
35787	22922s (+1.0s)	4284	4284	256	92	252	13	0	357
35788	22922s (+0.5s)	2044	2044	256	43	120	7	0	170
35789	22922s (+0.4s)	1064	1064	64	26	98	5	0	129
35790	22923s (+0.4s)	1496	1496	128	30	120	8	0	158
35791	22923s (+0.5s)	1572	1572	128	45	112	3	0	160
35792	22924s (+0.5s)	1604	1604	128	44	117	7	0	168
35793	22925s (+0.7s)	2900	2900	256	55	178	9	0	242
35794	22925s (+0.3s)	712	712	64	18	73	3	1	95
35795	22925s (+0.3s)	812	812	64	26	80	4	0	110
35796	22926s (+1.0s)	4340	4340	256	83	250	22	0	355
35797	22927s (+0.5s)	1696	1696	128	43	122	6	0	171
35798	22927s (+0.8s)	3348	3348	256	71	200	14	0	285
35799	22928s (+0.7s)	2688	2688	256	66	159	11	0	236
Episode	Time	Reward	Score	Highest	L	U	R	D	Steps
35800	22929s (+0.8s)	3240	3240	256	54	209	10	0	273
35801	22929s (+0.2s)	604	604	64	16	63	2	0	81
35802	22930s (+0.3s)	1116	1116	128	26	93	5	0	124
35803	22930s (+0.3s)	720	720	64	20	74	0	0	94
35804	22931s (+0.9s)	3760	3760	256	71	220	15	0	306
35805	22931s (+0.4s)	1132	1132	64	40	87	7	1	135
35806	22932s (+0.7s)	2920	2920	256	48	197	0	12	257
35807	22932s (+0.5s)	1620	1620	128	35	122	0	5	162
35808	22933s (+0.5s)	1584	1584	128	32	118	0	12	162
35809	22933s (+0.7s)	2872	2872	256	55	182	12	0	249
35810	22934s (+0.5s)	1616	1616	128	33	120	8	0	161
35811	22935s (+0.7s)	3152	3152	256	58	194	11	0	263
35812	22935s (+0.4s)	1492	1492	128	48	102	7	0	157
35813	22936s (+0.5s)	1784	1784	128	43	131	8	0	182
35814	22937s (+1.1s)	5388	5388	512	95	261	19	1	376
35815	22937s (+0.6s)	2628	2628	256	62	148	12	0	222
35816	22938s (+1.0s)	4424	4424	256	89	253	22	0	364
35817	22939s (+0.4s)	1096	1096	64	48	77	8	0	133
35818	22939s (+0.4s)	1256	1256	128	27	103	4	0	134
35819	22940s (+0.7s)	2932	2932	256	58	175	11	0	244
35820	22941s (+0.9s)	5004	5004	512	74	250	13	0	337
35821	22942s (+0.7s)	3168	3168	256	61	191	8	0	260
35822	22942s (+0.9s)	3748	3748	256	82	224	17	0	323
35823	22943s (+0.4s)	1044	1044	64	28	90	8	0	126
35824	22943s (+0.5s)	1620	1620	128	43	120	8	0	171
35825	22944s (+0.7s)	2788	2788	256	56	172	12	0	240
35826	22945s (+0.5s)	1812	1812	128	37	147	4	0	188
35827	22945s (+0.7s)	2704	2704	256	81	143	11	0	235
35828	22946s (+0.4s)	1440	1440	128	33	107	0	9	149
35829	22946s (+0.5s)	1748	1748	128	29	141	0	8	178
35830	22946s (+0.2s)	632	632	64	10	71	0	4	85
35831	22947s (+0.7s)	2772	2772	256	59	167	10	0	236
35832	22948s (+0.4s)	1168	1168	64	41	89	9	0	139
35833	22948s (+0.7s)	2908	2908	256	65	177	11	0	253
35834	22949s (+0.4s)	1504	1504	128	33	116	7	0	156
35835	22950s (+0.9s)	3628	3628	256	81	208	21	0	310
35836	22950s (+0.5s)	1740	1740	128	39	129	7	0	175
35837	22951s (+0.6s)	2620	2620	256	65	157	8	0	230
35838	22951s (+0.7s)	3140	3140	256	66	178	14	0	258
35839	22952s (+0.7s)	2888	2888	256	55	183	10	0	248
35840	22953s (+0.5s)	1668	1668	128	47	113	8	0	168
35841	22953s (+0.5s)	1664	1664	128	36	127	6	0	169
35842	22954s (+0.5s)	1828	1828	128	53	119	13	0	185
35843	22954s (+0.5s)	1664	1664	128	44	130	4	0	178
35844	22955s (+0.7s)	3004	3004	256	50	194	0	13	257
35845	22955s (+0.5s)	1588	1588	128	28	131	0	5	164
35846	22956s (+0.7s)	3152	3152	256	52	200	0	11	263
35847	22957s (+0.8s)	3224	3224	256	50	212	0	9	271
35848	22957s (+0.5s)	1784	1784	128	38	135	0	8	181
35849	22958s (+0.3s)	1032	1032	64	21	93	0	6	120
35850	22958s (+0.4s)	1672	1672	128	39	111	5	1	156
35851	22959s (+0.7s)	3064	3064	256	49	192	9	0	250
35852	22959s (+0.4s)	1132	1132	64	44	80	11	0	135
35853	22960s (+0.5s)	1928	1928	128	58	134	8	0	200
35854	22960s (+0.5s)	1600	1600	128	36	113	9	0	158
35855	22961s (+0.9s)	3920	3920	256	73	235	13	0	321
35856	22962s (+0.8s)	3352	3352	256	66	204	14	0	284
35857	22963s (+0.8s)	3472	3472	256	69	218	11	0	298
35858	22963s (+0.5s)	1840	1840	128	52	131	7	0	190
35859	22964s (+0.8s)	3512	3512	256	62	216	18	0	296
35860	22965s (+0.4s)	1568	1568	128	29	119	6	0	154
35861	22965s (+0.7s)	2804	2804	256	50	170	10	0	230
35862	22966s (+0.5s)	1652	1652	128	49	117	7	0	173
35863	22967s (+0.9s)	3984	3984	256	80	235	15	0	330
35864	22967s (+0.5s)	1760	1760	128	47	122	10	0	179
35865	22968s (+0.9s)	3572	3572	256	82	203	15	0	300
35866	22969s (+0.6s)	1924	1924	128	50	143	5	0	198
35867	22969s (+0.6s)	2416	2416	128	63	152	12	0	227
35868	22970s (+0.5s)	1716	1716	128	55	107	11	0	173
35869	22970s (+0.4s)	1496	1496	128	28	126	3	0	157
35870	22971s (+0.5s)	2052	2052	256	49	117	5	0	171
35871	22971s (+0.5s)	1760	1760	128	51	122	7	0	180
35872	22972s (+0.6s)	2200	2200	128	56	144	10	0	210
35873	22972s (+0.5s)	1496	1496	128	38	116	4	0	158
35874	22973s (+0.3s)	944	944	64	23	88	6	0	117
35875	22973s (+0.4s)	1476	1476	128	29	121	4	0	154
35876	22974s (+0.8s)	3404	3404	256	71	198	13	0	282
35877	22975s (+0.4s)	1320	1320	128	28	112	5	0	145
35878	22975s (+0.4s)	1192	1192	128	26	96	8	0	130
35879	22976s (+1.1s)	5392	5392	512	98	258	22	1	379
35880	22977s (+0.7s)	3092	3092	256	60	185	8	0	253
35881	22977s (+0.6s)	1944	1944	128	37	154	0	6	197
35882	22978s (+0.6s)	2608	2608	256	47	173	0	7	227
35883	22978s (+0.4s)	1184	1184	128	22	96	0	5	123
35884	22979s (+0.5s)	1804	1804	128	45	133	0	8	186
35885	22980s (+0.9s)	3840	3840	256	73	219	0	19	311
35886	22980s (+0.4s)	1500	1500	128	34	110	0	12	156
35887	22981s (+0.6s)	1888	1888	128	46	141	8	0	195
35888	22981s (+0.4s)	1224	1224	64	36	107	5	0	148
35889	22982s (+0.4s)	1364	1364	128	30	105	6	0	141
35890	22982s (+0.8s)	3200	3200	256	71	182	14	0	267
35891	22983s (+0.9s)	3560	3560	256	69	215	14	0	298
35892	22984s (+0.5s)	1716	1716	128	42	129	6	0	177
35893	22985s (+1.0s)	4476	4476	256	92	259	14	0	365
35894	22985s (+0.7s)	2628	2628	256	49	173	9	0	231
35895	22986s (+0.3s)	828	828	64	25	78	6	0	109
35896	22986s (+0.7s)	2804	2804	256	48	180	0	15	243
35897	22987s (+0.6s)	2492	2492	256	46	159	0	9	214
35898	22988s (+1.1s)	4484	4484	256	83	284	0	7	374
35899	22989s (+0.6s)	2380	2380	128	45	164	0	14	223
Episode	Time	Reward	Score	Highest	L	U	R	D	Steps
35900	22989s (+0.6s)	2488	2488	256	39	166	0	10	215
35901	22990s (+0.7s)	3024	3024	256	59	182	0	10	251
35902	22990s (+0.3s)	940	940	64	23	84	0	9	116
35903	22992s (+1.1s)	5724	5724	512	81	314	0	14	409
35904	22993s (+1.0s)	4260	4260	256	65	269	0	17	351
35905	22993s (+0.6s)	2720	2720	256	43	176	0	9	228
35906	22994s (+0.5s)	1888	1888	128	37	149	0	5	191
35907	22994s (+0.4s)	1040	1040	64	27	93	0	5	125
35908	22995s (+0.7s)	3040	3040	256	57	189	0	10	256
35909	22996s (+0.6s)	2572	2572	256	50	163	0	10	223
35910	22996s (+0.7s)	3104	3104	256	55	191	0	11	257
35911	22997s (+0.5s)	1932	1932	128	40	134	0	13	187
35912	22997s (+0.5s)	1596	1596	128	29	134	0	5	168
35913	22998s (+0.3s)	784	784	64	16	76	0	3	95
35914	22998s (+0.7s)	3016	3016	256	47	189	0	11	247
35915	22999s (+0.6s)	1860	1860	128	49	139	6	0	194
35916	23000s (+1.3s)	6260	6260	512	127	295	28	1	451
35917	23001s (+0.6s)	2416	2416	256	50	141	11	0	202
35918	23001s (+0.7s)	2928	2928	256	60	172	13	0	245
35919	23002s (+0.7s)	2852	2852	256	62	180	9	0	251
35920	23003s (+0.8s)	2988	2988	256	70	182	16	0	268
35921	23003s (+0.4s)	1316	1316	128	32	100	9	0	141
35922	23004s (+1.0s)	5124	5124	512	106	232	19	0	357
35923	23005s (+0.4s)	948	948	64	33	91	3	0	127
35924	23005s (+0.6s)	1872	1872	128	44	136	7	0	187
35925	23006s (+1.0s)	4172	4172	256	83	244	18	0	345
35926	23007s (+0.5s)	2292	2292	256	44	132	12	0	188
35927	23007s (+0.4s)	1420	1420	128	43	99	9	0	151
35928	23008s (+0.5s)	1660	1660	128	36	123	7	0	166
35929	23008s (+0.8s)	3312	3312	256	64	201	9	0	274
35930	23009s (+0.7s)	3036	3036	256	56	186	12	0	254
35931	23010s (+0.7s)	2792	2792	256	65	166	10	0	241
35932	23011s (+0.7s)	2892	2892	256	57	181	11	0	249
35933	23011s (+0.5s)	1876	1876	128	43	138	6	0	187
35934	23012s (+1.0s)	4644	4644	256	106	241	20	1	368
35935	23013s (+0.5s)	1872	1872	128	50	132	9	0	191
35936	23013s (+0.6s)	2384	2384	256	55	136	11	0	202
35937	23014s (+0.5s)	1608	1608	128	41	116	11	0	168
35938	23014s (+0.6s)	1928	1928	128	48	144	8	0	200
35939	23015s (+0.4s)	1472	1472	128	41	104	7	0	152
35940	23016s (+0.9s)	4700	4700	512	67	247	10	1	325
35941	23016s (+0.5s)	1888	1888	128	45	135	10	0	190
35942	23017s (+1.1s)	4620	4620	256	93	264	19	0	376
35943	23018s (+0.9s)	3812	3812	256	85	221	13	0	319
35944	23019s (+0.3s)	904	904	64	37	75	5	0	117
35945	23019s (+0.6s)	2600	2600	256	46	174	5	0	225
35946	23020s (+0.6s)	2772	2772	256	49	164	10	0	223
35947	23021s (+0.8s)	3320	3320	256	67	200	11	0	278
35948	23021s (+0.4s)	1052	1052	64	35	89	4	0	128
35949	23022s (+0.7s)	3164	3164	256	77	172	15	0	264
35950	23022s (+0.4s)	1448	1448	128	46	98	7	0	151
35951	23023s (+0.4s)	1220	1220	128	33	96	3	0	132
35952	23023s (+0.6s)	2448	2448	256	55	136	13	0	204
35953	23023s (+0.4s)	1240	1240	128	23	105	3	0	131
35954	23024s (+0.6s)	2448	2448	256	35	164	1	9	209
35955	23025s (+0.5s)	1776	1776	128	48	124	0	7	179
35956	23025s (+0.8s)	3500	3500	256	65	213	0	12	290
35957	23026s (+0.7s)	2752	2752	256	39	191	0	7	237
35958	23027s (+0.5s)	1652	1652	128	21	138	0	4	163
35959	23027s (+0.3s)	1128	1128	128	20	94	0	6	120
35960	23028s (+0.7s)	2920	2920	256	56	191	9	0	256
35961	23028s (+0.8s)	3668	3668	256	77	210	12	0	299
35962	23029s (+0.7s)	2840	2840	256	65	177	6	0	248
35963	23030s (+0.8s)	3364	3364	256	70	207	10	0	287
35964	23030s (+0.4s)	1504	1504	128	33	115	7	0	155
35965	23031s (+0.5s)	1860	1860	128	56	115	12	1	184
35966	23032s (+0.6s)	2508	2508	128	64	161	8	0	233
35967	23032s (+0.4s)	1328	1328	64	43	103	6	0	152
35968	23032s (+0.4s)	1176	1176	64	36	100	5	0	141
35969	23033s (+0.4s)	1504	1504	128	31	114	7	1	153
35970	23034s (+0.7s)	3140	3140	256	61	188	16	0	265
35971	23034s (+0.5s)	1704	1704	128	47	117	9	0	173
35972	23035s (+0.9s)	4080	4080	256	76	245	17	0	338
35973	23036s (+0.6s)	1948	1948	128	56	131	11	0	198
35974	23036s (+0.5s)	1816	1816	128	56	119	9	0	184
35975	23037s (+0.6s)	1992	1992	128	49	143	12	0	204
35976	23037s (+0.5s)	1940	1940	128	60	115	13	0	188
35977	23038s (+0.5s)	1608	1608	128	50	113	6	0	169
35978	23038s (+0.4s)	1496	1496	128	36	113	8	0	157
35979	23039s (+0.5s)	1752	1752	128	42	128	8	0	178
35980	23039s (+0.3s)	1136	1136	128	34	87	3	0	124
35981	23040s (+0.5s)	1672	1672	128	33	130	6	0	169
35982	23041s (+1.1s)	4580	4580	256	101	253	21	0	375
35983	23041s (+0.6s)	2348	2348	256	42	143	0	11	196
35984	23042s (+0.8s)	3272	3272	256	49	207	0	11	267
35985	23043s (+0.7s)	2944	2944	256	48	193	0	6	247
35986	23043s (+0.4s)	1156	1156	64	30	98	0	9	137
35987	23044s (+0.7s)	3108	3108	256	57	189	6	0	252
35988	23044s (+0.5s)	1764	1764	128	41	128	8	0	177
35989	23045s (+0.9s)	3600	3600	256	93	193	21	0	307
35990	23045s (+0.3s)	712	712	64	25	69	2	0	96
35991	23047s (+1.1s)	4592	4592	256	105	251	22	0	378
35992	23047s (+0.7s)	2844	2844	256	69	164	16	0	249
35993	23048s (+0.5s)	2252	2252	256	41	146	7	0	194
35994	23048s (+0.6s)	2592	2592	256	43	164	10	0	217
35995	23049s (+0.8s)	3568	3568	256	70	219	12	0	301
35996	23050s (+0.3s)	784	784	64	14	87	3	1	105
35997	23050s (+0.7s)	3040	3040	256	54	177	13	0	244
35998	23051s (+0.4s)	1188	1188	128	27	96	6	1	130
35999	23051s (+0.8s)	3332	3332	256	60	208	11	0	279
Episode	Time	Reward	Score	Highest	L	U	R	D	Steps
36000	23052s (+0.5s)	1764	1764	128	39	132	6	0	177
36001	23053s (+0.6s)	1932	1932	128	55	142	4	0	201
36002	23054s (+1.0s)	4152	4152	256	92	231	17	0	340
36003	23054s (+0.5s)	1820	1820	128	45	135	10	0	190
36004	23054s (+0.3s)	1008	1008	128	27	71	6	0	104
36005	23055s (+0.6s)	1948	1948	128	43	152	10	0	205
36006	23056s (+0.7s)	2996	2996	256	80	155	16	0	251
36007	23057s (+0.8s)	3376	3376	256	58	221	11	0	290
36008	23057s (+0.3s)	1056	1056	128	23	86	4	0	113
36009	23058s (+0.9s)	4132	4132	256	86	237	16	0	339
36010	23058s (+0.6s)	1924	1924	128	48	138	10	0	196
36011	23059s (+0.6s)	2480	2480	256	46	160	5	0	211
36012	23060s (+0.6s)	1984	1984	128	52	150	7	0	209
36013	23060s (+0.6s)	2544	2544	256	49	160	8	0	217
36014	23061s (+0.8s)	3400	3400	256	70	198	13	0	281
36015	23062s (+0.6s)	1916	1916	128	37	152	0	8	197
36016	23062s (+0.6s)	2696	2696	256	49	173	0	12	234
36017	23063s (+0.6s)	2496	2496	256	57	151	0	8	216
36018	23064s (+0.9s)	3780	3780	256	53	242	0	18	313
36019	23064s (+0.5s)	1468	1468	64	40	115	7	0	162
36020	23065s (+0.5s)	1812	1812	128	51	125	12	0	188
36021	23065s (+0.4s)	1220	1220	128	27	93	5	1	126
36022	23066s (+0.7s)	2968	2968	256	60	178	9	0	247
36023	23066s (+0.6s)	2372	2372	256	54	143	9	0	206
36024	23067s (+0.6s)	2304	2304	128	52	158	10	0	220
36025	23068s (+0.6s)	2092	2092	128	56	141	13	0	210
36026	23068s (+0.6s)	2192	2192	128	46	150	11	0	207
36027	23069s (+0.9s)	4056	4056	256	89	222	22	0	333
36028	23070s (+0.7s)	2872	2872	256	68	172	10	0	250
36029	23070s (+0.4s)	1292	1292	128	36	93	8	1	138
36030	23071s (+0.5s)	1976	1976	128	59	125	13	0	197
36031	23072s (+0.8s)	3380	3380	256	67	212	12	0	291
36032	23072s (+0.4s)	1428	1428	128	27	114	5	0	146
36033	23072s (+0.4s)	1112	1112	128	31	89	3	0	123
36034	23073s (+0.2s)	616	616	64	15	62	2	0	79
36035	23073s (+0.5s)	1628	1628	128	41	120	9	0	170
36036	23074s (+0.9s)	4108	4108	256	91	226	18	0	335
36037	23074s (+0.3s)	856	856	64	24	81	5	0	110
36038	23075s (+0.5s)	1644	1644	128	39	131	8	0	178
36039	23076s (+1.0s)	4064	4064	256	72	249	16	1	338
36040	23077s (+1.1s)	5500	5500	512	101	265	22	2	390
36041	23078s (+0.7s)	2684	2684	128	61	173	16	0	250
36042	23079s (+1.0s)	4204	4204	256	80	255	11	0	346
36043	23079s (+0.7s)	2584	2584	128	77	151	17	0	245
36044	23080s (+0.9s)	3816	3816	256	86	215	16	0	317
36045	23081s (+0.5s)	1596	1596	128	44	115	4	0	163
36046	23081s (+0.5s)	1720	1720	128	38	127	9	0	174
36047	23082s (+0.3s)	936	936	64	24	84	6	0	114
36048	23082s (+0.3s)	668	668	64	15	71	4	0	90
36049	23082s (+0.6s)	2116	2116	128	72	130	8	0	210
36050	23083s (+0.4s)	1108	1108	64	32	99	5	0	136
36051	23084s (+0.6s)	2640	2640	256	57	167	5	0	229
36052	23084s (+0.5s)	1716	1716	128	38	128	6	1	173
36053	23085s (+0.6s)	2052	2052	128	55	135	8	0	198
36054	23085s (+0.7s)	2948	2948	256	63	188	12	0	263
36055	23086s (+0.9s)	3784	3784	256	81	217	14	0	312
36056	23087s (+0.5s)	1752	1752	128	36	136	6	0	178
36057	23088s (+0.9s)	3988	3988	256	78	237	16	0	331
36058	23088s (+0.5s)	2324	2324	256	41	143	8	0	192
36059	23089s (+0.4s)	980	980	64	37	82	5	0	124
36060	23089s (+0.5s)	1724	1724	128	42	126	10	0	178
36061	23090s (+0.6s)	2324	2324	256	48	147	9	0	204
36062	23091s (+0.9s)	4052	4052	256	74	243	14	0	331
36063	23091s (+0.5s)	1616	1616	128	45	121	5	0	171
36064	23092s (+0.4s)	1384	1384	128	28	111	7	0	146
36065	23092s (+0.5s)	2244	2244	256	47	128	7	0	182
36066	23093s (+0.6s)	1908	1908	128	42	148	10	0	200
36067	23093s (+0.7s)	2768	2768	256	67	160	12	0	239
36068	23094s (+0.5s)	1760	1760	128	43	127	7	0	177
36069	23094s (+0.5s)	1796	1796	128	39	136	9	0	184
36070	23095s (+0.5s)	1644	1644	128	33	126	0	8	167
36071	23095s (+0.6s)	1868	1868	128	39	149	0	9	197
36072	23096s (+0.5s)	1872	1872	128	45	135	7	0	187
36073	23097s (+0.6s)	2152	2152	128	65	133	16	0	214
36074	23097s (+0.5s)	2280	2280	256	41	139	6	0	186
36075	23098s (+0.5s)	1852	1852	128	49	129	9	0	187
36076	23098s (+0.4s)	1424	1424	128	31	108	7	0	146
36077	23099s (+0.9s)	3768	3768	256	98	205	14	0	317
36078	23100s (+0.8s)	3304	3304	256	77	183	14	0	274
36079	23101s (+0.7s)	2436	2436	128	57	164	11	0	232
36080	23101s (+0.8s)	3236	3236	256	57	205	9	0	271
36081	23102s (+0.5s)	1820	1820	128	51	116	13	0	180
36082	23103s (+0.8s)	3492	3492	256	75	201	16	0	292
36083	23103s (+0.6s)	2444	2444	256	54	141	13	0	208
36084	23104s (+0.7s)	3120	3120	256	61	187	12	0	260
36085	23105s (+0.7s)	2912	2912	256	68	177	9	0	254
36086	23105s (+0.2s)	360	360	32	8	51	0	2	61
36087	23105s (+0.5s)	1720	1720	128	33	135	0	3	171
36088	23106s (+0.5s)	1772	1772	128	40	130	8	0	178
36089	23107s (+0.8s)	3492	3492	256	69	209	15	0	293
36090	23107s (+0.6s)	2572	2572	256	56	151	11	0	218
36091	23108s (+0.8s)	3432	3432	256	74	202	8	0	284
36092	23109s (+0.8s)	3592	3592	256	70	207	14	0	291
36093	23110s (+0.8s)	3632	3632	256	88	195	13	0	296
36094	23111s (+0.8s)	3088	3088	256	65	193	13	0	271
36095	23111s (+0.6s)	2492	2492	256	53	153	10	0	216
36096	23112s (+0.5s)	1736	1736	128	53	114	9	0	176
36097	23112s (+0.6s)	2436	2436	256	44	154	8	0	206
36098	23113s (+0.9s)	3892	3892	256	64	237	16	0	317
36099	23114s (+0.6s)	2524	2524	256	59	143	11	0	213
Episode	Time	Reward	Score	Highest	L	U	R	D	Steps
36100	23114s (+0.3s)	1096	1096	128	28	84	5	0	117
36101	23115s (+0.7s)	2888	2888	256	66	158	14	0	238
36102	23115s (+0.3s)	732	732	64	20	77	1	0	98
36103	23116s (+0.4s)	1220	1220	128	35	91	5	2	133
36104	23116s (+0.4s)	1312	1312	128	36	101	6	0	143
36105	23117s (+0.6s)	2752	2752	256	50	161	11	0	222
36106	23117s (+0.4s)	1204	1204	128	28	94	7	0	129
36107	23118s (+1.0s)	4208	4208	256	96	235	16	0	347
36108	23119s (+0.6s)	2568	2568	256	62	149	10	0	221
36109	23119s (+0.4s)	992	992	64	33	89	5	0	127
36110	23120s (+0.6s)	2208	2208	128	61	131	15	0	207
36111	23121s (+1.1s)	5396	5396	512	90	266	18	1	375
36112	23121s (+0.7s)	2420	2420	128	62	158	8	0	228
36113	23122s (+0.6s)	1916	1916	128	47	144	6	0	197
36114	23122s (+0.6s)	1916	1916	128	47	141	9	0	197
36115	23123s (+1.0s)	5152	5152	512	89	251	16	1	357
36116	23124s (+0.4s)	1372	1372	64	38	102	11	0	151
36117	23125s (+1.0s)	4028	4028	256	77	245	14	0	336
36118	23126s (+1.0s)	4152	4152	256	98	224	18	0	340
36119	23126s (+0.5s)	1772	1772	128	42	136	3	1	182
36120	23127s (+0.4s)	1452	1452	128	33	112	7	0	152
36121	23128s (+0.9s)	3556	3556	256	77	207	19	0	303
36122	23128s (+0.6s)	2144	2144	128	46	144	8	0	198
36123	23129s (+0.5s)	1788	1788	128	35	146	1	0	182
36124	23129s (+0.7s)	2696	2696	256	51	169	13	1	234
36125	23130s (+0.8s)	3372	3372	256	61	201	13	0	275
36126	23131s (+0.5s)	1724	1724	128	44	125	9	0	178
36127	23131s (+0.6s)	2380	2380	128	58	156	9	0	223
36128	23132s (+0.4s)	1180	1180	64	38	97	7	0	142
36129	23132s (+0.4s)	1304	1304	128	39	91	8	0	138
36130	23133s (+0.3s)	1100	1100	128	26	89	5	0	120
36131	23133s (+0.9s)	3852	3852	256	81	222	11	0	314
36132	23134s (+0.6s)	2124	2124	128	51	148	11	0	210
36133	23134s (+0.3s)	692	692	64	15	78	0	2	95
36134	23135s (+0.5s)	1596	1596	128	30	129	0	6	165
36135	23136s (+0.7s)	3084	3084	256	54	183	0	15	252
36136	23136s (+0.5s)	1368	1368	64	33	116	0	8	157
36137	23137s (+0.8s)	3356	3356	256	62	202	1	12	277
36138	23138s (+0.9s)	3712	3712	256	93	201	17	0	311
36139	23138s (+0.6s)	2224	2224	128	50	144	11	0	205
36140	23139s (+0.5s)	1576	1576	128	35	119	7	0	161
36141	23139s (+0.8s)	3280	3280	256	72	195	11	0	278
36142	23140s (+0.4s)	1596	1596	128	23	135	2	0	160
36143	23140s (+0.4s)	1036	1036	64	26	91	6	0	123
36144	23141s (+0.4s)	1108	1108	128	26	91	5	0	122
36145	23142s (+0.9s)	4240	4240	256	88	241	18	0	347
36146	23142s (+0.8s)	3348	3348	256	81	185	17	0	283
36147	23143s (+0.6s)	2528	2528	256	51	154	8	0	213
36148	23144s (+0.6s)	2776	2776	256	66	160	11	0	237
36149	23144s (+0.5s)	1512	1512	128	44	110	7	0	161
36150	23145s (+0.7s)	2876	2876	256	65	176	10	0	251
36151	23146s (+0.8s)	3556	3556	256	68	216	12	0	296
36152	23146s (+0.5s)	1648	1648	128	31	128	6	0	165
36153	23147s (+0.7s)	3068	3068	256	68	174	11	0	253
36154	23147s (+0.5s)	1760	1760	128	29	144	6	1	180
36155	23148s (+1.0s)	4964	4964	512	86	240	17	0	343
36156	23149s (+0.3s)	876	876	64	21	89	4	0	114
36157	23149s (+0.3s)	920	920	64	39	72	9	0	120
36158	23150s (+0.5s)	1536	1536	128	38	116	9	0	163
36159	23150s (+0.4s)	1512	1512	128	32	122	7	0	161
36160	23151s (+0.8s)	3324	3324	256	78	187	13	0	278
36161	23152s (+0.7s)	3212	3212	256	58	201	13	0	272
36162	23152s (+0.5s)	1784	1784	128	42	134	9	0	185
36163	23153s (+0.6s)	1936	1936	128	49	142	11	0	202
36164	23153s (+0.4s)	1080	1080	64	32	90	5	0	127
36165	23154s (+1.0s)	4436	4436	256	81	272	0	14	367
36166	23154s (+0.3s)	660	660	64	18	66	0	6	90
36167	23155s (+1.0s)	4208	4208	256	76	248	0	19	343
36168	23156s (+0.8s)	3436	3436	256	66	211	0	13	290
36169	23157s (+0.9s)	3796	3796	256	73	217	12	3	305
36170	23158s (+0.8s)	3372	3372	256	83	190	11	0	284
36171	23159s (+0.9s)	3544	3544	256	78	204	16	0	298
36172	23159s (+0.5s)	1552	1552	128	40	119	7	0	166
36173	23160s (+0.3s)	868	868	64	35	73	6	0	114
36174	23160s (+0.8s)	3360	3360	256	66	202	18	0	286
36175	23161s (+0.3s)	828	828	64	23	80	4	0	107
36176	23162s (+0.8s)	3524	3524	256	71	204	20	0	295
36177	23162s (+0.8s)	3252	3252	256	76	183	12	0	271
36178	23163s (+0.7s)	3192	3192	256	62	190	9	0	261
36179	23164s (+0.6s)	2444	2444	256	51	146	14	0	211
36180	23164s (+0.3s)	976	976	64	36	83	4	0	123
36181	23165s (+0.9s)	3592	3592	256	69	223	12	0	304
36182	23166s (+0.8s)	3456	3456	256	72	211	12	0	295
36183	23167s (+0.8s)	3636	3636	256	62	218	12	0	292
36184	23167s (+0.5s)	1784	1784	128	41	135	5	0	181
36185	23168s (+0.5s)	1640	1640	128	42	126	8	0	176
36186	23168s (+0.8s)	3296	3296	256	70	201	11	0	282
36187	23169s (+0.7s)	2876	2876	256	56	177	12	0	245
36188	23170s (+0.8s)	3352	3352	256	59	210	14	1	284
36189	23170s (+0.5s)	2140	2140	256	37	140	6	0	183
36190	23171s (+0.4s)	1400	1400	128	24	117	5	0	146
36191	23171s (+0.3s)	764	764	64	23	76	4	0	103
36192	23172s (+0.8s)	4508	4508	512	74	217	13	1	305
36193	23173s (+0.5s)	1760	1760	128	40	133	7	0	180
36194	23173s (+0.8s)	3228	3228	256	46	209	1	14	270
36195	23174s (+0.6s)	1848	1848	128	38	150	0	4	192
36196	23174s (+0.6s)	2548	2548	256	41	165	0	12	218
36197	23175s (+0.6s)	2184	2184	128	34	161	0	7	202
36198	23176s (+0.7s)	3048	3048	256	49	187	0	8	244
36199	23177s (+0.7s)	3040	3040	256	47	200	0	11	258
Episode	Time	Reward	Score	Highest	L	U	R	D	Steps
36200	23177s (+0.9s)	3976	3976	256	67	245	0	16	328
36201	23178s (+0.7s)	2744	2744	256	43	182	0	10	235
36202	23178s (+0.4s)	1196	1196	128	19	98	0	5	122
36203	23179s (+0.6s)	2224	2224	128	41	158	1	11	211
36204	23180s (+0.4s)	1420	1420	128	30	114	6	0	150
36205	23180s (+0.6s)	1944	1944	128	48	135	11	0	194
36206	23181s (+0.5s)	1768	1768	128	35	137	9	0	181
36207	23181s (+0.5s)	1604	1604	128	33	130	5	0	168
36208	23182s (+0.4s)	1448	1448	128	34	110	6	0	150
36209	23182s (+0.5s)	1528	1528	128	43	107	9	0	159
36210	23182s (+0.5s)	1576	1576	128	46	111	9	0	166
36211	23183s (+0.5s)	1648	1648	128	40	125	4	0	169
36212	23184s (+0.5s)	1880	1880	128	49	137	7	0	193
36213	23184s (+0.5s)	1724	1724	128	41	126	6	0	173
36214	23185s (+0.6s)	2156	2156	128	61	135	10	0	206
36215	23185s (+0.6s)	2136	2136	128	61	133	12	0	206
36216	23186s (+0.4s)	1464	1464	128	35	105	10	0	150
36217	23186s (+0.6s)	2480	2480	256	44	160	8	0	212
36218	23187s (+0.8s)	3308	3308	256	82	178	16	2	278
36219	23188s (+0.6s)	2460	2460	256	58	132	16	1	207
36220	23188s (+0.5s)	1896	1896	128	42	142	8	0	192
36221	23189s (+0.5s)	1644	1644	128	44	126	0	3	173
36222	23189s (+0.4s)	1544	1544	128	29	118	0	8	155
36223	23190s (+0.5s)	1656	1656	128	38	115	0	8	161
36224	23190s (+0.7s)	3192	3192	256	47	205	0	8	260
36225	23191s (+0.3s)	584	584	32	21	60	0	6	87
36226	23191s (+0.8s)	3500	3500	256	66	216	0	12	294
36227	23192s (+0.6s)	1928	1928	128	46	146	8	0	200
36228	23193s (+0.8s)	3468	3468	256	73	199	19	0	291
36229	23193s (+0.6s)	2388	2388	256	67	125	13	0	205
36230	23194s (+0.6s)	2280	2280	128	48	157	8	0	213
36231	23195s (+0.7s)	3092	3092	256	57	183	14	0	254
36232	23196s (+0.7s)	2608	2608	128	69	163	15	0	247
36233	23196s (+0.2s)	624	624	64	23	58	3	1	85
36234	23197s (+1.0s)	4160	4160	256	77	246	17	2	342
36235	23197s (+0.4s)	1560	1560	128	44	105	8	0	157
36236	23198s (+0.9s)	3952	3952	256	73	234	0	15	322
36237	23199s (+0.4s)	1564	1564	128	35	117	0	8	160
36238	23199s (+0.8s)	3192	3192	256	56	200	0	10	266
36239	23200s (+0.9s)	3516	3516	256	56	230	0	13	299
36240	23201s (+0.5s)	1620	1620	128	32	125	0	6	163
36241	23201s (+0.4s)	1340	1340	64	32	112	0	6	150
36242	23202s (+0.8s)	3508	3508	256	62	206	0	13	281
36243	23202s (+0.4s)	1300	1300	128	22	105	0	5	132
36244	23203s (+0.8s)	3264	3264	256	52	210	0	17	279
36245	23204s (+0.6s)	2540	2540	256	45	172	0	5	222
36246	23205s (+0.9s)	3804	3804	256	60	234	0	13	307
36247	23205s (+0.8s)	3512	3512	256	80	195	16	1	292
36248	23206s (+0.4s)	1416	1416	128	20	118	6	0	144
36249	23207s (+0.8s)	3444	3444	256	87	176	20	1	284
36250	23208s (+1.3s)	6456	6456	512	120	306	31	0	457
36251	23209s (+0.9s)	3600	3600	256	102	187	18	0	307
36252	23210s (+0.7s)	3004	3004	256	55	174	12	1	242
36253	23210s (+0.8s)	4392	4392	512	65	216	15	0	296
36254	23211s (+0.8s)	3180	3180	256	63	196	10	0	269
36255	23212s (+0.5s)	1576	1576	128	44	115	7	0	166
36256	23212s (+0.6s)	1916	1916	128	61	127	10	0	198
36257	23213s (+0.7s)	2500	2500	128	68	154	14	0	236
36258	23214s (+1.0s)	4324	4324	256	106	233	21	0	360
36259	23215s (+0.8s)	3228	3228	256	70	181	13	0	264
36260	23215s (+0.7s)	3188	3188	256	67	185	8	0	260
36261	23216s (+0.6s)	2340	2340	256	49	148	7	0	204
36262	23217s (+0.9s)	3632	3632	256	76	219	15	0	310
36263	23218s (+1.1s)	5764	5764	512	102	271	21	0	394
36264	23219s (+0.9s)	3544	3544	256	85	196	19	0	300
36265	23220s (+0.6s)	2568	2568	256	39	172	8	0	219
36266	23220s (+0.5s)	1504	1504	128	35	121	4	0	160
36267	23221s (+0.5s)	1924	1924	128	50	138	11	0	199
36268	23222s (+1.5s)	7912	7912	512	159	355	39	0	553
36269	23223s (+0.5s)	2012	2012	256	31	130	4	0	165
36270	23223s (+0.6s)	2648	2648	256	56	160	10	0	226
36271	23224s (+0.5s)	1652	1652	128	49	108	12	0	169
36272	23225s (+0.8s)	3324	3324	256	85	180	17	0	282
36273	23225s (+0.4s)	1356	1356	128	32	103	5	0	140
36274	23226s (+0.4s)	1504	1504	128	30	116	6	0	152
36275	23227s (+0.9s)	3772	3772	256	89	208	17	0	314
36276	23227s (+0.4s)	1388	1388	128	32	110	5	0	147
36277	23227s (+0.5s)	1560	1560	128	38	117	6	1	162
36278	23228s (+0.5s)	1508	1508	128	42	111	8	0	161
36279	23228s (+0.4s)	1188	1188	128	30	99	1	0	130
36280	23229s (+0.5s)	1896	1896	128	41	143	8	0	192
36281	23230s (+0.8s)	3192	3192	256	66	188	12	0	266
36282	23231s (+0.9s)	4128	4128	256	94	226	14	0	334
36283	23231s (+0.5s)	1908	1908	128	49	137	9	0	195
36284	23232s (+0.4s)	1476	1476	128	33	111	8	0	152
36285	23232s (+0.8s)	3480	3480	256	72	197	20	0	289
36286	23233s (+0.4s)	1500	1500	128	42	100	9	1	152
36287	23233s (+0.5s)	1728	1728	128	51	115	10	1	177
36288	23234s (+0.5s)	1608	1608	128	40	120	9	0	169
36289	23234s (+0.5s)	1804	1804	128	36	134	0	12	182
36290	23235s (+0.4s)	1176	1176	128	21	102	0	5	128
36291	23236s (+0.9s)	3928	3928	256	79	225	16	0	320
36292	23236s (+0.5s)	1832	1832	128	45	128	13	0	186
36293	23237s (+1.0s)	5076	5076	512	72	279	13	0	364
36294	23238s (+0.5s)	1808	1808	128	48	118	14	0	180
36295	23238s (+0.5s)	1552	1552	128	22	134	0	6	162
36296	23239s (+0.8s)	3356	3356	256	52	221	0	13	286
36297	23240s (+1.0s)	4176	4176	256	101	222	0	23	346
36298	23241s (+0.6s)	2468	2468	256	47	157	0	6	210
36299	23241s (+0.5s)	1632	1632	128	31	129	0	6	166
Episode	Time	Reward	Score	Highest	L	U	R	D	Steps
36300	23242s (+0.5s)	1780	1780	128	26	150	0	6	182
36301	23242s (+0.8s)	3220	3220	256	51	205	0	12	268
36302	23243s (+0.6s)	2616	2616	256	45	173	0	6	224
36303	23243s (+0.4s)	1456	1456	128	27	115	0	8	150
36304	23244s (+0.7s)	2868	2868	256	68	168	12	0	248
36305	23245s (+0.9s)	3572	3572	256	76	210	14	0	300
36306	23246s (+0.8s)	3168	3168	256	66	190	11	0	267
36307	23246s (+0.4s)	1472	1472	128	29	119	5	0	153
36308	23247s (+0.4s)	1344	1344	128	47	93	7	0	147
36309	23247s (+0.5s)	2040	2040	256	35	128	5	0	168
36310	23248s (+0.4s)	1412	1412	128	27	118	1	0	146
36311	23248s (+0.6s)	2628	2628	256	52	156	13	1	222
36312	23249s (+0.7s)	2576	2576	128	66	170	8	0	244
36313	23250s (+0.9s)	3908	3908	256	87	213	18	0	318
36314	23250s (+0.4s)	1260	1260	128	28	104	4	0	136
36315	23251s (+0.6s)	1948	1948	128	45	146	9	0	200
36316	23251s (+0.6s)	2436	2436	256	47	156	8	0	211
36317	23252s (+0.6s)	2364	2364	256	49	145	6	0	200
36318	23253s (+0.9s)	4820	4820	512	89	215	26	0	330
36319	23254s (+0.7s)	2904	2904	256	55	178	10	0	243
36320	23255s (+1.2s)	6332	6332	512	111	324	19	0	454
36321	23256s (+0.9s)	3920	3920	256	79	232	15	0	326
36322	23257s (+0.8s)	3336	3336	256	76	191	13	0	280
36323	23257s (+0.8s)	3360	3360	256	64	212	10	0	286
36324	23258s (+0.4s)	1392	1392	128	42	105	6	0	153
36325	23259s (+0.9s)	4728	4728	512	81	229	20	0	330
36326	23259s (+0.3s)	800	800	64	27	75	5	0	107
36327	23259s (+0.4s)	1316	1316	128	27	105	4	0	136
36328	23260s (+0.7s)	2828	2828	256	75	150	10	0	235
36329	23261s (+0.8s)	3440	3440	256	70	205	15	1	291
36330	23261s (+0.3s)	808	808	64	21	83	5	0	109
36331	23262s (+0.7s)	2916	2916	256	66	162	6	1	235
36332	23263s (+0.6s)	2728	2728	256	58	154	15	0	227
36333	23263s (+0.5s)	1620	1620	128	48	108	5	1	162
36334	23264s (+0.7s)	2872	2872	256	64	174	11	0	249
36335	23265s (+0.7s)	3112	3112	256	59	179	13	0	251
36336	23265s (+0.8s)	3248	3248	256	74	180	13	1	268
36337	23266s (+0.6s)	1932	1932	128	61	125	8	1	195
36338	23266s (+0.5s)	1672	1672	128	43	133	4	0	180
36339	23267s (+0.7s)	3032	3032	256	60	174	9	1	244
36340	23268s (+0.8s)	3604	3604	256	76	206	12	0	294
36341	23268s (+0.3s)	684	684	64	21	63	7	0	91
36342	23269s (+0.3s)	944	944	64	25	80	6	0	111
36343	23269s (+0.5s)	1696	1696	128	46	119	6	0	171
36344	23270s (+0.8s)	3764	3764	256	67	218	12	1	298
36345	23271s (+0.7s)	2460	2460	128	61	152	16	0	229
36346	23271s (+0.8s)	3500	3500	256	73	211	9	1	294
36347	23272s (+0.8s)	3476	3476	256	73	201	18	0	292
36348	23273s (+0.6s)	2228	2228	128	46	161	5	1	213
36349	23273s (+0.5s)	1736	1736	128	40	125	9	1	175
36350	23274s (+0.8s)	3252	3252	256	69	185	14	0	268
36351	23275s (+0.4s)	1404	1404	128	38	105	7	0	150
36352	23275s (+0.6s)	2384	2384	256	41	158	5	0	204
36353	23276s (+0.4s)	1488	1488	128	43	106	7	0	156
36354	23277s (+0.9s)	3796	3796	256	81	215	19	0	315
36355	23278s (+1.1s)	5224	5224	512	84	272	0	14	370
36356	23278s (+0.4s)	1168	1168	128	27	92	0	5	124
36357	23279s (+0.7s)	2728	2728	256	51	175	0	9	235
36358	23279s (+0.8s)	3672	3672	256	67	217	0	18	302
36359	23280s (+0.4s)	1344	1344	128	31	103	0	6	140
36360	23281s (+0.9s)	3872	3872	256	61	241	0	13	315
36361	23281s (+0.5s)	1644	1644	128	36	129	0	8	173
36362	23282s (+0.5s)	1816	1816	128	37	147	0	5	189
36363	23282s (+0.6s)	2000	2000	128	56	137	10	0	203
36364	23283s (+0.5s)	1600	1600	128	27	133	6	0	166
36365	23283s (+0.5s)	1596	1596	128	45	117	4	0	166
36366	23284s (+0.4s)	1272	1272	128	27	99	6	0	132
36367	23284s (+0.5s)	1824	1824	128	43	141	6	0	190
36368	23285s (+0.6s)	2528	2528	256	46	165	8	0	219
36369	23286s (+0.7s)	2820	2820	256	47	193	8	0	248
36370	23286s (+0.7s)	3248	3248	256	68	190	15	1	274
36371	23287s (+0.6s)	1968	1968	128	48	140	7	0	195
36372	23288s (+0.6s)	1960	1960	128	46	147	8	0	201
36373	23289s (+1.3s)	6340	6340	512	115	308	21	0	444
36374	23290s (+1.0s)	4300	4300	256	96	238	20	0	354
36375	23290s (+0.4s)	1184	1184	128	24	101	5	0	130
36376	23291s (+0.4s)	1508	1508	128	39	111	6	0	156
36377	23291s (+0.7s)	2288	2288	128	59	155	17	0	231
36378	23292s (+0.4s)	1444	1444	128	38	107	4	0	149
36379	23292s (+0.7s)	2620	2620	256	61	159	10	0	230
36380	23294s (+1.0s)	4316	4316	256	103	243	18	0	364
36381	23294s (+0.7s)	2504	2504	128	60	159	12	2	233
36382	23295s (+0.5s)	1636	1636	128	34	120	11	0	165
36383	23295s (+0.6s)	2684	2684	256	50	166	10	0	226
36384	23296s (+0.5s)	1792	1792	128	45	128	10	0	183
36385	23296s (+0.5s)	1528	1528	128	34	122	4	0	160
36386	23297s (+1.1s)	4572	4572	256	105	248	22	0	375
36387	23298s (+0.5s)	2456	2456	256	32	163	0	8	203
36388	23298s (+0.5s)	1740	1740	128	30	139	0	6	175
36389	23299s (+0.7s)	3172	3172	256	58	194	0	10	262
36390	23300s (+1.2s)	5880	5880	512	96	307	0	21	424
36391	23301s (+0.7s)	2812	2812	256	54	182	0	9	245
36392	23302s (+0.8s)	3284	3284	256	65	200	12	0	277
36393	23303s (+1.0s)	4340	4340	256	109	231	23	1	364
36394	23303s (+0.4s)	1616	1616	128	43	115	5	0	163
36395	23304s (+0.4s)	1204	1204	128	32	91	10	1	134
36396	23305s (+0.8s)	3340	3340	256	82	185	14	0	281
36397	23305s (+0.8s)	3224	3224	256	67	188	13	0	268
36398	23306s (+0.5s)	1932	1932	128	55	123	13	0	191
36399	23306s (+0.4s)	980	980	64	30	85	9	0	124
Episode	Time	Reward	Score	Highest	L	U	R	D	Steps
36400	23307s (+0.3s)	892	892	64	32	78	4	0	114
36401	23307s (+0.5s)	1740	1740	128	49	118	11	0	178
36402	23308s (+0.4s)	1232	1232	128	31	98	6	0	135
36403	23308s (+0.8s)	3476	3476	256	65	206	18	0	289
36404	23309s (+0.8s)	3632	3632	256	66	211	0	16	293
36405	23310s (+0.4s)	1512	1512	128	32	117	0	7	156
36406	23311s (+0.9s)	3932	3932	256	61	246	0	16	323
36407	23311s (+0.9s)	3544	3544	256	71	214	0	15	300
36408	23312s (+0.8s)	3420	3420	256	66	204	0	16	286
36409	23313s (+0.8s)	3532	3532	256	71	210	0	16	297
36410	23313s (+0.4s)	1368	1368	128	25	113	0	5	143
36411	23314s (+0.6s)	2212	2212	128	45	154	0	9	208
36412	23315s (+1.0s)	5168	5168	512	84	261	0	14	359
36413	23316s (+0.7s)	2624	2624	256	52	166	0	8	226
36414	23316s (+0.6s)	2344	2344	256	32	160	0	8	200
36415	23317s (+0.4s)	1440	1440	128	38	107	5	0	150
36416	23317s (+0.5s)	1500	1500	128	46	105	8	0	159
36417	23318s (+0.6s)	2432	2432	256	47	158	7	0	212
36418	23318s (+0.6s)	2064	2064	128	45	138	9	1	193
36419	23319s (+0.5s)	1748	1748	128	46	131	6	0	183
36420	23320s (+0.9s)	3700	3700	256	69	232	13	0	314
36421	23321s (+0.7s)	2860	2860	256	55	179	13	0	247
36422	23321s (+0.4s)	1048	1048	64	36	81	9	0	126
36423	23322s (+0.8s)	3336	3336	256	80	181	19	0	280
36424	23322s (+0.5s)	1768	1768	128	42	133	7	0	182
36425	23323s (+0.8s)	3412	3412	256	57	222	0	9	288
36426	23324s (+0.7s)	2576	2576	256	46	173	0	8	227
36427	23324s (+0.5s)	1816	1816	128	53	121	0	11	185
36428	23325s (+0.7s)	2948	2948	256	55	181	1	12	249
36429	23326s (+0.7s)	3116	3116	256	72	167	19	1	259
36430	23326s (+0.2s)	560	560	32	22	57	4	1	84
36431	23327s (+0.8s)	3516	3516	256	59	229	10	0	298
36432	23327s (+0.5s)	1528	1528	128	48	111	2	0	161
36433	23328s (+0.8s)	3432	3432	256	71	205	12	1	289
36434	23329s (+0.4s)	1272	1272	128	28	106	5	0	139
36435	23329s (+0.8s)	3328	3328	256	76	190	16	0	282
36436	23330s (+0.6s)	2344	2344	256	60	132	7	0	199
36437	23331s (+0.6s)	2216	2216	128	72	142	10	0	224
36438	23331s (+0.7s)	2772	2772	256	69	153	14	0	236
36439	23332s (+1.1s)	4504	4504	256	90	260	21	1	372
36440	23333s (+0.3s)	844	844	64	27	81	3	0	111
36441	23333s (+0.5s)	1696	1696	128	32	133	0	11	176
36442	23334s (+0.8s)	3248	3248	256	82	185	15	1	283
36443	23335s (+0.6s)	2088	2088	128	39	160	0	9	208
36444	23335s (+0.6s)	1908	1908	128	54	132	9	0	195
36445	23336s (+0.9s)	3588	3588	256	70	213	17	0	300
36446	23336s (+0.3s)	1116	1116	128	40	81	3	0	124
36447	23337s (+0.3s)	1124	1124	128	24	93	2	0	119
36448	23337s (+0.3s)	896	896	64	33	77	5	0	115
36449	23338s (+1.0s)	4392	4392	256	91	239	26	0	356
36450	23339s (+0.8s)	3260	3260	256	72	195	11	0	278
36451	23340s (+0.7s)	2968	2968	256	55	178	6	0	239
36452	23340s (+0.8s)	3664	3664	256	58	232	1	12	303
36453	23341s (+0.4s)	1440	1440	128	27	114	0	8	149
36454	23342s (+0.8s)	3512	3512	256	60	225	0	11	296
36455	23342s (+0.3s)	768	768	64	27	70	0	7	104
36456	23343s (+0.8s)	3352	3352	256	72	197	14	1	284
36457	23344s (+0.9s)	3620	3620	256	83	206	15	0	304
36458	23344s (+0.7s)	2660	2660	256	70	158	11	1	240
36459	23345s (+0.8s)	3496	3496	256	80	199	14	0	293
36460	23346s (+0.6s)	2532	2532	256	50	163	7	0	220
36461	23347s (+0.8s)	3412	3412	256	73	196	15	0	284
36462	23347s (+0.3s)	816	816	64	27	71	6	0	104
36463	23347s (+0.5s)	1788	1788	128	43	132	7	0	182
36464	23348s (+0.6s)	2244	2244	128	64	142	9	0	215
36465	23349s (+0.7s)	3168	3168	256	68	185	12	0	265
36466	23349s (+0.5s)	1544	1544	128	33	117	8	0	158
36467	23350s (+0.8s)	3356	3356	256	72	204	9	0	285
36468	23350s (+0.3s)	936	936	64	23	87	5	0	115
36469	23351s (+0.6s)	2400	2400	256	40	156	8	0	204
36470	23352s (+0.9s)	3736	3736	256	83	212	15	0	310
36471	23353s (+1.0s)	4368	4368	256	95	246	17	0	358
36472	23354s (+0.7s)	3132	3132	256	67	171	14	0	252
36473	23354s (+0.8s)	2880	2880	128	83	169	19	0	271
36474	23355s (+0.9s)	4756	4756	512	71	248	12	1	332
36475	23356s (+0.3s)	836	836	64	23	83	4	0	110
36476	23357s (+0.8s)	3316	3316	256	68	198	15	0	281
36477	23358s (+1.1s)	5624	5624	512	101	282	20	0	403
36478	23359s (+0.9s)	3604	3604	256	98	190	20	0	308
36479	23359s (+0.5s)	1668	1668	128	37	124	8	1	170
36480	23360s (+0.5s)	1672	1672	128	45	117	8	0	170
36481	23360s (+0.6s)	2276	2276	256	48	142	10	0	200
36482	23361s (+0.5s)	1520	1520	128	36	121	4	0	161
36483	23362s (+0.9s)	3968	3968	256	84	229	17	0	330
36484	23362s (+0.8s)	3488	3488	256	81	193	18	1	293
36485	23363s (+0.5s)	1716	1716	128	51	111	11	0	173
36486	23364s (+0.7s)	3000	3000	256	67	175	11	1	254
36487	23364s (+0.7s)	2624	2624	256	64	157	10	0	231
36488	23365s (+0.6s)	2040	2040	128	50	134	13	0	197
36489	23366s (+0.9s)	3844	3844	256	82	216	14	0	312
36490	23366s (+0.7s)	2788	2788	256	54	174	12	0	240
36491	23368s (+1.3s)	6116	6116	512	96	325	0	21	442
36492	23368s (+0.8s)	3172	3172	256	55	194	0	12	261
36493	23369s (+0.4s)	1432	1432	128	24	117	0	6	147
36494	23369s (+0.4s)	1124	1124	64	24	99	0	6	129
36495	23370s (+0.3s)	724	724	64	16	73	0	6	95
36496	23370s (+0.6s)	2556	2556	256	44	178	4	0	226
36497	23371s (+0.4s)	1208	1208	128	21	107	6	0	134
36498	23371s (+0.6s)	2676	2676	256	52	168	9	0	229
36499	23372s (+0.4s)	1368	1368	128	32	105	5	0	142
Episode	Time	Reward	Score	Highest	L	U	R	D	Steps
36500	23372s (+0.7s)	3100	3100	256	68	168	15	1	252
36501	23373s (+0.5s)	1720	1720	128	39	119	17	0	175
36502	23374s (+0.8s)	3376	3376	256	68	208	14	0	290
36503	23374s (+0.6s)	2620	2620	256	58	153	9	0	220
36504	23375s (+0.7s)	2996	2996	256	74	173	16	0	263
36505	23376s (+0.7s)	2632	2632	256	57	164	12	0	233
36506	23376s (+0.5s)	1880	1880	128	42	135	12	0	189
36507	23377s (+0.6s)	1976	1976	128	43	159	5	0	207
36508	23377s (+0.4s)	1236	1236	64	39	106	6	0	151
36509	23378s (+0.9s)	4144	4144	256	96	222	20	0	338
36510	23379s (+0.3s)	596	596	32	24	60	5	0	89
36511	23379s (+0.8s)	3380	3380	256	65	208	9	0	282
36512	23380s (+0.7s)	2732	2732	256	51	169	0	11	231
36513	23380s (+0.4s)	1372	1372	128	32	105	0	7	144
36514	23381s (+0.6s)	2048	2048	128	40	153	0	6	199
36515	23382s (+0.5s)	1700	1700	128	31	138	0	7	176
36516	23382s (+0.6s)	2564	2564	256	46	162	0	11	219
36517	23383s (+0.7s)	2780	2780	256	51	181	0	11	243
36518	23383s (+0.3s)	1072	1072	64	26	93	0	6	125
36519	23384s (+0.4s)	1380	1380	128	18	121	0	7	146
36520	23384s (+0.5s)	1740	1740	128	30	135	0	10	175
36521	23385s (+0.4s)	1432	1432	128	33	107	0	7	147
36522	23385s (+0.4s)	1364	1364	128	29	100	0	7	136
36523	23385s (+0.5s)	1616	1616	128	35	127	0	8	170
36524	23386s (+0.3s)	752	752	64	35	62	4	0	101
36525	23386s (+0.4s)	1532	1532	128	40	112	7	0	159
36526	23387s (+0.5s)	1564	1564	128	38	116	6	0	160
36527	23388s (+1.0s)	4104	4104	256	93	233	17	0	343
36528	23388s (+0.5s)	1768	1768	128	46	127	5	0	178
36529	23389s (+0.8s)	3252	3252	256	71	197	8	0	276
36530	23390s (+0.8s)	3532	3532	256	80	202	15	0	297
36531	23390s (+0.5s)	1624	1624	128	40	116	7	0	163
36532	23391s (+0.7s)	2904	2904	256	59	184	9	0	252
36533	23392s (+0.8s)	3380	3380	256	60	217	14	0	291
36534	23392s (+0.5s)	1664	1664	128	34	126	8	0	168
36535	23393s (+0.5s)	1744	1744	128	48	121	6	1	176
36536	23393s (+0.4s)	1420	1420	128	40	97	8	0	145
36537	23394s (+1.2s)	5716	5716	512	100	285	20	0	405
36538	23395s (+0.4s)	1164	1164	64	31	102	5	0	138
36539	23395s (+0.5s)	1816	1816	128	41	134	7	0	182
36540	23396s (+0.5s)	1788	1788	128	47	131	5	0	183
36541	23397s (+0.9s)	3808	3808	256	86	209	18	0	313
36542	23397s (+0.7s)	2780	2780	256	63	162	12	0	237
36543	23399s (+1.3s)	6824	6824	512	116	336	21	1	474
36544	23399s (+0.4s)	1364	1364	128	32	101	8	0	141
36545	23400s (+0.5s)	1508	1508	128	34	121	6	0	161
36546	23400s (+0.4s)	1200	1200	128	26	103	0	3	132
36547	23401s (+0.7s)	2740	2740	256	45	173	0	16	234
36548	23401s (+0.6s)	2076	2076	128	41	143	0	12	196
36549	23402s (+0.5s)	1844	1844	128	48	140	3	0	191
36550	23403s (+0.7s)	2808	2808	256	67	168	9	0	244
36551	23403s (+0.7s)	3148	3148	256	65	187	14	0	266
36552	23404s (+0.5s)	1668	1668	128	37	118	13	1	169
36553	23404s (+0.6s)	2504	2504	256	53	155	7	0	215
36554	23405s (+0.6s)	2568	2568	256	45	162	0	10	217
36555	23406s (+0.9s)	4080	4080	256	78	232	0	13	323
36556	23406s (+0.5s)	1672	1672	128	30	136	0	5	171
36557	23407s (+0.9s)	3564	3564	256	68	224	0	13	305
36558	23408s (+0.3s)	856	856	64	32	73	5	0	110
36559	23409s (+1.0s)	4240	4240	256	83	249	18	0	350
36560	23410s (+1.1s)	4620	4620	256	110	247	28	0	385
36561	23410s (+0.4s)	1420	1420	128	41	107	3	0	151
36562	23411s (+0.8s)	3220	3220	256	52	205	0	11	268
36563	23412s (+0.9s)	3952	3952	256	73	238	0	12	323
36564	23412s (+0.3s)	808	808	64	22	72	0	9	103
36565	23413s (+0.7s)	2748	2748	256	46	179	0	10	235
36566	23414s (+0.8s)	3332	3332	256	71	201	0	8	280
36567	23414s (+0.5s)	1764	1764	128	28	144	0	6	178
36568	23415s (+0.6s)	2324	2324	256	46	140	0	8	194
36569	23415s (+0.4s)	1672	1672	128	40	119	0	5	164
36570	23416s (+0.8s)	3512	3512	256	65	218	0	14	297
36571	23417s (+0.9s)	3816	3816	256	95	203	20	0	318
36572	23417s (+0.5s)	1772	1772	128	58	115	9	1	183
36573	23418s (+0.8s)	3344	3344	256	70	200	9	0	279
36574	23419s (+0.8s)	3448	3448	256	80	192	14	0	286
36575	23420s (+0.4s)	1596	1596	128	36	110	11	0	157
36576	23420s (+0.5s)	1756	1756	128	42	129	8	0	179
36577	23421s (+0.7s)	2588	2588	128	77	150	15	0	242
36578	23421s (+0.5s)	1704	1704	128	47	124	6	0	177
36579	23422s (+0.3s)	932	932	64	27	85	5	0	117
36580	23422s (+0.7s)	3184	3184	256	56	194	14	1	265
36581	23423s (+1.0s)	4456	4456	256	87	266	19	0	372
36582	23424s (+0.6s)	2620	2620	256	63	149	13	1	226
36583	23425s (+0.5s)	2324	2324	256	31	149	0	14	194
36584	23425s (+0.3s)	792	792	64	17	81	0	2	100
36585	23425s (+0.3s)	1124	1124	128	26	85	0	8	119
36586	23426s (+0.5s)	1684	1684	128	34	130	0	9	173
36587	23427s (+1.0s)	4188	4188	256	65	264	0	15	344
36588	23427s (+0.4s)	1220	1220	64	26	102	0	9	137
36589	23428s (+0.9s)	3916	3916	256	58	252	0	9	319
36590	23429s (+0.5s)	1824	1824	128	40	141	0	5	186
36591	23429s (+0.4s)	1532	1532	128	30	119	0	6	155
36592	23430s (+0.5s)	1924	1924	128	48	138	0	13	199
36593	23430s (+0.2s)	516	516	64	14	50	0	5	69
36594	23430s (+0.5s)	1692	1692	128	51	115	8	0	174
36595	23431s (+0.5s)	2048	2048	256	36	125	8	0	169
36596	23431s (+0.7s)	2756	2756	256	58	167	12	0	237
36597	23432s (+0.3s)	800	800	64	32	72	3	0	107
36598	23433s (+0.8s)	3448	3448	256	81	196	11	1	289
36599	23433s (+0.6s)	2340	2340	256	47	146	5	0	198
Episode	Time	Reward	Score	Highest	L	U	R	D	Steps
36600	23434s (+0.7s)	2684	2684	256	56	165	9	0	230
36601	23434s (+0.6s)	2420	2420	256	33	168	6	0	207
36602	23435s (+0.3s)	796	796	64	23	74	8	1	106
36603	23435s (+0.5s)	1736	1736	128	41	133	8	0	182
36604	23436s (+0.5s)	1656	1656	128	42	117	6	1	166
36605	23437s (+1.0s)	4312	4312	256	91	243	21	1	356
36606	23437s (+0.7s)	2792	2792	256	56	174	11	0	241
36607	23438s (+0.6s)	2300	2300	128	62	149	7	0	218
36608	23439s (+0.5s)	1852	1852	128	31	152	3	0	186
36609	23439s (+0.8s)	3464	3464	256	68	204	13	0	285
36610	23440s (+0.3s)	668	668	64	23	64	4	0	91
36611	23440s (+0.7s)	3040	3040	256	62	179	5	0	246
36612	23441s (+0.3s)	876	876	64	22	88	4	0	114
36613	23441s (+0.5s)	1796	1796	128	50	128	6	0	184
36614	23442s (+0.8s)	3236	3236	256	61	201	9	1	272
36615	23443s (+0.5s)	1588	1588	128	37	122	5	0	164
36616	23443s (+0.5s)	2320	2320	256	43	144	7	0	194
36617	23443s (+0.4s)	1456	1456	128	36	111	5	0	152
36618	23444s (+0.6s)	2768	2768	256	59	161	15	0	235
36619	23445s (+0.5s)	1652	1652	128	51	110	5	0	166
36620	23445s (+0.4s)	1216	1216	128	42	84	7	0	133
36621	23445s (+0.5s)	1788	1788	128	43	124	9	0	176
36622	23446s (+0.6s)	2592	2592	256	53	151	11	0	215
36623	23447s (+0.5s)	2100	2100	256	43	120	0	12	175
36624	23447s (+0.3s)	872	872	64	21	89	0	4	114
36625	23448s (+0.8s)	3352	3352	256	59	208	11	0	278
36626	23448s (+0.4s)	1376	1376	128	30	106	8	0	144
36627	23449s (+0.8s)	3388	3388	256	74	196	13	0	283
36628	23450s (+0.7s)	2864	2864	256	64	170	13	0	247
36629	23450s (+0.3s)	904	904	64	27	86	4	0	117
36630	23451s (+0.6s)	2152	2152	128	52	152	9	0	213
36631	23451s (+0.4s)	1460	1460	128	32	114	0	7	153
36632	23452s (+0.5s)	1600	1600	128	33	126	0	8	167
36633	23452s (+0.5s)	1808	1808	128	52	127	0	8	187
36634	23453s (+1.1s)	5584	5584	512	109	265	20	0	394
36635	23454s (+0.5s)	1796	1796	128	39	138	6	0	183
36636	23454s (+0.6s)	2180	2180	128	59	137	8	0	204
36637	23455s (+0.4s)	1168	1168	64	34	100	5	0	139
36638	23455s (+0.7s)	2968	2968	256	60	195	8	0	263
36639	23456s (+1.1s)	4524	4524	256	82	285	10	0	377
36640	23457s (+0.7s)	2896	2896	128	92	165	14	0	271
36641	23458s (+0.5s)	1828	1828	128	46	131	10	0	187
36642	23458s (+0.6s)	2304	2304	128	53	147	10	0	210
36643	23459s (+0.7s)	3204	3204	256	65	192	11	0	268
36644	23460s (+0.8s)	3312	3312	256	82	182	14	1	279
36645	23461s (+0.6s)	2328	2328	128	62	139	14	0	215
36646	23461s (+0.9s)	3804	3804	256	93	216	13	0	322
36647	23462s (+0.4s)	1284	1284	128	31	101	8	0	140
36648	23463s (+0.7s)	2792	2792	256	56	175	10	0	241
36649	23463s (+0.8s)	3320	3320	256	68	192	11	0	271
36650	23464s (+0.5s)	1668	1668	128	36	121	11	0	168
36651	23464s (+0.2s)	668	668	64	25	57	5	0	87
36652	23465s (+0.8s)	3344	3344	256	73	199	10	0	282
36653	23465s (+0.3s)	904	904	64	25	88	5	0	118
36654	23466s (+0.5s)	1668	1668	128	48	115	6	0	169
36655	23466s (+0.8s)	3644	3644	256	62	219	0	13	294
36656	23467s (+0.4s)	1380	1380	128	30	105	0	5	140
36657	23467s (+0.5s)	2220	2220	256	33	148	0	7	188
36658	23468s (+0.3s)	1204	1204	128	24	88	0	5	117
36659	23468s (+0.5s)	1656	1656	128	33	124	0	9	166
36660	23469s (+0.7s)	2812	2812	256	43	186	0	11	240
36661	23470s (+0.9s)	4708	4708	512	79	234	0	16	329
36662	23471s (+0.7s)	3168	3168	256	65	182	0	14	261
36663	23471s (+0.5s)	1776	1776	128	40	137	0	3	180
36664	23472s (+0.6s)	2080	2080	128	47	136	0	10	193
36665	23472s (+0.5s)	1776	1776	128	37	133	0	5	175
36666	23473s (+1.0s)	4176	4176	256	76	256	0	14	346
36667	23474s (+0.4s)	1460	1460	128	30	112	0	8	150
36668	23474s (+0.3s)	876	876	64	31	77	7	0	115
36669	23475s (+0.7s)	2752	2752	256	74	162	7	0	243
36670	23476s (+0.9s)	3848	3848	256	73	223	16	0	312
36671	23477s (+0.9s)	4140	4140	256	94	227	21	0	342
36672	23477s (+0.4s)	1488	1488	128	37	111	7	0	155
36673	23477s (+0.5s)	1556	1556	128	41	114	7	0	162
36674	23478s (+0.8s)	3220	3220	256	68	185	15	0	268
36675	23479s (+1.0s)	4240	4240	256	80	255	15	0	350
36676	23480s (+0.8s)	3224	3224	256	66	191	12	0	269
36677	23480s (+0.3s)	728	728	64	13	79	0	3	95
36678	23481s (+0.4s)	1208	1208	64	35	104	5	0	144
36679	23481s (+0.5s)	1908	1908	128	44	144	7	0	195
36680	23482s (+0.5s)	1372	1372	64	52	97	10	0	159
36681	23482s (+0.7s)	2808	2808	256	50	184	0	6	240
36682	23483s (+0.5s)	1676	1676	128	32	132	0	7	171
36683	23484s (+0.7s)	2972	2972	256	44	195	0	11	250
36684	23484s (+0.3s)	1260	1260	128	21	100	0	6	127
36685	23485s (+0.8s)	3288	3288	256	43	235	0	2	280
36686	23485s (+0.7s)	3012	3012	256	48	186	0	11	245
36687	23486s (+0.5s)	1888	1888	128	52	131	8	0	191
36688	23487s (+0.9s)	3980	3980	256	77	228	17	0	322
36689	23488s (+0.8s)	3404	3404	256	70	199	15	0	284
36690	23488s (+0.4s)	1132	1132	128	30	91	5	0	126
36691	23489s (+0.8s)	3436	3436	256	70	208	11	0	289
36692	23489s (+0.5s)	1628	1628	128	42	125	7	0	174
36693	23490s (+0.5s)	1596	1596	128	42	120	4	0	166
36694	23490s (+0.4s)	1460	1460	128	28	119	0	7	154
36695	23491s (+0.5s)	2076	2076	128	40	150	0	5	195
36696	23491s (+0.2s)	344	344	32	6	49	0	3	58
36697	23491s (+0.3s)	664	664	64	19	64	0	5	88
36698	23492s (+0.5s)	1792	1792	128	37	136	0	11	184
36699	23492s (+0.3s)	1128	1128	128	27	87	5	1	120
Episode	Time	Reward	Score	Highest	L	U	R	D	Steps
36700	23493s (+0.6s)	2420	2420	256	45	156	11	0	212
36701	23494s (+1.1s)	5400	5400	512	110	234	29	1	374
36702	23494s (+0.3s)	856	856	64	31	67	6	0	104
36703	23495s (+0.9s)	3880	3880	256	100	211	16	1	328
36704	23496s (+0.4s)	1580	1580	128	41	112	10	0	163
36705	23496s (+0.5s)	1752	1752	128	33	135	7	0	175
36706	23497s (+0.4s)	1196	1196	64	20	116	0	5	141
36707	23498s (+1.0s)	4176	4176	256	65	269	0	13	347
36708	23498s (+0.5s)	2140	2140	256	39	131	0	10	180
36709	23498s (+0.4s)	1388	1388	128	35	104	5	0	144
36710	23499s (+0.4s)	1180	1180	64	34	93	5	0	132
36711	23499s (+0.6s)	2460	2460	256	43	157	8	0	208
36712	23500s (+0.7s)	2572	2572	128	73	150	15	1	239
36713	23501s (+0.9s)	3684	3684	256	92	208	14	0	314
36714	23502s (+0.5s)	1712	1712	128	45	119	11	0	175
36715	23502s (+0.6s)	1908	1908	128	38	158	4	0	200
36716	23503s (+0.7s)	2976	2976	256	45	184	9	0	238
36717	23503s (+0.6s)	2636	2636	256	62	147	11	0	220
36718	23504s (+0.4s)	1360	1360	128	31	97	7	0	135
36719	23505s (+0.9s)	4000	4000	256	84	235	15	0	334
36720	23505s (+0.3s)	752	752	64	30	66	5	0	101
36721	23506s (+0.7s)	2744	2744	256	57	170	14	0	241
36722	23506s (+0.4s)	1404	1404	64	44	106	9	0	159
36723	23507s (+0.8s)	3064	3064	256	78	169	18	0	265
36724	23507s (+0.4s)	1596	1596	128	28	125	0	3	156
36725	23508s (+0.7s)	2872	2872	256	47	193	0	16	256
36726	23509s (+0.5s)	1872	1872	128	28	155	0	6	189
36727	23509s (+0.5s)	1904	1904	128	48	138	0	8	194
36728	23510s (+0.6s)	2292	2292	256	50	137	0	10	197
36729	23510s (+0.5s)	1760	1760	128	27	142	0	7	176
36730	23511s (+0.3s)	692	692	64	15	73	0	3	91
36731	23511s (+0.9s)	3560	3560	256	58	230	0	16	304
36732	23512s (+0.4s)	1352	1352	128	39	95	0	5	139
36733	23512s (+0.6s)	2468	2468	256	59	144	0	6	209
36734	23513s (+0.5s)	1868	1868	128	46	134	10	0	190
36735	23514s (+0.8s)	3372	3372	256	70	199	13	0	282
36736	23514s (+0.4s)	1308	1308	64	44	98	9	0	151
36737	23514s (+0.2s)	492	492	32	20	56	3	0	79
36738	23515s (+0.3s)	732	732	64	30	60	6	0	96
36739	23515s (+0.7s)	2808	2808	256	74	147	16	1	238
36740	23516s (+0.8s)	3376	3376	256	61	216	13	0	290
36741	23517s (+0.8s)	3524	3524	256	70	208	17	0	295
36742	23518s (+0.5s)	1628	1628	128	40	117	7	0	164
36743	23518s (+0.6s)	2036	2036	128	58	126	16	0	200
36744	23519s (+1.2s)	6276	6276	512	108	302	26	0	436
36745	23520s (+0.9s)	3900	3900	256	94	200	20	0	314
36746	23521s (+0.6s)	1960	1960	128	54	128	11	0	193
36747	23521s (+0.3s)	908	908	64	28	82	8	0	118
36748	23522s (+0.4s)	1136	1136	128	39	79	6	0	124
36749	23522s (+0.7s)	2648	2648	256	55	175	7	0	237
36750	23523s (+0.6s)	2684	2684	256	57	156	11	0	224
36751	23524s (+0.8s)	3256	3256	256	65	205	6	1	277
36752	23525s (+1.3s)	6504	6504	512	113	310	23	0	446
36753	23526s (+0.8s)	3528	3528	256	72	210	14	0	296
36754	23526s (+0.7s)	2896	2896	256	67	165	18	0	250
36755	23528s (+1.3s)	6572	6572	512	134	312	23	0	469
36756	23528s (+0.2s)	376	376	32	8	51	3	0	62
36757	23528s (+0.4s)	1464	1464	128	42	98	0	11	151
36758	23529s (+0.7s)	3284	3284	256	55	199	0	10	264
36759	23529s (+0.3s)	1032	1032	64	18	102	0	2	122
36760	23530s (+0.4s)	1444	1444	128	32	112	0	7	151
36761	23531s (+0.7s)	2804	2804	256	60	170	0	13	243
36762	23531s (+0.6s)	2424	2424	128	48	165	0	12	225
36763	23532s (+0.8s)	3440	3440	256	56	224	0	11	291
36764	23533s (+0.6s)	2616	2616	256	44	175	0	10	229
36765	23533s (+0.8s)	3492	3492	256	71	207	0	10	288
36766	23534s (+0.8s)	3364	3364	256	56	222	0	9	287
36767	23535s (+0.9s)	4008	4008	256	63	252	0	16	331
36768	23536s (+0.6s)	2204	2204	128	40	157	0	14	211
36769	23536s (+0.6s)	2432	2432	256	44	150	0	11	205
36770	23537s (+0.5s)	1812	1812	128	38	141	0	9	188
36771	23538s (+0.6s)	2660	2660	256	51	164	0	10	225
36772	23539s (+0.9s)	3840	3840	256	65	231	19	0	315
36773	23539s (+0.6s)	2248	2248	128	42	149	12	1	204
36774	23540s (+0.9s)	3996	3996	256	116	197	20	0	333
36775	23540s (+0.3s)	1048	1048	128	25	85	3	0	113
36776	23541s (+0.6s)	2684	2684	256	57	162	11	0	230
36777	23542s (+1.3s)	7008	7008	512	124	336	27	0	487
36778	23543s (+0.6s)	2248	2248	128	69	133	9	0	211
36779	23544s (+0.7s)	3104	3104	256	61	186	8	0	255
36780	23544s (+0.4s)	1160	1160	128	22	98	4	0	124
36781	23545s (+0.4s)	1336	1336	128	34	95	9	0	138
36782	23545s (+0.5s)	1744	1744	128	43	124	9	0	176
36783	23546s (+0.5s)	1748	1748	128	37	130	9	0	176
36784	23546s (+0.7s)	2796	2796	256	56	175	10	0	241
36785	23547s (+1.0s)	4252	4252	256	79	262	13	0	354
36786	23549s (+1.3s)	6424	6424	512	127	311	22	0	460
36787	23549s (+0.6s)	2428	2428	256	61	135	8	0	204
36788	23550s (+0.5s)	1856	1856	128	49	128	10	1	188
36789	23550s (+0.2s)	488	488	32	17	59	3	0	79
36790	23551s (+0.9s)	3808	3808	256	73	222	13	0	308
36791	23551s (+0.3s)	1024	1024	128	29	79	2	0	110
36792	23552s (+0.4s)	1176	1176	64	37	99	5	0	141
36793	23552s (+0.5s)	1760	1760	128	28	144	5	0	177
36794	23553s (+0.6s)	2224	2224	128	57	140	12	0	209
36795	23553s (+0.4s)	1372	1372	128	49	87	7	0	143
36796	23554s (+0.6s)	2268	2268	128	53	150	12	0	215
36797	23554s (+0.3s)	828	828	64	32	71	4	0	107
36798	23555s (+0.5s)	1844	1844	128	37	139	7	1	184
36799	23555s (+0.5s)	1504	1504	128	38	112	9	0	159
Episode	Time	Reward	Score	Highest	L	U	R	D	Steps
36800	23556s (+0.8s)	3348	3348	256	54	210	0	19	283
36801	23556s (+0.5s)	1856	1856	128	36	133	0	5	174
36802	23557s (+0.9s)	3932	3932	256	58	252	0	10	320
36803	23558s (+1.0s)	4212	4212	256	69	265	0	16	350
36804	23559s (+0.5s)	1840	1840	128	42	136	0	11	189
36805	23560s (+0.7s)	2788	2788	256	60	173	0	7	240
36806	23560s (+0.6s)	2180	2180	128	42	154	0	10	206
36807	23561s (+0.8s)	3100	3100	256	70	188	0	12	270
36808	23562s (+0.6s)	2432	2432	256	48	151	0	7	206
36809	23562s (+0.4s)	1444	1444	128	34	108	0	7	149
36810	23562s (+0.5s)	1800	1800	128	46	130	0	9	185
36811	23563s (+0.3s)	764	764	64	22	77	0	4	103
36812	23563s (+0.4s)	1376	1376	128	31	104	0	11	146
36813	23564s (+0.4s)	1540	1540	128	30	125	1	9	165
36814	23565s (+1.0s)	4196	4196	256	76	260	0	15	351
36815	23565s (+0.4s)	1304	1304	128	22	104	0	6	132
36816	23566s (+0.5s)	1652	1652	128	35	128	0	6	169
36817	23566s (+0.5s)	1912	1912	128	43	144	0	9	196
36818	23567s (+0.7s)	2868	2868	128	89	151	23	0	263
36819	23567s (+0.4s)	1496	1496	128	31	113	10	1	155
36820	23568s (+0.7s)	2516	2516	128	78	143	17	1	239
36821	23568s (+0.5s)	1876	1876	128	49	113	13	0	175
36822	23570s (+1.3s)	6288	6288	512	123	307	28	0	458
36823	23571s (+1.3s)	6464	6464	512	114	310	23	1	448
36824	23572s (+0.8s)	3584	3584	256	86	195	17	0	298
36825	23573s (+1.2s)	5768	5768	512	105	291	17	0	413
36826	23574s (+0.5s)	1812	1812	128	44	138	6	0	188
36827	23574s (+0.6s)	2432	2432	256	53	143	8	0	204
36828	23576s (+1.5s)	7436	7436	512	135	358	20	3	516
36829	23577s (+0.9s)	4064	4064	256	98	217	18	0	333
36830	23577s (+0.4s)	1184	1184	64	31	97	4	0	132
36831	23577s (+0.3s)	692	692	64	23	64	4	0	91
36832	23578s (+0.8s)	3444	3444	256	54	214	13	0	281
36833	23579s (+0.5s)	1648	1648	128	44	126	8	0	178
36834	23579s (+0.5s)	2212	2212	256	45	136	8	0	189
36835	23579s (+0.3s)	696	696	64	17	76	2	0	95
36836	23580s (+0.6s)	2668	2668	256	58	159	10	0	227
36837	23581s (+0.8s)	3056	3056	256	59	192	8	0	259
36838	23581s (+0.7s)	2532	2532	128	67	166	11	0	244
36839	23582s (+0.5s)	2292	2292	256	40	141	7	0	188
36840	23583s (+0.5s)	2316	2316	256	44	145	4	0	193
36841	23583s (+0.7s)	2932	2932	256	58	188	12	1	259
36842	23584s (+1.0s)	5236	5236	512	103	236	21	1	361
36843	23585s (+0.4s)	1524	1524	128	36	111	0	13	160
36844	23585s (+0.5s)	1812	1812	128	39	142	0	7	188
36845	23586s (+0.4s)	1504	1504	128	31	123	0	6	160
36846	23586s (+0.4s)	1212	1212	128	24	96	0	8	128
36847	23587s (+1.0s)	4180	4180	256	72	258	0	17	347
36848	23587s (+0.3s)	996	996	64	24	89	0	8	121
36849	23588s (+0.8s)	3544	3544	256	56	230	0	14	300
36850	23589s (+0.8s)	3296	3296	256	74	205	11	0	290
36851	23590s (+0.9s)	3812	3812	256	80	227	12	0	319
36852	23590s (+0.4s)	1408	1408	128	30	113	6	0	149
36853	23591s (+0.4s)	1324	1324	64	34	102	13	0	149
36854	23592s (+0.7s)	2584	2584	128	65	159	17	0	241
36855	23592s (+0.8s)	3292	3292	256	69	187	15	0	271
36856	23593s (+1.0s)	4460	4460	256	117	236	15	0	368
36857	23594s (+0.6s)	2460	2460	256	43	156	8	0	207
36858	23594s (+0.4s)	1524	1524	128	29	122	9	0	160
36859	23596s (+1.1s)	5748	5748	512	108	259	26	0	393
36860	23596s (+0.5s)	1652	1652	64	55	114	10	0	179
36861	23597s (+0.6s)	2020	2020	128	64	126	8	0	198
36862	23597s (+0.5s)	1816	1816	128	48	130	11	0	189
36863	23598s (+0.3s)	812	812	64	20	81	2	0	103
36864	23598s (+0.5s)	1912	1912	128	42	147	7	0	196
36865	23599s (+0.8s)	3408	3408	256	59	221	11	0	291
36866	23600s (+0.6s)	2400	2400	256	57	139	10	1	207
36867	23600s (+0.5s)	1736	1736	128	43	133	4	0	180
36868	23600s (+0.3s)	1080	1080	128	29	85	4	1	119
36869	23601s (+1.1s)	4512	4512	256	111	236	27	0	374
36870	23602s (+0.4s)	1516	1516	128	34	113	9	0	156
36871	23603s (+0.7s)	2920	2920	256	63	172	6	0	241
36872	23604s (+0.9s)	3708	3708	256	67	228	14	0	309
36873	23604s (+0.7s)	3104	3104	256	69	166	19	1	255
36874	23605s (+0.9s)	3620	3620	256	94	202	12	0	308
36875	23606s (+0.6s)	2176	2176	128	49	140	11	0	200
36876	23607s (+0.8s)	3328	3328	256	71	186	19	0	276
36877	23607s (+0.3s)	880	880	64	25	82	8	0	115
36878	23607s (+0.5s)	1744	1744	128	37	135	4	0	176
36879	23608s (+0.3s)	748	748	64	28	66	6	0	100
36880	23608s (+0.8s)	3268	3268	256	62	208	9	0	279
36881	23609s (+0.8s)	3128	3128	256	53	206	0	13	272
36882	23610s (+0.4s)	1476	1476	128	35	110	0	9	154
36883	23610s (+0.7s)	2900	2900	256	52	173	0	17	242
36884	23611s (+0.5s)	1864	1864	128	52	116	0	7	175
36885	23611s (+0.6s)	2620	2620	256	45	176	0	10	231
36886	23612s (+0.6s)	2264	2264	128	51	157	0	9	217
36887	23613s (+0.5s)	1592	1592	128	38	121	0	6	165
36888	23613s (+0.7s)	2816	2816	256	50	189	0	8	247
36889	23614s (+0.3s)	1128	1128	128	25	90	0	5	120
36890	23614s (+0.7s)	2752	2752	256	45	178	0	10	233
36891	23615s (+0.6s)	2372	2372	128	41	172	0	8	221
36892	23616s (+0.7s)	3328	3328	256	60	194	1	14	269
36893	23616s (+0.5s)	1636	1636	128	28	131	0	7	166
36894	23617s (+1.1s)	5692	5692	512	83	294	0	19	396
36895	23618s (+0.9s)	3556	3556	256	56	230	0	17	303
36896	23619s (+0.5s)	1660	1660	128	34	128	0	5	167
36897	23619s (+0.7s)	2792	2792	256	47	182	0	13	242
36898	23620s (+0.5s)	2356	2356	256	35	151	0	7	193
36899	23620s (+0.3s)	660	660	64	11	70	0	6	87
Episode	Time	Reward	Score	Highest	L	U	R	D	Steps
36900	23620s (+0.4s)	1184	1184	128	28	95	0	6	129
36901	23621s (+0.6s)	2420	2420	256	28	179	3	0	210
36902	23622s (+0.5s)	1532	1532	128	37	117	9	0	163
36903	23622s (+0.6s)	1936	1936	128	43	151	8	0	202
36904	23622s (+0.3s)	988	988	64	29	91	6	0	126
36905	23623s (+0.3s)	788	788	64	21	80	4	0	105
36906	23623s (+0.5s)	2392	2392	256	45	146	6	0	197
36907	23624s (+0.8s)	3532	3532	256	79	208	15	0	302
36908	23625s (+0.5s)	1808	1808	128	58	121	8	0	187
36909	23625s (+0.6s)	1928	1928	128	68	116	12	0	196
36910	23626s (+0.5s)	1628	1628	128	46	109	9	0	164
36911	23627s (+0.9s)	3556	3556	256	69	217	16	1	303
36912	23627s (+0.9s)	3552	3552	256	74	212	16	0	302
36913	23628s (+0.9s)	3960	3960	256	83	230	11	0	324
36914	23629s (+0.5s)	1832	1832	128	34	149	3	0	186
36915	23630s (+0.7s)	2928	2928	256	46	181	5	0	232
36916	23630s (+0.4s)	1476	1476	128	43	105	8	1	157
36917	23630s (+0.3s)	768	768	64	23	73	7	0	103
36918	23631s (+0.7s)	2776	2776	128	69	171	17	0	257
36919	23632s (+0.7s)	2716	2716	256	46	186	6	0	238
36920	23632s (+0.4s)	1436	1436	128	32	110	6	0	148
36921	23633s (+0.8s)	3420	3420	256	59	208	13	0	280
36922	23634s (+0.5s)	1876	1876	128	39	140	10	0	189
36923	23635s (+1.3s)	6624	6624	512	114	347	21	0	482
36924	23636s (+1.0s)	4260	4260	256	107	226	18	0	351
36925	23636s (+0.4s)	1332	1332	128	39	95	10	0	144
36926	23637s (+0.3s)	720	720	64	19	72	3	0	94
36927	23637s (+0.5s)	1388	1388	64	42	108	11	0	161
36928	23638s (+0.5s)	1832	1832	128	40	144	8	0	192
36929	23638s (+0.6s)	2440	2440	256	37	163	7	0	207
36930	23639s (+0.4s)	1640	1640	128	41	117	0	5	163
36931	23639s (+0.6s)	2608	2608	256	40	167	0	11	218
36932	23640s (+0.5s)	1628	1628	128	29	131	0	4	164
36933	23640s (+0.6s)	2128	2128	128	40	151	0	8	199
36934	23641s (+1.0s)	4136	4136	256	64	260	0	12	336
36935	23642s (+0.4s)	1048	1048	64	35	86	0	6	127
36936	23642s (+0.5s)	1784	1784	128	34	137	0	10	181
36937	23643s (+0.6s)	2152	2152	128	48	139	0	12	199
36938	23644s (+0.9s)	3804	3804	256	66	230	0	21	317
36939	23644s (+0.8s)	3308	3308	256	58	200	10	2	270
36940	23645s (+0.8s)	3260	3260	256	67	191	12	0	270
36941	23646s (+1.0s)	4220	4220	256	91	238	17	0	346
36942	23647s (+0.7s)	3112	3112	256	55	187	16	0	258
36943	23648s (+0.7s)	3068	3068	256	58	179	14	1	252
36944	23649s (+1.1s)	5552	5552	512	96	280	20	0	396
36945	23650s (+0.9s)	3844	3844	256	99	210	11	0	320
36946	23650s (+0.3s)	1112	1112	128	23	88	6	0	117
36947	23651s (+0.7s)	3212	3212	256	62	195	10	0	267
36948	23652s (+0.8s)	3388	3388	256	71	195	16	0	282
36949	23652s (+0.4s)	1404	1404	128	32	105	8	0	145
36950	23653s (+0.5s)	1868	1868	128	51	128	11	0	190
36951	23653s (+0.6s)	2128	2128	128	56	138	13	0	207
36952	23654s (+0.8s)	3392	3392	256	79	196	14	0	289
36953	23654s (+0.3s)	936	936	64	34	74	8	0	116
36954	23655s (+0.6s)	2500	2500	256	50	146	12	0	208
36955	23656s (+0.6s)	2060	2060	128	45	151	10	0	206
36956	23657s (+1.2s)	5856	5856	512	106	290	23	0	419
36957	23657s (+0.6s)	2496	2496	256	52	158	6	0	216
36958	23658s (+0.9s)	4068	4068	256	79	246	14	0	339
36959	23659s (+0.4s)	1272	1272	128	37	91	6	0	134
36960	23659s (+0.3s)	968	968	64	25	93	3	0	121
36961	23659s (+0.3s)	700	700	64	22	68	3	0	93
36962	23660s (+0.7s)	3020	3020	256	64	165	10	0	239
36963	23661s (+0.5s)	2164	2164	256	39	136	6	0	181
36964	23662s (+1.5s)	7608	7608	512	151	357	23	1	532
36965	23663s (+0.9s)	3704	3704	256	88	204	21	0	313
36966	23663s (+0.4s)	1184	1184	64	35	101	7	0	143
36967	23664s (+0.5s)	1944	1944	128	54	131	10	0	195
36968	23664s (+0.4s)	1456	1456	128	43	100	10	0	153
36969	23665s (+0.4s)	1404	1404	128	39	101	7	0	147
36970	23666s (+0.8s)	3420	3420	256	56	217	0	13	286
36971	23666s (+0.3s)	748	748	64	18	79	0	3	100
36972	23666s (+0.6s)	1860	1860	128	47	143	5	0	195
36973	23667s (+0.8s)	3308	3308	256	71	194	13	0	278
36974	23667s (+0.2s)	620	620	64	13	68	4	0	85
36975	23668s (+0.7s)	3260	3260	256	63	197	9	0	269
36976	23669s (+0.8s)	3400	3400	256	77	170	20	0	267
36977	23670s (+0.9s)	3548	3548	256	77	210	14	0	301
36978	23670s (+0.3s)	1044	1044	128	31	78	5	0	114
36979	23671s (+0.7s)	2900	2900	256	59	180	12	0	251
36980	23672s (+0.7s)	2788	2788	256	64	163	13	0	240
36981	23672s (+0.5s)	1696	1696	128	36	125	8	0	169
36982	23672s (+0.4s)	1160	1160	128	23	93	0	8	124
36983	23673s (+0.3s)	888	888	64	20	87	0	6	113
36984	23673s (+0.6s)	2428	2428	256	44	158	0	5	207
36985	23674s (+0.8s)	3280	3280	256	60	208	0	7	275
36986	23675s (+0.5s)	1624	1624	128	25	136	0	6	167
36987	23675s (+0.5s)	1604	1604	128	27	131	0	10	168
36988	23676s (+0.8s)	3352	3352	256	53	215	0	16	284
36989	23676s (+0.4s)	1600	1600	128	39	113	6	0	158
36990	23677s (+0.9s)	4160	4160	256	94	228	15	0	337
36991	23678s (+0.6s)	2588	2588	256	46	168	8	0	222
36992	23679s (+1.2s)	5924	5924	512	107	291	19	0	417
36993	23680s (+0.6s)	2432	2432	256	41	159	11	0	211
36994	23680s (+0.4s)	1456	1456	128	49	96	7	0	152
36995	23681s (+0.9s)	3876	3876	256	76	227	16	0	319
36996	23682s (+0.4s)	1320	1320	128	47	91	7	0	145
36997	23682s (+0.7s)	3124	3124	256	48	196	9	0	253
36998	23683s (+0.7s)	2908	2908	256	56	177	7	0	240
36999	23683s (+0.3s)	1004	1004	64	28	82	5	0	115
Episode	Time	Reward	Score	Highest	L	U	R	D	Steps
37000	23684s (+0.8s)	3132	3132	256	61	192	9	0	262
37001	23684s (+0.4s)	1464	1464	128	41	101	8	0	150
37002	23685s (+0.5s)	1780	1780	128	33	138	9	1	181
37003	23686s (+0.5s)	2160	2160	256	33	154	4	0	191
37004	23686s (+0.6s)	2564	2564	256	43	170	8	0	221
37005	23687s (+0.3s)	1080	1080	128	21	93	1	0	115
37006	23687s (+0.6s)	2088	2088	128	69	127	12	1	209
37007	23688s (+0.5s)	2340	2340	256	58	123	12	0	193
37008	23689s (+1.0s)	4148	4148	256	104	214	21	0	339
37009	23689s (+0.4s)	1488	1488	128	26	125	5	0	156
37010	23690s (+1.0s)	4140	4140	256	88	234	20	0	342
37011	23691s (+0.7s)	2748	2748	256	61	168	7	0	236
37012	23691s (+0.5s)	1712	1712	128	49	116	9	0	174
37013	23692s (+0.5s)	1816	1816	128	46	135	8	0	189
37014	23692s (+0.4s)	1500	1500	128	43	107	9	0	159
37015	23693s (+0.4s)	952	952	64	27	93	4	0	124
37016	23693s (+0.5s)	1668	1668	128	37	123	9	0	169
37017	23694s (+0.7s)	2896	2896	256	54	177	9	0	240
37018	23694s (+0.6s)	1912	1912	128	49	139	7	1	196
37019	23695s (+0.5s)	1604	1604	128	34	126	8	0	168
37020	23696s (+1.0s)	4380	4380	256	101	241	23	0	365
37021	23697s (+0.7s)	2792	2792	256	50	181	0	10	241
37022	23697s (+0.5s)	2036	2036	128	34	145	0	8	187
37023	23698s (+0.6s)	2676	2676	256	50	162	0	11	223
37024	23699s (+0.8s)	3664	3664	256	71	215	0	13	299
37025	23699s (+0.4s)	1480	1480	128	31	117	0	7	155
37026	23700s (+0.6s)	2252	2252	128	43	151	0	10	204
37027	23700s (+0.4s)	1364	1364	128	25	112	0	4	141
37028	23701s (+1.2s)	5704	5704	512	88	300	0	21	409
37029	23702s (+0.8s)	3044	3044	256	66	179	0	16	261
37030	23703s (+0.6s)	2556	2556	256	43	169	0	7	219
37031	23703s (+0.6s)	2176	2176	128	41	158	0	6	205
37032	23704s (+0.5s)	1608	1608	128	32	131	6	0	169
37033	23704s (+0.8s)	3356	3356	256	59	207	9	0	275
37034	23705s (+0.8s)	3560	3560	256	93	188	15	1	297
37035	23706s (+0.8s)	3128	3128	256	66	186	17	0	269
37036	23707s (+0.5s)	1548	1548	128	39	121	5	0	165
37037	23707s (+0.6s)	2272	2272	128	62	138	10	1	211
37038	23707s (+0.2s)	652	652	64	21	63	4	0	88
37039	23708s (+0.6s)	2520	2520	256	54	154	8	0	216
37040	23709s (+0.5s)	1796	1796	128	46	131	7	0	184
37041	23709s (+1.0s)	4056	4056	256	107	212	18	0	337
37042	23710s (+0.4s)	1404	1404	64	41	106	8	0	155
37043	23710s (+0.3s)	996	996	128	21	77	5	0	103
37044	23711s (+0.4s)	1184	1184	64	30	105	7	1	143
37045	23711s (+0.7s)	2508	2508	128	70	157	12	0	239
37046	23712s (+0.9s)	3960	3960	256	90	223	16	0	329
37047	23713s (+0.7s)	2480	2480	128	72	151	12	0	235
37048	23713s (+0.4s)	1288	1288	128	29	111	4	0	144
37049	23714s (+0.5s)	2192	2192	256	41	141	6	0	188
37050	23714s (+0.5s)	2020	2020	256	29	132	0	6	167
37051	23715s (+0.5s)	1588	1588	128	33	122	0	9	164
37052	23715s (+0.6s)	1820	1820	128	40	142	0	8	190
37053	23716s (+0.8s)	3328	3328	256	74	187	9	0	270
37054	23717s (+0.6s)	2604	2604	256	44	166	6	0	216
37055	23718s (+0.7s)	3072	3072	256	59	186	9	0	254
37056	23719s (+1.0s)	4952	4952	512	86	238	19	0	343
37057	23719s (+0.7s)	3224	3224	256	68	185	16	0	269
37058	23720s (+1.0s)	4176	4176	256	93	239	14	0	346
37059	23721s (+0.9s)	4032	4032	256	85	228	17	0	330
37060	23722s (+0.3s)	788	788	64	27	71	6	0	104
37061	23722s (+0.4s)	1568	1568	128	32	113	6	0	151
37062	23723s (+0.8s)	3788	3788	256	80	218	15	0	313
37063	23723s (+0.6s)	2580	2580	256	45	166	7	0	218
37064	23724s (+0.5s)	1920	1920	128	52	138	8	0	198
37065	23724s (+0.5s)	1636	1636	128	48	117	5	0	170
37066	23725s (+0.8s)	3632	3632	256	72	203	16	0	291
37067	23726s (+0.5s)	1768	1768	128	40	135	4	0	179
37068	23726s (+0.6s)	2456	2456	256	47	156	7	0	210
37069	23727s (+0.5s)	1676	1676	128	47	117	7	0	171
37070	23728s (+0.6s)	2628	2628	256	51	162	9	0	222
37071	23728s (+0.5s)	1932	1932	256	35	117	6	0	158
37072	23728s (+0.5s)	1564	1564	128	38	113	8	0	159
37073	23729s (+0.8s)	3464	3464	256	81	191	16	1	289
37074	23730s (+0.9s)	3748	3748	256	84	210	9	0	303
37075	23731s (+0.7s)	2932	2932	256	60	189	10	0	259
37076	23732s (+0.7s)	3096	3096	256	68	174	12	0	254
37077	23732s (+0.6s)	2416	2416	128	67	148	12	0	227
37078	23733s (+0.5s)	1632	1632	128	36	118	10	0	164
37079	23733s (+0.7s)	2932	2932	256	59	176	9	0	244
37080	23734s (+0.3s)	796	796	64	23	77	6	0	106
37081	23734s (+0.4s)	1028	1028	64	27	92	3	0	122
37082	23735s (+0.6s)	2604	2604	256	58	154	14	0	226
37083	23736s (+1.0s)	4252	4252	256	78	262	0	13	353
37084	23736s (+0.6s)	2464	2464	256	42	160	0	11	213
37085	23737s (+0.8s)	3356	3356	256	65	203	0	9	277
37086	23738s (+0.8s)	3440	3440	256	60	217	0	14	291
37087	23739s (+0.8s)	3484	3484	256	67	212	0	12	291
37088	23740s (+1.0s)	4396	4396	256	95	262	15	0	372
37089	23740s (+0.4s)	1088	1088	128	27	88	6	0	121
37090	23740s (+0.3s)	704	704	64	19	71	3	0	93
37091	23741s (+0.4s)	1448	1448	128	31	113	6	0	150
37092	23742s (+1.0s)	4904	4904	512	92	235	18	0	345
37093	23743s (+0.9s)	3624	3624	256	76	215	17	0	308
37094	23743s (+0.4s)	1420	1420	128	21	123	0	0	144
37095	23744s (+0.7s)	3084	3084	256	56	187	12	0	255
37096	23744s (+0.5s)	1692	1692	128	29	141	5	0	175
37097	23745s (+0.6s)	1924	1924	128	48	141	10	0	199
37098	23746s (+0.9s)	3764	3764	256	73	219	0	15	307
37099	23746s (+0.4s)	1524	1524	128	30	117	0	11	158
Episode	Time	Reward	Score	Highest	L	U	R	D	Steps
37100	23747s (+0.7s)	2648	2648	256	49	177	0	10	236
37101	23747s (+0.3s)	1052	1052	64	26	93	0	7	126
37102	23748s (+0.7s)	2900	2900	256	47	195	0	10	252
37103	23748s (+0.4s)	1324	1324	128	26	108	0	2	136
37104	23749s (+0.8s)	3248	3248	256	63	200	11	0	274
37105	23750s (+0.8s)	3248	3248	256	57	209	10	0	276
37106	23750s (+0.2s)	684	684	64	19	64	6	0	89
37107	23751s (+0.4s)	1444	1444	128	32	107	8	0	147
37108	23751s (+0.5s)	1812	1812	128	48	130	5	0	183
37109	23752s (+0.3s)	804	804	64	21	81	0	4	106
37110	23752s (+0.6s)	2416	2416	256	41	152	0	7	200
37111	23753s (+0.8s)	3340	3340	256	72	196	0	13	281
37112	23753s (+0.5s)	1608	1608	128	39	125	0	5	169
37113	23754s (+0.9s)	3896	3896	256	72	230	10	1	313
37114	23755s (+0.6s)	2444	2444	256	56	140	11	1	208
37115	23756s (+0.8s)	3228	3228	256	75	179	16	0	270
37116	23756s (+0.6s)	2532	2532	256	51	154	12	0	217
37117	23757s (+0.4s)	1464	1464	128	38	108	7	1	154
37118	23758s (+0.7s)	2740	2740	256	56	167	10	0	233
37119	23758s (+0.8s)	3480	3480	256	71	207	13	0	291
37120	23759s (+0.8s)	3424	3424	256	67	207	14	0	288
37121	23760s (+1.0s)	4228	4228	256	83	248	16	0	347
37122	23761s (+0.4s)	1240	1240	128	23	102	3	0	128
37123	23761s (+0.8s)	3372	3372	256	71	207	11	0	289
37124	23762s (+0.6s)	2380	2380	128	73	132	15	0	220
37125	23763s (+1.0s)	4228	4228	256	100	225	18	0	343
37126	23763s (+0.3s)	672	672	32	27	59	9	0	95
37127	23764s (+0.4s)	1380	1380	128	33	102	10	0	145
37128	23764s (+0.6s)	2372	2372	256	40	156	5	0	201
37129	23765s (+0.9s)	3988	3988	256	93	220	18	0	331
37130	23766s (+0.8s)	3536	3536	256	73	194	18	0	285
37131	23766s (+0.4s)	1460	1460	128	35	113	5	0	153
37132	23767s (+0.8s)	3652	3652	256	62	213	12	0	287
37133	23768s (+1.0s)	4064	4064	256	90	232	16	0	338
37134	23769s (+0.3s)	1072	1072	128	16	92	3	0	111
37135	23770s (+1.3s)	6424	6424	512	128	302	30	0	460
37136	23771s (+1.1s)	5496	5496	512	96	270	23	0	389
37137	23771s (+0.4s)	1408	1408	64	44	102	10	0	156
37138	23772s (+0.6s)	2052	2052	128	63	128	9	0	200
37139	23772s (+0.4s)	1496	1496	128	30	118	9	0	157
37140	23773s (+0.4s)	1092	1092	128	20	96	6	0	122
37141	23773s (+0.7s)	2772	2772	256	49	177	10	0	236
37142	23774s (+0.8s)	3316	3316	256	77	185	18	0	280
37143	23775s (+0.6s)	2220	2220	256	43	138	11	0	192
37144	23775s (+0.6s)	1936	1936	128	51	141	10	0	202
37145	23776s (+0.7s)	3076	3076	256	73	171	9	0	253
37146	23777s (+0.5s)	1736	1736	128	46	131	8	0	185
37147	23777s (+0.3s)	740	740	64	24	68	0	6	98
37148	23777s (+0.5s)	2096	2096	256	30	140	0	8	178
37149	23778s (+0.6s)	2432	2432	256	44	150	0	7	201
37150	23778s (+0.3s)	768	768	64	19	71	0	5	95
37151	23779s (+0.6s)	2316	2316	128	55	145	12	0	212
37152	23780s (+1.3s)	6236	6236	512	136	285	24	0	445
37153	23781s (+0.6s)	2428	2428	256	53	141	9	1	204
37154	23781s (+0.6s)	2016	2016	128	51	149	6	0	206
37155	23782s (+0.6s)	2388	2388	256	45	148	6	0	199
37156	23783s (+1.0s)	4020	4020	256	91	221	20	0	332
37157	23783s (+0.5s)	1744	1744	128	45	119	11	0	175
37158	23784s (+0.4s)	1452	1452	128	28	116	5	2	151
37159	23784s (+0.4s)	1332	1332	128	28	104	6	0	138
37160	23785s (+0.9s)	4012	4012	256	85	223	22	0	330
37161	23786s (+0.7s)	2804	2804	256	42	180	8	0	230
37162	23786s (+0.4s)	1224	1224	128	34	92	7	1	134
37163	23787s (+0.8s)	3536	3536	256	77	204	10	0	291
37164	23788s (+0.5s)	1832	1832	128	36	130	5	0	171
37165	23788s (+0.9s)	3656	3656	256	77	209	19	1	306
37166	23789s (+0.7s)	2836	2836	256	61	181	9	0	251
37167	23790s (+1.0s)	4144	4144	256	93	237	13	0	343
37168	23791s (+0.4s)	1148	1148	64	37	86	11	0	134
37169	23791s (+0.8s)	3516	3516	256	78	199	16	0	293
37170	23792s (+0.9s)	4132	4132	256	100	219	16	0	335
37171	23793s (+0.6s)	2508	2508	256	54	160	4	0	218
37172	23794s (+0.6s)	2180	2180	128	56	154	10	0	220
37173	23794s (+0.5s)	1596	1596	128	48	108	12	0	168
37174	23795s (+0.5s)	1676	1676	128	33	130	7	0	170
37175	23795s (+0.7s)	2880	2880	256	60	161	15	0	236
37176	23796s (+0.7s)	2784	2784	256	54	170	13	1	238
37177	23796s (+0.4s)	1460	1460	128	35	114	4	0	153
37178	23797s (+0.7s)	2684	2684	256	49	187	5	0	241
37179	23798s (+0.7s)	2748	2748	256	59	165	11	0	235
37180	23799s (+0.7s)	3156	3156	256	80	172	10	0	262
37181	23799s (+0.4s)	1356	1356	128	37	96	6	0	139
37182	23800s (+0.7s)	2928	2928	256	67	162	15	0	244
37183	23800s (+0.7s)	2812	2812	256	61	170	14	0	245
37184	23801s (+0.7s)	2920	2920	256	64	184	8	0	256
37185	23802s (+0.7s)	2904	2904	256	60	182	10	0	252
37186	23802s (+0.5s)	1800	1800	128	39	139	7	0	185
37187	23803s (+0.5s)	1532	1532	128	41	112	11	0	164
37188	23803s (+0.6s)	2536	2536	256	56	159	5	0	220
37189	23804s (+0.6s)	2452	2452	256	46	152	11	0	209
37190	23804s (+0.4s)	1520	1520	128	29	126	5	0	160
37191	23805s (+0.5s)	1532	1532	128	35	120	7	0	162
37192	23805s (+0.3s)	708	708	64	24	64	3	0	91
37193	23806s (+0.8s)	3148	3148	256	60	190	0	16	266
37194	23806s (+0.3s)	696	696	64	11	80	0	1	92
37195	23807s (+0.7s)	2724	2724	256	48	174	0	12	234
37196	23807s (+0.6s)	2140	2140	128	38	153	0	12	203
37197	23808s (+0.4s)	1184	1184	64	26	102	0	9	137
37198	23809s (+0.6s)	2244	2244	128	44	155	0	17	216
37199	23809s (+0.8s)	3244	3244	256	49	207	0	17	273
Episode	Time	Reward	Score	Highest	L	U	R	D	Steps
37200	23810s (+0.2s)	572	572	64	11	64	0	3	78
37201	23810s (+0.8s)	3244	3244	256	54	211	0	9	274
37202	23811s (+0.4s)	1208	1208	128	27	100	0	7	134
37203	23811s (+0.2s)	424	424	32	11	52	0	5	68
37204	23811s (+0.5s)	1816	1816	128	49	132	0	8	189
37205	23812s (+1.0s)	4112	4112	256	96	237	12	0	345
37206	23813s (+0.7s)	2920	2920	256	47	188	7	0	242
37207	23814s (+1.0s)	5088	5088	512	100	226	29	0	355
37208	23815s (+0.8s)	3368	3368	256	66	200	13	0	279
37209	23816s (+0.9s)	3660	3660	256	83	218	11	0	312
37210	23817s (+0.8s)	3492	3492	256	70	209	13	0	292
37211	23817s (+0.6s)	2540	2540	256	66	145	10	0	221
37212	23818s (+0.5s)	1964	1964	128	56	131	11	0	198
37213	23819s (+0.9s)	3856	3856	256	96	210	17	0	323
37214	23819s (+0.5s)	2376	2376	256	46	147	10	0	203
37215	23820s (+0.4s)	1256	1256	128	39	86	6	0	131
37216	23820s (+0.5s)	1576	1576	128	41	121	5	0	167
37217	23821s (+0.8s)	3256	3256	256	66	197	9	0	272
37218	23822s (+0.7s)	3180	3180	256	60	187	15	0	262
37219	23822s (+0.3s)	960	960	64	30	79	5	1	115
37220	23822s (+0.5s)	1624	1624	128	49	116	8	0	173
37221	23823s (+0.7s)	2880	2880	256	45	191	10	1	247
37222	23824s (+0.8s)	3480	3480	256	76	202	12	0	290
37223	23825s (+0.8s)	3368	3368	256	68	200	20	0	288
37224	23825s (+0.5s)	1864	1864	128	54	115	13	0	182
37225	23826s (+0.7s)	2912	2912	256	65	183	7	0	255
37226	23827s (+0.5s)	2308	2308	256	46	136	9	0	191
37227	23827s (+0.6s)	1908	1908	128	64	120	12	0	196
37228	23827s (+0.3s)	792	792	64	24	69	6	0	99
37229	23829s (+1.1s)	5688	5688	512	96	287	22	0	405
37230	23829s (+0.8s)	3552	3552	256	71	204	13	0	288
37231	23830s (+0.4s)	1352	1352	128	33	99	7	1	140
37232	23830s (+0.4s)	1444	1444	128	41	98	11	0	150
37233	23831s (+0.6s)	2484	2484	128	72	148	12	0	232
37234	23831s (+0.5s)	1740	1740	128	27	143	5	0	175
37235	23832s (+0.6s)	1956	1956	128	51	136	9	0	196
37236	23832s (+0.4s)	1168	1168	64	41	90	9	0	140
37237	23833s (+0.4s)	1520	1520	128	46	105	8	0	159
37238	23834s (+1.0s)	4280	4280	256	91	250	19	0	360
37239	23835s (+0.7s)	2796	2796	256	62	168	11	1	242
37240	23836s (+1.0s)	4104	4104	256	81	238	15	0	334
37241	23836s (+0.4s)	1440	1440	128	27	115	6	0	148
37242	23836s (+0.4s)	1484	1484	128	40	106	9	0	155
37243	23837s (+0.3s)	892	892	64	19	90	5	0	114
37244	23837s (+0.3s)	1012	1012	64	32	78	11	0	121
37245	23838s (+0.9s)	3648	3648	256	72	229	8	0	309
37246	23838s (+0.4s)	1292	1292	128	28	102	9	0	139
37247	23839s (+0.8s)	3228	3228	256	73	179	18	0	270
37248	23840s (+0.8s)	3548	3548	256	70	212	20	0	302
37249	23840s (+0.2s)	572	572	64	16	59	2	1	78
37250	23841s (+0.4s)	1420	1420	128	36	105	7	0	148
37251	23841s (+0.7s)	2708	2708	128	75	161	16	0	252
37252	23842s (+0.8s)	3464	3464	256	74	200	15	0	289
37253	23843s (+0.4s)	1488	1488	128	38	113	4	0	155
37254	23843s (+0.8s)	3296	3296	256	70	191	15	0	276
37255	23844s (+0.8s)	3344	3344	256	80	186	16	0	282
37256	23845s (+0.8s)	3488	3488	256	70	204	17	0	291
37257	23846s (+0.8s)	3608	3608	256	71	207	12	0	290
37258	23847s (+1.0s)	5028	5028	512	75	268	15	0	358
37259	23847s (+0.4s)	1196	1196	128	29	97	5	0	131
37260	23848s (+0.5s)	1608	1608	128	39	122	7	0	168
37261	23849s (+0.7s)	2976	2976	256	57	176	11	0	244
37262	23849s (+0.8s)	3504	3504	256	74	203	13	0	290
37263	23850s (+1.0s)	4300	4300	256	90	240	23	0	353
37264	23851s (+0.2s)	308	308	32	10	45	2	0	57
37265	23851s (+0.3s)	764	764	64	28	67	4	0	99
37266	23852s (+0.9s)	3888	3888	256	84	213	14	0	311
37267	23853s (+0.7s)	2912	2912	256	60	185	9	0	254
37268	23853s (+0.5s)	1820	1820	128	48	134	8	0	190
37269	23854s (+0.8s)	3528	3528	256	46	244	10	0	300
37270	23855s (+0.6s)	2520	2520	256	53	157	11	0	221
37271	23855s (+0.7s)	3064	3064	256	63	186	11	0	260
37272	23856s (+0.9s)	4008	4008	256	89	212	24	0	325
37273	23857s (+0.5s)	2040	2040	128	51	130	12	0	193
37274	23858s (+0.7s)	3160	3160	256	64	184	11	0	259
37275	23858s (+0.6s)	2496	2496	256	53	156	7	0	216
37276	23859s (+0.5s)	1604	1604	128	39	124	5	0	168
37277	23859s (+0.8s)	3180	3180	256	52	203	8	0	263
37278	23860s (+0.8s)	3156	3156	256	55	198	11	0	264
37279	23861s (+0.6s)	2372	2372	256	46	148	8	0	202
37280	23861s (+0.5s)	1548	1548	128	37	121	7	0	165
37281	23862s (+0.5s)	1880	1880	128	42	141	9	1	193
37282	23862s (+0.4s)	1440	1440	128	31	116	3	0	150
37283	23863s (+0.6s)	2596	2596	256	59	153	12	0	224
37284	23864s (+0.7s)	2952	2952	256	80	166	13	0	259
37285	23864s (+0.7s)	2920	2920	256	61	187	8	0	256
37286	23865s (+0.4s)	1436	1436	128	29	116	3	0	148
37287	23865s (+0.7s)	2856	2856	256	59	179	11	0	249
37288	23866s (+0.6s)	1904	1904	128	48	139	7	0	194
37289	23867s (+0.7s)	2964	2964	256	60	186	14	0	260
37290	23867s (+0.5s)	1680	1680	128	41	119	11	0	171
37291	23869s (+1.4s)	7168	7168	512	141	325	32	0	498
37292	23870s (+1.1s)	5504	5504	512	103	265	22	0	390
37293	23870s (+0.3s)	712	712	64	24	65	3	0	92
37294	23871s (+0.8s)	3408	3408	256	81	185	17	0	283
37295	23872s (+0.9s)	3996	3996	256	82	225	19	0	326
37296	23872s (+0.5s)	1740	1740	128	38	126	11	0	175
37297	23873s (+0.9s)	4084	4084	256	87	226	16	0	329
37298	23874s (+0.5s)	1816	1816	128	44	136	4	0	184
37299	23875s (+1.1s)	4604	4604	256	111	250	20	1	382
Episode	Time	Reward	Score	Highest	L	U	R	D	Steps
37300	23876s (+0.8s)	3192	3192	256	69	183	14	0	266
37301	23876s (+0.5s)	1928	1928	128	42	139	0	9	190
37302	23877s (+0.4s)	1480	1480	128	42	109	3	0	154
37303	23877s (+0.9s)	3580	3580	256	78	210	13	1	302
37304	23878s (+0.4s)	1336	1336	128	18	120	2	0	140
37305	23879s (+0.8s)	3324	3324	256	67	193	11	0	271
37306	23880s (+1.2s)	6420	6420	512	129	287	23	0	439
37307	23881s (+0.8s)	3616	3616	256	75	205	22	0	302
37308	23882s (+1.0s)	4140	4140	256	95	225	17	0	337
37309	23883s (+0.8s)	3356	3356	256	71	202	12	0	285
37310	23883s (+0.3s)	884	884	64	23	87	6	0	116
37311	23883s (+0.5s)	1780	1780	128	44	129	8	0	181
37312	23884s (+0.7s)	2920	2920	256	62	168	12	1	243
37313	23885s (+0.4s)	1312	1312	128	32	101	10	0	143
37314	23885s (+0.4s)	1324	1324	128	31	99	5	1	136
37315	23886s (+0.8s)	3348	3348	256	60	212	12	0	284
37316	23886s (+0.7s)	2692	2692	256	59	158	16	0	233
37317	23887s (+0.4s)	1400	1400	128	38	106	6	0	150
37318	23887s (+0.5s)	1488	1488	64	39	114	7	0	160
37319	23888s (+0.4s)	1460	1460	128	31	117	5	0	153
37320	23888s (+0.4s)	1324	1324	64	41	102	7	1	151
37321	23889s (+0.9s)	4232	4232	256	111	190	27	1	329
37322	23890s (+1.1s)	5712	5712	512	113	261	25	1	400
37323	23891s (+0.6s)	1896	1896	128	50	131	12	0	193
37324	23891s (+0.4s)	1452	1452	128	35	109	4	0	148
37325	23892s (+1.1s)	5704	5704	512	117	261	23	0	401
37326	23893s (+0.9s)	4000	4000	256	94	226	14	0	334
37327	23894s (+0.8s)	3484	3484	256	70	211	9	0	290
37328	23895s (+0.5s)	1616	1616	128	38	124	8	0	170
37329	23896s (+0.9s)	3596	3596	256	54	226	0	18	298
37330	23896s (+0.8s)	3544	3544	256	66	214	0	20	300
37331	23897s (+0.6s)	2496	2496	256	42	166	0	8	216
37332	23898s (+0.5s)	2148	2148	256	33	141	0	9	183
37333	23898s (+0.7s)	2896	2896	256	77	164	14	0	255
37334	23899s (+0.4s)	1268	1268	128	46	85	6	1	138
37335	23900s (+1.0s)	4148	4148	256	84	241	14	0	339
37336	23900s (+0.4s)	1320	1320	128	33	105	5	0	143
37337	23901s (+0.9s)	3856	3856	256	67	232	16	0	315
37338	23902s (+0.7s)	2780	2780	256	53	172	13	0	238
37339	23903s (+0.9s)	3924	3924	256	90	214	16	0	320
37340	23903s (+0.5s)	1820	1820	128	34	152	4	0	190
37341	23904s (+0.5s)	2304	2304	256	51	133	9	0	193
37342	23904s (+0.3s)	748	748	64	23	70	3	1	97
37343	23905s (+0.7s)	2748	2748	256	60	165	7	0	232
37344	23906s (+1.0s)	4232	4232	256	117	213	18	0	348
37345	23906s (+0.8s)	3452	3452	256	76	192	18	1	287
37346	23907s (+0.9s)	3936	3936	256	80	228	15	0	323
37347	23908s (+0.7s)	2472	2472	128	71	145	13	0	229
37348	23909s (+1.3s)	6164	6164	512	138	283	27	0	448
37349	23910s (+0.3s)	1152	1152	128	25	88	2	0	115
37350	23910s (+0.5s)	1508	1508	128	37	116	7	0	160
37351	23911s (+1.0s)	4172	4172	256	81	245	12	0	338
37352	23912s (+1.2s)	6100	6100	512	112	296	20	0	428
37353	23913s (+0.5s)	1508	1508	128	31	122	8	0	161
37354	23914s (+0.7s)	2628	2628	256	55	165	11	1	232
37355	23914s (+0.8s)	2972	2972	256	71	178	15	0	264
37356	23915s (+1.0s)	4516	4516	256	97	257	17	0	371
37357	23916s (+0.4s)	1376	1376	128	39	97	7	1	144
37358	23916s (+0.7s)	2548	2548	128	61	172	10	0	243
37359	23917s (+0.6s)	1920	1920	128	48	141	9	0	198
37360	23918s (+0.8s)	3352	3352	256	62	198	13	1	274
37361	23918s (+0.5s)	1536	1536	128	51	101	9	0	161
37362	23919s (+0.6s)	2428	2428	256	54	141	13	0	208
37363	23919s (+0.5s)	1680	1680	128	51	114	7	0	172
37364	23920s (+0.6s)	2760	2760	256	43	176	5	0	224
37365	23921s (+0.7s)	3280	3280	256	60	201	14	0	275
37366	23921s (+0.5s)	1720	1720	128	46	118	6	0	170
37367	23922s (+0.6s)	2536	2536	256	59	153	9	0	221
37368	23923s (+0.6s)	2504	2504	256	47	166	5	0	218
37369	23923s (+0.7s)	3028	3028	256	64	180	8	0	252
37370	23924s (+0.6s)	2164	2164	128	56	147	13	0	216
37371	23924s (+0.5s)	1496	1496	128	30	124	5	0	159
37372	23925s (+0.8s)	3360	3360	256	75	190	15	0	280
37373	23926s (+0.6s)	2452	2452	256	58	143	8	0	209
37374	23927s (+0.8s)	3480	3480	256	75	199	15	0	289
37375	23927s (+0.5s)	1872	1872	128	36	152	4	0	192
37376	23928s (+0.7s)	2476	2476	128	61	156	13	0	230
37377	23928s (+0.5s)	1616	1616	64	32	137	6	0	175
37378	23929s (+0.7s)	2792	2792	256	52	179	10	0	241
37379	23930s (+1.2s)	6016	6016	512	113	289	29	0	431
37380	23931s (+0.9s)	3680	3680	256	64	227	0	15	306
37381	23932s (+0.7s)	2960	2960	256	54	179	0	10	243
37382	23933s (+1.2s)	5692	5692	512	84	299	0	23	406
37383	23934s (+0.8s)	3728	3728	256	59	223	0	19	301
37384	23934s (+0.5s)	1704	1704	128	36	131	0	4	171
37385	23935s (+0.5s)	2092	2092	128	41	144	0	10	195
37386	23936s (+0.9s)	3956	3956	256	75	230	0	18	323
37387	23937s (+0.8s)	3344	3344	256	68	201	0	13	282
37388	23937s (+0.6s)	2376	2376	256	44	145	0	13	202
37389	23938s (+0.6s)	2144	2144	128	40	154	0	13	207
37390	23939s (+1.2s)	6304	6304	512	106	316	0	25	447
37391	23940s (+0.9s)	3628	3628	256	68	228	0	13	309
37392	23940s (+0.5s)	2256	2256	256	42	133	0	11	186
37393	23941s (+0.5s)	1652	1652	128	36	129	0	4	169
37394	23941s (+0.4s)	1236	1236	64	40	108	3	0	151
37395	23942s (+0.5s)	1808	1808	128	37	142	8	0	187
37396	23943s (+0.5s)	1844	1844	128	51	122	12	0	185
37397	23943s (+0.6s)	2288	2288	128	63	150	9	0	222
37398	23944s (+1.0s)	4160	4160	256	83	241	15	0	339
37399	23945s (+0.7s)	2792	2792	256	61	167	13	1	242
Episode	Time	Reward	Score	Highest	L	U	R	D	Steps
37400	23946s (+0.8s)	3300	3300	256	64	201	11	0	276
37401	23946s (+0.8s)	3496	3496	256	72	206	15	0	293
37402	23947s (+0.8s)	3532	3532	256	73	204	15	0	292
37403	23948s (+0.5s)	1508	1508	128	37	115	7	1	160
37404	23949s (+0.8s)	3432	3432	256	69	206	13	0	288
37405	23949s (+0.7s)	2952	2952	256	68	163	16	0	247
37406	23950s (+0.4s)	1368	1368	128	29	111	6	0	146
37407	23950s (+0.4s)	1484	1484	128	38	110	7	0	155
37408	23951s (+0.7s)	2676	2676	256	49	171	9	0	229
37409	23952s (+0.8s)	3376	3376	256	69	198	13	0	280
37410	23952s (+0.5s)	1692	1692	128	53	111	9	1	174
37411	23953s (+0.7s)	2808	2808	256	53	173	12	0	238
37412	23953s (+0.5s)	1776	1776	128	33	144	3	0	180
37413	23954s (+0.9s)	3788	3788	256	72	212	19	0	303
37414	23955s (+0.9s)	3780	3780	256	82	216	13	0	311
37415	23956s (+0.8s)	3492	3492	256	71	201	19	1	292
37416	23957s (+0.9s)	3932	3932	256	90	221	11	0	322
37417	23957s (+0.6s)	2636	2636	256	42	177	5	0	224
37418	23958s (+0.8s)	3304	3304	256	89	177	11	0	277
37419	23959s (+0.4s)	1364	1364	128	32	104	6	0	142
37420	23959s (+0.7s)	3172	3172	256	57	195	0	10	262
37421	23960s (+0.4s)	1060	1060	64	22	97	0	7	126
37422	23960s (+0.3s)	920	920	128	17	79	0	3	99
37423	23961s (+0.6s)	2468	2468	256	51	148	0	10	209
37424	23961s (+0.7s)	2968	2968	256	52	183	0	6	241
37425	23962s (+0.9s)	3760	3760	256	59	233	0	14	306
37426	23963s (+0.5s)	1688	1688	128	29	135	0	10	174
37427	23963s (+0.7s)	2604	2604	256	42	175	0	9	226
37428	23964s (+0.6s)	2576	2576	256	43	175	5	0	223
37429	23965s (+0.9s)	4052	4052	256	71	250	14	0	335
37430	23965s (+0.3s)	888	888	64	27	83	7	0	117
37431	23966s (+0.4s)	1164	1164	64	37	98	3	0	138
37432	23966s (+0.3s)	932	932	64	32	76	5	0	113
37433	23966s (+0.4s)	1180	1180	64	44	93	5	0	142
37434	23967s (+0.5s)	1736	1736	128	55	120	5	0	180
37435	23968s (+0.6s)	2412	2412	128	48	168	0	11	227
37436	23968s (+0.6s)	2480	2480	256	44	153	0	15	212
37437	23969s (+0.8s)	3232	3232	256	53	211	0	12	276
37438	23969s (+0.2s)	328	328	32	10	44	0	5	59
37439	23970s (+0.7s)	2964	2964	256	44	196	0	12	252
37440	23970s (+0.3s)	888	888	64	29	79	0	7	115
37441	23971s (+0.5s)	1512	1512	128	32	122	0	8	162
37442	23971s (+0.6s)	2508	2508	256	44	170	0	6	220
37443	23972s (+0.5s)	1576	1576	128	37	112	10	0	159
37444	23973s (+0.9s)	3612	3612	256	89	198	19	0	306
37445	23973s (+0.7s)	2808	2808	256	56	175	14	0	245
37446	23974s (+0.7s)	2660	2660	128	69	156	18	1	244
37447	23975s (+0.6s)	2600	2600	256	50	165	10	0	225
37448	23975s (+0.6s)	1920	1920	128	48	145	5	0	198
37449	23976s (+0.6s)	2452	2452	256	50	152	8	0	210
37450	23977s (+0.9s)	3812	3812	256	90	203	15	1	309
37451	23977s (+0.6s)	1916	1916	128	47	141	9	0	197
37452	23978s (+0.5s)	1616	1616	128	34	127	6	0	167
37453	23978s (+0.5s)	1684	1684	128	42	121	7	1	171
37454	23979s (+0.9s)	3952	3952	256	75	240	11	0	326
37455	23979s (+0.2s)	576	576	64	12	67	0	0	79
37456	23980s (+0.4s)	1168	1168	64	31	103	5	0	139
37457	23981s (+0.9s)	4700	4700	512	85	224	11	0	320
37458	23981s (+0.6s)	2472	2472	256	58	133	17	1	209
37459	23982s (+0.5s)	1816	1816	128	47	133	9	0	189
37460	23982s (+0.4s)	1392	1392	128	21	123	0	5	149
37461	23983s (+0.4s)	1468	1468	128	34	108	0	10	152
37462	23983s (+0.4s)	1264	1264	64	32	104	0	8	144
37463	23984s (+1.0s)	5108	5108	512	85	267	0	15	367
37464	23985s (+0.4s)	1180	1180	64	30	103	0	9	142
37465	23986s (+0.9s)	3960	3960	256	61	240	0	23	324
37466	23986s (+0.7s)	2952	2952	256	49	195	0	16	260
37467	23987s (+0.5s)	1784	1784	128	49	126	6	0	181
37468	23987s (+0.5s)	1792	1792	128	47	130	6	0	183
37469	23988s (+0.5s)	1892	1892	128	45	139	7	0	191
37470	23988s (+0.4s)	1508	1508	128	29	118	7	0	154
37471	23989s (+0.8s)	3452	3452	256	85	186	20	0	291
37472	23990s (+0.6s)	1968	1968	128	56	141	8	0	205
37473	23991s (+0.8s)	3136	3136	256	82	174	8	0	264
37474	23991s (+0.5s)	2320	2320	256	33	148	9	0	190
37475	23992s (+0.7s)	3268	3268	256	77	180	12	0	269
37476	23992s (+0.4s)	1416	1416	128	42	96	6	0	144
37477	23993s (+0.4s)	1512	1512	128	33	119	8	1	161
37478	23994s (+0.8s)	3536	3536	256	59	223	14	0	296
37479	23994s (+0.6s)	2376	2376	256	24	169	4	0	197
37480	23995s (+0.5s)	1768	1768	128	38	131	8	0	177
37481	23995s (+0.3s)	868	868	64	35	74	4	0	113
37482	23995s (+0.3s)	720	720	64	13	80	0	4	97
37483	23996s (+0.5s)	1512	1512	128	33	118	6	0	157
37484	23997s (+0.9s)	3760	3760	256	84	212	14	1	311
37485	23997s (+0.4s)	1452	1452	128	32	108	6	0	146
37486	23998s (+0.4s)	1512	1512	128	39	107	9	0	155
37487	23998s (+0.5s)	1676	1676	128	39	123	7	0	169
37488	23999s (+0.9s)	3796	3796	256	76	211	18	0	305
37489	24000s (+0.8s)	3532	3532	256	75	209	10	0	294
37490	24000s (+0.6s)	2216	2216	256	42	144	7	0	193
37491	24001s (+0.6s)	1924	1924	128	57	131	11	0	199
37492	24002s (+0.7s)	2704	2704	256	76	133	20	1	230
37493	24003s (+1.0s)	4448	4448	256	101	244	19	0	364
37494	24003s (+0.7s)	2992	2992	256	57	177	14	0	248
37495	24004s (+0.8s)	3200	3200	256	81	169	13	0	263
37496	24004s (+0.5s)	1544	1544	128	42	119	4	0	165
37497	24005s (+0.5s)	1604	1604	128	51	106	11	0	168
37498	24005s (+0.4s)	1476	1476	128	32	116	6	0	154
37499	24006s (+0.4s)	1360	1360	128	40	98	3	0	141
Episode	Time	Reward	Score	Highest	L	U	R	D	Steps
37500	24006s (+0.7s)	2396	2396	128	61	154	12	0	227
37501	24007s (+0.9s)	3916	3916	256	78	222	18	0	318
37502	24009s (+1.1s)	5672	5672	512	105	279	17	0	401
37503	24009s (+0.7s)	3028	3028	256	60	172	11	0	243
37504	24010s (+0.4s)	1476	1476	128	37	114	3	0	154
37505	24010s (+0.5s)	2084	2084	256	36	133	8	1	178
37506	24011s (+0.5s)	1836	1836	128	36	149	8	0	193
37507	24012s (+0.8s)	3228	3228	256	59	193	0	18	270
37508	24012s (+0.7s)	3184	3184	256	62	185	0	13	260
37509	24013s (+0.7s)	2964	2964	256	58	170	10	0	238
37510	24013s (+0.5s)	1772	1772	128	42	131	9	0	182
37511	24014s (+0.7s)	2840	2840	256	65	172	9	0	246
37512	24015s (+0.8s)	3364	3364	256	81	192	15	0	288
37513	24016s (+0.7s)	3124	3124	256	62	181	10	2	255
37514	24016s (+0.5s)	1764	1764	128	43	123	10	0	176
37515	24017s (+0.5s)	1824	1824	128	53	128	10	0	191
37516	24018s (+0.8s)	3260	3260	256	57	212	9	0	278
37517	24018s (+0.8s)	3324	3324	256	66	204	8	0	278
37518	24019s (+0.5s)	1588	1588	128	36	128	6	0	170
37519	24019s (+0.3s)	704	704	64	25	66	3	0	94
37520	24020s (+0.5s)	1628	1628	128	50	117	7	0	174
37521	24020s (+0.6s)	2152	2152	128	58	136	17	1	212
37522	24021s (+0.4s)	1440	1440	128	41	98	9	0	148
37523	24021s (+0.6s)	2680	2680	256	48	173	0	10	231
37524	24022s (+0.8s)	3420	3420	256	63	210	0	13	286
37525	24023s (+0.7s)	2656	2656	256	46	178	0	10	234
37526	24024s (+0.7s)	2796	2796	256	40	190	0	13	243
37527	24024s (+0.3s)	592	592	32	21	60	0	7	88
37528	24024s (+0.6s)	2608	2608	256	39	174	0	14	227
37529	24025s (+0.8s)	3480	3480	256	77	201	11	1	290
37530	24026s (+0.3s)	756	756	64	27	70	4	0	101
37531	24026s (+0.4s)	1344	1344	64	41	113	4	0	158
37532	24026s (+0.4s)	1192	1192	64	42	96	7	0	145
37533	24027s (+0.7s)	2680	2680	256	45	177	9	0	231
37534	24028s (+0.7s)	3332	3332	256	61	200	12	0	273
37535	24028s (+0.5s)	1884	1884	128	44	137	7	1	189
37536	24030s (+1.2s)	6056	6056	512	95	315	22	0	432
37537	24030s (+0.3s)	704	704	64	23	66	4	0	93
37538	24031s (+0.8s)	3508	3508	256	67	216	13	0	296
37539	24031s (+0.5s)	1464	1464	128	44	107	8	1	160
37540	24032s (+0.7s)	2544	2544	128	68	155	13	0	236
37541	24033s (+0.8s)	3408	3408	256	80	200	13	0	293
37542	24033s (+0.5s)	1636	1636	128	49	114	9	0	172
37543	24034s (+1.0s)	4144	4144	256	86	241	15	0	342
37544	24035s (+0.5s)	1808	1808	128	38	137	8	0	183
37545	24035s (+0.6s)	2612	2612	256	53	152	8	0	213
37546	24036s (+0.6s)	1932	1932	128	46	149	6	0	201
37547	24036s (+0.4s)	1204	1204	128	33	95	5	0	133
37548	24038s (+2.0s)	11632	11632	1024	200	477	37	0	714
37549	24040s (+1.3s)	6212	6212	512	128	291	20	0	439
37550	24041s (+0.9s)	3600	3600	256	74	213	12	0	299
37551	24041s (+0.4s)	1312	1312	128	31	95	6	0	132
37552	24042s (+0.5s)	1636	1636	128	37	127	7	0	171
37553	24042s (+0.4s)	1288	1288	128	32	98	8	0	138
37554	24042s (+0.4s)	1312	1312	128	33	101	9	0	143
37555	24043s (+0.8s)	3440	3440	256	61	212	11	1	285
37556	24044s (+0.7s)	2948	2948	256	57	172	12	0	241
37557	24044s (+0.3s)	736	736	64	18	73	7	0	98
37558	24045s (+0.8s)	3532	3532	256	77	201	12	0	290
37559	24046s (+0.8s)	3376	3376	256	68	201	12	0	281
37560	24046s (+0.5s)	1744	1744	128	26	146	0	4	176
37561	24047s (+0.5s)	1872	1872	128	36	131	0	11	178
37562	24047s (+0.3s)	1128	1128	128	26	88	0	3	117
37563	24048s (+0.7s)	3204	3204	256	61	194	10	0	265
37564	24049s (+0.5s)	1820	1820	128	38	143	8	0	189
37565	24049s (+0.7s)	2560	2560	128	68	158	12	1	239
37566	24050s (+0.5s)	1768	1768	128	46	119	16	0	181
37567	24050s (+0.7s)	3028	3028	256	67	170	11	0	248
37568	24051s (+0.4s)	1484	1484	128	47	104	4	0	155
37569	24051s (+0.6s)	2476	2476	256	53	153	5	0	211
37570	24052s (+0.5s)	1808	1808	128	51	127	9	0	187
37571	24053s (+0.7s)	2768	2768	256	51	173	11	0	235
37572	24053s (+0.5s)	1588	1588	128	40	120	3	0	163
37573	24054s (+0.4s)	1060	1060	64	31	94	4	0	129
37574	24054s (+0.7s)	2868	2868	256	53	178	9	0	240
37575	24055s (+0.4s)	1460	1460	128	23	125	0	6	154
37576	24055s (+0.6s)	2640	2640	256	44	168	1	8	221
37577	24056s (+0.5s)	2092	2092	256	32	137	0	8	177
37578	24057s (+0.9s)	3868	3868	256	66	252	0	10	328
37579	24058s (+0.9s)	3840	3840	256	80	212	0	21	313
37580	24058s (+0.8s)	3528	3528	256	60	225	0	15	300
37581	24059s (+0.4s)	1256	1256	128	37	96	8	0	141
37582	24059s (+0.2s)	528	528	32	27	54	2	0	83
37583	24060s (+0.7s)	2796	2796	256	57	171	14	0	242
37584	24060s (+0.5s)	1616	1616	128	50	113	8	0	171
37585	24061s (+0.7s)	2956	2956	256	60	170	15	1	246
37586	24062s (+0.7s)	3032	3032	256	58	175	10	0	243
37587	24063s (+0.8s)	3492	3492	256	79	198	14	1	292
37588	24063s (+0.8s)	3292	3292	256	83	182	16	0	281
37589	24064s (+1.1s)	4544	4544	256	96	251	24	0	371
37590	24065s (+0.5s)	1584	1584	128	42	111	9	1	163
37591	24066s (+0.8s)	3320	3320	256	56	204	9	1	270
37592	24067s (+0.9s)	3900	3900	256	92	206	16	1	315
37593	24067s (+0.6s)	1932	1932	128	42	149	10	0	201
37594	24068s (+0.4s)	1140	1140	64	35	88	4	0	127
37595	24068s (+0.8s)	3292	3292	256	66	200	12	0	278
37596	24069s (+0.8s)	3384	3384	256	67	197	13	0	277
37597	24070s (+0.4s)	1292	1292	128	27	104	2	0	133
37598	24070s (+0.5s)	1864	1864	128	48	127	10	0	185
37599	24071s (+1.1s)	5612	5612	512	111	265	24	1	401
Episode	Time	Reward	Score	Highest	L	U	R	D	Steps
37600	24072s (+0.4s)	1200	1200	128	23	95	0	3	121
37601	24072s (+0.8s)	3356	3356	256	53	220	0	12	285
37602	24073s (+0.4s)	1176	1176	64	24	113	0	4	141
37603	24073s (+0.6s)	1908	1908	128	32	157	0	8	197
37604	24074s (+0.8s)	3312	3312	256	58	207	0	13	278
37605	24075s (+0.5s)	1584	1584	128	32	132	0	4	168
37606	24076s (+0.9s)	3800	3800	256	80	204	16	1	301
37607	24077s (+1.3s)	6548	6548	512	132	281	34	1	448
37608	24078s (+0.9s)	3636	3636	256	78	216	13	0	307
37609	24078s (+0.5s)	1796	1796	128	34	143	7	0	184
37610	24079s (+0.6s)	2308	2308	256	45	144	11	0	200
37611	24079s (+0.6s)	2628	2628	256	43	173	6	0	222
37612	24080s (+0.7s)	2668	2668	256	53	171	6	0	230
37613	24081s (+1.0s)	4132	4132	256	94	224	21	1	340
37614	24082s (+0.7s)	3124	3124	256	72	172	17	0	261
37615	24082s (+0.5s)	1784	1784	128	39	136	6	0	181
37616	24083s (+1.0s)	5108	5108	512	96	243	18	0	357
37617	24084s (+0.5s)	1544	1544	128	41	107	8	0	156
37618	24084s (+0.5s)	1780	1780	128	56	116	8	0	180
37619	24085s (+0.3s)	664	664	64	18	67	3	0	88
37620	24085s (+0.8s)	3396	3396	256	73	192	10	0	275
37621	24086s (+0.6s)	2596	2596	256	49	163	7	0	219
37622	24087s (+0.7s)	2792	2792	256	59	172	10	0	241
37623	24087s (+0.6s)	2476	2476	256	48	153	10	0	211
37624	24088s (+0.4s)	924	924	64	28	87	7	0	122
37625	24088s (+0.5s)	1896	1896	128	46	136	10	0	192
37626	24089s (+0.4s)	1340	1340	128	28	111	1	0	140
37627	24089s (+0.5s)	1604	1604	128	34	125	9	0	168
37628	24090s (+0.5s)	1776	1776	128	40	129	10	0	179
37629	24091s (+1.0s)	4880	4880	512	84	248	15	0	347
37630	24091s (+0.6s)	2084	2084	128	58	130	14	0	202
37631	24092s (+0.6s)	2684	2684	256	50	165	10	0	225
37632	24092s (+0.3s)	1016	1016	128	26	78	4	0	108
37633	24093s (+0.5s)	1804	1804	128	51	130	6	0	187
37634	24093s (+0.5s)	1712	1712	128	40	127	5	0	172
37635	24094s (+0.5s)	1784	1784	128	41	134	6	0	181
37636	24094s (+0.4s)	1536	1536	128	38	110	9	0	157
37637	24095s (+0.8s)	3496	3496	256	99	181	11	0	291
37638	24096s (+0.9s)	3956	3956	256	63	242	16	0	321
37639	24097s (+0.7s)	2828	2828	256	52	190	8	0	250
37640	24097s (+0.8s)	3372	3372	256	76	184	18	0	278
37641	24098s (+0.8s)	3424	3424	256	68	205	13	1	287
37642	24099s (+0.3s)	928	928	64	32	77	4	0	113
37643	24100s (+1.1s)	5416	5416	512	99	257	23	0	379
37644	24100s (+0.7s)	2956	2956	256	58	180	12	0	250
37645	24101s (+1.0s)	4248	4248	256	80	255	17	0	352
37646	24102s (+0.8s)	3268	3268	256	59	210	11	0	280
37647	24103s (+0.4s)	1444	1444	128	26	118	5	0	149
37648	24103s (+0.5s)	1748	1748	128	40	125	7	0	172
37649	24104s (+1.0s)	4240	4240	256	87	245	18	0	350
37650	24105s (+0.5s)	1832	1832	128	42	134	10	0	186
37651	24105s (+0.8s)	3188	3188	256	72	188	6	0	266
37652	24106s (+0.4s)	1332	1332	128	36	102	6	0	144
37653	24106s (+0.3s)	856	856	64	25	81	4	0	110
37654	24106s (+0.4s)	1420	1420	128	28	114	2	0	144
37655	24107s (+0.9s)	3688	3688	256	88	199	25	0	312
37656	24108s (+0.6s)	1900	1900	128	48	135	10	0	193
37657	24108s (+0.2s)	280	280	32	9	42	0	2	53
37658	24109s (+0.6s)	2644	2644	256	38	178	0	6	222
37659	24110s (+0.8s)	3228	3228	256	63	192	0	15	270
37660	24110s (+0.4s)	1328	1328	128	29	105	0	5	139
37661	24110s (+0.3s)	720	720	64	12	80	0	2	94
37662	24111s (+0.5s)	2036	2036	256	25	139	4	0	168
37663	24111s (+0.6s)	2632	2632	256	36	166	7	1	210
37664	24112s (+0.7s)	2792	2792	256	55	177	9	0	241
37665	24112s (+0.5s)	1516	1516	128	40	113	9	0	162
37666	24113s (+0.5s)	2180	2180	256	44	129	13	0	186
37667	24114s (+0.9s)	3560	3560	256	64	226	13	1	304
37668	24114s (+0.4s)	1052	1052	64	39	83	5	0	127
37669	24115s (+0.7s)	2584	2584	128	69	163	12	0	244
37670	24115s (+0.5s)	1604	1604	128	36	121	7	0	164
37671	24116s (+0.9s)	4004	4004	256	82	227	16	0	325
37672	24117s (+0.5s)	1876	1876	128	50	138	4	0	192
37673	24117s (+0.4s)	1216	1216	64	46	95	6	0	147
37674	24118s (+0.8s)	3588	3588	256	73	190	22	0	285
37675	24119s (+0.5s)	1868	1868	128	52	129	9	0	190
37676	24119s (+0.6s)	2496	2496	256	51	155	11	0	217
37677	24120s (+0.3s)	1072	1072	128	23	92	2	0	117
37678	24121s (+0.9s)	3940	3940	256	86	227	11	0	324
37679	24121s (+0.9s)	4000	4000	256	77	227	17	1	322
37680	24122s (+0.5s)	2108	2108	128	48	135	13	3	199
37681	24123s (+0.5s)	1880	1880	128	50	126	12	0	188
37682	24123s (+0.5s)	1580	1580	128	36	121	5	0	162
37683	24124s (+0.6s)	2388	2388	256	43	147	1	10	201
37684	24124s (+0.8s)	3564	3564	256	57	230	0	15	302
37685	24125s (+0.4s)	1344	1344	128	37	97	0	5	139
37686	24125s (+0.6s)	2192	2192	128	41	158	0	9	208
37687	24126s (+0.3s)	976	976	64	25	84	0	8	117
37688	24126s (+0.4s)	1616	1616	128	41	113	0	7	161
37689	24127s (+0.6s)	2752	2752	256	46	167	0	8	221
37690	24127s (+0.4s)	1440	1440	128	21	120	0	7	148
37691	24128s (+0.8s)	3604	3604	256	80	207	13	0	300
37692	24129s (+0.5s)	1576	1576	128	30	127	5	0	162
37693	24130s (+1.1s)	5604	5604	512	96	283	17	0	396
37694	24130s (+0.6s)	2660	2660	256	55	159	12	0	226
37695	24131s (+0.7s)	3228	3228	256	56	198	7	0	261
37696	24132s (+0.9s)	3928	3928	256	73	231	10	0	314
37697	24133s (+0.6s)	2488	2488	256	54	150	10	1	215
37698	24133s (+0.4s)	1384	1384	128	39	101	3	0	143
37699	24134s (+0.7s)	3236	3236	256	53	200	9	0	262
Episode	Time	Reward	Score	Highest	L	U	R	D	Steps
37700	24134s (+0.7s)	2476	2476	128	51	172	7	0	230
37701	24135s (+0.6s)	2584	2584	256	57	143	12	0	212
37702	24136s (+0.5s)	1824	1824	128	42	138	10	0	190
37703	24136s (+0.3s)	1116	1116	128	25	88	4	0	117
37704	24136s (+0.5s)	2324	2324	256	48	145	2	0	195
37705	24137s (+0.5s)	2304	2304	256	39	146	15	0	200
37706	24137s (+0.3s)	780	780	64	30	59	7	1	97
37707	24138s (+0.4s)	1204	1204	128	31	97	0	5	133
37708	24138s (+0.4s)	1332	1332	128	28	100	0	7	135
37709	24138s (+0.4s)	1168	1168	128	24	99	0	3	126
37710	24139s (+0.8s)	3220	3220	256	56	198	0	18	272
37711	24140s (+0.5s)	1796	1796	128	41	133	0	10	184
37712	24140s (+0.5s)	1496	1496	128	28	124	0	6	158
37713	24141s (+0.4s)	1384	1384	128	24	108	0	8	140
37714	24141s (+0.3s)	880	880	64	18	89	7	1	115
37715	24142s (+0.6s)	2464	2464	256	47	157	5	0	209
37716	24142s (+0.4s)	972	972	64	39	76	6	2	123
37717	24143s (+0.9s)	3728	3728	256	97	202	14	1	314
37718	24144s (+0.8s)	3160	3160	256	71	197	9	0	277
37719	24144s (+0.5s)	1800	1800	128	49	122	14	0	185
37720	24145s (+0.7s)	3136	3136	256	54	201	9	0	264
37721	24146s (+0.7s)	2792	2792	256	46	187	8	0	241
37722	24146s (+0.4s)	1472	1472	128	32	119	5	0	156
37723	24147s (+1.1s)	4632	4632	256	128	236	21	0	385
37724	24148s (+0.5s)	1544	1544	128	37	122	7	0	166
37725	24148s (+0.4s)	1308	1308	128	28	108	6	0	142
37726	24148s (+0.4s)	1156	1156	128	34	87	5	0	126
37727	24149s (+0.8s)	3244	3244	256	59	201	14	0	274
37728	24150s (+0.7s)	2804	2804	256	57	181	7	0	245
37729	24151s (+0.9s)	4132	4132	256	93	225	17	0	335
37730	24151s (+0.5s)	1928	1928	128	64	125	9	0	198
37731	24152s (+0.5s)	1516	1516	128	30	128	4	0	162
37732	24153s (+0.7s)	2952	2952	256	45	186	11	1	243
37733	24153s (+0.8s)	3076	3076	256	70	173	20	0	263
37734	24154s (+0.8s)	3252	3252	256	87	175	14	0	276
37735	24155s (+0.5s)	1848	1848	128	45	135	9	1	190
37736	24155s (+0.7s)	2944	2944	256	67	181	14	0	262
37737	24156s (+1.0s)	4276	4276	256	78	252	18	0	348
37738	24157s (+0.8s)	3396	3396	256	73	206	11	0	290
37739	24158s (+0.4s)	1424	1424	128	29	109	0	7	145
37740	24159s (+1.1s)	5216	5216	512	76	292	14	0	382
37741	24159s (+0.4s)	1456	1456	128	38	105	6	0	149
37742	24160s (+0.6s)	2220	2220	256	56	131	8	0	195
37743	24160s (+0.6s)	2404	2404	256	48	148	6	0	202
37744	24161s (+0.9s)	3632	3632	256	86	195	18	0	299
37745	24162s (+0.4s)	1392	1392	64	40	110	6	0	156
37746	24162s (+0.4s)	1460	1460	128	32	118	3	0	153
37747	24163s (+0.8s)	3544	3544	256	79	201	13	0	293
37748	24164s (+0.6s)	2112	2112	128	59	142	13	0	214
37749	24164s (+0.8s)	3228	3228	256	84	168	21	1	274
37750	24165s (+0.7s)	2848	2848	256	61	174	8	0	243
37751	24166s (+0.5s)	1764	1764	128	40	128	9	0	177
37752	24166s (+0.6s)	2872	2872	256	61	164	9	0	234
37753	24167s (+0.4s)	1468	1468	128	34	109	8	0	151
37754	24167s (+0.6s)	1896	1896	128	54	130	12	0	196
37755	24168s (+0.4s)	1528	1528	128	34	117	7	0	158
37756	24168s (+0.3s)	712	712	64	26	63	3	0	92
37757	24169s (+0.8s)	3396	3396	256	81	190	14	0	285
37758	24169s (+0.8s)	3272	3272	256	74	182	14	0	270
37759	24170s (+0.5s)	1876	1876	128	29	135	6	1	171
37760	24170s (+0.3s)	924	924	64	28	81	3	0	112
37761	24171s (+0.5s)	1524	1524	128	29	125	6	0	160
37762	24171s (+0.7s)	2800	2800	256	75	156	12	0	243
37763	24172s (+0.6s)	2564	2564	256	53	158	9	0	220
37764	24173s (+1.0s)	4228	4228	256	94	230	23	0	347
37765	24174s (+1.0s)	4328	4328	256	92	245	19	0	356
37766	24175s (+0.6s)	2656	2656	256	43	175	7	0	225
37767	24175s (+0.7s)	2920	2920	256	60	180	16	0	256
37768	24176s (+0.4s)	1344	1344	128	22	112	0	4	138
37769	24176s (+0.6s)	2432	2432	256	36	162	0	7	205
37770	24177s (+0.5s)	2256	2256	256	38	139	0	10	187
37771	24177s (+0.4s)	1332	1332	128	30	106	0	8	144
37772	24178s (+0.6s)	2576	2576	256	51	154	0	9	214
37773	24178s (+0.4s)	1472	1472	128	38	112	0	6	156
37774	24179s (+0.5s)	1796	1796	128	40	139	0	5	184
37775	24179s (+0.4s)	1020	1020	64	24	93	0	9	126
37776	24180s (+0.7s)	3080	3080	256	44	197	0	10	251
37777	24181s (+0.9s)	3552	3552	256	54	238	0	10	302
37778	24181s (+0.5s)	1788	1788	128	40	133	0	9	182
37779	24182s (+0.4s)	1192	1192	64	32	97	0	6	135
37780	24182s (+0.5s)	1712	1712	128	42	117	10	0	169
37781	24183s (+0.9s)	3956	3956	256	70	237	18	0	325
37782	24184s (+0.5s)	1784	1784	128	34	141	6	0	181
37783	24184s (+0.4s)	1300	1300	128	34	97	9	0	140
37784	24185s (+0.8s)	3644	3644	256	80	214	15	0	309
37785	24185s (+0.4s)	1460	1460	128	33	111	6	0	150
37786	24186s (+0.6s)	2376	2376	128	59	157	7	0	223
37787	24187s (+0.8s)	3232	3232	256	73	195	14	0	282
37788	24187s (+0.4s)	1236	1236	64	36	99	6	0	141
37789	24188s (+0.3s)	1080	1080	128	23	93	3	0	119
37790	24188s (+0.7s)	3208	3208	256	70	187	12	0	269
37791	24189s (+0.6s)	1932	1932	128	50	140	6	0	196
37792	24189s (+0.4s)	1416	1416	128	20	124	3	0	147
37793	24190s (+0.4s)	1340	1340	128	33	98	8	1	140
37794	24190s (+0.5s)	1944	1944	128	55	128	10	0	193
37795	24191s (+0.9s)	3944	3944	256	80	218	22	0	320
37796	24192s (+0.3s)	756	756	64	18	79	4	0	101
37797	24192s (+0.4s)	1500	1500	128	33	114	7	0	154
37798	24192s (+0.4s)	1464	1464	128	34	112	4	0	150
37799	24193s (+0.8s)	3560	3560	256	92	188	17	0	297
Episode	Time	Reward	Score	Highest	L	U	R	D	Steps
37800	24194s (+0.8s)	3560	3560	256	80	206	19	0	305
37801	24195s (+0.7s)	2768	2768	256	56	171	12	0	239
37802	24195s (+0.5s)	1864	1864	128	52	127	11	0	190
37803	24196s (+0.3s)	792	792	64	34	68	4	0	106
37804	24196s (+0.8s)	3192	3192	256	71	193	9	0	273
37805	24197s (+0.2s)	456	456	32	18	52	4	0	74
37806	24197s (+0.4s)	1284	1284	128	37	92	8	0	137
37807	24197s (+0.4s)	1376	1376	128	21	123	0	0	144
37808	24198s (+0.6s)	2772	2772	256	51	164	11	0	226
37809	24199s (+0.8s)	3432	3432	256	78	210	11	0	299
37810	24199s (+0.3s)	972	972	64	31	82	5	0	118
37811	24200s (+0.8s)	3344	3344	256	72	195	0	15	282
37812	24201s (+0.8s)	3356	3356	256	69	207	0	9	285
37813	24201s (+0.5s)	1716	1716	128	31	139	0	10	180
37814	24202s (+0.7s)	2460	2460	128	43	176	0	10	229
37815	24203s (+0.6s)	2472	2472	256	34	168	0	9	211
37816	24203s (+0.6s)	2424	2424	128	62	152	16	0	230
37817	24204s (+0.7s)	2848	2848	256	62	166	15	0	243
37818	24205s (+0.8s)	3372	3372	256	70	204	15	0	289
37819	24206s (+0.7s)	3312	3312	256	57	203	10	0	270
37820	24206s (+0.5s)	1748	1748	128	52	116	9	0	177
37821	24207s (+0.8s)	3376	3376	256	84	178	18	0	280
37822	24207s (+0.4s)	1328	1328	128	36	93	8	0	137
37823	24208s (+0.6s)	1992	1992	128	50	133	10	0	193
37824	24209s (+0.6s)	2644	2644	256	51	168	7	0	226
37825	24209s (+0.8s)	3312	3312	256	74	192	13	0	279
37826	24210s (+0.9s)	3784	3784	256	86	212	14	0	312
37827	24211s (+0.5s)	1576	1576	128	43	105	8	1	157
37828	24211s (+0.7s)	2456	2456	128	57	163	9	1	230
37829	24212s (+0.7s)	2636	2636	256	46	177	9	1	233
37830	24213s (+0.9s)	4016	4016	256	90	228	13	0	331
37831	24214s (+0.9s)	4064	4064	256	74	244	15	0	333
37832	24214s (+0.5s)	1612	1612	128	46	118	6	0	170
37833	24215s (+0.4s)	1556	1556	128	42	115	4	0	161
37834	24216s (+0.7s)	2500	2500	128	53	171	12	0	236
37835	24216s (+0.3s)	808	808	64	25	73	5	0	103
37836	24217s (+0.9s)	3840	3840	256	83	210	18	0	311
37837	24217s (+0.4s)	1472	1472	128	41	107	8	0	156
37838	24218s (+0.6s)	2000	2000	128	43	150	9	0	202
37839	24218s (+0.5s)	1768	1768	128	44	128	8	1	181
37840	24219s (+0.7s)	2584	2584	128	71	157	13	0	241
37841	24220s (+0.8s)	3400	3400	256	76	202	14	0	292
37842	24220s (+0.6s)	1968	1968	128	53	146	6	0	205
37843	24221s (+0.6s)	1936	1936	128	47	141	10	1	199
37844	24221s (+0.4s)	1512	1512	128	22	125	6	0	153
37845	24222s (+0.8s)	3332	3332	256	85	181	17	1	284
37846	24223s (+0.5s)	2024	2024	128	48	132	6	1	187
37847	24223s (+0.3s)	1048	1048	128	28	75	9	0	112
37848	24224s (+0.6s)	2660	2660	256	51	166	8	0	225
37849	24224s (+0.5s)	1764	1764	128	39	131	6	1	177
37850	24225s (+0.6s)	2176	2176	128	52	141	11	0	204
37851	24226s (+1.3s)	6256	6256	512	142	275	27	0	444
37852	24227s (+1.1s)	5236	5236	512	110	255	17	0	382
37853	24228s (+0.4s)	1380	1380	128	28	112	5	0	145
37854	24228s (+0.4s)	1228	1228	128	27	100	7	0	134
37855	24228s (+0.3s)	728	728	64	19	75	2	0	96
37856	24229s (+0.7s)	3152	3152	256	57	189	17	0	263
37857	24230s (+0.6s)	1936	1936	128	47	144	11	0	202
37858	24230s (+0.8s)	3440	3440	256	68	215	8	0	291
37859	24231s (+0.6s)	1968	1968	128	68	125	12	0	205
37860	24232s (+0.8s)	3544	3544	256	67	205	12	1	285
37861	24232s (+0.3s)	1128	1128	128	35	82	3	0	120
37862	24233s (+0.6s)	2536	2536	256	39	170	0	6	215
37863	24233s (+0.6s)	2752	2752	256	46	175	0	12	233
37864	24234s (+0.5s)	1808	1808	128	54	124	0	9	187
37865	24234s (+0.3s)	996	996	64	26	86	0	6	118
37866	24235s (+0.8s)	3224	3224	256	65	194	10	0	269
37867	24235s (+0.3s)	780	780	64	24	71	7	0	102
37868	24236s (+0.7s)	2744	2744	256	50	177	6	0	233
37869	24237s (+0.6s)	1968	1968	128	54	145	6	0	205
37870	24237s (+0.4s)	1044	1044	64	28	90	6	0	124
37871	24237s (+0.5s)	1588	1588	128	35	125	5	0	165
37872	24238s (+0.5s)	1608	1608	128	41	121	2	0	164
37873	24239s (+0.9s)	3844	3844	256	67	226	14	0	307
37874	24240s (+0.7s)	2920	2920	256	68	173	11	0	252
37875	24240s (+0.7s)	3156	3156	256	52	196	10	1	259
37876	24241s (+0.8s)	3448	3448	256	84	190	12	0	286
37877	24242s (+0.5s)	1824	1824	128	49	131	10	0	190
37878	24242s (+0.5s)	1608	1608	128	38	123	8	0	169
37879	24243s (+0.9s)	4540	4540	512	78	215	11	0	304
37880	24244s (+0.7s)	2796	2796	256	64	166	12	1	243
37881	24244s (+0.6s)	2736	2736	256	49	160	10	0	219
37882	24245s (+0.8s)	3244	3244	256	59	201	14	0	274
37883	24246s (+0.5s)	1568	1568	128	50	111	9	0	170
37884	24246s (+0.4s)	1324	1324	128	19	116	2	0	137
37885	24247s (+0.6s)	2524	2524	256	44	170	9	0	223
37886	24247s (+0.5s)	1820	1820	128	34	150	6	0	190
37887	24248s (+0.7s)	3364	3364	256	65	197	14	1	277
37888	24248s (+0.3s)	644	644	64	20	65	4	1	90
37889	24249s (+1.0s)	4152	4152	256	91	230	19	0	340
37890	24250s (+0.7s)	2840	2840	256	53	186	13	1	253
37891	24251s (+0.8s)	3536	3536	256	68	210	19	1	298
37892	24252s (+1.0s)	4488	4488	256	96	254	18	0	368
37893	24253s (+0.9s)	3624	3624	256	83	207	18	0	308
37894	24253s (+0.6s)	2608	2608	256	55	160	10	2	227
37895	24254s (+0.5s)	1740	1740	128	45	124	5	0	174
37896	24254s (+0.2s)	328	328	32	12	47	1	0	60
37897	24254s (+0.5s)	1628	1628	128	42	125	7	0	174
37898	24255s (+1.0s)	5200	5200	512	80	267	15	1	363
37899	24256s (+0.5s)	1700	1700	128	47	118	11	0	176
Episode	Time	Reward	Score	Highest	L	U	R	D	Steps
37900	24256s (+0.5s)	1700	1700	128	27	132	0	7	166
37901	24257s (+0.8s)	3528	3528	256	58	220	0	18	296
37902	24258s (+0.4s)	1152	1152	128	31	85	1	8	125
37903	24258s (+0.5s)	1556	1556	128	42	111	8	0	161
37904	24259s (+0.6s)	2560	2560	256	47	169	7	2	225
37905	24260s (+0.8s)	3584	3584	256	71	214	13	0	298
37906	24261s (+1.2s)	5856	5856	512	105	294	19	0	418
37907	24262s (+0.8s)	3208	3208	256	72	183	14	1	270
37908	24262s (+0.6s)	2348	2348	256	44	144	8	0	196
37909	24263s (+0.6s)	2600	2600	256	69	147	9	0	225
37910	24264s (+1.0s)	4256	4256	256	92	245	17	0	354
37911	24264s (+0.6s)	1916	1916	128	47	142	8	0	197
37912	24265s (+0.5s)	1908	1908	128	48	140	8	0	196
37913	24265s (+0.4s)	1128	1128	64	27	102	5	0	134
37914	24266s (+1.0s)	4508	4508	256	106	239	24	0	369
37915	24267s (+0.4s)	1256	1256	128	33	92	0	7	132
37916	24268s (+1.0s)	4844	4844	512	72	247	0	19	338
37917	24268s (+0.4s)	1364	1364	128	27	110	0	4	141
37918	24269s (+0.9s)	3676	3676	256	59	227	0	16	302
37919	24270s (+0.8s)	3308	3308	256	49	213	0	17	279
37920	24270s (+0.5s)	1868	1868	128	39	144	0	7	190
37921	24271s (+0.6s)	2408	2408	256	44	146	0	14	204
37922	24272s (+0.7s)	2760	2760	256	60	162	0	12	234
37923	24272s (+0.8s)	3316	3316	256	51	217	0	9	277
37924	24273s (+0.3s)	988	988	64	27	84	0	6	117
37925	24273s (+0.6s)	2012	2012	128	43	156	0	7	206
37926	24274s (+0.7s)	2904	2904	256	66	172	14	0	252
37927	24275s (+0.5s)	1872	1872	128	42	141	7	1	191
37928	24276s (+0.9s)	3868	3868	256	82	221	15	0	318
37929	24276s (+0.6s)	2420	2420	256	39	164	5	0	208
37930	24277s (+0.5s)	1672	1672	128	38	129	4	0	171
37931	24277s (+0.5s)	1800	1800	128	46	129	10	0	185
37932	24278s (+0.4s)	1480	1480	128	33	111	9	1	154
37933	24278s (+0.4s)	1052	1052	64	40	78	9	0	127
37934	24279s (+0.9s)	3760	3760	256	81	220	14	0	315
37935	24279s (+0.3s)	996	996	64	39	70	8	1	118
37936	24280s (+0.6s)	2432	2432	256	51	143	12	0	206
37937	24280s (+0.5s)	1900	1900	128	51	135	7	0	193
37938	24281s (+0.5s)	1892	1892	128	50	131	10	0	191
37939	24281s (+0.2s)	636	636	64	15	68	2	0	85
37940	24282s (+0.5s)	1864	1864	128	44	136	10	0	190
37941	24282s (+0.7s)	2908	2908	256	59	184	10	0	253
37942	24283s (+0.7s)	3228	3228	256	42	213	0	16	271
37943	24284s (+0.3s)	780	780	64	15	82	0	4	101
37944	24284s (+0.6s)	2688	2688	256	48	173	0	5	226
37945	24285s (+0.7s)	2688	2688	256	44	175	0	12	231
37946	24285s (+0.6s)	2704	2704	256	43	174	0	12	229
37947	24286s (+0.7s)	2804	2804	256	51	187	0	6	244
37948	24287s (+0.5s)	1868	1868	128	40	138	0	9	187
37949	24287s (+0.3s)	764	764	64	22	74	0	5	101
37950	24288s (+0.8s)	3488	3488	256	70	209	13	0	292
37951	24288s (+0.4s)	1504	1504	128	42	109	9	0	160
37952	24289s (+0.4s)	1212	1212	128	31	88	7	0	126
37953	24289s (+0.4s)	1056	1056	64	39	82	7	0	128
37954	24290s (+0.8s)	3224	3224	256	67	190	12	0	269
37955	24290s (+0.5s)	1648	1648	128	25	135	6	0	166
37956	24291s (+0.4s)	1004	1004	64	30	94	6	0	130
37957	24291s (+0.4s)	1492	1492	128	35	118	5	0	158
37958	24292s (+0.7s)	3192	3192	256	53	203	10	0	266
37959	24292s (+0.4s)	1356	1356	128	34	112	4	0	150
37960	24293s (+1.0s)	4408	4408	256	107	228	25	0	360
37961	24294s (+0.7s)	2808	2808	256	55	182	5	0	242
37962	24295s (+0.7s)	3184	3184	256	64	194	7	0	265
37963	24296s (+0.7s)	3192	3192	256	52	201	9	0	262
37964	24296s (+0.9s)	3632	3632	256	95	195	17	0	307
37965	24297s (+0.4s)	1276	1276	128	26	101	5	0	132
37966	24297s (+0.3s)	896	896	64	29	80	6	0	115
37967	24298s (+0.5s)	1744	1744	128	54	113	8	0	175
37968	24298s (+0.8s)	3224	3224	256	56	199	14	0	269
37969	24300s (+1.3s)	6144	6144	512	122	293	24	0	439
37970	24300s (+0.3s)	872	872	64	26	83	5	0	114
37971	24301s (+0.7s)	2732	2732	256	62	162	6	0	230
37972	24301s (+0.3s)	908	908	64	32	71	5	0	108
37973	24301s (+0.4s)	1640	1640	128	38	116	8	0	162
37974	24302s (+0.5s)	1796	1796	128	39	130	8	0	177
37975	24302s (+0.5s)	1656	1656	128	36	125	5	0	166
37976	24303s (+0.6s)	2668	2668	256	60	156	10	1	227
37977	24304s (+0.8s)	3432	3432	256	76	198	14	1	289
37978	24305s (+0.6s)	2324	2324	128	53	150	11	0	214
37979	24305s (+0.7s)	2748	2748	256	49	177	10	0	236
37980	24306s (+0.7s)	2820	2820	256	61	164	16	0	241
37981	24306s (+0.4s)	1324	1324	128	32	94	7	0	133
37982	24307s (+0.4s)	1416	1416	128	37	109	7	0	153
37983	24308s (+1.0s)	4228	4228	256	111	221	19	0	351
37984	24308s (+0.4s)	1212	1212	128	28	98	0	6	132
37985	24309s (+0.7s)	2452	2452	128	57	155	13	0	225
37986	24309s (+0.4s)	1220	1220	128	32	99	2	0	133
37987	24310s (+0.5s)	1844	1844	128	48	130	7	0	185
37988	24311s (+0.9s)	4112	4112	256	95	220	17	0	332
37989	24311s (+0.8s)	3428	3428	256	75	197	14	2	288
37990	24312s (+0.7s)	3040	3040	256	47	189	10	0	246
37991	24313s (+0.6s)	2264	2264	128	68	140	8	0	216
37992	24313s (+0.3s)	856	856	64	20	87	4	0	111
37993	24314s (+0.7s)	3104	3104	256	66	187	7	1	261
37994	24315s (+0.8s)	3384	3384	256	74	192	15	0	281
37995	24315s (+0.4s)	1212	1212	128	32	96	0	4	132
37996	24315s (+0.5s)	2020	2020	128	60	129	12	0	201
37997	24316s (+0.3s)	600	600	32	20	67	2	1	90
37998	24316s (+0.6s)	2484	2484	256	51	151	10	1	213
37999	24317s (+1.1s)	5200	5200	256	117	255	27	0	399
Episode	Time	Reward	Score	Highest	L	U	R	D	Steps
38000	24318s (+0.8s)	3508	3508	256	79	204	14	0	297
38001	24319s (+0.4s)	1388	1388	128	40	99	8	0	147
38002	24319s (+0.4s)	1248	1248	128	29	93	8	0	130
38003	24320s (+0.5s)	1588	1588	128	40	113	5	1	159
38004	24320s (+0.7s)	2868	2868	256	73	159	16	0	248
38005	24321s (+0.6s)	2136	2136	128	48	149	7	1	205
38006	24321s (+0.5s)	1616	1616	128	46	114	10	1	171
38007	24322s (+0.9s)	3588	3588	256	73	220	10	0	303
38008	24323s (+0.4s)	1216	1216	64	34	96	5	1	136
38009	24323s (+0.4s)	1376	1376	128	38	102	4	0	144
38010	24324s (+0.5s)	2112	2112	256	60	112	8	0	180
38011	24324s (+0.3s)	892	892	64	30	80	8	0	118
38012	24325s (+0.8s)	3564	3564	256	79	202	13	0	294
38013	24326s (+0.7s)	2988	2988	256	75	172	10	1	258
38014	24326s (+0.7s)	2808	2808	256	57	170	11	0	238
38015	24327s (+0.5s)	1632	1632	128	47	118	10	0	175
38016	24327s (+0.6s)	2604	2604	256	54	164	8	0	226
38017	24329s (+1.1s)	4688	4688	256	118	256	23	0	397
38018	24329s (+0.4s)	1216	1216	128	22	102	2	0	126
38019	24329s (+0.5s)	2072	2072	128	48	133	0	10	191
38020	24330s (+0.4s)	1388	1388	128	33	107	0	7	147
38021	24330s (+0.6s)	2580	2580	256	47	154	0	19	220
38022	24331s (+0.9s)	3800	3800	256	62	246	0	13	321
38023	24332s (+1.0s)	4072	4072	256	74	253	13	0	340
38024	24333s (+0.6s)	2472	2472	256	40	163	6	1	210
38025	24334s (+0.8s)	3568	3568	256	77	205	17	0	299
38026	24334s (+0.5s)	1844	1844	128	56	124	8	0	188
38027	24335s (+0.3s)	788	788	64	20	81	4	0	105
38028	24335s (+0.6s)	2056	2056	128	42	157	10	0	209
38029	24336s (+0.8s)	3480	3480	256	72	203	15	0	290
38030	24337s (+0.6s)	1916	1916	128	51	137	9	0	197
38031	24337s (+0.8s)	3260	3260	256	63	193	14	0	270
38032	24338s (+0.4s)	1020	1020	64	35	89	10	0	134
38033	24339s (+0.7s)	2500	2500	128	65	158	13	0	236
38034	24339s (+0.4s)	1376	1376	128	35	105	8	0	148
38035	24339s (+0.4s)	1508	1508	128	31	118	0	6	155
38036	24340s (+0.7s)	2788	2788	256	47	186	0	7	240
38037	24341s (+0.5s)	1644	1644	128	30	134	0	4	168
38038	24341s (+0.7s)	3036	3036	256	41	212	0	8	261
38039	24342s (+0.8s)	3400	3400	256	75	193	0	14	282
38040	24343s (+0.9s)	3928	3928	256	86	214	21	0	321
38041	24343s (+0.3s)	792	792	64	23	80	2	0	105
38042	24344s (+0.6s)	2368	2368	256	34	163	4	0	201
38043	24345s (+0.6s)	2152	2152	128	56	145	12	0	213
38044	24346s (+0.9s)	4032	4032	256	80	237	14	0	331
38045	24346s (+0.5s)	2184	2184	256	37	141	8	0	186
38046	24347s (+0.7s)	2936	2936	256	64	169	13	0	246
38047	24348s (+0.9s)	3580	3580	256	76	208	18	0	302
38048	24348s (+0.6s)	2460	2460	256	49	154	8	0	211
38049	24349s (+0.5s)	1724	1724	128	46	115	10	1	172
38050	24349s (+0.6s)	2072	2072	128	62	139	6	1	208
38051	24350s (+0.4s)	1404	1404	128	30	109	7	0	146
38052	24351s (+0.8s)	3560	3560	256	73	203	21	0	297
38053	24351s (+0.3s)	940	940	64	24	81	6	0	111
38054	24352s (+0.9s)	3760	3760	256	85	211	19	0	315
38055	24352s (+0.4s)	1552	1552	128	41	110	9	0	160
38056	24353s (+0.6s)	2952	2952	256	48	177	11	0	236
38057	24353s (+0.5s)	1816	1816	128	48	123	11	0	182
38058	24354s (+0.5s)	1660	1660	128	39	120	9	0	168
38059	24355s (+1.0s)	4188	4188	256	90	239	12	1	342
38060	24355s (+0.5s)	1792	1792	128	48	126	12	0	186
38061	24356s (+0.4s)	1272	1272	128	35	94	5	0	134
38062	24357s (+0.8s)	3276	3276	256	68	195	15	0	278
38063	24357s (+0.4s)	1444	1444	128	38	104	8	0	150
38064	24358s (+0.6s)	2432	2432	256	50	144	11	0	205
38065	24358s (+0.5s)	1620	1620	128	41	107	14	0	162
38066	24358s (+0.4s)	1116	1116	128	34	82	7	0	123
38067	24359s (+0.4s)	1284	1284	128	27	104	6	0	137
38068	24359s (+0.4s)	1204	1204	128	36	91	2	0	129
38069	24360s (+0.4s)	1224	1224	128	30	97	7	1	135
38070	24360s (+0.4s)	1260	1260	128	32	99	4	0	135
38071	24360s (+0.5s)	1596	1596	128	48	111	7	0	166
38072	24361s (+0.2s)	672	672	64	21	66	3	0	90
38073	24361s (+0.6s)	2476	2476	256	43	153	0	15	211
38074	24362s (+0.3s)	1148	1148	128	27	94	0	4	125
38075	24362s (+0.4s)	1308	1308	128	27	108	0	8	143
38076	24362s (+0.4s)	1292	1292	128	31	102	0	6	139
38077	24363s (+0.5s)	1792	1792	128	43	132	7	0	182
38078	24363s (+0.4s)	1492	1492	128	36	114	7	0	157
38079	24364s (+0.7s)	2908	2908	256	63	177	13	0	253
38080	24365s (+0.6s)	2380	2380	256	43	149	5	1	198
38081	24365s (+0.3s)	1064	1064	128	20	88	4	1	113
38082	24365s (+0.4s)	1284	1284	128	30	104	4	0	138
38083	24366s (+0.3s)	964	964	64	35	79	7	0	121
38084	24367s (+0.8s)	3220	3220	256	73	182	16	1	272
38085	24367s (+0.4s)	1468	1468	128	39	110	6	0	155
38086	24368s (+0.6s)	2416	2416	256	53	143	12	0	208
38087	24368s (+0.6s)	2660	2660	256	60	146	16	2	224
38088	24369s (+0.7s)	3052	3052	256	63	175	10	0	248
38089	24370s (+0.9s)	3740	3740	256	70	214	16	0	300
38090	24371s (+0.9s)	3736	3736	256	77	216	16	0	309
38091	24371s (+0.7s)	2828	2828	256	70	158	15	0	243
38092	24372s (+0.4s)	1528	1528	128	43	104	9	0	156
38093	24373s (+1.0s)	4192	4192	256	89	229	20	0	338
38094	24373s (+0.4s)	1456	1456	128	42	98	9	0	149
38095	24374s (+0.8s)	3376	3376	256	69	197	13	0	279
38096	24375s (+0.8s)	3616	3616	256	56	222	0	13	291
38097	24375s (+0.2s)	584	584	64	13	63	0	4	80
38098	24376s (+0.6s)	2616	2616	256	47	169	0	12	228
38099	24377s (+1.4s)	6908	6908	512	109	357	18	0	484
Episode	Time	Reward	Score	Highest	L	U	R	D	Steps
38100	24378s (+0.6s)	1948	1948	128	54	139	7	0	200
38101	24378s (+0.6s)	2612	2612	256	53	158	7	1	219
38102	24379s (+0.6s)	2428	2428	256	41	162	7	0	210
38103	24380s (+0.8s)	3244	3244	256	71	184	16	2	273
38104	24380s (+0.5s)	1796	1796	128	52	124	8	0	184
38105	24381s (+0.6s)	2292	2292	128	52	150	10	0	212
38106	24381s (+0.5s)	1824	1824	128	49	134	7	0	190
38107	24382s (+0.4s)	1332	1332	128	38	94	6	0	138
38108	24383s (+0.8s)	3244	3244	256	70	191	13	0	274
38109	24383s (+0.3s)	904	904	64	24	88	5	0	117
38110	24384s (+0.6s)	2396	2396	256	56	139	11	1	207
38111	24385s (+1.1s)	5456	5456	512	103	265	16	0	384
38112	24385s (+0.7s)	3044	3044	256	52	184	10	0	246
38113	24386s (+0.3s)	972	972	64	24	88	7	0	119
38114	24386s (+0.5s)	1748	1748	128	44	127	7	0	178
38115	24387s (+0.8s)	3216	3216	256	69	188	14	0	271
38116	24388s (+0.7s)	2784	2784	256	53	174	12	0	239
38117	24388s (+0.6s)	1904	1904	128	49	135	10	0	194
38118	24389s (+0.5s)	1760	1760	128	41	129	5	1	176
38119	24389s (+0.6s)	1964	1964	128	47	137	0	9	193
38120	24390s (+0.7s)	2948	2948	256	58	175	0	8	241
38121	24391s (+0.5s)	1640	1640	128	42	126	0	4	172
38122	24391s (+0.5s)	1552	1552	128	39	116	0	7	162
38123	24392s (+0.9s)	3680	3680	256	70	220	0	13	303
38124	24393s (+0.8s)	3252	3252	256	52	212	0	12	276
38125	24393s (+0.7s)	3032	3032	256	43	203	0	6	252
38126	24394s (+0.9s)	3940	3940	256	76	236	0	12	324
38127	24395s (+0.7s)	3060	3060	256	43	198	0	14	255
38128	24396s (+0.6s)	2524	2524	256	35	173	0	4	212
38129	24396s (+0.4s)	1480	1480	128	35	109	0	9	153
38130	24397s (+0.5s)	1532	1532	128	33	125	0	4	162
38131	24397s (+0.5s)	1576	1576	128	30	123	0	9	162
38132	24397s (+0.3s)	912	912	64	31	82	5	1	119
38133	24398s (+0.5s)	1804	1804	128	34	145	0	7	186
38134	24399s (+0.7s)	2792	2792	256	63	165	14	0	242
38135	24399s (+0.5s)	1724	1724	128	34	134	4	0	172
38136	24400s (+0.6s)	2584	2584	256	56	153	11	1	221
38137	24401s (+0.9s)	3636	3636	256	80	204	16	1	301
38138	24401s (+0.3s)	896	896	64	21	90	3	0	114
38139	24402s (+0.6s)	2528	2528	256	60	142	10	0	212
38140	24403s (+1.0s)	4356	4356	256	107	234	19	0	360
38141	24404s (+1.3s)	6612	6612	512	118	306	24	1	449
38142	24405s (+1.0s)	4488	4488	256	105	236	23	0	364
38143	24406s (+0.7s)	2876	2876	256	68	173	9	0	250
38144	24406s (+0.4s)	1348	1348	128	35	108	5	0	148
38145	24407s (+0.6s)	2248	2248	128	67	145	17	0	229
38146	24407s (+0.3s)	708	708	64	12	79	3	0	94
38147	24407s (+0.5s)	1600	1600	128	35	120	9	1	165
38148	24408s (+0.3s)	1032	1032	128	18	92	0	3	113
38149	24408s (+0.5s)	1800	1800	128	41	132	0	11	184
38150	24409s (+0.8s)	3548	3548	256	59	217	0	11	287
38151	24410s (+1.2s)	5808	5808	512	114	280	29	0	423
38152	24411s (+0.4s)	1152	1152	64	37	89	9	0	135
38153	24412s (+0.8s)	3364	3364	256	75	186	15	0	276
38154	24412s (+0.4s)	1256	1256	128	32	98	5	0	135
38155	24412s (+0.3s)	804	804	64	30	76	2	1	109
38156	24413s (+0.7s)	2768	2768	256	46	177	0	12	235
38157	24414s (+0.7s)	2776	2776	256	36	197	6	0	239
38158	24415s (+0.9s)	3896	3896	256	77	222	18	0	317
38159	24416s (+1.1s)	5452	5452	512	107	263	17	0	387
38160	24416s (+0.6s)	2504	2504	256	47	162	8	0	217
38161	24417s (+0.5s)	1944	1944	128	58	128	8	0	194
38162	24417s (+0.6s)	1980	1980	128	43	146	10	0	199
38163	24418s (+0.8s)	3372	3372	256	62	207	9	0	278
38164	24418s (+0.3s)	1040	1040	128	26	85	4	0	115
38165	24419s (+0.6s)	2032	2032	128	61	124	10	0	195
38166	24419s (+0.4s)	1112	1112	64	39	90	8	0	137
38167	24420s (+0.3s)	1032	1032	128	20	89	3	0	112
38168	24420s (+0.6s)	2572	2572	256	46	169	4	0	219
38169	24421s (+0.6s)	2656	2656	256	51	164	9	0	224
38170	24422s (+1.0s)	4164	4164	256	85	235	16	1	337
38171	24423s (+0.9s)	3696	3696	256	77	211	18	0	306
38172	24424s (+1.2s)	5776	5776	512	93	293	18	2	406
38173	24425s (+0.5s)	1664	1664	128	33	132	3	0	168
38174	24425s (+0.9s)	3544	3544	256	61	228	15	0	304
38175	24426s (+0.6s)	1924	1924	128	52	139	8	0	199
38176	24427s (+0.9s)	3796	3796	256	83	221	11	0	315
38177	24427s (+0.5s)	1788	1788	128	41	132	9	0	182
38178	24428s (+0.5s)	1832	1832	128	47	129	10	0	186
38179	24429s (+0.6s)	2604	2604	256	56	158	12	0	226
38180	24429s (+0.3s)	640	640	32	19	70	3	0	92
38181	24429s (+0.5s)	1804	1804	128	41	131	11	0	183
38182	24430s (+0.4s)	1376	1376	128	37	103	5	0	145
38183	24430s (+0.7s)	2692	2692	256	44	178	11	0	233
38184	24431s (+0.2s)	488	488	64	18	51	2	0	71
38185	24431s (+0.5s)	1916	1916	128	54	137	6	0	197
38186	24432s (+0.8s)	3448	3448	256	88	177	17	0	282
38187	24433s (+1.2s)	5876	5876	512	111	293	26	0	430
38188	24434s (+0.5s)	1804	1804	128	41	138	6	1	186
38189	24435s (+0.9s)	4124	4124	256	69	248	0	17	334
38190	24435s (+0.6s)	2512	2512	256	41	174	0	5	220
38191	24436s (+0.4s)	1524	1524	128	33	113	0	9	155
38192	24437s (+1.2s)	6368	6368	512	109	321	0	17	447
38193	24438s (+0.6s)	2396	2396	256	42	146	0	12	200
38194	24439s (+1.3s)	6220	6220	512	82	335	0	25	442
38195	24440s (+0.7s)	3028	3028	256	53	191	0	9	253
38196	24440s (+0.6s)	2828	2828	256	38	185	0	6	229
38197	24441s (+0.6s)	2604	2604	256	43	168	0	6	217
38198	24441s (+0.5s)	1856	1856	128	44	139	0	5	188
38199	24442s (+0.7s)	3092	3092	256	47	205	0	11	263
Episode	Time	Reward	Score	Highest	L	U	R	D	Steps
38200	24443s (+0.5s)	1732	1732	128	34	131	1	7	173
38201	24443s (+0.6s)	1900	1900	128	36	147	0	10	193
38202	24444s (+0.7s)	2792	2792	256	50	184	0	7	241
38203	24445s (+0.6s)	2244	2244	128	44	161	0	11	216
38204	24445s (+0.4s)	1300	1300	128	20	119	0	2	141
38205	24446s (+0.8s)	3360	3360	256	67	200	0	19	286
38206	24446s (+0.4s)	1224	1224	128	43	85	6	0	134
38207	24447s (+0.4s)	1248	1248	128	23	105	4	0	132
38208	24447s (+0.8s)	3352	3352	256	77	194	13	0	284
38209	24448s (+0.5s)	1508	1508	128	34	117	9	0	160
38210	24449s (+0.8s)	3464	3464	256	76	198	15	0	289
38211	24449s (+0.5s)	1568	1568	128	42	116	6	0	164
38212	24450s (+0.9s)	3872	3872	256	100	209	19	0	328
38213	24451s (+1.0s)	4284	4284	256	118	214	21	0	353
38214	24452s (+0.7s)	2620	2620	256	48	172	11	0	231
38215	24453s (+0.8s)	3628	3628	256	95	197	17	0	309
38216	24454s (+1.2s)	6264	6264	512	115	296	15	0	426
38217	24454s (+0.3s)	740	740	64	14	78	6	0	98
38218	24455s (+1.1s)	5648	5648	512	103	272	20	0	395
38219	24456s (+0.3s)	1144	1144	128	24	99	2	0	125
38220	24456s (+0.7s)	2960	2960	256	61	175	10	0	246
38221	24457s (+0.3s)	1008	1008	128	16	87	3	0	106
38222	24457s (+0.7s)	3168	3168	256	59	194	7	0	260
38223	24458s (+0.4s)	1472	1472	128	36	109	8	0	153
38224	24458s (+0.3s)	768	768	64	10	88	1	0	99
38225	24459s (+0.9s)	3796	3796	256	76	216	13	0	305
38226	24460s (+1.0s)	4096	4096	256	87	226	20	0	333
38227	24461s (+0.8s)	3412	3412	256	73	202	8	1	284
38228	24462s (+0.9s)	4076	4076	256	71	242	17	0	330
38229	24462s (+0.4s)	1340	1340	128	36	97	6	1	140
38230	24463s (+0.8s)	3360	3360	256	84	174	18	0	276
38231	24464s (+0.7s)	2860	2860	256	69	173	11	0	253
38232	24464s (+0.4s)	1296	1296	128	31	101	7	1	140
38233	24465s (+0.6s)	2748	2748	256	57	162	11	0	230
38234	24466s (+0.9s)	4060	4060	256	76	245	17	0	338
38235	24467s (+0.8s)	3484	3484	256	84	189	13	0	286
38236	24467s (+0.6s)	2488	2488	256	59	144	11	0	214
38237	24468s (+0.5s)	1500	1500	128	38	114	7	0	159
38238	24468s (+0.4s)	1568	1568	128	39	116	5	0	160
38239	24469s (+0.6s)	2532	2532	256	31	186	3	0	220
38240	24469s (+0.5s)	1852	1852	128	34	129	0	10	173
38241	24470s (+0.9s)	3560	3560	256	60	229	0	15	304
38242	24471s (+0.6s)	2348	2348	256	34	157	0	6	197
38243	24471s (+0.7s)	2756	2756	256	52	175	0	10	237
38244	24472s (+0.5s)	1604	1604	128	36	122	0	11	169
38245	24472s (+0.4s)	1064	1064	64	31	91	0	8	130
38246	24473s (+0.9s)	3532	3532	256	71	218	0	13	302
38247	24473s (+0.3s)	864	864	64	17	90	0	5	112
38248	24474s (+0.7s)	2812	2812	256	60	162	10	0	232
38249	24475s (+0.5s)	1904	1904	128	46	139	9	0	194
38250	24475s (+0.4s)	1292	1292	128	38	96	8	0	142
38251	24476s (+0.7s)	2996	2996	256	58	173	15	0	246
38252	24476s (+0.4s)	1380	1380	128	36	105	5	0	146
38253	24477s (+0.9s)	4144	4144	256	94	234	14	0	342
38254	24478s (+0.7s)	2968	2968	256	56	187	10	0	253
38255	24478s (+0.7s)	3032	3032	256	64	179	14	0	257
38256	24479s (+0.7s)	3020	3020	256	65	170	14	1	250
38257	24480s (+0.4s)	1452	1452	128	31	117	4	0	152
38258	24480s (+0.5s)	1676	1676	128	46	117	8	0	171
38259	24481s (+0.7s)	2752	2752	256	61	159	15	0	235
38260	24481s (+0.2s)	612	612	64	19	64	3	0	86
38261	24482s (+0.8s)	3572	3572	256	75	210	15	0	300
38262	24483s (+1.0s)	3984	3984	256	82	236	17	0	335
38263	24483s (+0.5s)	2336	2336	256	41	148	7	0	196
38264	24484s (+0.8s)	3576	3576	256	73	212	17	0	302
38265	24485s (+0.9s)	3800	3800	256	87	208	21	0	316
38266	24486s (+0.5s)	1752	1752	128	37	131	11	0	179
38267	24486s (+0.5s)	1864	1864	128	56	127	7	0	190
38268	24487s (+0.4s)	1388	1388	128	34	101	6	0	141
38269	24487s (+0.5s)	1656	1656	128	46	111	9	0	166
38270	24488s (+0.7s)	3152	3152	256	65	180	12	0	257
38271	24489s (+0.8s)	3560	3560	256	78	209	17	0	304
38272	24489s (+0.6s)	2092	2092	128	63	123	13	0	199
38273	24490s (+0.8s)	3548	3548	256	80	211	10	0	301
38274	24490s (+0.3s)	816	816	64	28	76	6	1	111
38275	24491s (+0.5s)	1788	1788	128	38	136	8	0	182
38276	24491s (+0.4s)	1468	1468	128	33	113	6	0	152
38277	24492s (+0.3s)	1028	1028	128	27	73	7	0	107
38278	24492s (+0.5s)	1796	1796	128	36	143	5	0	184
38279	24493s (+0.7s)	3052	3052	256	52	202	4	0	258
38280	24494s (+0.7s)	2896	2896	256	67	170	14	0	251
38281	24494s (+0.4s)	1360	1360	128	29	105	0	8	142
38282	24495s (+0.5s)	1588	1588	128	28	127	0	10	165
38283	24495s (+0.7s)	2868	2868	128	75	175	18	0	268
38284	24496s (+0.9s)	4184	4184	256	93	234	14	0	341
38285	24497s (+1.0s)	4464	4464	256	107	246	16	0	369
38286	24498s (+0.4s)	1436	1436	128	24	120	5	0	149
38287	24499s (+1.0s)	4136	4136	256	94	224	17	1	336
38288	24499s (+0.7s)	2784	2784	256	57	169	13	0	239
38289	24500s (+0.5s)	1644	1644	128	46	116	8	1	171
38290	24501s (+1.0s)	4220	4220	256	90	238	21	0	349
38291	24502s (+0.5s)	1988	1988	128	38	143	8	2	191
38292	24502s (+0.4s)	1104	1104	64	26	94	5	0	125
38293	24503s (+0.7s)	2848	2848	256	64	176	10	0	250
38294	24503s (+0.5s)	2084	2084	128	57	134	12	0	203
38295	24504s (+1.0s)	4488	4488	256	116	230	22	0	368
38296	24505s (+0.8s)	3264	3264	256	60	200	11	1	272
38297	24506s (+0.7s)	2892	2892	256	60	164	14	0	238
38298	24506s (+0.6s)	2512	2512	256	43	163	8	0	214
38299	24507s (+0.6s)	1920	1920	128	56	134	7	1	198
Episode	Time	Reward	Score	Highest	L	U	R	D	Steps
38300	24507s (+0.6s)	1924	1924	128	57	132	10	0	199
38301	24508s (+0.7s)	2752	2752	256	53	176	8	0	237
38302	24509s (+0.6s)	2360	2360	256	51	145	7	0	203
38303	24509s (+0.6s)	2696	2696	256	38	161	10	0	209
38304	24510s (+0.5s)	1564	1564	128	49	114	6	0	169
38305	24511s (+0.8s)	3492	3492	256	85	193	12	0	290
38306	24511s (+0.7s)	2476	2476	128	60	163	11	0	234
38307	24512s (+0.7s)	2872	2872	256	61	163	10	1	235
38308	24512s (+0.3s)	1140	1140	128	33	83	7	0	123
38309	24513s (+0.4s)	1464	1464	128	40	109	5	0	154
38310	24513s (+0.4s)	1424	1424	128	37	99	9	0	145
38311	24514s (+0.7s)	2904	2904	256	67	178	7	0	252
38312	24515s (+0.7s)	2976	2976	256	72	165	15	0	252
38313	24516s (+0.8s)	3568	3568	256	81	196	18	0	295
38314	24516s (+0.3s)	1132	1132	128	35	81	4	0	120
38315	24517s (+0.8s)	3480	3480	256	87	198	11	0	296
38316	24517s (+0.7s)	2920	2920	256	55	175	13	0	243
38317	24518s (+0.7s)	2800	2800	256	67	162	13	0	242
38318	24519s (+0.7s)	2840	2840	256	46	174	0	11	231
38319	24519s (+0.3s)	956	956	64	27	85	0	4	116
38320	24520s (+0.8s)	3436	3436	256	88	185	0	13	286
38321	24521s (+0.7s)	2788	2788	256	55	175	0	10	240
38322	24521s (+0.5s)	1824	1824	128	38	142	6	0	186
38323	24522s (+0.9s)	3956	3956	256	82	227	19	0	328
38324	24522s (+0.4s)	1144	1144	128	26	97	6	0	129
38325	24523s (+0.6s)	1904	1904	128	47	141	7	0	195
38326	24524s (+0.8s)	3748	3748	256	73	224	15	0	312
38327	24524s (+0.4s)	1284	1284	128	40	99	2	0	141
38328	24525s (+0.4s)	1192	1192	128	34	92	4	0	130
38329	24525s (+0.4s)	1520	1520	128	34	117	8	0	159
38330	24526s (+0.9s)	3484	3484	256	79	207	15	0	301
38331	24526s (+0.5s)	1660	1660	128	37	124	0	7	168
38332	24527s (+0.5s)	1700	1700	128	30	137	0	3	170
38333	24528s (+0.7s)	3120	3120	256	49	191	0	13	253
38334	24528s (+0.7s)	2844	2844	256	46	186	0	12	244
38335	24529s (+0.9s)	3796	3796	256	69	232	0	10	311
38336	24530s (+0.7s)	2800	2800	256	41	190	0	12	243
38337	24530s (+0.5s)	2124	2124	256	37	127	0	8	172
38338	24531s (+0.3s)	1016	1016	128	23	84	0	2	109
38339	24531s (+0.4s)	1176	1176	64	32	101	0	8	141
38340	24532s (+0.5s)	1800	1800	128	40	138	0	7	185
38341	24532s (+0.4s)	1180	1180	64	35	100	7	0	142
38342	24533s (+0.6s)	1908	1908	128	50	139	7	0	196
38343	24533s (+0.8s)	3184	3184	256	64	187	13	0	264
38344	24534s (+0.4s)	1272	1272	128	32	97	9	0	138
38345	24535s (+0.8s)	3392	3392	256	64	204	10	1	279
38346	24536s (+0.9s)	4092	4092	256	90	219	22	0	331
38347	24536s (+0.8s)	3216	3216	256	69	184	13	0	266
38348	24537s (+0.4s)	1324	1324	128	32	103	7	0	142
38349	24538s (+0.8s)	3632	3632	256	74	206	12	0	292
38350	24538s (+0.9s)	3680	3680	256	67	224	12	0	303
38351	24539s (+0.9s)	3532	3532	256	85	197	20	0	302
38352	24540s (+0.5s)	1536	1536	128	36	118	9	0	163
38353	24541s (+1.0s)	4376	4376	256	115	228	20	0	363
38354	24542s (+0.9s)	3576	3576	256	69	226	13	0	308
38355	24542s (+0.6s)	2444	2444	256	51	144	9	0	204
38356	24543s (+0.7s)	3028	3028	256	61	184	12	0	257
38357	24544s (+0.6s)	2176	2176	128	60	142	8	0	210
38358	24544s (+0.4s)	1444	1444	128	30	114	6	0	150
38359	24544s (+0.3s)	1084	1084	128	17	93	4	0	114
38360	24545s (+0.8s)	3668	3668	256	91	191	22	0	304
38361	24546s (+0.3s)	972	972	64	27	88	4	0	119
38362	24546s (+0.5s)	1916	1916	128	43	130	10	0	183
38363	24547s (+0.5s)	1696	1696	128	41	127	7	0	175
38364	24547s (+0.5s)	2208	2208	256	52	123	13	0	188
38365	24548s (+0.4s)	1504	1504	128	33	115	7	0	155
38366	24548s (+0.5s)	1600	1600	128	38	123	7	0	168
38367	24548s (+0.3s)	716	716	64	15	78	3	0	96
38368	24549s (+0.9s)	3608	3608	256	83	210	12	0	305
38369	24550s (+0.4s)	1492	1492	128	29	122	0	6	157
38370	24550s (+0.3s)	676	676	64	17	73	0	2	92
38371	24551s (+1.1s)	5432	5432	512	77	287	0	15	379
38372	24552s (+0.8s)	3244	3244	256	46	213	0	15	274
38373	24552s (+0.6s)	2644	2644	256	39	174	0	9	222
38374	24553s (+0.9s)	3528	3528	256	65	222	0	10	297
38375	24554s (+0.7s)	2832	2832	256	59	174	0	13	246
38376	24555s (+0.5s)	1816	1816	128	39	127	0	9	175
38377	24555s (+0.5s)	1764	1764	128	38	132	0	6	176
38378	24556s (+0.8s)	3236	3236	256	47	211	0	14	272
38379	24557s (+0.8s)	3452	3452	256	46	229	0	19	294
38380	24557s (+0.6s)	2480	2480	256	64	141	7	0	212
38381	24558s (+0.5s)	1840	1840	128	40	138	7	0	185
38382	24558s (+0.5s)	1696	1696	128	41	121	9	0	171
38383	24559s (+0.9s)	3840	3840	256	79	220	16	0	315
38384	24560s (+0.7s)	2912	2912	256	55	191	8	0	254
38385	24561s (+0.8s)	3384	3384	256	65	205	12	0	282
38386	24562s (+1.2s)	5984	5984	512	139	257	25	0	421
38387	24563s (+0.8s)	3480	3480	256	89	187	12	0	288
38388	24564s (+1.0s)	4352	4352	256	118	226	18	0	362
38389	24564s (+0.4s)	1412	1412	128	35	107	4	0	146
38390	24565s (+1.2s)	5636	5636	512	105	283	19	0	407
38391	24566s (+0.6s)	2424	2424	128	61	150	11	0	222
38392	24567s (+0.5s)	1848	1848	128	53	129	7	0	189
38393	24567s (+0.4s)	1312	1312	128	30	108	6	0	144
38394	24567s (+0.4s)	1472	1472	128	41	104	8	0	153
38395	24568s (+0.3s)	800	800	64	22	79	6	0	107
38396	24568s (+0.4s)	1304	1304	128	29	96	6	0	131
38397	24569s (+0.4s)	1304	1304	128	33	106	3	0	142
38398	24569s (+0.5s)	1520	1520	128	33	116	10	0	159
38399	24570s (+0.7s)	3044	3044	256	57	183	12	0	252
Episode	Time	Reward	Score	Highest	L	U	R	D	Steps
38400	24571s (+0.8s)	3092	3092	256	63	192	15	0	270
38401	24571s (+0.4s)	1072	1072	64	25	95	4	1	125
38402	24571s (+0.5s)	1868	1868	128	51	130	8	0	189
38403	24572s (+0.7s)	3152	3152	256	79	165	16	0	260
38404	24573s (+0.5s)	1788	1788	128	31	149	3	0	183
38405	24573s (+0.3s)	752	752	64	19	81	1	0	101
38406	24574s (+0.6s)	1928	1928	128	42	153	5	0	200
38407	24574s (+0.6s)	2440	2440	128	56	158	11	1	226
38408	24575s (+0.4s)	1184	1184	128	34	88	6	0	128
38409	24575s (+0.5s)	1772	1772	128	42	132	9	0	183
38410	24576s (+0.7s)	3176	3176	256	75	171	11	0	257
38411	24576s (+0.3s)	808	808	64	28	71	7	0	106
38412	24577s (+0.5s)	1748	1748	128	41	124	0	11	176
38413	24577s (+0.6s)	2516	2516	256	45	163	0	8	216
38414	24578s (+0.3s)	944	944	64	19	93	0	6	118
38415	24578s (+0.3s)	828	828	64	21	68	0	4	93
38416	24578s (+0.3s)	728	728	64	18	74	0	3	95
38417	24579s (+0.7s)	3036	3036	256	52	186	0	10	248
38418	24579s (+0.3s)	1052	1052	128	18	92	0	4	114
38419	24580s (+0.4s)	1244	1244	128	33	95	4	0	132
38420	24581s (+1.2s)	6084	6084	512	111	300	23	0	434
38421	24582s (+0.9s)	3564	3564	256	65	224	15	1	305
38422	24582s (+0.3s)	1112	1112	128	30	84	8	0	122
38423	24583s (+0.7s)	2820	2820	256	56	169	12	0	237
38424	24583s (+0.7s)	2764	2764	256	73	147	18	0	238
38425	24584s (+0.5s)	1624	1624	128	44	117	11	0	172
38426	24585s (+0.8s)	3336	3336	256	59	201	15	0	275
38427	24585s (+0.7s)	2888	2888	256	56	184	8	0	248
38428	24586s (+0.7s)	3012	3012	256	50	195	7	0	252
38429	24587s (+0.6s)	2348	2348	256	43	146	7	0	196
38430	24587s (+0.4s)	1332	1332	128	35	103	6	0	144
38431	24588s (+0.4s)	1492	1492	128	28	122	6	0	156
38432	24588s (+0.6s)	2696	2696	256	61	155	12	1	229
38433	24589s (+1.0s)	4280	4280	256	86	247	19	0	352
38434	24590s (+0.6s)	2024	2024	128	53	131	13	0	197
38435	24590s (+0.7s)	2576	2576	128	57	167	15	0	239
38436	24591s (+0.5s)	1660	1660	128	46	123	9	0	178
38437	24592s (+0.7s)	2852	2852	256	43	184	10	0	237
38438	24593s (+1.0s)	4472	4472	256	95	247	22	0	364
38439	24593s (+0.5s)	1900	1900	128	38	150	5	0	193
38440	24594s (+0.4s)	1240	1240	128	27	92	7	1	127
38441	24594s (+0.4s)	1576	1576	128	34	118	3	0	155
38442	24594s (+0.4s)	1392	1392	128	31	107	6	0	144
38443	24595s (+0.5s)	1804	1804	128	51	128	0	7	186
38444	24595s (+0.4s)	1420	1420	128	25	116	0	4	145
38445	24596s (+0.7s)	2864	2864	256	48	174	0	6	228
38446	24597s (+0.8s)	3368	3368	256	64	212	0	12	288
38447	24597s (+0.5s)	2320	2320	256	39	144	0	10	193
38448	24598s (+0.5s)	1764	1764	128	32	143	0	6	181
38449	24599s (+0.8s)	3236	3236	256	56	204	0	12	272
38450	24599s (+0.4s)	1420	1420	128	25	119	0	3	147
38451	24600s (+0.9s)	3704	3704	256	67	230	0	15	312
38452	24601s (+1.0s)	4184	4184	256	85	249	14	0	348
38453	24602s (+0.4s)	1504	1504	128	37	113	5	0	155
38454	24602s (+0.6s)	2400	2400	128	69	139	15	0	223
38455	24602s (+0.3s)	896	896	64	34	72	9	0	115
38456	24603s (+0.5s)	1856	1856	128	55	113	16	0	184
38457	24604s (+0.8s)	3184	3184	256	65	181	18	0	264
38458	24605s (+0.8s)	3620	3620	256	87	187	15	0	289
38459	24605s (+0.4s)	1512	1512	128	45	109	7	0	161
38460	24606s (+0.6s)	1884	1884	128	60	121	13	0	194
38461	24606s (+0.8s)	3468	3468	256	66	206	15	0	287
38462	24607s (+0.7s)	2732	2732	256	50	169	10	0	229
38463	24609s (+1.5s)	7500	7500	512	147	348	30	0	525
38464	24610s (+1.2s)	6220	6220	512	135	284	27	0	446
38465	24610s (+0.4s)	1080	1080	64	33	93	7	0	133
38466	24611s (+0.4s)	1480	1480	128	36	112	6	0	154
38467	24611s (+0.5s)	1624	1624	128	37	124	8	0	169
38468	24612s (+0.5s)	1720	1720	128	33	133	0	4	170
38469	24612s (+0.5s)	1764	1764	128	44	130	0	9	183
38470	24612s (+0.2s)	416	416	32	12	52	0	3	67
38471	24613s (+0.2s)	512	512	64	11	63	0	0	74
38472	24613s (+0.5s)	1952	1952	128	51	131	15	1	198
38473	24613s (+0.3s)	876	876	64	36	64	8	0	108
38474	24614s (+1.0s)	4264	4264	256	88	246	15	0	349
38475	24615s (+0.6s)	2044	2044	128	60	133	9	0	202
38476	24616s (+0.9s)	3548	3548	256	74	211	16	0	301
38477	24616s (+0.4s)	1436	1436	128	37	107	6	0	150
38478	24617s (+0.7s)	2756	2756	128	68	171	17	0	256
38479	24618s (+0.7s)	2452	2452	128	60	155	13	1	229
38480	24618s (+0.4s)	1200	1200	128	26	99	0	3	128
38481	24618s (+0.2s)	400	400	32	12	50	0	3	65
38482	24619s (+0.5s)	1776	1776	128	40	135	5	0	180
38483	24619s (+0.7s)	2612	2612	128	75	157	16	0	248
38484	24620s (+0.8s)	3380	3380	256	78	187	16	0	281
38485	24621s (+0.7s)	2616	2616	128	65	169	15	0	249
38486	24622s (+0.5s)	1820	1820	128	42	134	6	0	182
38487	24622s (+0.3s)	900	900	64	27	85	5	0	117
38488	24623s (+0.8s)	3476	3476	256	84	193	13	0	290
38489	24623s (+0.5s)	1776	1776	128	59	113	7	0	179
38490	24624s (+0.7s)	3084	3084	256	66	181	8	0	255
38491	24624s (+0.3s)	1168	1168	128	29	91	5	0	125
38492	24625s (+0.7s)	2968	2968	256	60	180	9	0	249
38493	24625s (+0.4s)	1480	1480	128	37	108	9	0	154
38494	24626s (+0.3s)	1100	1100	128	22	88	5	1	116
38495	24627s (+1.0s)	4380	4380	256	99	250	17	0	366
38496	24627s (+0.4s)	1196	1196	64	33	91	7	0	131
38497	24628s (+0.6s)	1900	1900	128	43	144	7	0	194
38498	24629s (+1.0s)	4216	4216	256	98	229	17	1	345
38499	24629s (+0.5s)	1800	1800	128	51	127	7	0	185
Episode	Time	Reward	Score	Highest	L	U	R	D	Steps
38500	24630s (+0.4s)	1448	1448	128	32	108	7	0	147
38501	24631s (+1.0s)	4152	4152	256	66	257	0	17	340
38502	24631s (+0.6s)	2160	2160	128	36	152	0	13	201
38503	24632s (+0.5s)	1876	1876	128	38	140	0	9	187
38504	24632s (+0.3s)	864	864	64	25	75	0	6	106
38505	24633s (+0.7s)	2828	2828	256	55	182	0	12	249
38506	24633s (+0.5s)	1568	1568	128	36	119	5	0	160
38507	24634s (+0.4s)	1204	1204	64	41	88	8	0	137
38508	24635s (+0.9s)	3780	3780	256	75	223	13	0	311
38509	24636s (+0.8s)	3480	3480	256	71	205	19	0	295
38510	24636s (+0.6s)	2120	2120	128	41	156	12	0	209
38511	24637s (+0.5s)	1636	1636	128	41	130	5	0	176
38512	24637s (+0.4s)	1500	1500	128	27	125	6	1	159
38513	24638s (+0.4s)	1356	1356	128	41	92	7	0	140
38514	24638s (+0.9s)	3908	3908	256	82	217	16	0	315
38515	24639s (+0.5s)	1780	1780	128	41	132	7	0	180
38516	24640s (+1.0s)	4248	4248	256	88	233	19	0	340
38517	24640s (+0.4s)	1440	1440	128	39	106	5	0	150
38518	24641s (+0.5s)	1520	1520	128	36	112	11	0	159
38519	24641s (+0.6s)	1924	1924	128	49	140	10	0	199
38520	24642s (+0.4s)	1440	1440	128	25	118	5	0	148
38521	24642s (+0.5s)	1772	1772	128	40	133	0	9	182
38522	24643s (+0.9s)	4600	4600	512	70	229	0	12	311
38523	24644s (+1.0s)	4236	4236	256	70	266	0	14	350
38524	24645s (+0.5s)	1676	1676	128	32	131	0	8	171
38525	24645s (+0.5s)	1676	1676	128	29	146	0	5	180
38526	24646s (+0.7s)	2920	2920	256	55	191	10	0	256
38527	24647s (+0.9s)	3576	3576	256	81	210	11	0	302
38528	24647s (+0.4s)	1468	1468	128	48	100	8	0	156
38529	24648s (+0.7s)	3188	3188	256	74	172	18	0	264
38530	24649s (+0.6s)	2416	2416	128	73	138	15	0	226
38531	24650s (+0.9s)	3932	3932	256	79	229	14	0	322
38532	24651s (+1.3s)	6416	6416	512	116	316	27	0	459
38533	24651s (+0.4s)	1152	1152	64	35	93	7	0	135
38534	24652s (+0.6s)	2752	2752	256	47	175	9	0	231
38535	24652s (+0.5s)	1692	1692	128	35	131	8	0	174
38536	24654s (+1.1s)	4516	4516	256	96	259	15	0	370
38537	24654s (+0.5s)	1608	1608	128	37	130	2	0	169
38538	24655s (+0.6s)	2416	2416	128	46	169	0	12	227
38539	24655s (+0.5s)	1620	1620	128	30	128	0	4	162
38540	24656s (+1.0s)	4360	4360	256	92	258	14	0	364
38541	24657s (+0.5s)	1944	1944	128	49	128	12	0	189
38542	24657s (+0.4s)	1260	1260	64	41	101	7	0	149
38543	24658s (+0.3s)	1100	1100	128	31	84	3	1	119
38544	24658s (+0.5s)	1656	1656	128	42	127	7	0	176
38545	24659s (+0.6s)	1876	1876	128	45	139	8	0	192
38546	24659s (+0.5s)	1744	1744	128	37	130	8	1	176
38547	24660s (+0.4s)	1352	1352	128	33	100	6	0	139
38548	24660s (+0.6s)	1916	1916	128	50	140	7	0	197
38549	24661s (+0.8s)	3432	3432	256	78	196	15	1	290
38550	24661s (+0.4s)	1176	1176	64	41	91	9	0	141
38551	24662s (+0.6s)	2544	2544	256	45	168	4	0	217
38552	24663s (+0.6s)	2096	2096	128	56	134	10	0	200
38553	24664s (+1.0s)	4300	4300	256	88	245	17	0	350
38554	24664s (+0.9s)	4040	4040	256	82	222	18	0	322
38555	24665s (+0.8s)	3536	3536	256	68	219	12	0	299
38556	24666s (+0.4s)	1504	1504	128	37	116	6	0	159
38557	24667s (+0.9s)	4464	4464	512	76	213	15	0	304
38558	24667s (+0.8s)	3588	3588	256	79	199	22	0	300
38559	24668s (+0.6s)	2444	2444	256	49	150	9	0	208
38560	24669s (+0.7s)	2884	2884	256	58	185	8	0	251
38561	24669s (+0.4s)	1068	1068	64	20	102	7	1	130
38562	24670s (+0.7s)	3216	3216	256	59	195	13	0	267
38563	24670s (+0.6s)	2480	2480	256	53	147	12	0	212
38564	24671s (+0.5s)	1576	1576	128	32	123	6	0	161
38565	24672s (+1.0s)	4308	4308	256	76	265	14	0	355
38566	24673s (+0.6s)	2104	2104	128	70	133	9	0	212
38567	24673s (+0.6s)	2544	2544	256	56	158	8	0	222
38568	24674s (+0.8s)	3368	3368	256	75	199	9	0	283
38569	24675s (+0.8s)	3228	3228	256	72	187	11	0	270
38570	24675s (+0.3s)	792	792	64	28	73	5	0	106
38571	24676s (+0.7s)	2776	2776	256	58	168	12	0	238
38572	24677s (+0.8s)	3336	3336	256	67	194	11	0	272
38573	24677s (+0.6s)	2464	2464	256	53	144	11	0	208
38574	24678s (+0.4s)	1268	1268	128	30	100	4	0	134
38575	24678s (+0.6s)	2508	2508	256	42	170	6	0	218
38576	24679s (+0.7s)	2816	2816	256	54	181	12	0	247
38577	24680s (+0.6s)	2444	2444	256	43	154	7	0	204
38578	24680s (+0.3s)	876	876	64	28	83	4	0	115
38579	24680s (+0.5s)	1664	1664	128	42	128	7	0	177
38580	24681s (+0.8s)	3488	3488	256	86	199	13	0	298
38581	24682s (+0.4s)	1172	1172	64	35	96	9	0	140
38582	24683s (+1.2s)	6240	6240	512	99	319	18	0	436
38583	24684s (+0.9s)	3608	3608	256	81	206	13	0	300
38584	24684s (+0.6s)	2136	2136	128	53	149	8	0	210
38585	24685s (+0.4s)	1492	1492	128	36	114	5	1	156
38586	24686s (+0.7s)	2896	2896	256	56	186	8	0	250
38587	24686s (+0.8s)	3212	3212	256	79	175	13	0	267
38588	24687s (+0.4s)	1356	1356	128	27	110	6	0	143
38589	24688s (+0.8s)	3528	3528	256	68	210	18	0	296
38590	24688s (+0.2s)	600	600	64	15	62	0	4	81
38591	24688s (+0.6s)	1856	1856	128	43	141	0	10	194
38592	24689s (+0.6s)	1916	1916	128	33	160	0	4	197
38593	24690s (+0.6s)	2668	2668	256	53	165	9	0	227
38594	24690s (+0.4s)	1496	1496	128	36	113	9	0	158
38595	24691s (+1.0s)	4300	4300	256	106	230	17	0	353
38596	24692s (+0.7s)	3128	3128	256	91	155	12	0	258
38597	24693s (+1.1s)	5720	5720	512	102	280	19	1	402
38598	24693s (+0.5s)	1552	1552	128	44	113	8	1	166
38599	24694s (+0.7s)	2944	2944	256	67	174	16	1	258
Episode	Time	Reward	Score	Highest	L	U	R	D	Steps
38600	24695s (+0.4s)	1352	1352	128	40	91	8	0	139
38601	24695s (+0.5s)	1608	1608	128	41	119	9	0	169
38602	24695s (+0.4s)	1480	1480	128	42	107	6	0	155
38603	24696s (+0.6s)	2492	2492	256	48	156	10	1	215
38604	24696s (+0.1s)	240	240	32	13	30	4	0	47
38605	24697s (+0.4s)	1208	1208	64	29	103	0	7	139
38606	24697s (+0.8s)	3500	3500	256	80	198	11	0	289
38607	24698s (+0.9s)	3908	3908	256	86	213	16	1	316
38608	24699s (+0.7s)	2912	2912	256	68	179	7	0	254
38609	24700s (+0.9s)	3768	3768	256	86	223	9	0	318
38610	24701s (+0.8s)	3288	3288	256	64	206	10	0	280
38611	24701s (+0.5s)	1780	1780	128	52	118	10	0	180
38612	24702s (+0.8s)	3480	3480	256	79	195	15	0	289
38613	24703s (+0.6s)	2172	2172	128	55	152	12	0	219
38614	24703s (+0.6s)	2860	2860	256	62	160	10	0	232
38615	24704s (+0.3s)	864	864	64	25	84	3	0	112
38616	24704s (+0.2s)	524	524	32	22	56	4	0	82
38617	24704s (+0.4s)	1320	1320	128	39	99	7	0	145
38618	24705s (+0.8s)	3568	3568	256	64	212	0	13	289
38619	24706s (+0.9s)	3908	3908	256	65	250	0	8	323
38620	24707s (+0.9s)	3964	3964	256	68	238	0	20	326
38621	24708s (+0.6s)	2380	2380	128	35	181	0	7	223
38622	24708s (+0.4s)	1548	1548	128	26	124	0	7	157
38623	24709s (+0.4s)	1484	1484	128	38	112	0	6	156
38624	24709s (+0.8s)	3424	3424	256	52	227	0	8	287
38625	24710s (+0.5s)	2196	2196	256	32	138	0	9	179
38626	24711s (+0.8s)	3364	3364	256	57	214	0	12	283
38627	24711s (+0.5s)	1752	1752	128	42	121	0	14	177
38628	24712s (+0.5s)	1672	1672	128	33	127	0	11	171
38629	24713s (+0.7s)	3212	3212	256	55	197	0	14	266
38630	24713s (+0.5s)	1652	1652	128	23	147	0	9	179
38631	24713s (+0.3s)	1136	1136	128	25	91	0	5	121
38632	24714s (+0.5s)	1784	1784	128	29	144	0	8	181
38633	24714s (+0.5s)	1800	1800	128	43	132	0	10	185
38634	24715s (+0.9s)	3948	3948	256	61	243	0	18	322
38635	24716s (+0.3s)	892	892	64	21	87	3	0	111
38636	24716s (+0.5s)	2132	2132	256	37	136	6	1	180
38637	24717s (+0.4s)	1512	1512	128	37	120	4	0	161
38638	24717s (+0.5s)	1608	1608	128	34	132	3	0	169
38639	24718s (+0.8s)	3208	3208	256	67	188	14	0	269
38640	24718s (+0.4s)	1328	1328	128	29	106	3	0	138
38641	24719s (+0.3s)	908	908	64	25	79	4	0	108
38642	24719s (+0.7s)	3212	3212	256	67	186	14	0	267
38643	24720s (+0.5s)	1864	1864	128	41	136	12	0	189
38644	24721s (+0.6s)	2452	2452	256	51	150	8	1	210
38645	24721s (+0.5s)	1816	1816	128	42	137	5	0	184
38646	24722s (+0.7s)	2920	2920	256	66	177	13	1	257
38647	24723s (+0.9s)	3932	3932	256	78	232	13	0	323
38648	24724s (+1.1s)	4600	4600	256	116	247	17	0	380
38649	24724s (+0.4s)	1484	1484	128	33	118	4	0	155
38650	24725s (+0.9s)	4096	4096	256	82	236	12	0	330
38651	24726s (+0.5s)	2304	2304	256	42	144	6	0	192
38652	24727s (+1.0s)	4280	4280	256	98	233	20	2	353
38653	24727s (+0.7s)	2648	2648	256	51	165	12	0	228
38654	24728s (+0.7s)	2952	2952	256	63	186	9	1	259
38655	24729s (+0.3s)	692	692	64	18	71	2	0	91
38656	24729s (+0.9s)	3620	3620	256	72	223	11	1	307
38657	24730s (+0.8s)	3280	3280	256	60	197	14	1	272
38658	24731s (+0.5s)	1896	1896	128	55	130	7	0	192
38659	24732s (+0.9s)	4712	4712	512	62	252	13	0	327
38660	24732s (+0.6s)	1964	1964	128	60	135	9	0	204
38661	24733s (+0.6s)	2136	2136	128	49	144	12	0	205
38662	24734s (+0.8s)	3472	3472	256	68	206	13	0	287
38663	24734s (+0.7s)	2808	2808	256	50	181	7	0	238
38664	24735s (+0.8s)	3656	3656	256	82	202	13	0	297
38665	24736s (+0.5s)	1652	1652	128	50	115	13	1	179
38666	24736s (+0.6s)	1964	1964	128	46	145	11	0	202
38667	24737s (+0.5s)	1784	1784	128	45	127	10	0	182
38668	24738s (+1.3s)	6668	6668	512	105	332	22	0	459
38669	24740s (+1.3s)	6740	6740	512	134	309	28	0	471
38670	24740s (+0.5s)	1748	1748	128	44	125	7	0	176
38671	24741s (+0.9s)	3992	3992	256	73	236	17	0	326
38672	24741s (+0.3s)	1076	1076	128	31	82	6	0	119
38673	24742s (+0.9s)	3896	3896	256	83	228	17	1	329
38674	24743s (+0.6s)	1956	1956	128	55	141	6	0	202
38675	24743s (+0.3s)	852	852	64	26	76	6	0	108
38676	24743s (+0.1s)	264	264	32	9	40	1	0	50
38677	24744s (+0.5s)	1616	1616	128	46	113	12	0	171
38678	24744s (+0.4s)	1464	1464	128	38	106	6	0	150
38679	24745s (+0.5s)	1732	1732	128	49	112	11	0	172
38680	24745s (+0.6s)	2572	2572	256	59	155	6	0	220
38681	24746s (+0.8s)	3448	3448	256	68	212	13	0	293
38682	24747s (+0.9s)	3852	3852	256	79	218	16	0	313
38683	24748s (+0.5s)	1788	1788	128	40	131	10	0	181
38684	24748s (+0.7s)	3228	3228	256	72	180	12	1	265
38685	24749s (+0.3s)	1164	1164	128	24	92	8	0	124
38686	24749s (+0.3s)	868	868	64	29	79	5	0	113
38687	24750s (+0.5s)	1624	1624	128	37	120	7	0	164
38688	24750s (+0.5s)	1616	1616	128	38	123	3	0	164
38689	24751s (+0.7s)	2628	2628	256	52	168	12	0	232
38690	24751s (+0.5s)	1784	1784	128	42	134	5	0	181
38691	24752s (+1.0s)	5376	5376	512	94	260	21	0	375
38692	24753s (+0.7s)	3004	3004	256	66	169	15	0	250
38693	24754s (+0.5s)	1684	1684	128	44	123	6	0	173
38694	24754s (+0.7s)	2768	2768	256	56	172	11	0	239
38695	24755s (+1.0s)	4220	4220	256	95	246	11	0	352
38696	24756s (+0.5s)	1796	1796	128	51	124	9	0	184
38697	24756s (+0.7s)	2504	2504	128	60	166	10	1	237
38698	24757s (+0.5s)	1660	1660	128	46	124	6	0	176
38699	24757s (+0.4s)	1496	1496	128	31	116	8	0	155
Episode	Time	Reward	Score	Highest	L	U	R	D	Steps
38700	24758s (+1.0s)	4280	4280	256	110	232	14	0	356
38701	24759s (+0.4s)	1068	1068	64	33	93	5	0	131
38702	24760s (+0.8s)	3392	3392	256	67	196	15	1	279
38703	24760s (+0.7s)	2884	2884	256	62	182	8	0	252
38704	24761s (+0.4s)	1044	1044	64	30	89	6	0	125
38705	24762s (+0.8s)	3408	3408	256	83	201	9	0	293
38706	24762s (+0.4s)	1528	1528	128	37	112	5	1	155
38707	24763s (+0.9s)	3516	3516	256	82	196	15	0	293
38708	24764s (+0.8s)	3240	3240	256	62	201	10	0	273
38709	24764s (+0.6s)	2400	2400	256	47	146	11	0	204
38710	24765s (+0.8s)	3228	3228	256	67	188	14	1	270
38711	24766s (+0.5s)	1836	1836	128	50	131	8	0	189
38712	24766s (+0.8s)	3444	3444	256	76	193	16	0	285
38713	24767s (+1.0s)	4456	4456	256	102	236	22	0	360
38714	24768s (+0.7s)	2768	2768	256	68	164	7	0	239
38715	24769s (+0.4s)	1504	1504	128	33	115	7	0	155
38716	24769s (+0.7s)	2984	2984	256	73	167	13	0	253
38717	24770s (+0.6s)	2448	2448	256	57	145	14	0	216
38718	24771s (+0.7s)	2832	2832	256	58	178	14	0	250
38719	24771s (+0.3s)	848	848	64	30	73	5	0	108
38720	24772s (+1.0s)	4328	4328	256	88	254	18	0	360
38721	24773s (+0.6s)	1936	1936	128	52	143	7	0	202
38722	24774s (+1.4s)	6648	6648	512	123	339	21	0	483
38723	24774s (+0.6s)	1908	1908	128	49	140	6	0	195
38724	24775s (+0.5s)	1736	1736	128	43	122	8	2	175
38725	24775s (+0.5s)	1484	1484	64	49	102	11	1	163
38726	24776s (+0.2s)	452	452	32	14	52	3	0	69
38727	24776s (+0.7s)	2916	2916	256	66	179	10	0	255
38728	24777s (+0.5s)	1616	1616	128	32	131	7	0	170
38729	24778s (+0.7s)	2900	2900	256	62	177	13	0	252
38730	24778s (+0.2s)	536	536	64	13	64	2	0	79
38731	24779s (+0.7s)	3056	3056	256	44	196	9	0	249
38732	24779s (+0.3s)	796	796	64	23	80	4	0	107
38733	24780s (+0.8s)	3468	3468	256	66	212	15	0	293
38734	24780s (+0.3s)	988	988	64	29	83	5	1	118
38735	24781s (+1.0s)	5348	5348	512	94	241	31	0	366
38736	24782s (+0.7s)	2816	2816	256	56	180	11	0	247
38737	24783s (+0.8s)	2972	2972	256	64	192	8	0	264
38738	24784s (+1.1s)	5740	5740	512	99	269	23	1	392
38739	24784s (+0.4s)	1196	1196	128	24	99	8	0	131
38740	24785s (+0.4s)	1340	1340	64	35	106	9	0	150
38741	24785s (+0.5s)	1796	1796	128	49	125	9	0	183
38742	24786s (+0.5s)	1792	1792	128	48	129	6	0	183
38743	24786s (+0.5s)	1524	1524	128	29	128	7	0	164
38744	24787s (+0.5s)	1628	1628	128	41	124	9	0	174
38745	24787s (+0.4s)	1488	1488	128	46	102	9	0	157
38746	24788s (+0.7s)	2924	2924	256	61	184	12	0	257
38747	24788s (+0.4s)	1360	1360	128	36	105	5	0	146
38748	24789s (+0.9s)	3552	3552	256	77	212	13	0	302
38749	24790s (+0.8s)	3244	3244	256	71	193	9	1	274
38750	24791s (+0.8s)	3496	3496	256	79	194	16	1	290
38751	24791s (+0.6s)	2144	2144	128	41	152	7	2	202
38752	24792s (+1.2s)	5992	5992	512	121	280	24	0	425
38753	24793s (+0.5s)	1568	1568	128	45	112	7	1	165
38754	24793s (+0.5s)	1696	1696	128	37	131	7	0	175
38755	24794s (+0.5s)	1520	1520	128	52	103	8	0	163
38756	24794s (+0.5s)	1992	1992	128	45	134	10	1	190
38757	24795s (+0.7s)	2680	2680	256	44	181	5	0	230
38758	24796s (+0.7s)	3156	3156	256	74	169	15	1	259
38759	24797s (+0.7s)	2932	2932	256	64	183	12	0	259
38760	24798s (+1.0s)	4932	4932	512	82	250	13	0	345
38761	24798s (+0.5s)	1568	1568	128	30	123	7	0	160
38762	24798s (+0.3s)	696	696	64	16	69	6	1	92
38763	24799s (+0.4s)	1484	1484	128	37	111	7	0	155
38764	24799s (+0.6s)	2760	2760	256	48	167	9	0	224
38765	24801s (+1.0s)	4520	4520	256	115	240	21	0	376
38766	24801s (+0.6s)	1912	1912	128	51	135	10	0	196
38767	24802s (+0.9s)	3604	3604	256	78	213	12	0	303
38768	24803s (+0.8s)	3496	3496	256	73	205	15	0	293
38769	24803s (+0.5s)	1752	1752	128	44	124	10	0	178
38770	24804s (+0.6s)	1980	1980	128	54	132	11	1	198
38771	24805s (+0.9s)	3624	3624	256	93	196	16	0	305
38772	24805s (+0.4s)	1224	1224	64	28	104	5	1	138
38773	24805s (+0.3s)	864	864	64	25	71	6	0	102
38774	24806s (+0.6s)	2136	2136	128	65	134	11	0	210
38775	24807s (+0.5s)	1552	1552	128	41	117	9	0	167
38776	24807s (+0.6s)	2136	2136	128	53	145	11	0	209
38777	24808s (+0.4s)	1460	1460	128	30	116	7	0	153
38778	24808s (+0.7s)	2924	2924	256	58	189	10	0	257
38779	24809s (+0.9s)	3656	3656	256	84	214	12	0	310
38780	24810s (+0.8s)	3476	3476	256	74	201	11	1	287
38781	24811s (+0.5s)	1576	1576	128	38	117	7	0	162
38782	24812s (+1.0s)	4816	4816	256	90	258	19	0	367
38783	24812s (+0.8s)	3516	3516	256	71	210	11	1	293
38784	24813s (+0.5s)	1724	1724	128	36	134	3	0	173
38785	24814s (+0.8s)	3544	3544	256	82	201	11	0	294
38786	24814s (+0.6s)	2076	2076	128	43	141	7	0	191
38787	24815s (+0.4s)	1324	1324	128	34	109	3	0	146
38788	24815s (+0.2s)	580	580	32	15	67	3	0	85
38789	24815s (+0.4s)	1280	1280	64	47	97	6	0	150
38790	24816s (+0.5s)	1656	1656	128	45	115	6	0	166
38791	24817s (+0.7s)	2892	2892	256	60	177	13	0	250
38792	24817s (+0.5s)	1740	1740	128	45	122	8	0	175
38793	24818s (+0.9s)	3800	3800	256	90	220	17	0	327
38794	24819s (+0.4s)	1488	1488	128	29	117	9	0	155
38795	24820s (+1.0s)	4200	4200	256	84	256	12	0	352
38796	24820s (+0.3s)	604	604	32	26	62	3	0	91
38797	24820s (+0.5s)	1556	1556	128	40	116	5	0	161
38798	24821s (+0.9s)	4132	4132	256	99	219	17	0	335
38799	24822s (+0.8s)	3424	3424	256	74	185	13	0	272
Episode	Time	Reward	Score	Highest	L	U	R	D	Steps
38800	24823s (+0.6s)	2300	2300	256	46	144	9	0	199
38801	24824s (+0.9s)	4692	4692	512	76	240	11	0	327
38802	24824s (+0.5s)	1520	1520	128	52	97	10	0	159
38803	24825s (+0.7s)	3220	3220	256	63	196	0	10	269
38804	24825s (+0.6s)	2024	2024	128	41	156	0	11	208
38805	24826s (+0.5s)	1872	1872	128	36	139	0	9	184
38806	24826s (+0.4s)	1348	1348	128	39	96	0	3	138
38807	24827s (+0.8s)	3420	3420	256	76	196	0	14	286
38808	24828s (+0.4s)	1172	1172	64	28	104	0	8	140
38809	24828s (+0.9s)	4064	4064	256	66	252	0	16	334
38810	24829s (+0.5s)	1640	1640	128	38	121	0	8	167
38811	24830s (+0.7s)	2952	2952	256	54	184	0	11	249
38812	24830s (+0.5s)	1796	1796	128	45	132	0	7	184
38813	24831s (+0.5s)	1620	1620	128	33	121	0	8	162
38814	24831s (+0.6s)	1928	1928	128	36	157	0	7	200
38815	24832s (+0.6s)	2480	2480	256	47	149	0	10	206
38816	24832s (+0.5s)	1612	1612	128	45	114	11	0	170
38817	24833s (+0.5s)	1600	1600	128	27	126	7	0	160
38818	24833s (+0.5s)	2272	2272	256	38	137	9	0	184
38819	24834s (+0.8s)	3524	3524	256	86	192	17	0	295
38820	24835s (+0.5s)	1504	1504	128	34	118	8	0	160
38821	24835s (+0.4s)	1476	1476	128	33	111	8	0	152
38822	24836s (+0.6s)	2756	2756	256	56	154	13	0	223
38823	24836s (+0.5s)	1608	1608	128	45	115	9	0	169
38824	24837s (+0.8s)	3572	3572	256	80	201	19	0	300
38825	24837s (+0.3s)	1148	1148	128	38	81	5	0	124
38826	24838s (+0.6s)	2148	2148	128	71	132	14	0	217
38827	24839s (+0.6s)	2216	2216	128	52	143	14	0	209
38828	24839s (+0.3s)	956	956	128	23	79	3	0	105
38829	24840s (+0.7s)	2876	2876	256	66	156	13	0	235
38830	24840s (+0.4s)	1336	1336	128	26	114	5	0	145
38831	24841s (+0.6s)	2000	2000	128	50	147	10	0	207
38832	24841s (+0.6s)	2372	2372	256	37	157	6	1	201
38833	24842s (+0.7s)	2620	2620	256	57	159	14	0	230
38834	24843s (+1.0s)	4372	4372	256	113	237	16	1	367
38835	24844s (+0.8s)	3460	3460	256	71	197	17	0	285
38836	24845s (+0.8s)	3424	3424	256	71	202	7	0	280
38837	24845s (+0.6s)	2256	2256	128	43	156	7	0	206
38838	24846s (+0.4s)	1412	1412	128	28	110	6	0	144
38839	24846s (+0.5s)	1856	1856	128	50	129	7	1	187
38840	24847s (+0.8s)	3416	3416	256	78	189	17	0	284
38841	24848s (+0.9s)	3568	3568	256	78	206	14	0	298
38842	24848s (+0.3s)	932	932	64	29	85	5	0	119
38843	24849s (+0.6s)	2364	2364	256	39	156	5	0	200
38844	24849s (+0.6s)	2500	2500	256	49	157	0	11	217
38845	24850s (+0.9s)	3580	3580	256	49	239	0	21	309
38846	24851s (+0.5s)	1820	1820	128	42	138	0	6	186
38847	24851s (+0.2s)	480	480	32	20	53	0	4	77
38848	24851s (+0.4s)	1240	1240	64	35	110	0	7	152
38849	24852s (+0.8s)	3468	3468	256	68	210	13	0	291
38850	24853s (+0.6s)	2508	2508	256	43	164	12	0	219
38851	24854s (+0.7s)	3248	3248	256	61	201	13	0	275
38852	24854s (+0.8s)	3344	3344	256	58	212	0	13	283
38853	24855s (+0.9s)	3600	3600	256	88	196	19	0	303
38854	24856s (+0.5s)	1552	1552	128	44	117	6	0	167
38855	24856s (+0.5s)	1816	1816	128	53	117	12	0	182
38856	24857s (+0.5s)	1748	1748	128	45	130	6	0	181
38857	24857s (+0.6s)	2132	2132	128	57	135	12	0	204
38858	24858s (+0.4s)	1480	1480	128	24	130	0	4	158
38859	24858s (+0.4s)	1568	1568	128	30	128	2	0	160
38860	24859s (+0.3s)	884	884	64	38	68	5	1	112
38861	24860s (+0.8s)	3448	3448	256	68	206	18	0	292
38862	24860s (+0.8s)	3564	3564	256	69	216	13	0	298
38863	24861s (+0.6s)	2584	2584	256	60	153	8	0	221
38864	24862s (+0.7s)	2500	2500	128	48	180	8	0	236
38865	24862s (+0.5s)	1800	1800	128	42	132	10	0	184
38866	24863s (+0.5s)	1800	1800	128	50	123	11	1	185
38867	24863s (+0.6s)	2404	2404	256	44	157	7	0	208
38868	24864s (+0.7s)	2912	2912	256	62	182	10	0	254
38869	24865s (+0.8s)	3412	3412	256	61	210	0	13	284
38870	24865s (+0.4s)	1324	1324	64	32	109	0	10	151
38871	24866s (+0.6s)	1876	1876	128	45	142	0	11	198
38872	24866s (+0.5s)	2072	2072	256	29	140	0	6	175
38873	24867s (+0.6s)	2540	2540	256	42	163	0	11	216
38874	24868s (+1.0s)	4412	4412	256	62	258	0	22	342
38875	24869s (+0.8s)	3580	3580	256	78	207	17	0	302
38876	24869s (+0.5s)	1772	1772	128	44	124	10	0	178
38877	24870s (+0.8s)	3240	3240	256	71	184	17	0	272
38878	24871s (+0.7s)	2880	2880	256	57	171	8	0	236
38879	24872s (+0.7s)	2804	2804	256	61	174	9	0	244
38880	24872s (+0.4s)	1308	1308	128	19	108	3	1	131
38881	24873s (+0.5s)	1980	1980	128	51	135	6	0	192
38882	24873s (+0.4s)	1244	1244	128	23	111	4	0	138
38883	24873s (+0.3s)	1068	1068	128	26	81	9	0	116
38884	24874s (+0.8s)	3388	3388	256	70	210	9	0	289
38885	24874s (+0.3s)	704	704	64	10	80	3	0	93
38886	24875s (+0.8s)	3224	3224	256	59	201	9	0	269
38887	24876s (+0.4s)	1392	1392	128	27	112	5	0	144
38888	24876s (+0.6s)	2492	2492	256	55	151	9	0	215
38889	24877s (+0.4s)	1380	1380	128	35	102	8	1	146
38890	24878s (+1.2s)	6124	6124	512	107	308	19	0	434
38891	24878s (+0.6s)	2564	2564	256	60	155	12	0	227
38892	24880s (+1.1s)	5376	5376	512	97	257	21	1	376
38893	24881s (+1.0s)	4412	4412	256	74	270	0	17	361
38894	24882s (+1.1s)	5460	5460	512	84	276	0	20	380
38895	24882s (+0.5s)	1836	1836	128	42	123	0	13	178
38896	24882s (+0.2s)	696	696	64	19	66	4	0	89
38897	24883s (+0.9s)	3664	3664	256	74	219	10	0	303
38898	24884s (+0.8s)	2884	2884	128	88	170	13	0	271
38899	24885s (+0.4s)	1488	1488	128	32	119	5	0	156
Episode	Time	Reward	Score	Highest	L	U	R	D	Steps
38900	24885s (+0.6s)	2240	2240	128	51	151	6	0	208
38901	24886s (+0.7s)	2852	2852	256	66	175	7	0	248
38902	24886s (+0.4s)	1480	1480	128	33	114	6	0	153
38903	24887s (+0.8s)	3224	3224	256	62	196	11	1	270
38904	24888s (+0.8s)	3488	3488	256	65	215	12	0	292
38905	24889s (+0.8s)	3268	3268	256	82	180	12	1	275
38906	24890s (+0.8s)	3496	3496	256	80	196	17	1	294
38907	24890s (+0.5s)	1780	1780	128	33	142	5	0	180
38908	24891s (+0.5s)	1736	1736	128	28	139	0	7	174
38909	24891s (+0.7s)	2924	2924	256	70	174	13	0	257
38910	24892s (+0.4s)	1136	1136	64	33	100	3	0	136
38911	24892s (+0.6s)	2476	2476	256	43	160	8	1	212
38912	24893s (+1.0s)	4284	4284	256	89	242	19	0	350
38913	24894s (+0.7s)	2948	2948	256	60	172	16	0	248
38914	24895s (+0.7s)	2856	2856	256	50	187	9	0	246
38915	24895s (+0.5s)	1636	1636	128	41	128	7	0	176
38916	24896s (+0.5s)	1696	1696	128	40	127	8	0	175
38917	24896s (+0.5s)	1864	1864	128	46	135	8	0	189
38918	24897s (+0.4s)	1176	1176	64	39	99	3	0	141
38919	24897s (+0.5s)	1620	1620	128	35	126	0	3	164
38920	24898s (+0.6s)	2624	2624	256	49	161	0	10	220
38921	24898s (+0.5s)	1544	1544	128	32	126	0	2	160
38922	24899s (+0.9s)	3800	3800	256	54	250	0	12	316
38923	24900s (+1.0s)	4028	4028	256	69	255	0	12	336
38924	24901s (+0.5s)	1588	1588	128	32	127	0	5	164
38925	24901s (+0.7s)	3084	3084	256	59	191	0	10	260
38926	24902s (+0.3s)	1088	1088	128	19	95	0	4	118
38927	24903s (+1.0s)	4124	4124	256	68	257	0	13	338
38928	24903s (+0.8s)	3336	3336	256	65	207	0	5	277
38929	24904s (+0.6s)	1952	1952	128	54	141	11	0	206
38930	24904s (+0.5s)	1616	1616	128	44	118	9	0	171
38931	24905s (+0.5s)	1728	1728	128	50	119	10	0	179
38932	24906s (+0.8s)	3252	3252	256	74	190	11	0	275
38933	24906s (+0.6s)	1916	1916	128	43	147	7	0	197
38934	24907s (+0.5s)	1888	1888	128	33	137	9	1	180
38935	24908s (+0.8s)	3432	3432	256	68	205	16	0	289
38936	24909s (+0.9s)	3776	3776	256	72	227	11	0	310
38937	24909s (+0.7s)	3092	3092	256	57	188	0	12	257
38938	24910s (+0.3s)	1072	1072	128	22	87	0	3	112
38939	24910s (+0.2s)	332	332	32	11	45	0	5	61
38940	24911s (+1.0s)	5284	5284	512	101	242	20	0	363
38941	24912s (+0.8s)	3516	3516	256	68	212	14	0	294
38942	24912s (+0.5s)	1680	1680	128	37	130	5	0	172
38943	24914s (+1.4s)	6692	6692	512	132	333	18	0	483
38944	24914s (+0.5s)	1760	1760	128	37	140	3	0	180
38945	24915s (+0.5s)	2192	2192	256	47	133	8	0	188
38946	24915s (+0.6s)	2400	2400	128	54	148	15	1	218
38947	24916s (+0.5s)	1780	1780	128	43	130	7	0	180
38948	24916s (+0.6s)	2004	2004	128	71	125	12	0	208
38949	24917s (+0.5s)	1744	1744	128	32	121	8	1	162
38950	24918s (+0.9s)	3576	3576	256	75	210	16	0	301
38951	24919s (+0.8s)	3572	3572	256	70	201	16	0	287
38952	24919s (+0.3s)	680	680	64	17	70	1	0	88
38953	24919s (+0.4s)	1116	1116	64	35	89	7	0	131
38954	24920s (+0.6s)	2676	2676	256	45	175	9	0	229
38955	24921s (+1.0s)	4160	4160	256	90	232	20	0	342
38956	24921s (+0.4s)	1200	1200	64	39	101	7	0	147
38957	24922s (+0.7s)	2848	2848	256	75	165	10	0	250
38958	24923s (+1.0s)	4072	4072	256	72	260	8	0	340
38959	24924s (+1.0s)	4128	4128	256	84	237	14	0	335
38960	24925s (+0.7s)	3132	3132	256	65	186	11	0	262
38961	24925s (+0.5s)	1540	1540	128	35	122	6	0	163
38962	24926s (+0.9s)	3988	3988	256	82	239	10	0	331
38963	24927s (+0.8s)	3204	3204	256	66	187	12	0	265
38964	24928s (+1.1s)	5804	5804	512	94	291	18	0	403
38965	24929s (+0.7s)	3036	3036	256	61	183	10	0	254
38966	24929s (+0.4s)	1108	1108	64	26	98	8	0	132
38967	24929s (+0.4s)	1240	1240	128	33	99	5	0	137
38968	24930s (+0.4s)	1208	1208	128	23	106	5	0	134
38969	24930s (+0.4s)	1276	1276	128	35	92	2	0	129
38970	24932s (+1.4s)	6828	6828	512	146	303	25	0	474
38971	24932s (+0.6s)	2032	2032	128	55	138	11	0	204
38972	24933s (+0.4s)	1316	1316	128	26	100	1	8	135
38973	24933s (+0.8s)	3276	3276	256	61	199	0	10	270
38974	24934s (+0.9s)	3844	3844	256	66	232	0	18	316
38975	24935s (+0.7s)	2780	2780	256	42	184	0	14	240
38976	24936s (+0.9s)	3960	3960	256	80	231	0	13	324
38977	24937s (+0.6s)	2244	2244	128	42	158	0	16	216
38978	24937s (+0.4s)	1392	1392	128	27	111	0	7	145
38979	24937s (+0.3s)	1024	1024	64	22	94	0	4	120
38980	24938s (+0.7s)	3056	3056	256	36	207	0	6	249
38981	24938s (+0.4s)	1364	1364	128	23	110	0	9	142
38982	24939s (+1.0s)	4188	4188	256	74	257	0	18	349
38983	24940s (+0.9s)	3836	3836	256	65	241	0	14	320
38984	24941s (+0.6s)	2500	2500	256	47	158	0	12	217
38985	24941s (+0.4s)	1324	1324	128	31	98	0	8	137
38986	24942s (+0.6s)	2580	2580	256	39	157	0	16	212
38987	24942s (+0.5s)	1596	1596	128	38	121	0	7	166
38988	24943s (+0.9s)	3796	3796	256	60	227	0	18	305
38989	24944s (+0.4s)	1228	1228	128	42	87	6	0	135
38990	24944s (+0.5s)	1752	1752	128	38	128	8	0	174
38991	24945s (+0.6s)	2620	2620	256	66	154	9	0	229
38992	24945s (+0.5s)	1800	1800	128	51	122	9	0	182
38993	24946s (+0.5s)	2164	2164	256	41	132	8	1	182
38994	24947s (+0.7s)	3176	3176	256	68	182	11	1	262
38995	24947s (+0.7s)	2912	2912	256	61	181	12	0	254
38996	24948s (+0.5s)	1760	1760	128	40	130	9	0	179
38997	24949s (+0.7s)	2908	2908	256	50	187	16	0	253
38998	24950s (+1.0s)	4344	4344	256	81	259	21	0	361
38999	24950s (+0.8s)	3356	3356	256	66	211	8	0	285
Episode	Time	Reward	Score	Highest	L	U	R	D	Steps
39000	24951s (+0.5s)	1764	1764	128	38	135	8	0	181
39001	24951s (+0.5s)	1544	1544	128	36	112	10	0	158
39002	24952s (+0.8s)	3352	3352	256	73	190	15	0	278
39003	24953s (+0.3s)	1148	1148	128	34	84	6	0	124
39004	24953s (+0.5s)	1788	1788	128	47	126	9	0	182
39005	24954s (+0.6s)	2644	2644	256	54	160	8	0	222
39006	24954s (+0.5s)	1704	1704	128	45	120	12	0	177
39007	24955s (+0.5s)	1676	1676	128	38	125	7	0	170
39008	24955s (+0.2s)	556	556	64	18	60	2	0	80
39009	24956s (+1.0s)	4420	4420	256	97	246	20	0	363
39010	24957s (+0.7s)	2912	2912	256	67	177	10	0	254
39011	24957s (+0.4s)	1064	1064	64	28	95	6	0	129
39012	24958s (+0.8s)	3520	3520	256	65	218	16	0	299
39013	24958s (+0.3s)	1080	1080	128	22	91	6	0	119
39014	24959s (+0.6s)	2028	2028	128	53	147	10	0	210
39015	24960s (+1.1s)	5440	5440	512	95	263	22	0	380
39016	24961s (+0.5s)	1524	1524	128	28	122	9	0	159
39017	24962s (+1.3s)	6232	6232	512	120	304	20	0	444
39018	24963s (+0.8s)	3228	3228	256	56	205	10	0	271
39019	24963s (+0.9s)	3808	3808	256	81	222	10	0	313
39020	24964s (+0.9s)	4012	4012	256	96	214	16	0	326
39021	24965s (+0.5s)	1800	1800	128	39	135	11	0	185
39022	24965s (+0.5s)	1552	1552	128	35	127	0	4	166
39023	24966s (+0.8s)	3452	3452	256	62	209	2	10	283
39024	24966s (+0.2s)	556	556	32	19	63	1	0	83
39025	24967s (+0.9s)	3608	3608	256	66	227	11	0	304
39026	24968s (+0.6s)	2640	2640	256	56	153	12	0	221
39027	24969s (+0.7s)	2932	2932	256	54	181	9	0	244
39028	24969s (+0.3s)	676	676	32	23	70	4	0	97
39029	24969s (+0.3s)	960	960	64	30	81	4	0	115
39030	24970s (+0.5s)	1732	1732	128	39	127	7	0	173
39031	24970s (+0.5s)	1720	1720	128	41	127	9	0	177
39032	24971s (+0.8s)	3500	3500	256	61	217	0	11	289
39033	24972s (+0.9s)	3832	3832	256	55	256	0	17	328
39034	24972s (+0.3s)	1104	1104	128	26	91	0	1	118
39035	24973s (+0.3s)	1092	1092	128	18	95	0	2	115
39036	24973s (+0.4s)	1324	1324	128	29	101	0	6	136
39037	24974s (+0.9s)	3668	3668	256	56	227	0	17	300
39038	24975s (+0.8s)	3228	3228	256	58	197	0	11	266
39039	24975s (+0.5s)	1724	1724	128	33	137	7	0	177
39040	24976s (+1.0s)	4356	4356	256	92	253	17	0	362
39041	24977s (+0.5s)	1876	1876	128	49	133	7	0	189
39042	24978s (+0.9s)	3532	3532	256	79	204	14	0	297
39043	24979s (+1.1s)	5712	5712	512	116	262	20	1	399
39044	24979s (+0.4s)	1448	1448	128	31	114	6	0	151
39045	24980s (+0.5s)	1632	1632	128	38	130	7	0	175
39046	24980s (+0.4s)	1200	1200	128	42	89	2	0	133
39047	24981s (+0.4s)	1068	1068	64	36	89	6	0	131
39048	24982s (+1.0s)	4592	4592	256	116	239	23	0	378
39049	24982s (+0.7s)	2980	2980	256	58	184	7	0	249
39050	24983s (+0.7s)	2608	2608	256	70	150	10	0	230
39051	24984s (+0.4s)	1480	1480	128	26	123	5	1	155
39052	24984s (+0.5s)	1972	1972	128	44	137	8	0	189
39053	24985s (+0.7s)	2920	2920	256	64	172	11	0	247
39054	24985s (+0.6s)	2708	2708	256	48	173	0	6	227
39055	24986s (+0.4s)	1488	1488	128	32	116	0	9	157
39056	24986s (+0.5s)	1768	1768	128	29	142	0	7	178
39057	24987s (+0.6s)	2344	2344	256	34	158	0	7	199
39058	24988s (+0.5s)	1764	1764	128	35	139	0	7	181
39059	24988s (+0.6s)	2648	2648	256	44	164	0	7	215
39060	24989s (+0.4s)	1304	1304	128	29	92	0	9	130
39061	24990s (+1.1s)	5580	5580	512	105	269	24	0	398
39062	24990s (+0.7s)	3180	3180	256	65	185	13	0	263
39063	24991s (+0.6s)	2296	2296	128	61	154	9	0	224
39064	24992s (+0.5s)	1684	1684	128	39	121	11	1	172
39065	24992s (+0.8s)	3308	3308	256	90	168	20	0	278
39066	24993s (+0.5s)	1660	1660	128	34	128	5	0	167
39067	24993s (+0.6s)	2624	2624	256	54	156	10	1	221
39068	24994s (+0.5s)	1876	1876	128	51	131	10	0	192
39069	24995s (+0.7s)	3120	3120	256	40	212	8	0	260
39070	24995s (+0.6s)	2336	2336	256	54	131	13	0	198
39071	24996s (+0.7s)	2636	2636	256	57	161	12	1	231
39072	24996s (+0.3s)	712	712	64	17	73	5	0	95
39073	24997s (+0.5s)	1676	1676	128	37	126	8	0	171
39074	24998s (+0.9s)	3580	3580	256	64	220	15	1	300
39075	24998s (+0.6s)	1928	1928	128	50	141	9	0	200
39076	24999s (+0.4s)	1064	1064	64	30	90	0	6	126
39077	24999s (+0.7s)	3064	3064	256	60	189	0	11	260
39078	25000s (+0.6s)	2224	2224	128	47	151	0	13	211
39079	25000s (+0.6s)	1912	1912	128	53	133	0	12	198
39080	25001s (+0.7s)	2828	2828	256	54	191	0	4	249
39081	25002s (+0.4s)	1312	1312	128	52	82	0	6	140
39082	25002s (+0.4s)	1320	1320	64	28	115	0	7	150
39083	25003s (+1.0s)	4160	4160	256	79	245	18	0	342
39084	25003s (+0.4s)	1380	1380	128	28	110	7	0	145
39085	25005s (+1.2s)	5804	5804	512	102	288	27	0	417
39086	25005s (+0.6s)	2692	2692	256	75	138	10	0	223
39087	25006s (+0.7s)	2848	2848	256	48	189	11	0	248
39088	25007s (+0.7s)	2492	2492	128	67	156	11	0	234
39089	25007s (+0.3s)	924	924	64	21	98	3	0	122
39090	25007s (+0.4s)	1368	1368	128	32	103	8	0	143
39091	25008s (+0.5s)	1756	1756	128	39	127	10	0	176
39092	25009s (+0.8s)	3368	3368	256	64	202	11	1	278
39093	25009s (+0.7s)	2772	2772	256	60	168	8	0	236
39094	25010s (+0.9s)	3616	3616	256	83	201	22	0	306
39095	25011s (+0.3s)	1116	1116	128	22	91	5	0	118
39096	25011s (+0.5s)	1588	1588	128	41	118	6	0	165
39097	25011s (+0.3s)	852	852	64	15	85	2	1	103
39098	25012s (+0.8s)	3420	3420	256	68	211	7	0	286
39099	25013s (+0.4s)	1340	1340	128	32	107	3	0	142
Episode	Time	Reward	Score	Highest	L	U	R	D	Steps
39100	25013s (+0.8s)	3548	3548	256	78	210	12	1	301
39101	25014s (+0.6s)	2388	2388	256	44	154	8	0	206
39102	25015s (+0.5s)	1680	1680	128	42	121	8	0	171
39103	25015s (+0.6s)	2688	2688	256	51	163	0	12	226
39104	25016s (+1.1s)	5556	5556	512	99	277	0	23	399
39105	25017s (+0.9s)	3976	3976	256	59	252	0	17	328
39106	25018s (+0.6s)	2380	2380	128	47	163	0	13	223
39107	25018s (+0.4s)	1344	1344	128	26	110	0	7	143
39108	25018s (+0.1s)	180	180	16	6	35	0	1	42
39109	25019s (+0.5s)	1896	1896	128	35	133	0	12	180
39110	25020s (+0.7s)	3188	3188	256	57	192	0	13	262
39111	25021s (+0.8s)	3348	3348	256	57	215	0	12	284
39112	25021s (+0.5s)	1792	1792	128	41	137	0	6	184
39113	25022s (+0.6s)	2144	2144	128	58	140	13	0	211
39114	25022s (+0.7s)	2840	2840	256	53	185	9	0	247
39115	25023s (+0.7s)	3196	3196	256	68	184	13	1	266
39116	25023s (+0.3s)	904	904	64	39	74	4	0	117
39117	25025s (+1.1s)	5800	5800	512	102	293	21	0	416
39118	25025s (+0.6s)	2264	2264	128	54	149	13	0	216
39119	25026s (+0.6s)	1864	1864	128	51	135	10	1	197
39120	25026s (+0.4s)	1064	1064	64	28	97	4	1	130
39121	25027s (+1.0s)	5156	5156	512	110	236	21	0	367
39122	25028s (+0.5s)	1844	1844	128	46	130	8	0	184
39123	25028s (+0.6s)	2016	2016	128	55	136	9	0	200
39124	25029s (+0.9s)	4112	4112	256	90	227	18	0	335
39125	25030s (+0.8s)	3388	3388	256	64	208	11	0	283
39126	25031s (+1.2s)	6152	6152	512	126	283	25	0	434
39127	25032s (+0.7s)	2764	2764	256	56	169	14	0	239
39128	25033s (+0.7s)	2704	2704	256	58	160	11	1	230
39129	25033s (+0.6s)	2524	2524	256	69	140	13	0	222
39130	25034s (+0.5s)	1780	1780	128	41	130	8	0	179
39131	25035s (+0.7s)	2924	2924	256	53	172	18	0	243
39132	25035s (+0.6s)	1992	1992	128	53	134	17	0	204
39133	25036s (+0.6s)	2052	2052	128	52	145	11	0	208
39134	25036s (+0.4s)	1248	1248	128	39	87	7	0	133
39135	25037s (+0.6s)	2540	2540	256	56	156	10	0	222
39136	25038s (+0.9s)	3944	3944	256	80	227	13	0	320
39137	25039s (+1.0s)	5180	5180	512	93	267	14	0	374
39138	25039s (+0.5s)	1936	1936	128	54	131	10	0	195
39139	25040s (+1.0s)	5076	5076	512	93	253	18	0	364
39140	25041s (+0.7s)	2888	2888	256	64	163	11	0	238
39141	25042s (+0.7s)	3228	3228	256	65	191	14	0	270
39142	25042s (+0.4s)	1224	1224	128	26	102	4	1	133
39143	25043s (+0.8s)	3432	3432	256	63	201	17	0	281
39144	25043s (+0.3s)	1088	1088	128	29	83	7	1	120
39145	25044s (+0.6s)	1916	1916	128	51	135	11	0	197
39146	25045s (+0.8s)	3436	3436	256	63	209	17	0	289
39147	25045s (+0.7s)	2776	2776	256	60	164	13	0	237
39148	25046s (+0.4s)	1048	1048	64	37	78	11	0	126
39149	25046s (+0.6s)	2380	2380	256	42	152	10	0	204
39150	25047s (+0.5s)	1628	1628	128	45	121	8	0	174
39151	25047s (+0.5s)	1980	1980	128	55	134	12	0	201
39152	25048s (+0.7s)	2812	2812	256	55	178	8	0	241
39153	25049s (+1.1s)	5676	5676	512	86	296	0	19	401
39154	25049s (+0.1s)	272	272	32	10	38	0	3	51
39155	25050s (+0.5s)	1792	1792	128	48	127	0	9	184
39156	25050s (+0.4s)	1316	1316	128	30	99	0	6	135
39157	25051s (+0.6s)	2576	2576	256	38	173	0	11	222
39158	25052s (+0.6s)	2632	2632	256	44	170	0	9	223
39159	25053s (+0.8s)	3724	3724	256	71	219	12	0	302
39160	25053s (+0.9s)	3892	3892	256	85	222	12	0	319
39161	25054s (+0.6s)	1948	1948	128	46	139	15	1	201
39162	25055s (+0.7s)	2776	2776	256	59	164	15	0	238
39163	25055s (+0.8s)	3372	3372	256	52	215	10	1	278
39164	25056s (+0.8s)	3228	3228	256	81	174	11	0	266
39165	25057s (+0.8s)	3564	3564	256	69	227	9	0	305
39166	25057s (+0.3s)	780	780	64	24	75	4	0	103
39167	25058s (+0.5s)	1916	1916	128	50	136	11	0	197
39168	25058s (+0.4s)	1324	1324	128	21	112	0	4	137
39169	25059s (+0.5s)	1736	1736	128	35	133	0	7	175
39170	25060s (+0.9s)	3692	3692	256	67	223	0	16	306
39171	25060s (+0.7s)	2652	2652	256	50	174	0	10	234
39172	25061s (+0.7s)	2784	2784	256	49	183	0	11	243
39173	25062s (+0.7s)	3028	3028	256	45	193	0	13	251
39174	25062s (+0.5s)	2072	2072	256	45	125	6	0	176
39175	25063s (+0.4s)	1316	1316	128	36	94	5	0	135
39176	25063s (+0.6s)	2640	2640	256	67	159	4	0	230
39177	25064s (+0.4s)	1400	1400	128	28	111	4	0	143
39178	25065s (+0.8s)	3248	3248	256	67	197	11	0	275
39179	25066s (+1.1s)	5632	5632	512	91	294	21	0	406
39180	25066s (+0.4s)	1456	1456	128	32	111	6	0	149
39181	25067s (+0.8s)	3196	3196	256	55	199	11	1	266
39182	25067s (+0.3s)	820	820	64	28	73	4	0	105
39183	25068s (+1.1s)	5428	5428	512	92	272	14	0	378
39184	25069s (+0.6s)	2424	2424	256	47	158	5	0	210
39185	25070s (+0.8s)	3304	3304	256	55	209	12	1	277
39186	25070s (+0.4s)	1204	1204	128	30	94	6	0	130
39187	25071s (+0.5s)	1676	1676	128	28	142	0	7	177
39188	25071s (+0.4s)	1152	1152	64	28	104	0	3	135
39189	25072s (+0.6s)	2392	2392	256	37	156	0	5	198
39190	25072s (+0.6s)	2272	2272	128	45	149	0	14	208
39191	25073s (+0.5s)	1636	1636	128	29	127	0	9	165
39192	25073s (+0.6s)	2272	2272	128	65	144	9	0	218
39193	25074s (+1.0s)	4924	4924	512	90	236	18	0	344
39194	25075s (+0.8s)	3756	3756	256	71	215	11	0	297
39195	25076s (+0.6s)	2384	2384	256	47	150	7	0	204
39196	25076s (+0.5s)	1672	1672	128	26	140	5	0	171
39197	25077s (+0.7s)	3100	3100	256	53	187	15	0	255
39198	25077s (+0.4s)	1220	1220	128	35	93	5	0	133
39199	25078s (+0.6s)	2280	2280	128	49	157	13	0	219
Episode	Time	Reward	Score	Highest	L	U	R	D	Steps
39200	25079s (+0.6s)	2508	2508	256	45	168	5	0	218
39201	25079s (+0.7s)	3116	3116	256	75	174	9	0	258
39202	25080s (+1.0s)	4200	4200	256	95	232	18	0	345
39203	25081s (+0.5s)	1620	1620	128	41	123	8	0	172
39204	25081s (+0.5s)	1680	1680	128	53	111	14	0	178
39205	25082s (+0.8s)	4504	4504	512	71	220	13	0	304
39206	25083s (+0.5s)	1640	1640	128	43	124	6	0	173
39207	25083s (+0.7s)	3072	3072	256	50	192	11	0	253
39208	25084s (+0.5s)	1608	1608	128	39	123	7	0	169
39209	25084s (+0.2s)	560	560	64	13	66	0	0	79
39210	25084s (+0.5s)	1620	1620	128	37	128	7	0	172
39211	25085s (+0.5s)	1808	1808	128	56	124	7	0	187
39212	25085s (+0.4s)	1184	1184	128	21	103	4	0	128
39213	25086s (+0.7s)	2788	2788	256	58	170	12	0	240
39214	25087s (+0.7s)	3148	3148	256	45	205	12	0	262
39215	25088s (+1.2s)	5940	5940	512	126	270	24	0	420
39216	25089s (+0.6s)	1952	1952	128	47	144	8	0	199
39217	25089s (+0.3s)	716	716	64	19	72	2	1	94
39218	25090s (+0.7s)	3096	3096	256	62	183	13	0	258
39219	25090s (+0.6s)	2476	2476	256	44	157	10	0	211
39220	25091s (+0.8s)	3280	3280	256	91	164	17	0	272
39221	25091s (+0.2s)	664	664	64	19	63	3	0	85
39222	25093s (+1.4s)	7192	7192	512	121	342	34	0	497
39223	25094s (+0.9s)	3856	3856	256	78	219	17	0	314
39224	25094s (+0.6s)	1932	1932	128	44	146	11	0	201
39225	25095s (+0.7s)	3104	3104	256	68	178	11	0	257
39226	25096s (+0.6s)	2460	2460	256	60	136	15	0	211
39227	25096s (+0.5s)	1752	1752	128	40	127	7	0	174
39228	25097s (+0.6s)	2672	2672	256	59	157	10	1	227
39229	25098s (+0.8s)	3592	3592	256	82	207	15	1	305
39230	25098s (+0.9s)	3848	3848	256	86	212	15	0	313
39231	25099s (+0.5s)	1528	1528	128	35	123	7	0	165
39232	25099s (+0.5s)	1896	1896	128	47	138	7	0	192
39233	25100s (+0.5s)	1628	1628	64	48	116	10	0	174
39234	25100s (+0.5s)	1520	1520	128	32	118	0	10	160
39235	25101s (+0.8s)	3320	3320	256	54	209	0	14	277
39236	25101s (+0.3s)	1004	1004	128	22	83	0	1	106
39237	25102s (+0.5s)	1640	1640	128	30	132	0	5	167
39238	25102s (+0.5s)	1700	1700	128	30	133	0	7	170
39239	25103s (+0.8s)	3280	3280	256	55	216	0	12	283
39240	25104s (+0.5s)	1860	1860	128	44	137	7	0	188
39241	25105s (+0.7s)	2788	2788	256	48	181	13	0	242
39242	25105s (+0.5s)	1812	1812	128	48	132	8	0	188
39243	25106s (+0.7s)	3048	3048	256	62	175	12	0	249
39244	25106s (+0.7s)	2492	2492	128	66	157	12	0	235
39245	25107s (+0.5s)	1916	1916	128	52	134	7	1	194
39246	25108s (+1.0s)	4324	4324	256	91	247	21	0	359
39247	25108s (+0.4s)	1480	1480	128	37	109	7	0	153
39248	25109s (+0.6s)	2468	2468	256	67	127	15	0	209
39249	25110s (+0.8s)	3512	3512	256	67	220	10	0	297
39250	25111s (+1.0s)	4232	4232	256	97	234	17	0	348
39251	25112s (+0.7s)	3036	3036	256	59	176	9	0	244
39252	25112s (+0.5s)	1800	1800	128	36	141	9	0	186
39253	25113s (+0.6s)	1960	1960	128	50	139	10	1	200
39254	25114s (+0.9s)	3688	3688	256	56	243	0	16	315
39255	25114s (+0.4s)	1468	1468	128	31	118	0	3	152
39256	25115s (+0.8s)	3428	3428	256	62	222	0	14	298
39257	25116s (+0.6s)	2348	2348	128	47	170	0	9	226
39258	25116s (+0.4s)	1476	1476	128	30	111	0	12	153
39259	25116s (+0.5s)	1608	1608	128	33	128	0	8	169
39260	25117s (+0.5s)	1612	1612	128	38	126	6	0	170
39261	25118s (+0.8s)	3260	3260	256	77	190	11	0	278
39262	25118s (+0.5s)	1576	1576	128	43	114	10	0	167
39263	25119s (+0.6s)	2544	2544	256	50	154	9	0	213
39264	25120s (+0.9s)	3852	3852	256	81	219	22	0	322
39265	25121s (+0.9s)	3920	3920	256	83	224	12	0	319
39266	25122s (+1.1s)	5640	5640	512	100	273	25	0	398
39267	25122s (+0.6s)	2620	2620	256	56	157	8	0	221
39268	25123s (+0.5s)	1688	1688	128	44	116	10	0	170
39269	25124s (+0.8s)	3484	3484	256	74	203	14	0	291
39270	25124s (+0.7s)	2952	2952	256	60	164	17	1	242
39271	25125s (+0.7s)	2860	2860	256	78	148	17	0	243
39272	25126s (+0.6s)	2692	2692	256	62	153	10	0	225
39273	25126s (+0.4s)	1428	1428	128	40	100	6	0	146
39274	25126s (+0.2s)	628	628	64	12	73	0	2	87
39275	25127s (+1.0s)	4024	4024	256	90	235	10	0	335
39276	25128s (+0.3s)	788	788	64	23	78	4	0	105
39277	25128s (+0.6s)	1916	1916	128	54	136	7	0	197
39278	25129s (+0.9s)	4092	4092	256	82	233	15	0	330
39279	25130s (+0.7s)	2636	2636	256	52	173	8	0	233
39280	25131s (+0.7s)	3072	3072	256	60	180	13	0	253
39281	25131s (+0.7s)	3068	3068	256	56	181	15	0	252
39282	25132s (+0.6s)	1984	1984	128	52	150	7	0	209
39283	25133s (+0.9s)	4068	4068	256	80	208	14	3	305
39284	25134s (+1.1s)	5412	5412	512	76	290	15	0	381
39285	25135s (+0.8s)	3308	3308	256	62	196	8	0	266
39286	25136s (+1.0s)	4044	4044	256	79	246	15	0	340
39287	25136s (+0.6s)	2136	2136	128	62	136	11	0	209
39288	25137s (+0.5s)	1772	1772	128	33	142	3	0	178
39289	25137s (+0.7s)	2956	2956	256	57	175	14	0	246
39290	25138s (+0.9s)	3932	3932	256	73	234	0	11	318
39291	25139s (+0.7s)	2624	2624	256	57	164	0	10	231
39292	25139s (+0.4s)	1496	1496	128	33	119	0	6	158
39293	25140s (+0.3s)	716	716	64	15	76	0	3	94
39294	25140s (+0.4s)	1380	1380	128	32	106	0	6	144
39295	25141s (+0.5s)	1616	1616	128	33	130	0	8	171
39296	25142s (+1.3s)	6488	6488	512	117	324	23	0	464
39297	25142s (+0.3s)	800	800	64	17	86	4	0	107
39298	25143s (+0.4s)	1272	1272	128	33	92	3	0	128
39299	25143s (+0.3s)	1192	1192	128	29	84	8	0	121
Episode	Time	Reward	Score	Highest	L	U	R	D	Steps
39300	25144s (+0.9s)	3592	3592	256	68	220	17	0	305
39301	25144s (+0.3s)	780	780	64	30	69	3	0	102
39302	25145s (+0.5s)	1744	1744	128	45	124	8	0	177
39303	25145s (+0.7s)	2752	2752	256	50	170	16	0	236
39304	25146s (+0.5s)	2240	2240	256	45	135	10	0	190
39305	25146s (+0.4s)	1564	1564	128	45	106	8	0	159
39306	25147s (+0.4s)	1092	1092	64	35	91	6	0	132
39307	25148s (+0.9s)	4032	4032	256	83	232	16	0	331
39308	25148s (+0.6s)	1912	1912	128	49	142	5	0	196
39309	25149s (+0.2s)	492	492	64	11	51	0	5	67
39310	25149s (+0.7s)	2772	2772	256	52	172	11	0	235
39311	25150s (+0.4s)	1448	1448	128	32	110	9	0	151
39312	25151s (+1.0s)	4328	4328	256	109	239	17	0	365
39313	25151s (+0.7s)	2768	2768	256	58	167	10	0	235
39314	25152s (+0.7s)	2960	2960	256	81	159	10	1	251
39315	25153s (+1.0s)	4224	4224	256	84	249	13	0	346
39316	25154s (+0.6s)	2128	2128	128	49	147	8	0	204
39317	25154s (+0.3s)	704	704	64	20	71	3	0	94
39318	25154s (+0.5s)	1480	1480	64	48	110	7	0	165
39319	25155s (+0.8s)	3248	3248	256	65	197	13	0	275
39320	25156s (+0.8s)	3216	3216	256	53	205	9	0	267
39321	25156s (+0.5s)	1728	1728	128	31	139	3	0	173
39322	25157s (+0.4s)	1404	1404	128	35	102	9	1	147
39323	25158s (+0.8s)	3660	3660	256	68	218	12	0	298
39324	25158s (+0.7s)	2848	2848	256	68	172	10	0	250
39325	25159s (+0.6s)	2408	2408	256	38	158	7	0	203
39326	25160s (+0.9s)	4012	4012	256	78	233	11	0	322
39327	25160s (+0.4s)	984	984	64	30	87	8	0	125
39328	25161s (+0.4s)	1372	1372	128	33	104	6	0	143
39329	25161s (+0.5s)	1920	1920	128	53	133	12	0	198
39330	25162s (+0.5s)	1712	1712	128	38	129	6	0	173
39331	25162s (+0.4s)	1280	1280	128	19	106	4	0	129
39332	25163s (+0.8s)	3588	3588	256	68	199	22	1	290
39333	25164s (+0.8s)	3488	3488	256	86	185	20	0	291
39334	25165s (+0.7s)	2968	2968	256	58	191	12	0	261
39335	25165s (+0.3s)	880	880	64	24	85	6	0	115
39336	25165s (+0.4s)	1504	1504	128	43	108	9	0	160
39337	25166s (+0.8s)	3424	3424	256	62	206	11	0	279
39338	25167s (+0.5s)	1808	1808	128	45	138	4	0	187
39339	25167s (+0.5s)	1700	1700	128	52	127	5	0	184
39340	25168s (+0.7s)	2736	2736	256	48	176	8	0	232
39341	25168s (+0.5s)	1800	1800	128	45	128	8	1	182
39342	25169s (+0.7s)	2772	2772	256	63	164	9	0	236
39343	25170s (+0.7s)	2636	2636	256	63	157	14	0	234
39344	25170s (+0.3s)	1040	1040	128	23	83	5	0	111
39345	25170s (+0.3s)	684	684	64	18	71	1	0	90
39346	25171s (+0.6s)	2288	2288	128	66	145	10	1	222
39347	25172s (+0.8s)	3224	3224	256	52	204	17	0	273
39348	25172s (+0.5s)	1632	1632	128	55	99	11	1	166
39349	25173s (+0.3s)	920	920	64	27	84	9	0	120
39350	25173s (+0.4s)	1600	1600	128	39	114	5	0	158
39351	25174s (+0.5s)	1608	1608	128	41	123	5	0	169
39352	25174s (+0.5s)	1860	1860	128	42	138	8	0	188
39353	25175s (+0.5s)	1808	1808	128	36	146	5	0	187
39354	25175s (+0.4s)	1328	1328	128	29	100	8	0	137
39355	25175s (+0.3s)	744	744	64	15	80	4	0	99
39356	25176s (+0.2s)	464	464	64	7	58	0	3	68
39357	25176s (+0.4s)	1364	1364	128	31	104	0	6	141
39358	25176s (+0.2s)	624	624	64	12	63	1	4	80
39359	25177s (+0.4s)	1476	1476	128	36	110	0	9	155
39360	25177s (+0.5s)	1816	1816	128	49	134	0	6	189
39361	25178s (+0.6s)	2504	2504	256	44	159	0	11	214
39362	25178s (+0.2s)	544	544	32	12	68	2	0	82
39363	25179s (+0.9s)	3952	3952	256	70	239	13	0	322
39364	25180s (+1.0s)	4372	4372	256	105	233	19	0	357
39365	25181s (+0.6s)	1940	1940	128	45	152	6	0	203
39366	25181s (+0.2s)	652	652	64	11	71	1	0	83
39367	25182s (+0.7s)	3044	3044	256	64	185	10	1	260
39368	25182s (+0.2s)	480	480	32	18	53	6	0	77
39369	25183s (+0.9s)	3800	3800	256	91	208	17	0	316
39370	25183s (+0.4s)	1472	1472	128	41	106	5	0	152
39371	25184s (+0.4s)	1176	1176	128	36	86	4	0	126
39372	25184s (+0.7s)	2684	2684	256	47	171	12	1	231
39373	25185s (+0.9s)	3900	3900	256	81	224	20	0	325
39374	25186s (+0.5s)	1812	1812	128	44	134	9	0	187
39375	25187s (+1.1s)	5484	5484	512	75	288	0	22	385
39376	25188s (+0.8s)	3392	3392	256	69	199	0	11	279
39377	25188s (+0.3s)	724	724	64	11	83	0	2	96
39378	25188s (+0.5s)	1840	1840	128	35	139	0	9	183
39379	25189s (+0.7s)	2852	2852	256	63	168	16	1	248
39380	25190s (+0.7s)	3212	3212	256	67	184	16	0	267
39381	25191s (+0.7s)	2840	2840	256	66	168	12	0	246
39382	25191s (+0.6s)	2612	2612	256	56	157	9	0	222
39383	25192s (+0.4s)	1176	1176	64	35	98	8	0	141
39384	25192s (+0.4s)	1492	1492	128	35	118	4	0	157
39385	25193s (+0.7s)	2872	2872	256	62	172	7	0	241
39386	25194s (+0.7s)	3220	3220	256	68	192	12	0	272
39387	25194s (+0.6s)	2760	2760	256	57	165	12	0	234
39388	25195s (+0.5s)	1460	1460	64	41	112	7	0	160
39389	25195s (+0.8s)	3212	3212	256	65	198	7	1	271
39390	25197s (+1.1s)	4536	4536	256	95	262	19	0	376
39391	25197s (+0.6s)	1912	1912	128	51	137	8	0	196
39392	25198s (+0.8s)	3488	3488	256	87	189	15	0	291
39393	25198s (+0.6s)	1900	1900	128	47	133	14	0	194
39394	25199s (+0.9s)	3652	3652	256	58	226	0	16	300
39395	25200s (+0.5s)	1792	1792	128	37	138	0	8	183
39396	25201s (+1.1s)	5628	5628	512	108	270	16	1	395
39397	25202s (+0.6s)	2312	2312	256	35	152	5	0	192
39398	25202s (+0.6s)	2568	2568	256	45	172	5	0	222
39399	25203s (+0.4s)	1468	1468	128	30	115	6	0	151
Episode	Time	Reward	Score	Highest	L	U	R	D	Steps
39400	25203s (+0.5s)	1620	1620	128	46	117	9	0	172
39401	25204s (+0.7s)	2756	2756	128	63	179	13	0	255
39402	25204s (+0.3s)	916	916	64	26	88	6	0	120
39403	25205s (+0.6s)	1944	1944	128	57	139	8	0	204
39404	25206s (+0.9s)	3964	3964	256	80	225	20	0	325
39405	25207s (+0.9s)	3588	3588	256	54	242	9	0	305
39406	25207s (+0.8s)	3400	3400	256	72	194	15	0	281
39407	25208s (+0.2s)	476	476	64	14	49	0	3	66
39408	25208s (+0.6s)	2264	2264	128	42	165	0	9	216
39409	25209s (+0.5s)	1808	1808	128	38	142	0	7	187
39410	25209s (+0.2s)	308	308	32	9	44	0	3	56
39411	25209s (+0.4s)	1432	1432	128	29	113	0	9	151
39412	25210s (+0.8s)	3468	3468	256	74	196	16	0	286
39413	25211s (+0.7s)	2664	2664	256	63	161	10	0	234
39414	25211s (+0.5s)	1684	1684	128	38	122	12	0	172
39415	25212s (+0.5s)	1844	1844	128	39	139	7	0	185
39416	25213s (+0.7s)	2756	2756	256	48	174	11	0	233
39417	25213s (+0.4s)	1304	1304	128	40	94	6	0	140
39418	25214s (+0.5s)	1964	1964	128	46	135	7	0	188
39419	25214s (+0.5s)	2120	2120	256	40	128	10	0	178
39420	25215s (+0.7s)	2744	2744	256	64	159	12	0	235
39421	25215s (+0.5s)	1728	1728	128	39	126	11	0	176
39422	25216s (+0.3s)	1108	1108	128	24	91	6	1	122
39423	25216s (+0.7s)	3132	3132	256	52	202	8	0	262
39424	25217s (+0.5s)	1788	1788	128	52	123	7	0	182
39425	25218s (+0.8s)	3292	3292	256	68	196	11	0	275
39426	25218s (+0.5s)	1748	1748	128	48	114	14	0	176
39427	25219s (+0.8s)	3724	3724	256	81	214	11	0	306
39428	25220s (+0.7s)	2984	2984	256	67	169	7	0	243
39429	25220s (+0.3s)	1004	1004	128	23	81	0	2	106
39430	25221s (+0.7s)	3012	3012	256	54	179	0	16	249
39431	25221s (+0.3s)	740	740	64	18	73	0	4	95
39432	25222s (+0.7s)	2816	2816	256	47	188	0	12	247
39433	25223s (+1.0s)	4380	4380	256	105	238	21	0	364
39434	25224s (+0.9s)	3796	3796	256	71	219	14	1	305
39435	25224s (+0.5s)	1728	1728	128	43	128	7	0	178
39436	25225s (+0.7s)	2796	2796	256	48	188	6	0	242
39437	25226s (+0.8s)	3252	3252	256	61	200	8	0	269
39438	25226s (+0.4s)	1424	1424	128	41	97	6	1	145
39439	25227s (+0.8s)	2888	2888	128	80	174	19	0	273
39440	25227s (+0.5s)	1592	1592	128	42	116	7	0	165
39441	25228s (+0.8s)	3444	3444	256	75	194	16	0	285
39442	25229s (+0.8s)	3316	3316	256	64	188	20	0	272
39443	25230s (+1.1s)	5424	5424	512	102	265	16	1	384
39444	25231s (+0.7s)	2716	2716	256	45	178	9	0	232
39445	25231s (+0.2s)	668	668	64	16	70	1	0	87
39446	25232s (+0.8s)	3164	3164	256	73	184	9	0	266
39447	25233s (+0.8s)	3444	3444	256	78	193	13	1	285
39448	25233s (+0.8s)	3556	3556	256	74	207	14	0	295
39449	25234s (+0.8s)	3416	3416	256	80	192	12	0	284
39450	25235s (+0.4s)	1304	1304	128	35	95	4	0	134
39451	25235s (+0.8s)	3424	3424	256	77	196	13	0	286
39452	25236s (+0.7s)	2780	2780	256	65	163	14	0	242
39453	25237s (+0.5s)	1636	1636	128	46	117	10	0	173
39454	25237s (+0.8s)	3260	3260	256	69	202	7	0	278
39455	25238s (+0.4s)	1120	1120	64	36	85	7	0	128
39456	25238s (+0.7s)	2896	2896	256	58	177	15	0	250
39457	25239s (+0.4s)	1372	1372	128	35	102	6	1	144
39458	25239s (+0.3s)	968	968	64	29	87	5	0	121
39459	25240s (+0.8s)	3352	3352	256	72	189	13	0	274
39460	25241s (+0.7s)	2940	2940	256	52	201	8	0	261
39461	25241s (+0.3s)	680	680	32	28	64	6	0	98
39462	25241s (+0.4s)	1444	1444	128	25	110	0	5	140
39463	25242s (+0.5s)	1624	1624	128	41	126	0	6	173
39464	25242s (+0.3s)	1028	1028	64	31	86	0	6	123
39465	25243s (+0.7s)	2912	2912	256	42	202	0	11	255
39466	25244s (+0.9s)	4136	4136	256	70	255	0	16	341
39467	25244s (+0.2s)	524	524	64	8	60	0	2	70
39468	25245s (+0.7s)	2912	2912	256	49	199	0	7	255
39469	25246s (+0.7s)	2900	2900	256	58	181	0	12	251
39470	25246s (+0.3s)	1048	1048	128	17	92	0	4	113
39471	25247s (+0.7s)	2812	2812	256	52	186	0	8	246
39472	25248s (+1.2s)	6028	6028	512	133	268	25	0	426
39473	25249s (+0.6s)	2548	2548	256	44	167	10	0	221
39474	25249s (+0.6s)	2472	2472	256	51	147	12	0	210
39475	25250s (+0.9s)	3540	3540	256	74	205	20	0	299
39476	25251s (+0.5s)	1816	1816	128	44	136	4	0	184
39477	25251s (+0.3s)	876	876	64	24	87	4	0	115
39478	25251s (+0.6s)	2556	2556	256	51	167	7	0	225
39479	25253s (+1.2s)	5716	5716	512	102	288	21	1	412
39480	25254s (+0.9s)	3688	3688	256	91	205	13	0	309
39481	25254s (+0.5s)	2192	2192	256	39	139	10	0	188
39482	25255s (+0.4s)	1368	1368	128	34	108	5	0	147
39483	25255s (+0.4s)	1496	1496	128	38	110	8	1	157
39484	25256s (+0.7s)	2728	2728	256	67	150	13	0	230
39485	25256s (+0.5s)	1852	1852	128	59	119	9	0	187
39486	25257s (+0.8s)	3232	3232	256	71	185	14	0	270
39487	25258s (+0.7s)	2792	2792	256	64	167	10	0	241
39488	25258s (+0.3s)	1028	1028	128	23	82	6	0	111
39489	25259s (+0.9s)	3620	3620	256	79	213	15	0	307
39490	25260s (+0.7s)	2920	2920	256	64	184	8	0	256
39491	25261s (+1.4s)	7192	7192	512	135	333	29	0	497
39492	25261s (+0.4s)	1440	1440	128	47	98	11	0	156
39493	25262s (+0.6s)	2476	2476	256	42	161	7	1	211
39494	25263s (+1.3s)	6340	6340	512	116	317	20	1	454
39495	25264s (+0.9s)	4008	4008	256	73	244	11	0	328
39496	25265s (+1.0s)	4372	4372	256	91	257	19	0	367
39497	25266s (+0.5s)	1608	1608	128	46	116	7	0	169
39498	25266s (+0.5s)	1492	1492	128	36	113	8	0	157
39499	25267s (+0.8s)	3416	3416	256	68	192	14	1	275
Episode	Time	Reward	Score	Highest	L	U	R	D	Steps
39500	25268s (+0.8s)	3732	3732	256	68	225	11	0	304
39501	25268s (+0.4s)	1140	1140	64	49	82	5	0	136
39502	25269s (+1.0s)	5076	5076	512	95	255	15	0	365
39503	25270s (+0.8s)	3512	3512	256	87	195	10	0	292
39504	25271s (+0.9s)	3484	3484	256	71	215	11	0	297
39505	25271s (+0.4s)	1228	1228	128	26	97	0	3	126
39506	25272s (+0.6s)	2404	2404	128	48	168	0	8	224
39507	25273s (+0.5s)	1804	1804	128	44	135	0	8	187
39508	25273s (+0.4s)	1356	1356	128	20	120	0	2	142
39509	25273s (+0.4s)	1172	1172	64	25	106	0	9	140
39510	25274s (+0.5s)	1532	1532	128	37	113	9	0	159
39511	25274s (+0.4s)	1472	1472	128	34	112	5	0	151
39512	25275s (+0.5s)	1744	1744	128	38	132	7	0	177
39513	25276s (+1.1s)	5496	5496	512	86	274	18	0	378
39514	25276s (+0.5s)	1748	1748	128	44	121	12	0	177
39515	25277s (+0.9s)	4008	4008	256	92	223	14	0	329
39516	25278s (+0.3s)	864	864	64	27	79	6	0	112
39517	25278s (+0.6s)	2652	2652	256	41	178	8	0	227
39518	25279s (+1.0s)	4184	4184	256	102	220	15	0	337
39519	25280s (+0.5s)	1652	1652	128	50	114	11	0	175
39520	25281s (+0.8s)	3396	3396	256	75	205	10	0	290
39521	25281s (+0.8s)	3188	3188	256	56	203	7	0	266
39522	25282s (+0.6s)	2388	2388	128	65	149	10	0	224
39523	25283s (+0.8s)	3404	3404	256	58	218	14	0	290
39524	25283s (+0.6s)	1928	1928	128	54	134	7	0	195
39525	25284s (+0.8s)	3352	3352	256	71	195	15	0	281
39526	25285s (+1.0s)	4204	4204	256	85	236	20	0	341
39527	25286s (+0.4s)	1388	1388	128	30	107	5	0	142
39528	25286s (+0.6s)	1920	1920	128	43	152	0	3	198
39529	25287s (+0.4s)	1304	1304	128	25	111	0	6	142
39530	25287s (+0.3s)	876	876	64	17	82	0	6	105
39531	25287s (+0.4s)	1304	1304	128	36	96	9	1	142
39532	25288s (+0.7s)	2788	2788	256	69	159	12	0	240
39533	25289s (+0.8s)	3492	3492	256	78	196	18	0	292
39534	25290s (+0.7s)	2860	2860	256	47	192	7	0	246
39535	25290s (+0.6s)	1976	1976	128	52	138	11	0	201
39536	25291s (+0.4s)	1492	1492	128	34	119	4	0	157
39537	25291s (+0.4s)	1504	1504	128	41	114	4	0	159
39538	25291s (+0.5s)	1520	1520	128	34	121	5	0	160
39539	25292s (+0.6s)	2240	2240	128	43	163	0	9	215
39540	25292s (+0.3s)	760	760	64	25	73	0	5	103
39541	25293s (+0.8s)	3536	3536	256	56	232	0	10	298
39542	25294s (+1.2s)	5720	5720	512	84	300	0	19	403
39543	25295s (+0.2s)	536	536	64	11	57	0	5	73
39544	25295s (+0.4s)	1404	1404	128	38	102	10	0	150
39545	25296s (+1.2s)	5964	5964	512	101	295	19	1	416
39546	25297s (+0.9s)	3972	3972	256	93	224	10	0	327
39547	25298s (+0.6s)	2536	2536	128	50	177	7	0	234
39548	25299s (+0.8s)	3412	3412	256	75	197	16	0	288
39549	25299s (+0.7s)	3248	3248	256	54	199	8	0	261
39550	25300s (+0.5s)	1520	1520	128	46	110	7	0	163
39551	25300s (+0.5s)	1732	1732	128	47	119	8	0	174
39552	25301s (+1.0s)	4056	4056	256	88	229	19	1	337
39553	25302s (+0.7s)	2532	2532	128	67	159	11	0	237
39554	25302s (+0.5s)	1512	1512	128	36	117	9	0	162
39555	25303s (+0.4s)	1380	1380	128	32	110	0	4	146
39556	25303s (+0.6s)	2028	2028	128	41	143	0	10	194
39557	25304s (+0.9s)	4132	4132	256	68	253	0	17	338
39558	25305s (+0.4s)	1224	1224	128	29	98	0	7	134
39559	25305s (+0.5s)	1772	1772	128	47	128	0	8	183
39560	25306s (+0.5s)	1776	1776	128	35	135	0	10	180
39561	25306s (+0.5s)	2024	2024	256	32	131	0	5	168
39562	25307s (+0.7s)	3104	3104	256	77	164	15	0	256
39563	25308s (+0.7s)	2916	2916	256	59	178	13	0	250
39564	25309s (+1.0s)	4232	4232	256	99	233	13	0	345
39565	25309s (+0.4s)	1032	1032	64	31	86	9	0	126
39566	25310s (+0.5s)	1704	1704	128	41	129	4	0	174
39567	25310s (+0.4s)	1300	1300	128	26	104	7	0	137
39568	25311s (+0.8s)	3352	3352	256	74	202	8	0	284
39569	25311s (+0.4s)	1248	1248	128	27	101	5	0	133
39570	25312s (+0.6s)	1952	1952	128	55	134	10	0	199
39571	25313s (+0.8s)	3260	3260	256	68	192	13	0	273
39572	25313s (+0.2s)	488	488	64	14	55	2	1	72
39573	25313s (+0.5s)	1828	1828	128	36	147	8	0	191
39574	25314s (+0.2s)	452	452	32	12	57	0	5	74
39575	25314s (+0.9s)	3948	3948	256	94	211	16	0	321
39576	25315s (+0.6s)	2664	2664	256	50	167	9	0	226
39577	25316s (+0.7s)	2696	2696	256	54	170	13	0	237
39578	25316s (+0.5s)	1744	1744	128	46	121	8	0	175
39579	25317s (+0.5s)	1584	1584	128	45	113	5	0	163
39580	25318s (+1.2s)	5868	5868	512	113	286	22	0	421
39581	25319s (+1.1s)	5388	5388	512	98	258	18	1	375
39582	25320s (+0.6s)	1916	1916	128	53	135	9	0	197
39583	25320s (+0.5s)	1608	1608	128	42	112	8	1	163
39584	25321s (+0.7s)	3140	3140	256	72	180	12	0	264
39585	25321s (+0.5s)	1824	1824	128	38	149	0	4	191
39586	25322s (+0.3s)	792	792	64	16	85	0	4	105
39587	25322s (+0.3s)	1004	1004	64	20	95	0	5	120
39588	25323s (+0.5s)	1616	1616	128	33	118	0	9	160
39589	25323s (+0.2s)	500	500	32	19	58	0	3	80
39590	25323s (+0.7s)	2936	2936	256	53	196	0	11	260
39591	25324s (+0.6s)	2264	2264	128	59	143	12	0	214
39592	25325s (+0.5s)	2116	2116	256	40	127	9	0	176
39593	25325s (+0.8s)	3236	3236	256	68	192	12	0	272
39594	25326s (+0.9s)	3960	3960	256	89	223	12	0	324
39595	25327s (+1.0s)	4040	4040	256	89	237	13	0	339
39596	25328s (+0.5s)	1680	1680	128	35	128	7	1	171
39597	25328s (+0.6s)	1904	1904	128	49	134	10	1	194
39598	25330s (+1.3s)	6748	6748	512	116	321	28	0	465
39599	25330s (+0.5s)	1848	1848	128	40	144	5	0	189
Episode	Time	Reward	Score	Highest	L	U	R	D	Steps
39600	25331s (+0.6s)	2308	2308	256	53	136	12	0	201
39601	25332s (+0.7s)	2924	2924	256	70	175	12	0	257
39602	25332s (+0.4s)	1460	1460	128	33	115	4	1	153
39603	25333s (+0.6s)	2384	2384	128	61	153	10	0	224
39604	25334s (+0.9s)	4004	4004	256	95	226	14	0	335
39605	25334s (+0.6s)	2604	2604	256	50	154	12	0	216
39606	25335s (+1.0s)	4224	4224	256	89	239	22	0	350
39607	25336s (+0.7s)	2728	2728	256	48	181	0	7	236
39608	25336s (+0.4s)	1168	1168	64	32	98	0	10	140
39609	25337s (+0.7s)	2780	2780	256	45	184	0	9	238
39610	25338s (+0.9s)	3740	3740	256	59	235	0	16	310
39611	25339s (+0.7s)	3048	3048	256	52	185	12	1	250
39612	25339s (+0.6s)	2480	2480	128	59	161	12	0	232
39613	25340s (+0.8s)	3488	3488	256	69	198	17	0	284
39614	25341s (+0.5s)	1544	1544	128	32	130	2	1	165
39615	25341s (+0.7s)	2916	2916	256	68	173	14	0	255
39616	25342s (+0.8s)	3552	3552	256	61	212	13	1	287
39617	25343s (+0.6s)	2636	2636	256	59	152	13	0	224
39618	25343s (+0.7s)	2740	2740	256	58	169	12	0	239
39619	25344s (+0.5s)	1736	1736	128	47	116	12	0	175
39620	25345s (+1.0s)	4864	4864	256	75	270	13	1	359
39621	25345s (+0.3s)	640	640	64	24	56	8	0	88
39622	25345s (+0.2s)	468	468	64	11	54	0	0	65
39623	25346s (+0.5s)	1620	1620	128	40	114	7	0	161
39624	25346s (+0.5s)	1620	1620	128	39	124	9	0	172
39625	25347s (+0.6s)	2256	2256	128	54	151	9	0	214
39626	25347s (+0.4s)	1060	1060	64	28	94	0	6	128
39627	25348s (+0.5s)	1800	1800	128	37	136	7	0	180
39628	25348s (+0.5s)	1624	1624	128	41	128	4	0	173
39629	25349s (+0.8s)	3316	3316	256	80	180	16	0	276
39630	25350s (+0.6s)	2380	2380	128	60	152	11	0	223
39631	25350s (+0.3s)	1028	1028	64	34	81	7	0	122
39632	25351s (+0.4s)	1484	1484	128	35	115	5	0	155
39633	25352s (+1.0s)	4356	4356	256	99	240	24	0	363
39634	25352s (+0.4s)	1468	1468	128	34	116	2	0	152
39635	25353s (+0.5s)	1812	1812	128	47	133	8	0	188
39636	25353s (+0.4s)	1384	1384	128	33	107	5	1	146
39637	25354s (+0.5s)	1816	1816	128	42	135	0	8	185
39638	25354s (+0.8s)	3248	3248	256	55	209	0	11	275
39639	25355s (+0.4s)	1376	1376	128	35	106	1	3	145
39640	25356s (+0.7s)	2976	2976	256	56	198	0	11	265
39641	25356s (+0.7s)	2784	2784	256	52	178	0	9	239
39642	25357s (+0.7s)	3148	3148	256	54	192	0	14	260
39643	25358s (+0.9s)	3996	3996	256	70	247	0	16	333
39644	25359s (+0.9s)	3644	3644	256	77	213	20	0	310
39645	25360s (+0.7s)	2692	2692	256	51	171	10	0	232
39646	25360s (+0.6s)	1928	1928	128	53	137	10	0	200
39647	25360s (+0.3s)	704	704	64	26	70	3	0	99
39648	25361s (+0.8s)	3316	3316	256	63	209	9	0	281
39649	25362s (+0.8s)	3228	3228	256	68	193	9	0	270
39650	25363s (+0.7s)	3072	3072	256	61	181	13	0	255
39651	25363s (+0.4s)	1428	1428	128	35	106	5	0	146
39652	25365s (+1.5s)	7512	7512	512	145	352	31	0	528
39653	25365s (+0.6s)	2524	2524	256	57	153	9	0	219
39654	25366s (+0.6s)	2044	2044	128	62	130	15	1	208
39655	25367s (+0.8s)	3456	3456	256	82	186	16	0	284
39656	25367s (+0.7s)	2924	2924	256	63	181	12	1	257
39657	25368s (+0.7s)	2852	2852	256	57	181	10	0	248
39658	25369s (+0.5s)	1668	1668	128	36	133	7	0	176
39659	25370s (+1.0s)	4484	4484	256	99	243	25	0	367
39660	25371s (+1.0s)	4204	4204	256	93	235	19	0	347
39661	25371s (+0.8s)	3268	3268	256	68	196	9	0	273
39662	25372s (+0.4s)	1440	1440	128	34	100	0	14	148
39663	25373s (+0.9s)	4756	4756	512	75	242	0	16	333
39664	25373s (+0.5s)	1776	1776	128	45	122	0	12	179
39665	25374s (+0.8s)	3448	3448	256	96	183	16	1	296
39666	25375s (+0.6s)	2580	2580	256	54	158	8	0	220
39667	25376s (+0.7s)	3144	3144	256	60	186	10	0	256
39668	25377s (+0.9s)	3976	3976	256	81	233	14	0	328
39669	25377s (+0.5s)	1572	1572	128	38	115	8	0	161
39670	25377s (+0.4s)	1216	1216	128	37	88	6	1	132
39671	25378s (+0.5s)	1716	1716	128	38	128	10	0	176
39672	25379s (+0.8s)	3364	3364	256	70	202	15	0	287
39673	25379s (+0.7s)	2836	2836	256	62	171	12	0	245
39674	25380s (+0.6s)	2556	2556	256	65	143	8	0	216
39675	25380s (+0.4s)	1140	1140	64	29	98	10	0	137
39676	25381s (+0.5s)	1848	1848	128	33	132	9	1	175
39677	25382s (+1.0s)	4196	4196	256	79	248	17	0	344
39678	25382s (+0.5s)	1960	1960	128	59	125	13	0	197
39679	25383s (+0.8s)	3564	3564	256	71	218	16	0	305
39680	25384s (+0.4s)	1052	1052	64	29	92	6	0	127
39681	25384s (+0.6s)	2572	2572	256	57	157	9	0	223
39682	25385s (+1.1s)	4512	4512	256	101	257	16	0	374
39683	25386s (+0.6s)	2036	2036	128	49	141	15	0	205
39684	25387s (+0.5s)	2208	2208	256	38	133	7	0	178
39685	25387s (+0.5s)	1636	1636	128	42	112	8	0	162
39686	25388s (+1.3s)	6412	6412	512	99	335	27	0	461
39687	25389s (+0.9s)	3964	3964	256	83	227	15	0	325
39688	25390s (+0.8s)	3780	3780	256	84	202	15	0	301
39689	25391s (+0.5s)	1468	1468	128	42	104	9	0	155
39690	25391s (+0.5s)	1800	1800	128	45	133	7	0	185
39691	25392s (+0.4s)	1460	1460	128	30	115	8	0	153
39692	25392s (+0.5s)	1652	1652	128	51	106	9	0	166
39693	25393s (+1.0s)	4380	4380	256	96	250	22	1	369
39694	25394s (+0.8s)	3536	3536	256	79	192	11	1	283
39695	25394s (+0.5s)	1804	1804	128	45	134	7	0	186
39696	25395s (+0.4s)	1212	1212	64	40	89	5	1	135
39697	25395s (+0.6s)	2240	2240	128	42	165	0	8	215
39698	25396s (+0.7s)	2536	2536	128	53	169	0	19	241
39699	25397s (+0.4s)	1436	1436	128	28	113	0	7	148
Episode	Time	Reward	Score	Highest	L	U	R	D	Steps
39700	25397s (+0.6s)	2372	2372	256	49	143	10	0	202
39701	25398s (+1.0s)	4492	4492	256	96	251	18	0	365
39702	25399s (+0.4s)	1496	1496	128	33	110	6	0	149
39703	25400s (+1.0s)	4112	4112	256	97	235	13	0	345
39704	25401s (+1.1s)	4660	4660	256	113	250	27	0	390
39705	25401s (+0.6s)	2556	2556	256	53	155	7	0	215
39706	25402s (+0.4s)	1148	1148	128	32	87	5	0	124
39707	25403s (+1.0s)	4344	4344	256	115	220	24	0	359
39708	25403s (+0.5s)	1880	1880	128	38	149	6	0	193
39709	25404s (+0.4s)	1264	1264	128	34	101	5	0	140
39710	25404s (+0.7s)	2848	2848	256	68	171	8	1	248
39711	25405s (+0.8s)	3560	3560	256	85	199	20	0	304
39712	25406s (+0.7s)	2912	2912	256	66	178	10	0	254
39713	25407s (+0.5s)	1788	1788	128	44	132	0	6	182
39714	25407s (+0.4s)	1468	1468	128	34	106	0	10	150
39715	25407s (+0.4s)	1376	1376	128	30	97	0	11	138
39716	25408s (+0.4s)	1524	1524	128	30	126	0	2	158
39717	25409s (+0.8s)	3600	3600	256	59	228	0	13	300
39718	25409s (+0.5s)	1568	1568	128	35	123	5	1	164
39719	25410s (+0.8s)	3348	3348	256	59	201	14	0	274
39720	25410s (+0.4s)	1432	1432	128	30	114	5	0	149
39721	25411s (+0.4s)	1304	1304	128	43	92	7	0	142
39722	25411s (+0.5s)	1816	1816	128	49	126	9	0	184
39723	25412s (+0.7s)	2608	2608	128	69	165	13	0	247
39724	25413s (+0.9s)	3848	3848	256	71	228	15	0	314
39725	25414s (+0.8s)	3252	3252	256	63	201	12	0	276
39726	25414s (+0.3s)	1152	1152	128	23	94	5	0	122
39727	25415s (+0.7s)	2704	2704	256	63	158	14	0	235
39728	25415s (+0.4s)	1404	1404	128	34	97	10	0	141
39729	25416s (+1.0s)	5092	5092	512	99	238	20	1	358
39730	25417s (+0.7s)	2876	2876	256	50	185	10	0	245
39731	25418s (+0.9s)	3568	3568	256	82	211	13	0	306
39732	25418s (+0.6s)	2396	2396	128	44	169	8	1	222
39733	25419s (+0.3s)	768	768	64	17	75	7	1	100
39734	25419s (+0.5s)	1812	1812	128	39	144	4	1	188
39735	25420s (+0.4s)	1480	1480	128	29	121	3	0	153
39736	25420s (+0.4s)	1384	1384	128	32	110	4	0	146
39737	25421s (+0.5s)	1700	1700	128	56	108	8	0	172
39738	25421s (+0.6s)	1988	1988	128	52	138	10	0	200
39739	25422s (+0.3s)	880	880	64	21	89	0	3	113
39740	25422s (+0.7s)	3108	3108	256	46	213	0	7	266
39741	25423s (+0.4s)	1320	1320	64	41	105	0	5	151
39742	25423s (+0.3s)	740	740	64	13	82	0	3	98
39743	25423s (+0.4s)	1356	1356	128	27	111	0	2	140
39744	25424s (+0.6s)	2624	2624	256	42	180	0	9	231
39745	25424s (+0.4s)	1036	1036	64	19	99	0	6	124
39746	25426s (+1.1s)	5396	5396	512	90	258	0	22	370
39747	25426s (+0.5s)	1792	1792	128	37	141	0	6	184
39748	25427s (+0.7s)	2724	2724	256	56	171	0	9	236
39749	25428s (+0.9s)	4648	4648	512	65	230	0	19	314
39750	25428s (+0.2s)	456	456	64	9	55	2	0	66
39751	25429s (+0.7s)	2848	2848	256	45	191	7	0	243
39752	25429s (+0.2s)	476	476	64	12	57	1	0	70
39753	25429s (+0.5s)	1540	1540	128	48	106	8	1	163
39754	25430s (+0.7s)	3188	3188	256	56	197	12	0	265
39755	25431s (+1.1s)	4552	4552	256	110	244	21	0	375
39756	25432s (+0.8s)	3336	3336	256	74	196	11	0	281
39757	25432s (+0.5s)	1912	1912	128	33	160	3	0	196
39758	25433s (+0.7s)	2804	2804	256	62	170	11	0	243
39759	25434s (+0.7s)	2836	2836	256	66	172	14	0	252
39760	25435s (+1.3s)	6300	6300	512	124	298	27	0	449
39761	25436s (+0.8s)	3180	3180	256	83	181	13	1	278
39762	25436s (+0.3s)	1072	1072	128	26	83	7	0	116
39763	25437s (+0.5s)	1744	1744	128	46	118	10	0	174
39764	25437s (+0.3s)	868	868	64	27	79	6	0	112
39765	25438s (+0.5s)	1864	1864	128	43	121	11	0	175
39766	25438s (+0.8s)	3344	3344	256	55	219	9	0	283
39767	25439s (+0.4s)	1360	1360	128	30	108	4	0	142
39768	25439s (+0.2s)	472	472	64	7	61	1	0	69
39769	25439s (+0.5s)	1904	1904	128	45	127	0	8	180
39770	25440s (+0.7s)	3164	3164	256	55	195	0	9	259
39771	25441s (+0.8s)	3168	3168	256	59	191	0	16	266
39772	25442s (+0.6s)	2576	2576	256	39	181	0	5	225
39773	25442s (+0.2s)	464	464	64	11	55	0	1	67
39774	25442s (+0.5s)	1648	1648	128	38	118	0	8	164
39775	25443s (+0.4s)	1428	1428	128	28	115	0	3	146
39776	25444s (+0.8s)	3368	3368	256	62	213	0	13	288
39777	25444s (+0.4s)	1180	1180	128	26	98	0	4	128
39778	25444s (+0.5s)	1852	1852	128	48	126	12	0	186
39779	25445s (+0.6s)	2480	2480	256	49	152	11	0	212
39780	25446s (+0.5s)	1856	1856	128	49	131	7	0	187
39781	25446s (+0.8s)	3448	3448	256	81	196	12	0	289
39782	25447s (+0.8s)	3540	3540	256	78	201	18	0	297
39783	25448s (+0.5s)	1864	1864	128	43	136	10	0	189
39784	25448s (+0.6s)	2600	2600	256	54	157	11	0	222
39785	25449s (+0.4s)	1168	1168	128	27	91	8	0	126
39786	25449s (+0.5s)	1588	1588	128	38	118	9	0	165
39787	25450s (+0.6s)	2208	2208	128	57	140	15	0	212
39788	25451s (+0.7s)	2980	2980	256	65	174	13	0	252
39789	25452s (+1.2s)	6196	6196	512	126	277	31	1	435
39790	25453s (+0.8s)	3356	3356	256	71	196	18	0	285
39791	25453s (+0.4s)	1264	1264	128	32	101	3	0	136
39792	25453s (+0.4s)	1436	1436	128	22	120	2	0	144
39793	25454s (+0.7s)	2960	2960	256	69	178	14	0	261
39794	25455s (+0.5s)	1572	1572	128	39	115	7	1	162
39795	25455s (+0.5s)	1744	1744	128	41	130	5	0	176
39796	25456s (+0.4s)	1112	1112	64	30	95	5	0	130
39797	25456s (+0.6s)	1908	1908	128	55	133	7	0	195
39798	25457s (+0.7s)	2916	2916	256	66	177	12	0	255
39799	25458s (+0.8s)	3340	3340	256	68	195	18	0	281
Episode	Time	Reward	Score	Highest	L	U	R	D	Steps
39800	25458s (+0.7s)	2816	2816	256	74	164	9	0	247
39801	25459s (+0.4s)	1012	1012	64	39	81	8	0	128
39802	25459s (+0.5s)	2212	2212	256	51	135	7	0	193
39803	25460s (+0.9s)	3812	3812	256	93	211	20	0	324
39804	25460s (+0.3s)	664	664	64	24	61	5	0	90
39805	25461s (+0.6s)	1908	1908	128	48	138	9	0	195
39806	25462s (+0.5s)	1836	1836	128	57	122	10	0	189
39807	25462s (+0.8s)	3356	3356	256	74	188	12	0	274
39808	25463s (+0.5s)	1496	1496	128	31	121	6	0	158
39809	25463s (+0.4s)	1488	1488	128	36	102	7	1	146
39810	25464s (+0.4s)	1108	1108	64	28	93	0	8	129
39811	25464s (+0.5s)	1628	1628	128	44	112	0	8	164
39812	25465s (+0.7s)	2944	2944	256	47	200	0	11	258
39813	25466s (+0.8s)	3056	3056	256	77	167	19	0	263
39814	25466s (+0.4s)	1564	1564	128	29	120	4	0	153
39815	25467s (+0.6s)	2360	2360	256	54	140	5	0	199
39816	25467s (+0.6s)	1968	1968	128	58	139	8	0	205
39817	25468s (+0.8s)	3508	3508	256	67	218	11	0	296
39818	25469s (+0.8s)	3416	3416	256	76	189	12	0	277
39819	25469s (+0.5s)	1804	1804	128	40	142	4	0	186
39820	25470s (+0.3s)	864	864	64	28	77	6	0	111
39821	25470s (+0.5s)	1900	1900	128	45	138	10	0	193
39822	25472s (+1.3s)	6256	6256	512	116	311	24	0	451
39823	25472s (+0.7s)	3008	3008	256	57	180	9	0	246
39824	25473s (+0.5s)	1776	1776	128	35	140	5	0	180
39825	25474s (+0.8s)	3356	3356	256	68	208	9	0	285
39826	25474s (+0.3s)	1036	1036	128	23	85	5	0	113
39827	25474s (+0.5s)	1800	1800	128	46	127	11	0	184
39828	25475s (+0.9s)	3592	3592	256	79	204	18	0	301
39829	25476s (+0.5s)	1720	1720	128	36	126	8	0	170
39830	25476s (+0.3s)	1124	1124	128	24	91	0	4	119
39831	25477s (+0.8s)	3268	3268	256	48	219	0	12	279
39832	25477s (+0.3s)	1048	1048	64	26	91	0	4	121
39833	25478s (+0.7s)	3040	3040	256	44	199	0	12	255
39834	25479s (+0.6s)	1932	1932	128	36	155	0	10	201
39835	25480s (+1.0s)	4440	4440	256	80	263	0	21	364
39836	25480s (+0.5s)	1832	1832	128	34	127	0	10	171
39837	25481s (+0.5s)	1616	1616	128	39	120	0	12	171
39838	25482s (+1.1s)	5452	5452	512	88	276	0	18	382
39839	25482s (+0.5s)	1624	1624	128	43	123	7	0	173
39840	25483s (+0.6s)	2796	2796	256	44	168	10	0	222
39841	25484s (+0.7s)	2928	2928	256	67	166	11	0	244
39842	25484s (+0.4s)	1184	1184	64	35	103	5	0	143
39843	25485s (+0.5s)	1904	1904	128	46	143	5	0	194
39844	25485s (+0.2s)	472	472	32	16	57	2	0	75
39845	25486s (+0.9s)	3676	3676	256	91	202	17	0	310
39846	25486s (+0.5s)	1804	1804	128	49	127	10	0	186
39847	25487s (+0.5s)	1628	1628	128	42	123	5	1	171
39848	25487s (+0.5s)	1632	1632	128	34	120	10	1	165
39849	25488s (+0.7s)	3144	3144	256	61	187	10	0	258
39850	25488s (+0.4s)	1420	1420	128	41	105	5	0	151
39851	25489s (+0.5s)	1520	1520	128	29	129	5	0	163
39852	25490s (+0.8s)	3396	3396	256	66	198	0	16	280
39853	25491s (+1.2s)	5632	5632	512	87	297	0	22	406
39854	25491s (+0.6s)	2432	2432	256	37	160	0	9	206
39855	25492s (+0.4s)	1488	1488	128	34	115	0	7	156
39856	25492s (+0.3s)	724	724	64	16	77	0	3	96
39857	25493s (+0.5s)	1636	1636	128	34	127	1	3	165
39858	25493s (+0.4s)	1452	1452	128	27	118	0	7	152
39859	25493s (+0.4s)	1228	1228	64	34	101	0	3	138
39860	25494s (+0.9s)	3732	3732	256	70	218	14	0	302
39861	25495s (+0.7s)	2712	2712	256	53	167	9	0	229
39862	25496s (+0.8s)	3296	3296	256	65	200	10	0	275
39863	25496s (+0.7s)	3020	3020	256	46	195	9	0	250
39864	25497s (+0.7s)	2664	2664	256	56	163	10	1	230
39865	25498s (+1.3s)	6604	6604	512	121	318	24	0	463
39866	25499s (+0.5s)	1784	1784	128	45	127	12	0	184
39867	25500s (+0.7s)	2832	2832	256	63	168	15	0	246
39868	25501s (+0.8s)	3464	3464	256	80	193	13	0	286
39869	25501s (+0.5s)	1740	1740	128	35	137	4	0	176
39870	25502s (+0.8s)	3208	3208	256	56	202	8	0	266
39871	25502s (+0.6s)	2360	2360	128	49	157	9	0	215
39872	25503s (+0.7s)	3000	3000	256	73	176	11	0	260
39873	25504s (+0.5s)	1612	1612	128	38	127	5	0	170
39874	25504s (+0.5s)	1776	1776	128	42	132	9	0	183
39875	25505s (+0.4s)	1504	1504	128	33	110	7	0	150
39876	25505s (+0.6s)	2488	2488	256	57	145	11	0	213
39877	25506s (+0.7s)	2584	2584	128	61	167	17	0	245
39878	25507s (+0.7s)	3004	3004	256	62	173	12	0	247
39879	25507s (+0.8s)	3220	3220	256	69	188	11	0	268
39880	25508s (+0.4s)	1220	1220	128	39	91	7	0	137
39881	25508s (+0.5s)	1624	1624	128	46	121	6	0	173
39882	25509s (+0.2s)	580	580	32	23	61	2	0	86
39883	25509s (+0.7s)	2816	2816	256	64	171	10	1	246
39884	25510s (+0.5s)	1784	1784	128	37	134	10	0	181
39885	25510s (+0.6s)	1920	1920	128	49	141	8	0	198
39886	25511s (+0.8s)	3528	3528	256	58	219	0	19	296
39887	25512s (+0.7s)	3124	3124	256	46	202	0	12	260
39888	25512s (+0.4s)	1340	1340	128	30	100	0	4	134
39889	25513s (+0.7s)	2728	2728	256	46	181	0	7	234
39890	25514s (+0.6s)	2576	2576	256	37	176	0	9	222
39891	25514s (+0.8s)	3548	3548	256	72	217	0	12	301
39892	25515s (+0.9s)	3584	3584	256	58	235	0	12	305
39893	25516s (+1.1s)	5664	5664	512	81	301	0	16	398
39894	25517s (+0.8s)	3436	3436	256	58	219	0	9	286
39895	25518s (+0.8s)	3404	3404	256	50	222	0	11	283
39896	25518s (+0.2s)	568	568	64	13	62	0	2	77
39897	25519s (+0.7s)	2668	2668	128	71	173	12	0	256
39898	25520s (+0.7s)	3048	3048	256	67	179	11	0	257
39899	25520s (+0.8s)	3196	3196	256	79	169	18	0	266
Episode	Time	Reward	Score	Highest	L	U	R	D	Steps
39900	25521s (+0.4s)	1480	1480	128	29	119	5	0	153
39901	25521s (+0.4s)	1408	1408	128	39	104	5	0	148
39902	25522s (+0.6s)	2544	2544	256	42	168	7	0	217
39903	25523s (+0.9s)	3872	3872	256	90	205	17	0	312
39904	25523s (+0.5s)	1540	1540	128	46	109	9	0	164
39905	25524s (+0.6s)	2664	2664	256	59	151	15	0	225
39906	25525s (+0.8s)	3536	3536	256	87	198	13	0	298
39907	25525s (+0.4s)	1148	1148	128	31	86	7	0	124
39908	25526s (+0.7s)	2544	2544	128	73	154	12	0	239
39909	25527s (+1.0s)	4488	4488	256	88	260	20	0	368
39910	25527s (+0.3s)	700	700	64	23	63	5	0	91
39911	25528s (+0.8s)	3360	3360	256	57	221	13	0	291
39912	25529s (+0.6s)	2112	2112	128	53	139	15	0	207
39913	25529s (+0.8s)	3236	3236	256	75	182	15	0	272
39914	25530s (+0.4s)	1444	1444	128	36	109	5	0	150
39915	25530s (+0.4s)	1260	1260	128	26	105	5	0	136
39916	25531s (+0.8s)	3244	3244	256	61	197	16	0	274
39917	25531s (+0.4s)	1208	1208	128	38	92	4	0	134
39918	25532s (+0.9s)	3868	3868	256	86	216	20	0	322
39919	25533s (+0.4s)	1076	1076	64	28	98	0	6	132
39920	25533s (+0.6s)	1908	1908	128	38	146	0	8	192
39921	25534s (+0.4s)	1464	1464	128	32	116	1	5	154
39922	25535s (+0.9s)	3592	3592	256	72	217	12	0	301
39923	25535s (+0.8s)	3244	3244	256	70	192	12	0	274
39924	25536s (+1.0s)	4320	4320	256	89	250	19	0	358
39925	25537s (+0.8s)	3200	3200	256	66	193	9	0	268
39926	25538s (+0.6s)	1896	1896	128	44	142	10	0	196
39927	25538s (+0.7s)	2964	2964	256	61	181	6	0	248
39928	25539s (+0.4s)	1492	1492	128	35	113	8	0	156
39929	25539s (+0.6s)	2528	2528	256	52	163	4	0	219
39930	25540s (+0.8s)	3260	3260	256	67	197	14	0	278
39931	25541s (+0.8s)	3228	3228	256	73	182	14	1	270
39932	25542s (+0.7s)	2752	2752	256	55	175	10	0	240
39933	25542s (+0.2s)	552	552	64	12	63	2	0	77
39934	25543s (+0.7s)	2512	2512	128	42	186	0	12	240
39935	25544s (+1.2s)	5944	5944	512	98	313	0	13	424
39936	25545s (+0.7s)	2796	2796	256	48	182	0	12	242
39937	25545s (+0.3s)	1028	1028	128	23	82	0	6	111
39938	25545s (+0.5s)	1500	1500	128	35	120	0	4	159
39939	25546s (+0.5s)	1632	1632	128	30	118	0	13	161
39940	25546s (+0.4s)	1480	1480	128	30	116	0	8	154
39941	25547s (+0.9s)	3516	3516	256	83	197	17	1	298
39942	25548s (+0.9s)	3576	3576	256	79	207	15	0	301
39943	25549s (+0.5s)	1760	1760	128	44	127	9	0	180
39944	25549s (+0.3s)	796	796	64	21	78	7	0	106
39945	25549s (+0.6s)	2124	2124	128	57	145	9	0	211
39946	25550s (+0.2s)	624	624	64	20	63	3	0	86
39947	25551s (+0.9s)	3916	3916	256	92	213	13	0	318
39948	25552s (+0.8s)	3460	3460	256	77	201	13	0	291
39949	25553s (+1.1s)	5364	5364	512	86	271	0	17	374
39950	25553s (+0.5s)	1852	1852	128	36	146	0	5	187
39951	25554s (+0.7s)	2928	2928	256	43	194	1	5	243
39952	25554s (+0.5s)	1608	1608	128	39	123	0	7	169
39953	25555s (+0.6s)	2764	2764	256	43	168	0	13	224
39954	25556s (+0.7s)	2580	2580	256	38	184	0	9	231
39955	25556s (+0.7s)	2436	2436	128	41	182	0	9	232
39956	25557s (+0.6s)	2352	2352	128	45	159	0	12	216
39957	25557s (+0.5s)	1704	1704	128	42	119	0	9	170
39958	25558s (+0.3s)	1160	1160	128	23	97	0	4	124
39959	25558s (+0.4s)	1064	1064	64	25	97	7	1	130
39960	25559s (+0.9s)	4048	4048	256	93	216	15	0	324
39961	25560s (+0.6s)	1996	1996	128	56	142	7	0	205
39962	25560s (+0.5s)	1844	1844	128	51	129	12	0	192
39963	25561s (+0.5s)	1512	1512	128	31	127	4	0	162
39964	25561s (+0.5s)	1516	1516	128	43	117	2	0	162
39965	25562s (+0.8s)	3376	3376	256	83	195	12	0	290
39966	25563s (+0.6s)	2456	2456	256	46	154	8	0	208
39967	25563s (+0.7s)	3072	3072	256	53	188	8	0	249
39968	25564s (+0.6s)	2468	2468	256	63	133	17	0	213
39969	25564s (+0.4s)	1452	1452	128	46	93	9	0	148
39970	25565s (+0.6s)	1912	1912	128	62	127	7	0	196
39971	25566s (+1.0s)	4128	4128	256	87	233	19	0	339
39972	25566s (+0.4s)	1196	1196	64	39	94	11	1	145
39973	25567s (+0.3s)	596	596	32	18	65	6	0	89
39974	25567s (+0.8s)	3660	3660	256	67	215	16	0	298
39975	25568s (+0.6s)	2040	2040	128	48	141	8	1	198
39976	25568s (+0.4s)	1336	1336	128	30	108	7	0	145
39977	25569s (+0.8s)	3252	3252	256	81	177	17	0	275
39978	25570s (+0.4s)	1348	1348	128	31	105	3	0	139
39979	25570s (+0.8s)	3316	3316	256	59	209	8	0	276
39980	25571s (+0.7s)	3128	3128	256	57	186	0	12	255
39981	25572s (+0.9s)	3976	3976	256	82	226	0	20	328
39982	25573s (+0.6s)	2348	2348	256	38	153	0	6	197
39983	25573s (+0.4s)	1280	1280	128	20	109	0	2	131
39984	25573s (+0.4s)	1160	1160	128	27	94	0	6	127
39985	25574s (+0.5s)	1604	1604	128	30	130	0	8	168
39986	25574s (+0.4s)	1376	1376	128	23	108	0	7	138
39987	25575s (+0.7s)	2764	2764	256	46	182	0	8	236
39988	25575s (+0.5s)	2344	2344	256	36	155	0	4	195
39989	25576s (+0.6s)	2456	2456	128	51	159	0	15	225
39990	25577s (+0.8s)	3236	3236	256	55	206	11	0	272
39991	25578s (+0.9s)	3552	3552	256	76	213	13	0	302
39992	25579s (+0.7s)	2992	2992	256	68	174	16	0	258
39993	25579s (+0.3s)	1156	1156	128	26	96	5	0	127
39994	25579s (+0.6s)	2264	2264	128	53	153	10	0	216
39995	25580s (+0.3s)	1080	1080	128	34	77	7	1	119
39996	25580s (+0.4s)	1484	1484	128	42	108	5	0	155
39997	25581s (+0.5s)	1584	1584	128	41	117	6	0	164
39998	25582s (+0.7s)	2896	2896	128	67	190	14	0	271
39999	25582s (+0.8s)	3352	3352	256	84	187	12	1	284
Episode	Time	Reward	Score	Highest	L	U	R	D	Steps
40000	25583s (+0.5s)	1680	1680	128	41	122	9	0	172
40001	25584s (+0.8s)	3568	3568	256	89	193	17	0	299
40002	25585s (+1.3s)	6280	6280	512	117	312	26	1	456
40003	25586s (+0.6s)	1920	1920	128	45	148	5	0	198
40004	25586s (+0.6s)	2664	2664	256	56	158	11	0	225
40005	25587s (+0.5s)	2224	2224	256	40	145	7	0	192
40006	25587s (+0.5s)	1796	1796	128	45	130	8	0	183
40007	25588s (+0.8s)	3312	3312	256	84	174	18	0	276
40008	25589s (+0.6s)	1908	1908	128	45	143	6	1	195
40009	25589s (+0.3s)	892	892	64	19	91	4	0	114
40010	25590s (+0.9s)	3600	3600	256	76	211	15	1	303
40011	25591s (+0.8s)	3200	3200	256	57	201	10	0	268
40012	25591s (+0.6s)	1952	1952	128	41	155	0	5	201
40013	25592s (+0.6s)	1916	1916	128	30	163	0	6	199
40014	25592s (+0.6s)	2576	2576	256	38	179	0	7	224
40015	25593s (+0.8s)	3228	3228	256	56	201	0	12	269
40016	25594s (+0.7s)	2856	2856	256	52	191	0	9	252
40017	25594s (+0.3s)	872	872	64	24	73	0	7	104
40018	25595s (+0.4s)	1540	1540	128	37	116	0	5	158
40019	25595s (+0.3s)	996	996	64	28	91	0	6	125
40020	25596s (+0.7s)	2780	2780	256	54	172	0	12	238
40021	25596s (+0.6s)	2676	2676	256	44	173	0	9	226
40022	25597s (+0.5s)	1792	1792	128	32	140	0	8	180
40023	25597s (+0.5s)	1808	1808	128	31	144	12	0	187
40024	25598s (+0.8s)	3284	3284	256	68	202	9	0	279
40025	25599s (+0.8s)	2928	2928	128	71	196	11	0	278
40026	25599s (+0.5s)	1524	1524	128	38	120	1	1	160
40027	25600s (+0.7s)	2804	2804	256	61	174	9	0	244
40028	25601s (+0.9s)	3788	3788	256	79	216	18	0	313
40029	25602s (+0.7s)	2768	2768	256	62	159	19	0	240
40030	25602s (+0.5s)	1632	1632	128	40	125	6	1	172
40031	25603s (+0.6s)	1936	1936	128	46	146	10	0	202
40032	25603s (+0.4s)	1196	1196	128	38	87	7	0	132
40033	25604s (+0.5s)	1524	1524	128	40	119	5	0	164
40034	25604s (+0.4s)	1284	1284	128	24	108	4	1	137
40035	25605s (+0.7s)	2872	2872	256	56	164	14	1	235
40036	25605s (+0.5s)	2004	2004	256	42	124	4	0	170
40037	25606s (+0.6s)	2548	2548	256	55	160	8	0	223
40038	25607s (+0.8s)	3244	3244	256	68	195	11	0	274
40039	25607s (+0.5s)	1800	1800	128	46	131	8	0	185
40040	25608s (+0.4s)	1484	1484	128	33	116	7	0	156
40041	25608s (+0.6s)	2204	2204	128	56	140	14	0	210
40042	25609s (+0.7s)	3052	3052	256	48	192	9	0	249
40043	25610s (+0.7s)	3080	3080	256	50	188	13	0	251
40044	25610s (+0.4s)	1352	1352	128	29	114	6	0	149
40045	25611s (+0.5s)	1424	1424	128	38	107	6	0	151
40046	25611s (+0.8s)	3200	3200	256	62	195	11	0	268
40047	25612s (+0.9s)	3936	3936	256	100	202	20	1	323
40048	25613s (+0.8s)	3496	3496	256	81	194	19	0	294
40049	25614s (+0.5s)	1536	1536	128	35	119	7	1	162
40050	25614s (+0.8s)	3240	3240	256	63	200	10	0	273
40051	25615s (+0.6s)	1960	1960	128	67	119	13	1	200
40052	25616s (+0.8s)	3752	3752	256	86	207	11	0	304
40053	25616s (+0.6s)	1928	1928	128	36	161	0	3	200
40054	25618s (+1.2s)	6240	6240	512	91	334	0	20	445
40055	25618s (+0.4s)	1432	1432	128	30	110	1	7	148
40056	25619s (+0.4s)	1360	1360	128	33	95	0	7	135
40057	25619s (+0.7s)	2940	2940	256	50	175	0	8	233
40058	25620s (+0.3s)	976	976	64	30	85	5	0	120
40059	25620s (+0.7s)	3160	3160	256	54	198	10	0	262
40060	25621s (+0.4s)	1232	1232	128	36	94	5	0	135
40061	25621s (+0.3s)	1136	1136	128	34	81	6	0	121
40062	25622s (+0.6s)	2564	2564	256	53	170	4	0	227
40063	25623s (+0.9s)	3832	3832	256	80	212	17	0	309
40064	25623s (+0.4s)	1164	1164	64	36	92	5	0	133
40065	25623s (+0.6s)	1916	1916	128	42	149	6	0	197
40066	25625s (+1.0s)	4196	4196	256	69	269	13	0	351
40067	25625s (+0.4s)	1460	1460	128	36	114	4	0	154
40068	25626s (+0.6s)	1912	1912	128	46	143	7	0	196
40069	25626s (+0.7s)	2688	2688	256	58	155	18	0	231
40070	25627s (+0.6s)	1904	1904	128	52	133	9	0	194
40071	25627s (+0.3s)	788	788	64	26	75	4	0	105
40072	25628s (+0.8s)	3436	3436	256	75	202	6	0	283
40073	25629s (+0.7s)	2992	2992	256	57	183	10	0	250
40074	25629s (+0.7s)	2720	2720	256	50	173	11	0	234
40075	25630s (+0.8s)	3256	3256	256	70	194	13	0	277
40076	25631s (+0.5s)	1800	1800	128	48	125	12	0	185
40077	25631s (+0.6s)	2428	2428	128	52	165	6	0	223
40078	25632s (+0.4s)	1256	1256	128	34	93	7	1	135
40079	25632s (+0.5s)	1676	1676	128	44	117	10	0	171
40080	25633s (+0.7s)	2816	2816	256	55	181	7	0	243
40081	25633s (+0.4s)	1196	1196	128	33	90	6	0	129
40082	25634s (+0.4s)	1424	1424	128	31	107	7	0	145
40083	25634s (+0.4s)	1492	1492	128	49	100	7	0	156
40084	25635s (+0.8s)	3456	3456	256	79	191	15	0	285
40085	25635s (+0.3s)	1072	1072	128	34	81	3	0	118
40086	25636s (+0.7s)	2940	2940	256	50	198	0	13	261
40087	25637s (+0.8s)	3228	3228	256	64	183	0	23	270
40088	25637s (+0.7s)	2612	2612	256	50	170	0	7	227
40089	25638s (+0.6s)	2480	2480	256	42	164	0	6	212
40090	25639s (+0.8s)	3548	3548	256	62	213	0	12	287
40091	25639s (+0.4s)	1476	1476	128	32	114	0	10	156
40092	25640s (+0.5s)	1776	1776	128	42	123	0	8	173
40093	25641s (+0.9s)	3848	3848	256	62	235	0	17	314
40094	25641s (+0.6s)	2552	2552	256	46	165	8	0	219
40095	25642s (+0.5s)	1864	1864	128	51	130	8	0	189
40096	25642s (+0.5s)	1568	1568	128	58	96	8	0	162
40097	25643s (+0.6s)	1988	1988	128	54	134	8	0	196
40098	25643s (+0.3s)	1120	1120	128	27	89	3	0	119
40099	25644s (+0.4s)	1384	1384	64	48	92	14	0	154
Episode	Time	Reward	Score	Highest	L	U	R	D	Steps
40100	25644s (+0.7s)	2800	2800	256	65	160	12	0	237
40101	25645s (+0.7s)	3196	3196	256	70	180	12	1	263
40102	25646s (+0.5s)	1688	1688	128	43	119	5	0	167
40103	25646s (+0.4s)	1168	1168	64	37	93	9	0	139
40104	25647s (+0.7s)	2616	2616	128	78	157	13	0	248
40105	25647s (+0.7s)	2484	2484	128	70	153	9	0	232
40106	25648s (+0.4s)	1448	1448	128	35	101	15	1	152
40107	25648s (+0.5s)	1444	1444	128	31	120	5	0	156
40108	25649s (+0.4s)	1040	1040	64	28	90	6	0	124
40109	25649s (+0.6s)	2244	2244	128	52	141	11	1	205
40110	25650s (+0.7s)	2852	2852	256	71	160	14	0	245
40111	25651s (+0.7s)	2752	2752	256	46	184	6	0	236
40112	25652s (+0.9s)	4040	4040	256	88	223	18	0	329
40113	25652s (+0.5s)	1768	1768	128	53	119	9	0	181
40114	25653s (+0.5s)	1832	1832	128	39	138	8	0	185
40115	25654s (+0.9s)	3580	3580	256	76	209	17	0	302
40116	25654s (+0.6s)	2480	2480	256	47	151	4	0	202
40117	25654s (+0.3s)	1104	1104	128	37	75	7	0	119
40118	25655s (+0.4s)	1212	1212	64	40	99	6	0	145
40119	25656s (+1.0s)	4220	4220	256	105	227	14	0	346
40120	25656s (+0.6s)	1920	1920	128	47	144	7	0	198
40121	25657s (+0.5s)	1596	1596	128	55	102	8	1	166
40122	25658s (+1.0s)	4240	4240	256	85	254	15	1	355
40123	25658s (+0.5s)	1632	1632	128	50	114	11	0	175
40124	25659s (+0.6s)	2632	2632	256	62	153	10	0	225
40125	25660s (+0.8s)	3244	3244	256	72	187	12	0	271
40126	25661s (+1.0s)	4196	4196	256	93	239	19	0	351
40127	25661s (+0.4s)	1392	1392	128	41	99	8	0	148
40128	25662s (+0.5s)	1904	1904	128	54	119	8	0	181
40129	25662s (+0.5s)	1844	1844	128	41	139	5	0	185
40130	25663s (+0.8s)	3448	3448	256	83	192	15	2	292
40131	25664s (+1.0s)	4176	4176	256	87	237	22	0	346
40132	25665s (+0.6s)	2560	2560	256	52	167	6	0	225
40133	25666s (+1.0s)	4380	4380	256	106	238	20	0	364
40134	25666s (+0.3s)	904	904	64	26	85	6	0	117
40135	25667s (+0.7s)	2796	2796	256	44	191	0	7	242
40136	25668s (+0.6s)	2576	2576	256	37	175	0	12	224
40137	25668s (+0.4s)	1072	1072	64	21	98	0	10	129
40138	25669s (+0.6s)	2544	2544	256	57	141	13	0	211
40139	25669s (+0.5s)	1796	1796	128	60	116	8	0	184
40140	25670s (+1.0s)	4332	4332	256	82	253	11	0	346
40141	25671s (+0.5s)	1680	1680	128	36	125	11	0	172
40142	25671s (+0.6s)	2536	2536	256	54	157	10	0	221
40143	25672s (+0.6s)	1944	1944	128	47	142	9	0	198
40144	25672s (+0.6s)	2296	2296	256	44	143	10	1	198
40145	25673s (+0.5s)	1596	1596	128	48	109	13	2	172
40146	25673s (+0.4s)	1388	1388	128	37	103	4	0	144
40147	25674s (+0.7s)	3088	3088	256	67	179	11	0	257
40148	25675s (+0.9s)	4056	4056	256	81	229	15	0	325
40149	25676s (+0.6s)	1924	1924	128	51	143	5	0	199
40150	25676s (+0.8s)	3328	3328	256	80	181	18	0	279
40151	25677s (+0.8s)	3356	3356	256	63	205	9	0	277
40152	25678s (+0.6s)	2796	2796	256	53	157	12	0	222
40153	25678s (+0.5s)	1744	1744	128	40	126	9	1	176
40154	25679s (+0.6s)	2616	2616	256	51	154	14	0	219
40155	25680s (+0.8s)	3600	3600	256	71	218	13	0	302
40156	25680s (+0.7s)	3064	3064	256	52	188	11	1	252
40157	25681s (+0.7s)	2872	2872	256	69	166	14	0	249
40158	25682s (+0.7s)	2652	2652	256	54	170	13	0	237
40159	25683s (+0.7s)	2756	2756	256	58	170	9	0	237
40160	25683s (+0.3s)	988	988	128	16	90	1	0	107
40161	25684s (+0.8s)	3720	3720	256	72	215	16	0	303
40162	25684s (+0.5s)	1880	1880	128	49	125	4	1	179
40163	25685s (+0.7s)	2556	2556	128	68	156	13	0	237
40164	25686s (+0.8s)	3408	3408	256	86	186	9	0	281
40165	25686s (+0.7s)	3196	3196	256	56	197	13	0	266
40166	25687s (+0.4s)	1420	1420	128	33	110	2	0	145
40167	25687s (+0.3s)	824	824	64	29	75	3	0	107
40168	25687s (+0.3s)	856	856	64	30	74	6	0	110
40169	25688s (+0.8s)	3512	3512	256	89	191	16	0	296
40170	25689s (+0.5s)	1660	1660	128	35	127	5	0	167
40171	25690s (+0.9s)	4132	4132	256	58	249	0	14	321
40172	25690s (+0.5s)	1620	1620	128	32	121	0	10	163
40173	25691s (+0.7s)	2988	2988	256	44	188	0	13	245
40174	25692s (+0.8s)	3492	3492	256	63	208	0	21	292
40175	25692s (+0.4s)	1484	1484	128	32	116	0	7	155
40176	25693s (+0.6s)	2148	2148	128	37	157	0	9	203
40177	25694s (+0.7s)	2612	2612	256	63	156	0	9	228
40178	25694s (+0.3s)	1072	1072	128	29	87	0	2	118
40179	25694s (+0.3s)	804	804	64	26	73	0	7	106
40180	25695s (+0.8s)	3248	3248	256	55	211	8	0	274
40181	25696s (+0.6s)	2644	2644	256	66	149	11	0	226
40182	25696s (+0.5s)	1992	1992	128	52	124	10	1	187
40183	25697s (+0.6s)	2436	2436	256	47	151	7	0	205
40184	25697s (+0.4s)	1040	1040	64	26	95	3	0	124
40185	25698s (+0.5s)	1768	1768	128	40	129	9	0	178
40186	25699s (+1.1s)	5648	5648	512	116	251	18	0	385
40187	25699s (+0.3s)	656	656	64	23	62	4	0	89
40188	25700s (+0.5s)	1864	1864	128	51	128	9	1	189
40189	25700s (+0.6s)	2476	2476	256	48	153	10	0	211
40190	25701s (+0.5s)	1516	1516	128	40	115	8	0	163
40191	25701s (+0.7s)	2640	2640	256	57	162	9	0	228
40192	25702s (+0.9s)	3908	3908	256	91	211	15	0	317
40193	25703s (+0.7s)	2784	2784	256	56	169	14	0	239
40194	25704s (+0.9s)	3784	3784	256	100	189	18	1	308
40195	25704s (+0.6s)	2424	2424	256	58	140	11	0	209
40196	25705s (+0.6s)	2568	2568	256	57	152	12	1	222
40197	25706s (+0.7s)	2460	2460	128	58	163	11	0	232
40198	25706s (+0.7s)	3132	3132	256	67	182	13	0	262
40199	25707s (+0.6s)	2156	2156	128	59	134	10	0	203
Episode	Time	Reward	Score	Highest	L	U	R	D	Steps
40200	25708s (+0.6s)	2272	2272	256	41	151	7	0	199
40201	25708s (+0.8s)	3508	3508	256	87	184	19	0	290
40202	25709s (+0.5s)	1612	1612	128	49	113	8	0	170
40203	25710s (+1.1s)	5456	5456	512	91	277	12	0	380
40204	25711s (+1.1s)	4456	4456	256	107	242	19	0	368
40205	25711s (+0.3s)	992	992	64	29	83	5	0	117
40206	25712s (+0.6s)	2336	2336	256	41	148	7	0	196
40207	25712s (+0.5s)	1552	1552	64	43	119	9	0	171
40208	25713s (+0.4s)	1568	1568	128	39	112	8	0	159
40209	25713s (+0.5s)	1848	1848	128	53	133	6	0	192
40210	25714s (+0.7s)	3204	3204	256	68	189	11	0	268
40211	25715s (+0.9s)	4112	4112	256	84	248	13	0	345
40212	25716s (+0.6s)	2364	2364	256	45	152	3	1	201
40213	25716s (+0.5s)	1804	1804	128	40	136	9	0	185
40214	25717s (+0.7s)	2804	2804	256	60	169	15	0	244
40215	25718s (+0.7s)	2944	2944	256	49	190	5	0	244
40216	25719s (+1.1s)	5540	5540	512	97	273	23	0	393
40217	25719s (+0.6s)	2384	2384	128	53	150	14	0	217
40218	25720s (+0.6s)	2012	2012	128	57	138	13	0	208
40219	25721s (+0.5s)	2136	2136	256	37	140	4	0	181
40220	25721s (+0.5s)	1616	1616	128	42	113	7	0	162
40221	25722s (+0.8s)	3384	3384	256	69	197	11	0	277
40222	25723s (+1.0s)	5436	5436	512	80	274	20	0	374
40223	25723s (+0.4s)	1492	1492	128	39	109	8	0	156
40224	25724s (+0.5s)	1820	1820	128	43	137	10	0	190
40225	25724s (+0.7s)	3060	3060	256	58	182	10	0	250
40226	25725s (+0.6s)	2132	2132	128	55	141	11	1	208
40227	25726s (+0.7s)	3020	3020	256	53	180	14	1	248
40228	25727s (+0.8s)	3572	3572	256	71	201	15	0	287
40229	25727s (+0.3s)	808	808	64	29	65	6	0	100
40230	25727s (+0.5s)	1640	1640	128	53	112	11	1	177
40231	25728s (+0.8s)	3136	3136	256	50	202	11	0	263
40232	25729s (+0.4s)	1204	1204	64	36	100	7	0	143
40233	25729s (+0.4s)	1504	1504	128	35	120	5	0	160
40234	25730s (+0.9s)	3812	3812	256	94	214	16	0	324
40235	25730s (+0.5s)	1544	1544	128	35	115	9	0	159
40236	25731s (+0.5s)	1768	1768	128	37	136	3	1	177
40237	25732s (+0.9s)	3920	3920	256	83	220	16	0	319
40238	25733s (+0.8s)	3700	3700	256	70	206	16	1	293
40239	25733s (+0.5s)	1752	1752	128	47	121	10	0	178
40240	25734s (+0.8s)	3400	3400	256	69	195	13	0	277
40241	25735s (+0.7s)	3212	3212	256	68	189	9	0	266
40242	25735s (+0.5s)	2280	2280	256	31	158	4	0	193
40243	25736s (+0.6s)	2116	2116	128	61	135	13	0	209
40244	25737s (+0.9s)	3988	3988	256	84	224	16	0	324
40245	25738s (+1.1s)	5660	5660	512	96	283	22	1	402
40246	25739s (+0.7s)	2832	2832	256	71	155	17	0	243
40247	25739s (+0.2s)	636	636	64	17	64	2	0	83
40248	25740s (+0.9s)	3612	3612	256	82	205	18	0	305
40249	25740s (+0.5s)	1620	1620	128	47	115	9	1	172
40250	25741s (+0.6s)	2640	2640	256	58	154	12	0	224
40251	25742s (+0.7s)	2912	2912	256	67	159	13	0	239
40252	25742s (+0.4s)	1236	1236	128	34	95	7	1	137
40253	25743s (+0.5s)	1632	1632	128	46	115	12	1	174
40254	25743s (+0.4s)	1336	1336	128	42	92	4	0	138
40255	25744s (+0.5s)	1804	1804	128	46	132	8	0	186
40256	25744s (+0.5s)	1684	1684	128	34	131	7	0	172
40257	25744s (+0.4s)	1488	1488	128	36	116	5	0	157
40258	25745s (+0.6s)	2188	2188	128	41	152	0	14	207
40259	25746s (+0.7s)	3064	3064	256	61	179	0	10	250
40260	25746s (+0.5s)	1640	1640	128	34	123	0	3	160
40261	25747s (+0.4s)	1496	1496	128	35	113	0	10	158
40262	25747s (+0.4s)	1344	1344	128	19	113	0	9	141
40263	25748s (+0.8s)	3464	3464	256	50	232	0	10	292
40264	25749s (+0.8s)	3184	3184	256	64	183	0	17	264
40265	25750s (+0.8s)	3556	3556	256	57	211	0	20	288
40266	25750s (+0.7s)	3260	3260	256	67	189	0	12	268
40267	25751s (+0.2s)	548	548	64	11	58	0	4	73
40268	25751s (+0.6s)	2596	2596	256	61	152	11	0	224
40269	25752s (+0.5s)	1632	1632	128	43	115	6	0	164
40270	25752s (+0.7s)	3116	3116	256	54	197	8	0	259
40271	25753s (+0.5s)	1532	1532	128	46	108	8	0	162
40272	25753s (+0.3s)	908	908	64	33	80	5	0	118
40273	25754s (+0.9s)	4060	4060	256	80	238	19	0	337
40274	25755s (+1.0s)	5060	5060	512	87	253	20	0	360
40275	25756s (+0.7s)	3160	3160	256	55	196	6	1	258
40276	25756s (+0.3s)	712	712	64	26	67	4	0	97
40277	25757s (+0.3s)	760	760	64	29	70	3	0	102
40278	25757s (+0.9s)	3952	3952	256	89	222	16	0	327
40279	25759s (+1.1s)	5160	5160	512	98	249	21	0	368
40280	25759s (+0.4s)	1280	1280	128	48	81	7	0	136
40281	25759s (+0.6s)	2248	2248	256	61	132	5	0	198
40282	25760s (+0.5s)	1508	1508	128	33	120	7	0	160
40283	25760s (+0.5s)	1744	1744	128	47	128	4	0	179
40284	25761s (+0.9s)	3832	3832	256	79	217	13	0	309
40285	25762s (+0.8s)	3364	3364	256	75	202	10	0	287
40286	25763s (+0.5s)	1796	1796	128	49	123	12	0	184
40287	25763s (+0.6s)	2532	2532	256	61	146	11	0	218
40288	25764s (+0.6s)	2024	2024	128	56	133	13	0	202
40289	25765s (+1.4s)	7188	7188	512	141	322	33	0	496
40290	25766s (+0.6s)	2312	2312	256	29	162	6	0	197
40291	25766s (+0.4s)	1464	1464	128	29	119	7	0	155
40292	25767s (+0.8s)	3200	3200	256	75	188	16	0	279
40293	25768s (+0.9s)	3968	3968	256	80	220	16	0	316
40294	25769s (+0.7s)	3152	3152	256	47	209	11	0	267
40295	25769s (+0.5s)	1888	1888	128	50	135	9	0	194
40296	25770s (+0.4s)	1308	1308	64	39	99	9	1	148
40297	25770s (+0.5s)	1684	1684	128	50	110	13	0	173
40298	25771s (+0.4s)	1456	1456	128	30	118	4	0	152
40299	25771s (+0.7s)	2904	2904	256	66	177	9	0	252
Episode	Time	Reward	Score	Highest	L	U	R	D	Steps
40300	25772s (+0.8s)	3280	3280	256	82	181	13	0	276
40301	25773s (+0.9s)	3972	3972	256	78	238	11	0	327
40302	25774s (+0.6s)	2400	2400	128	68	144	11	0	223
40303	25775s (+1.2s)	5828	5828	512	114	278	24	0	416
40304	25775s (+0.4s)	1308	1308	128	28	108	8	0	144
40305	25776s (+0.4s)	1452	1452	128	26	117	7	1	151
40306	25777s (+0.9s)	3768	3768	256	84	214	19	0	317
40307	25777s (+0.5s)	1796	1796	128	47	126	11	0	184
40308	25778s (+0.4s)	1432	1432	128	29	116	3	0	148
40309	25779s (+0.9s)	3884	3884	256	82	210	22	1	315
40310	25779s (+0.4s)	1348	1348	128	28	107	3	0	138
40311	25780s (+0.6s)	2628	2628	256	54	156	11	0	221
40312	25780s (+0.5s)	1516	1516	128	41	110	8	0	159
40313	25781s (+0.5s)	2200	2200	256	56	119	11	0	186
40314	25782s (+0.8s)	3496	3496	256	73	208	11	0	292
40315	25782s (+0.5s)	1588	1588	128	34	125	9	1	169
40316	25782s (+0.5s)	1600	1600	128	33	123	2	0	158
40317	25783s (+0.9s)	3964	3964	256	91	213	19	0	323
40318	25784s (+0.3s)	784	784	64	32	65	6	0	103
40319	25784s (+0.7s)	2780	2780	128	68	172	18	0	258
40320	25785s (+0.3s)	880	880	64	27	84	4	0	115
40321	25786s (+0.9s)	4092	4092	256	80	237	13	0	330
40322	25786s (+0.5s)	1548	1548	128	31	125	9	1	166
40323	25787s (+0.6s)	2536	2536	256	66	138	17	0	221
40324	25788s (+1.0s)	4224	4224	256	80	248	18	0	346
40325	25789s (+0.7s)	3120	3120	256	58	185	13	0	256
40326	25789s (+0.4s)	1164	1164	64	39	93	6	0	138
40327	25790s (+0.8s)	2912	2912	128	88	174	12	0	274
40328	25790s (+0.6s)	1920	1920	128	44	148	6	0	198
40329	25791s (+0.4s)	1608	1608	128	39	113	8	0	160
40330	25791s (+0.7s)	3112	3112	256	71	166	14	0	251
40331	25792s (+0.5s)	1636	1636	128	32	127	0	7	166
40332	25792s (+0.2s)	484	484	32	12	54	0	6	72
40333	25793s (+0.4s)	1348	1348	128	29	100	9	0	138
40334	25793s (+0.3s)	940	940	128	27	71	4	0	102
40335	25794s (+0.7s)	3036	3036	256	74	159	11	0	244
40336	25794s (+0.4s)	1336	1336	128	33	104	8	0	145
40337	25795s (+0.8s)	3264	3264	256	80	183	15	0	278
40338	25796s (+1.1s)	4536	4536	256	99	255	22	0	376
40339	25797s (+0.7s)	2888	2888	256	59	165	14	0	238
40340	25797s (+0.8s)	3524	3524	256	66	216	13	0	295
40341	25798s (+0.4s)	1456	1456	128	36	111	5	0	152
40342	25798s (+0.6s)	2268	2268	128	53	156	5	1	215
40343	25799s (+0.3s)	948	948	64	30	80	7	0	117
40344	25799s (+0.5s)	1648	1648	128	59	109	6	0	174
40345	25800s (+0.5s)	1776	1776	128	44	132	7	0	183
40346	25800s (+0.6s)	2256	2256	128	61	141	11	0	213
40347	25801s (+0.4s)	1036	1036	64	28	89	6	0	123
40348	25802s (+0.8s)	3356	3356	256	67	200	8	0	275
40349	25802s (+0.2s)	620	620	64	15	65	5	0	85
40350	25802s (+0.7s)	2792	2792	256	55	173	14	0	242
40351	25803s (+0.5s)	1612	1612	128	40	122	8	0	170
40352	25804s (+0.6s)	2708	2708	256	48	155	9	0	212
40353	25804s (+0.4s)	1220	1220	64	38	105	4	0	147
40354	25804s (+0.4s)	1512	1512	128	30	125	6	0	161
40355	25805s (+0.3s)	920	920	64	27	82	3	0	112
40356	25805s (+0.7s)	2804	2804	256	45	183	0	12	240
40357	25806s (+0.6s)	1976	1976	128	34	167	0	6	207
40358	25806s (+0.5s)	1628	1628	128	24	132	0	8	164
40359	25807s (+0.7s)	2996	2996	256	48	197	0	11	256
40360	25808s (+0.8s)	3568	3568	256	54	231	0	16	301
40361	25809s (+0.6s)	2460	2460	256	48	149	9	0	206
40362	25809s (+0.7s)	2552	2552	128	69	157	11	0	237
40363	25810s (+0.9s)	3804	3804	256	109	196	16	0	321
40364	25811s (+0.7s)	2928	2928	256	59	174	10	1	244
40365	25812s (+0.8s)	3236	3236	256	70	188	13	1	272
40366	25812s (+0.4s)	972	972	64	32	86	4	0	122
40367	25813s (+0.9s)	4016	4016	256	91	230	12	0	333
40368	25813s (+0.3s)	940	940	64	30	79	6	0	115
40369	25814s (+0.3s)	952	952	64	22	87	3	0	112
40370	25814s (+0.5s)	2044	2044	256	39	127	4	0	170
40371	25814s (+0.2s)	596	596	64	22	56	0	4	82
40372	25815s (+0.6s)	1944	1944	128	35	158	0	6	199
40373	25815s (+0.4s)	1192	1192	64	29	109	0	7	145
40374	25816s (+0.7s)	3136	3136	256	49	193	0	11	253
40375	25817s (+0.8s)	3456	3456	256	53	219	0	16	288
40376	25818s (+0.6s)	2412	2412	256	31	172	0	6	209
40377	25818s (+0.5s)	1888	1888	128	37	130	0	9	176
40378	25819s (+0.4s)	1632	1632	128	30	125	0	6	161
40379	25819s (+0.8s)	3484	3484	256	66	210	0	14	290
40380	25820s (+0.4s)	1376	1376	128	27	113	0	5	145
40381	25820s (+0.6s)	2496	2496	256	39	168	0	8	215
40382	25821s (+0.7s)	2872	2872	256	60	181	9	0	250
40383	25821s (+0.4s)	1036	1036	64	32	83	8	0	123
40384	25822s (+0.5s)	1728	1728	128	39	133	7	0	179
40385	25823s (+0.6s)	2500	2500	256	54	152	7	0	213
40386	25823s (+0.6s)	2164	2164	128	67	137	12	0	216
40387	25824s (+0.5s)	1912	1912	128	53	125	8	0	186
40388	25824s (+0.3s)	736	736	64	24	69	4	0	97
40389	25824s (+0.4s)	1320	1320	128	34	96	5	0	135
40390	25825s (+0.5s)	1536	1536	128	30	124	7	0	161
40391	25826s (+0.8s)	3332	3332	256	61	199	10	0	270
40392	25826s (+0.3s)	744	744	64	22	73	3	0	98
40393	25827s (+1.0s)	4220	4220	256	72	256	17	0	345
40394	25827s (+0.3s)	872	872	64	33	63	8	0	104
40395	25828s (+0.5s)	1772	1772	128	34	136	12	0	182
40396	25829s (+1.0s)	4180	4180	256	100	218	21	0	339
40397	25830s (+0.8s)	3404	3404	256	71	210	11	0	292
40398	25830s (+0.8s)	3320	3320	256	58	208	0	14	280
40399	25831s (+0.9s)	3644	3644	256	67	222	0	14	303
Episode	Time	Reward	Score	Highest	L	U	R	D	Steps
40400	25832s (+1.0s)	4408	4408	256	74	282	0	11	367
40401	25833s (+0.8s)	3408	3408	256	61	211	0	11	283
40402	25834s (+0.7s)	3248	3248	256	55	210	0	9	274
40403	25835s (+0.6s)	2480	2480	256	44	163	0	7	214
40404	25835s (+0.5s)	1592	1592	128	34	126	0	5	165
40405	25836s (+0.6s)	2652	2652	256	52	170	0	6	228
40406	25836s (+0.7s)	2900	2900	256	47	194	0	10	251
40407	25837s (+0.8s)	3120	3120	256	67	193	10	0	270
40408	25838s (+0.9s)	3864	3864	256	65	241	11	0	317
40409	25838s (+0.2s)	612	612	64	19	60	4	0	83
40410	25839s (+0.7s)	3160	3160	256	82	160	16	0	258
40411	25840s (+0.5s)	1604	1604	128	40	123	5	0	168
40412	25840s (+0.7s)	3012	3012	256	49	183	10	0	242
40413	25841s (+1.1s)	5680	5680	512	102	279	21	0	402
40414	25842s (+0.6s)	2172	2172	128	52	155	11	0	218
40415	25843s (+0.5s)	1980	1980	128	52	121	11	0	184
40416	25843s (+0.9s)	3932	3932	256	84	225	14	0	323
40417	25844s (+0.3s)	804	804	64	29	75	3	1	108
40418	25845s (+1.2s)	5840	5840	512	104	293	22	0	419
40419	25846s (+0.5s)	1792	1792	128	45	129	9	0	183
40420	25846s (+0.6s)	2008	2008	128	54	133	10	1	198
40421	25847s (+0.5s)	1820	1820	128	42	141	7	0	190
40422	25847s (+0.5s)	1916	1916	128	43	132	0	11	186
40423	25848s (+0.8s)	3616	3616	256	64	224	0	15	303
40424	25849s (+0.7s)	3232	3232	256	53	201	0	17	271
40425	25850s (+0.8s)	3448	3448	256	79	201	12	0	292
40426	25850s (+0.6s)	2616	2616	256	60	149	10	0	219
40427	25851s (+0.5s)	1796	1796	128	49	130	6	0	185
40428	25852s (+1.0s)	4428	4428	256	84	266	14	1	365
40429	25852s (+0.5s)	1584	1584	128	40	118	8	1	167
40430	25853s (+0.5s)	1712	1712	128	50	114	8	0	172
40431	25854s (+0.8s)	3352	3352	256	62	203	13	0	278
40432	25854s (+0.8s)	3328	3328	256	76	186	11	0	273
40433	25855s (+0.8s)	3336	3336	256	73	195	12	0	280
40434	25856s (+0.4s)	1328	1328	128	35	97	9	0	141
40435	25857s (+1.1s)	5448	5448	512	106	256	20	0	382
40436	25857s (+0.7s)	2812	2812	256	63	167	15	0	245
40437	25858s (+0.4s)	1148	1148	128	25	95	4	0	124
40438	25858s (+0.4s)	1476	1476	128	48	99	6	0	153
40439	25859s (+0.8s)	3340	3340	256	73	199	9	0	281
40440	25860s (+0.6s)	2252	2252	128	60	145	13	0	218
40441	25860s (+0.7s)	3172	3172	256	63	190	9	0	262
40442	25861s (+0.4s)	1416	1416	128	35	107	8	0	150
40443	25861s (+0.3s)	896	896	64	22	88	5	0	115
40444	25862s (+0.6s)	2588	2588	256	70	146	11	0	227
40445	25862s (+0.4s)	1188	1188	128	29	98	3	0	130
40446	25863s (+1.1s)	5484	5484	512	91	282	14	0	387
40447	25864s (+0.7s)	2964	2964	256	63	175	10	0	248
40448	25864s (+0.4s)	1460	1460	128	41	103	9	0	153
40449	25865s (+0.6s)	2496	2496	256	61	148	7	0	216
40450	25866s (+0.7s)	3048	3048	256	49	198	10	0	257
40451	25866s (+0.5s)	1520	1520	128	45	111	4	0	160
40452	25867s (+0.4s)	1316	1316	128	29	101	0	5	135
40453	25867s (+0.8s)	3464	3464	256	60	219	0	17	296
40454	25868s (+0.4s)	1176	1176	64	32	100	0	9	141
40455	25868s (+0.5s)	1820	1820	128	50	131	8	0	189
40456	25869s (+1.0s)	4188	4188	256	92	231	19	0	342
40457	25870s (+0.6s)	1920	1920	128	53	136	9	0	198
40458	25870s (+0.6s)	2288	2288	256	44	145	7	0	196
40459	25871s (+0.4s)	1524	1524	128	35	115	7	0	157
40460	25872s (+0.6s)	2628	2628	256	46	179	7	0	232
40461	25872s (+0.6s)	1912	1912	128	45	141	10	0	196
40462	25873s (+0.8s)	3528	3528	256	86	193	21	0	300
40463	25874s (+0.7s)	3252	3252	256	62	189	14	0	265
40464	25874s (+0.7s)	3136	3136	256	61	193	9	0	263
40465	25875s (+0.6s)	2076	2076	128	55	144	7	0	206
40466	25876s (+0.5s)	1676	1676	128	32	134	4	0	170
40467	25876s (+0.5s)	1804	1804	128	44	126	7	0	177
40468	25877s (+0.6s)	2380	2380	256	36	157	5	0	198
40469	25877s (+0.4s)	1300	1300	64	47	91	7	0	145
40470	25878s (+0.7s)	2436	2436	128	63	160	13	0	236
40471	25879s (+1.0s)	4876	4876	512	92	233	16	0	341
40472	25879s (+0.6s)	2404	2404	256	36	162	6	0	204
40473	25880s (+0.6s)	2452	2452	256	46	152	10	0	208
40474	25880s (+0.4s)	1276	1276	128	30	103	6	0	139
40475	25881s (+0.5s)	1800	1800	128	51	124	9	0	184
40476	25881s (+0.5s)	1600	1600	128	44	114	9	0	167
40477	25882s (+0.8s)	3660	3660	256	82	222	8	0	312
40478	25882s (+0.3s)	696	696	64	20	74	3	0	97
40479	25883s (+0.5s)	1756	1756	128	32	138	7	1	178
40480	25884s (+0.7s)	2756	2756	256	53	176	8	0	237
40481	25884s (+0.4s)	1504	1504	128	33	123	4	0	160
40482	25885s (+0.6s)	2076	2076	128	61	139	10	0	210
40483	25885s (+0.7s)	3232	3232	256	59	188	13	0	260
40484	25886s (+0.7s)	3200	3200	256	63	190	10	0	263
40485	25887s (+0.9s)	4124	4124	256	79	243	11	0	333
40486	25887s (+0.3s)	1048	1048	128	20	83	5	0	108
40487	25889s (+1.3s)	6544	6544	512	125	309	25	0	459
40488	25889s (+0.4s)	1180	1180	64	40	99	3	0	142
40489	25889s (+0.2s)	616	616	64	17	62	4	1	84
40490	25890s (+0.3s)	720	720	64	26	68	3	0	97
40491	25890s (+0.6s)	1964	1964	128	56	141	7	0	204
40492	25891s (+1.1s)	5188	5188	512	84	278	14	0	376
40493	25892s (+0.4s)	1424	1424	128	37	107	7	0	151
40494	25893s (+0.8s)	3580	3580	256	71	209	17	0	297
40495	25893s (+0.7s)	3052	3052	256	60	183	6	0	249
40496	25894s (+0.9s)	3928	3928	256	75	223	18	0	316
40497	25895s (+0.8s)	3276	3276	256	64	200	0	13	277
40498	25895s (+0.5s)	1436	1436	64	39	112	0	11	162
40499	25896s (+0.2s)	476	476	32	15	60	0	1	76
Episode	Time	Reward	Score	Highest	L	U	R	D	Steps
40500	25896s (+0.2s)	512	512	32	12	58	0	9	79
40501	25897s (+0.8s)	3816	3816	256	59	235	0	12	306
40502	25897s (+0.5s)	2340	2340	256	50	137	7	0	194
40503	25898s (+1.0s)	5016	5016	512	105	230	19	0	354
40504	25899s (+0.5s)	1804	1804	128	51	125	9	0	185
40505	25900s (+0.8s)	3444	3444	256	73	207	12	0	292
40506	25900s (+0.2s)	480	480	32	17	54	3	0	74
40507	25901s (+0.9s)	3616	3616	256	70	223	13	0	306
40508	25901s (+0.6s)	2564	2564	256	52	151	13	1	217
40509	25902s (+0.9s)	3964	3964	256	84	233	13	0	330
40510	25904s (+1.1s)	5684	5684	512	103	286	15	0	404
40511	25904s (+0.5s)	1656	1656	128	55	113	8	0	176
40512	25905s (+0.9s)	3760	3760	256	95	198	18	0	311
40513	25905s (+0.6s)	2036	2036	128	52	134	10	0	196
40514	25906s (+0.8s)	3272	3272	256	59	200	10	0	269
40515	25907s (+1.0s)	4500	4500	256	95	254	22	0	371
40516	25908s (+0.7s)	2896	2896	256	54	189	7	0	250
40517	25909s (+0.6s)	2248	2248	128	54	149	13	1	217
40518	25910s (+0.9s)	3988	3988	256	87	223	18	0	328
40519	25910s (+0.7s)	2776	2776	256	49	181	7	0	237
40520	25911s (+1.2s)	6484	6484	512	112	309	19	0	440
40521	25912s (+0.4s)	1340	1340	128	24	112	2	0	138
40522	25912s (+0.5s)	1680	1680	128	44	118	9	0	171
40523	25913s (+0.5s)	1676	1676	128	55	109	12	0	176
40524	25914s (+0.8s)	3420	3420	256	66	213	11	0	290
40525	25914s (+0.6s)	2772	2772	256	45	171	7	0	223
40526	25915s (+0.9s)	3608	3608	256	76	219	14	0	309
40527	25916s (+0.8s)	3496	3496	256	71	213	10	0	294
40528	25917s (+1.4s)	7148	7148	512	122	334	29	1	486
40529	25918s (+0.9s)	4088	4088	256	87	228	14	0	329
40530	25919s (+1.0s)	4204	4204	256	99	223	20	0	342
40531	25920s (+0.5s)	1564	1564	128	44	121	4	0	169
40532	25921s (+0.9s)	4588	4588	512	58	243	12	0	313
40533	25921s (+0.6s)	2732	2732	256	50	170	11	0	231
40534	25922s (+0.7s)	3176	3176	256	81	167	14	0	262
40535	25923s (+0.5s)	1508	1508	128	33	123	4	0	160
40536	25923s (+0.5s)	1916	1916	128	47	132	8	0	187
40537	25924s (+1.1s)	4484	4484	256	109	237	21	0	367
40538	25925s (+0.5s)	1800	1800	128	46	122	14	2	184
40539	25926s (+0.7s)	3144	3144	256	80	168	11	0	259
40540	25926s (+0.7s)	2620	2620	256	60	165	5	0	230
40541	25927s (+0.4s)	1172	1172	64	35	98	7	0	140
40542	25927s (+0.4s)	1232	1232	128	48	80	8	0	136
40543	25928s (+1.0s)	4500	4500	256	98	232	18	0	348
40544	25928s (+0.4s)	1456	1456	128	41	102	6	0	149
40545	25929s (+0.8s)	3416	3416	256	74	206	15	0	295
40546	25930s (+0.7s)	3088	3088	256	57	186	13	0	256
40547	25930s (+0.5s)	1680	1680	128	41	125	5	0	171
40548	25931s (+0.8s)	3492	3492	256	75	202	15	0	292
40549	25932s (+0.6s)	2316	2316	128	66	141	16	0	223
40550	25933s (+0.6s)	2612	2612	256	54	165	9	0	228
40551	25933s (+0.6s)	2420	2420	128	64	148	16	0	228
40552	25934s (+0.7s)	2904	2904	256	62	186	8	0	256
40553	25935s (+0.7s)	2608	2608	256	42	172	0	13	227
40554	25935s (+0.4s)	1380	1380	128	43	93	0	8	144
40555	25936s (+0.6s)	1912	1912	128	42	143	0	11	196
40556	25936s (+0.2s)	544	544	32	19	61	0	2	82
40557	25936s (+0.2s)	420	420	32	8	56	0	4	68
40558	25936s (+0.4s)	1052	1052	64	29	90	0	8	127
40559	25937s (+0.2s)	604	604	64	18	62	2	0	82
40560	25938s (+1.1s)	4688	4688	256	104	264	24	1	393
40561	25938s (+0.4s)	1504	1504	128	39	103	8	0	150
40562	25939s (+0.6s)	2352	2352	128	54	151	13	0	218
40563	25939s (+0.4s)	1472	1472	128	46	104	6	0	156
40564	25940s (+0.6s)	2692	2692	256	54	159	12	1	226
40565	25941s (+0.9s)	3544	3544	256	83	199	18	0	300
40566	25941s (+0.3s)	848	848	64	25	78	5	0	108
40567	25942s (+0.8s)	3376	3376	256	66	204	10	0	280
40568	25943s (+1.2s)	5900	5900	512	110	277	23	0	410
40569	25944s (+0.8s)	3464	3464	256	66	206	12	1	285
40570	25944s (+0.3s)	936	936	64	29	77	7	1	114
40571	25945s (+0.2s)	508	508	64	10	62	1	0	73
40572	25945s (+0.4s)	1564	1564	128	44	108	10	0	162
40573	25946s (+0.7s)	2816	2816	256	69	157	14	0	240
40574	25946s (+0.5s)	1892	1892	128	43	140	8	0	191
40575	25947s (+0.5s)	1692	1692	128	35	133	6	0	174
40576	25947s (+0.6s)	2008	2008	128	48	144	11	0	203
40577	25948s (+0.5s)	1640	1640	128	32	133	0	12	177
40578	25948s (+0.4s)	1068	1068	64	28	96	0	7	131
40579	25949s (+0.7s)	3112	3112	256	48	198	0	12	258
40580	25949s (+0.4s)	1304	1304	64	35	96	0	10	141
40581	25950s (+0.4s)	1312	1312	128	43	94	6	0	143
40582	25951s (+0.8s)	3336	3336	256	61	210	9	0	280
40583	25951s (+0.8s)	3536	3536	256	85	202	11	0	298
40584	25952s (+0.5s)	1600	1600	128	34	129	4	0	167
40585	25953s (+1.0s)	4208	4208	256	89	238	16	0	343
40586	25954s (+0.9s)	4172	4172	256	91	239	15	0	345
40587	25954s (+0.5s)	1800	1800	128	41	131	13	0	185
40588	25955s (+0.4s)	1368	1368	128	30	109	3	0	142
40589	25955s (+0.4s)	1420	1420	128	35	106	9	1	151
40590	25956s (+0.7s)	3056	3056	256	54	187	7	0	248
40591	25957s (+0.6s)	2472	2472	256	47	153	10	0	210
40592	25957s (+0.5s)	1616	1616	128	27	129	5	0	161
40593	25958s (+0.7s)	2944	2944	256	63	173	16	0	252
40594	25958s (+0.6s)	2388	2388	128	67	142	16	0	225
40595	25959s (+0.7s)	3216	3216	256	71	184	12	0	267
40596	25960s (+0.5s)	1572	1572	128	40	121	4	0	165
40597	25960s (+0.5s)	1792	1792	128	50	123	10	0	183
40598	25961s (+0.7s)	2968	2968	256	65	176	12	0	253
40599	25961s (+0.5s)	1712	1712	128	44	125	6	0	175
Episode	Time	Reward	Score	Highest	L	U	R	D	Steps
40600	25962s (+0.9s)	3996	3996	256	88	226	19	0	333
40601	25963s (+0.5s)	1880	1880	128	48	132	8	0	188
40602	25963s (+0.5s)	1596	1596	128	38	121	0	7	166
40603	25964s (+0.4s)	1184	1184	64	38	100	5	0	143
40604	25964s (+0.5s)	1756	1756	128	50	118	11	0	179
40605	25965s (+0.4s)	1452	1452	128	34	111	7	0	152
40606	25965s (+0.6s)	2484	2484	256	53	151	8	0	212
40607	25966s (+0.9s)	3796	3796	256	82	210	13	0	305
40608	25967s (+0.6s)	2204	2204	128	45	157	9	0	211
40609	25967s (+0.6s)	2204	2204	128	65	126	16	0	207
40610	25968s (+0.8s)	3260	3260	256	79	186	12	1	278
40611	25969s (+0.7s)	2760	2760	128	69	173	15	0	257
40612	25970s (+0.7s)	2936	2936	256	51	185	9	0	245
40613	25970s (+0.4s)	1436	1436	128	34	108	6	0	148
40614	25970s (+0.3s)	884	884	64	27	85	4	0	116
40615	25971s (+0.5s)	1640	1640	128	41	117	5	0	163
40616	25972s (+0.9s)	4052	4052	256	80	237	18	0	335
40617	25973s (+0.8s)	3484	3484	256	72	204	13	0	289
40618	25973s (+0.7s)	2928	2928	256	47	192	0	10	249
40619	25974s (+0.7s)	3284	3284	256	67	200	0	11	278
40620	25975s (+0.6s)	2556	2556	256	45	170	0	5	220
40621	25975s (+0.5s)	1500	1500	128	33	119	0	7	159
40622	25976s (+0.8s)	3200	3200	256	54	203	0	11	268
40623	25977s (+0.5s)	1792	1792	128	40	130	0	9	179
40624	25977s (+0.5s)	1792	1792	128	34	141	0	8	183
40625	25978s (+0.5s)	1860	1860	128	34	143	0	8	185
40626	25978s (+0.2s)	600	600	64	12	70	0	2	84
40627	25978s (+0.6s)	2164	2164	128	44	162	10	0	216
40628	25979s (+0.8s)	3556	3556	256	75	212	16	0	303
40629	25980s (+1.0s)	4320	4320	256	99	236	19	0	354
40630	25981s (+0.8s)	3324	3324	256	82	178	14	1	275
40631	25982s (+0.9s)	3548	3548	256	85	203	13	0	301
40632	25983s (+0.5s)	1888	1888	128	48	135	7	0	190
40633	25983s (+0.4s)	1532	1532	128	51	101	9	0	161
40634	25984s (+0.9s)	4156	4156	256	86	241	14	0	341
40635	25985s (+0.7s)	2784	2784	256	70	161	9	0	240
40636	25985s (+0.8s)	3236	3236	256	84	175	13	0	272
40637	25986s (+0.9s)	3588	3588	256	76	220	10	0	306
40638	25987s (+0.9s)	3528	3528	256	85	200	16	0	301
40639	25988s (+1.1s)	4600	4600	256	104	255	21	0	380
40640	25989s (+0.6s)	2580	2580	256	58	153	9	0	220
40641	25989s (+0.5s)	1500	1500	128	27	127	4	0	158
40642	25990s (+0.5s)	1664	1664	128	40	120	8	0	168
40643	25991s (+0.9s)	3816	3816	256	83	223	14	0	320
40644	25991s (+0.6s)	2428	2428	256	54	141	8	0	203
40645	25992s (+0.8s)	3380	3380	256	66	202	13	0	281
40646	25993s (+0.5s)	1556	1556	128	33	125	3	0	161
40647	25994s (+1.0s)	4928	4928	512	86	247	9	1	343
40648	25994s (+0.5s)	1796	1796	128	38	141	5	0	184
40649	25995s (+0.9s)	3924	3924	256	88	214	18	0	320
40650	25996s (+1.0s)	4188	4188	256	75	254	13	0	342
40651	25997s (+0.6s)	2488	2488	256	57	145	12	0	214
40652	25997s (+0.8s)	3060	3060	256	70	188	13	0	271
40653	25998s (+0.6s)	2200	2200	128	51	154	16	0	221
40654	25999s (+0.7s)	2728	2728	256	61	162	14	0	237
40655	25999s (+0.6s)	2520	2520	256	53	150	7	0	210
40656	26000s (+0.6s)	2592	2592	256	60	157	8	0	225
40657	26001s (+0.6s)	2472	2472	256	58	141	11	0	210
40658	26001s (+0.7s)	2572	2572	128	66	159	17	0	242
40659	26002s (+0.4s)	1440	1440	128	37	108	4	0	149
40660	26002s (+0.7s)	2972	2972	256	69	175	9	0	253
40661	26003s (+0.4s)	1256	1256	128	36	97	1	0	134
40662	26004s (+0.9s)	3944	3944	256	72	235	14	1	322
40663	26004s (+0.4s)	1480	1480	128	43	100	11	0	154
40664	26005s (+0.4s)	1232	1232	128	32	101	2	0	135
40665	26005s (+0.4s)	1316	1316	128	29	108	8	0	145
40666	26005s (+0.3s)	872	872	64	25	84	5	0	114
40667	26006s (+0.6s)	2508	2508	256	60	144	14	0	218
40668	26007s (+0.8s)	3592	3592	256	91	191	19	0	301
40669	26007s (+0.4s)	1312	1312	64	35	104	8	1	148
40670	26008s (+0.8s)	3388	3388	256	79	187	16	0	282
40671	26009s (+0.5s)	1912	1912	128	41	148	7	0	196
40672	26009s (+0.5s)	1700	1700	128	48	120	0	8	176
40673	26009s (+0.3s)	844	844	64	19	83	0	5	107
40674	26010s (+0.3s)	1020	1020	64	28	85	0	8	121
40675	26011s (+0.8s)	3268	3268	256	53	215	0	9	277
40676	26011s (+0.9s)	3864	3864	256	70	227	0	14	311
40677	26012s (+0.5s)	1608	1608	128	32	132	0	5	169
40678	26012s (+0.5s)	1504	1504	128	40	110	0	9	159
40679	26013s (+0.4s)	1476	1476	128	30	115	0	9	154
40680	26014s (+0.9s)	3948	3948	256	72	233	0	16	321
40681	26014s (+0.4s)	1396	1396	128	32	106	0	8	146
40682	26015s (+0.3s)	1092	1092	128	24	88	0	3	115
40683	26015s (+0.3s)	764	764	64	21	75	0	7	103
40684	26015s (+0.7s)	2772	2772	256	47	183	0	6	236
40685	26016s (+0.8s)	3420	3420	256	70	204	0	11	285
40686	26017s (+0.4s)	1244	1244	128	33	94	0	6	133
40687	26017s (+0.6s)	2080	2080	128	48	154	0	8	210
40688	26018s (+0.3s)	664	664	32	23	68	3	0	94
40689	26018s (+0.5s)	1924	1924	128	45	146	8	0	199
40690	26019s (+0.4s)	1140	1140	64	28	98	7	0	133
40691	26019s (+0.7s)	3056	3056	256	53	192	14	0	259
40692	26020s (+0.8s)	3324	3324	256	68	195	12	0	275
40693	26021s (+0.5s)	1812	1812	128	48	126	8	0	182
40694	26021s (+0.6s)	2368	2368	256	56	126	12	0	194
40695	26022s (+0.4s)	1324	1324	128	28	100	8	1	137
40696	26022s (+0.6s)	2448	2448	256	48	148	8	0	204
40697	26023s (+0.6s)	2216	2216	128	61	153	10	0	224
40698	26023s (+0.5s)	2160	2160	256	46	132	7	0	185
40699	26024s (+0.6s)	2728	2728	256	56	159	15	0	230
Episode	Time	Reward	Score	Highest	L	U	R	D	Steps
40700	26024s (+0.4s)	1016	1016	64	39	77	9	1	126
40701	26025s (+1.0s)	4096	4096	256	89	240	12	0	341
40702	26026s (+0.8s)	3224	3224	256	70	192	11	0	273
40703	26027s (+0.5s)	1628	1628	128	48	119	7	0	174
40704	26027s (+0.7s)	2924	2924	256	67	170	6	0	243
40705	26028s (+0.8s)	3284	3284	256	69	189	14	0	272
40706	26028s (+0.3s)	916	916	64	24	92	4	0	120
40707	26029s (+0.6s)	2548	2548	256	49	169	6	0	224
40708	26030s (+0.5s)	1812	1812	128	42	138	7	0	187
40709	26030s (+0.7s)	2768	2768	256	56	172	7	0	235
40710	26031s (+0.7s)	2680	2680	256	53	177	9	1	240
40711	26032s (+0.6s)	2160	2160	128	50	150	15	0	215
40712	26032s (+0.7s)	2916	2916	256	54	191	10	0	255
40713	26033s (+0.5s)	1860	1860	128	56	120	14	0	190
40714	26033s (+0.4s)	1472	1472	128	31	116	6	0	153
40715	26034s (+0.5s)	1552	1552	128	33	126	8	0	167
40716	26035s (+0.8s)	3320	3320	256	52	218	7	0	277
40717	26035s (+0.5s)	2240	2240	256	29	149	0	8	186
40718	26035s (+0.4s)	1124	1124	64	24	106	0	4	134
40719	26036s (+0.4s)	1396	1396	128	28	116	0	5	149
40720	26037s (+0.6s)	2044	2044	128	60	132	12	0	204
40721	26037s (+0.5s)	1732	1732	128	42	123	7	2	174
40722	26037s (+0.5s)	1520	1520	128	41	116	6	0	163
40723	26038s (+0.8s)	3412	3412	256	77	193	14	0	284
40724	26039s (+0.5s)	1676	1676	128	30	133	8	0	171
40725	26040s (+0.8s)	3528	3528	256	71	212	15	0	298
40726	26040s (+0.8s)	3208	3208	256	61	196	8	0	265
40727	26041s (+0.9s)	3804	3804	256	62	243	12	0	317
40728	26042s (+0.4s)	1376	1376	128	36	102	6	0	144
40729	26042s (+0.7s)	2612	2612	256	49	167	12	0	228
40730	26043s (+0.7s)	3220	3220	256	73	182	12	0	267
40731	26044s (+0.7s)	2884	2884	256	70	168	14	0	252
40732	26044s (+0.5s)	1724	1724	128	56	113	9	0	178
40733	26045s (+0.7s)	3312	3312	256	64	195	11	0	270
40734	26046s (+0.7s)	2876	2876	256	47	190	8	0	245
40735	26046s (+0.3s)	832	832	64	26	79	4	0	109
40736	26047s (+0.5s)	1848	1848	128	46	138	0	8	192
40737	26047s (+0.2s)	656	656	64	16	70	1	0	87
40738	26048s (+0.8s)	3412	3412	256	88	186	10	0	284
40739	26048s (+0.4s)	1448	1448	128	28	114	8	0	150
40740	26049s (+0.4s)	1492	1492	128	34	113	10	0	157
40741	26049s (+0.4s)	1284	1284	128	28	100	4	1	133
40742	26050s (+0.6s)	2304	2304	128	62	143	13	1	219
40743	26050s (+0.5s)	1616	1616	128	58	102	11	0	171
40744	26050s (+0.3s)	856	856	64	25	81	4	0	110
40745	26051s (+0.7s)	2792	2792	256	59	170	11	0	240
40746	26052s (+0.6s)	2428	2428	256	47	149	9	0	205
40747	26052s (+0.7s)	3168	3168	256	64	186	10	0	260
40748	26053s (+0.5s)	1664	1664	128	38	122	8	0	168
40749	26054s (+0.7s)	2792	2792	256	48	182	11	0	241
40750	26054s (+0.7s)	2684	2684	256	52	161	17	0	230
40751	26055s (+0.6s)	2320	2320	256	35	152	6	1	194
40752	26056s (+0.9s)	3788	3788	256	64	239	0	10	313
40753	26056s (+0.3s)	868	868	64	18	86	0	4	108
40754	26057s (+0.7s)	3100	3100	256	49	198	0	9	256
40755	26057s (+0.6s)	2768	2768	256	51	172	0	11	234
40756	26058s (+0.5s)	1884	1884	128	30	151	0	9	190
40757	26059s (+0.7s)	3116	3116	256	64	183	0	12	259
40758	26059s (+0.5s)	1736	1736	128	40	128	1	11	180
40759	26060s (+0.8s)	3212	3212	256	55	196	0	17	268
40760	26061s (+0.5s)	1704	1704	128	26	138	0	7	171
40761	26061s (+0.4s)	1300	1300	128	22	107	3	0	132
40762	26062s (+1.0s)	4280	4280	256	100	245	15	0	360
40763	26062s (+0.5s)	1840	1840	128	54	117	12	1	184
40764	26064s (+1.1s)	5548	5548	512	93	274	20	0	387
40765	26064s (+0.8s)	3644	3644	256	78	200	16	0	294
40766	26065s (+0.7s)	2892	2892	256	68	168	13	0	249
40767	26066s (+0.7s)	2912	2912	256	61	183	10	0	254
40768	26067s (+0.8s)	3716	3716	256	75	209	14	0	298
40769	26067s (+0.5s)	1704	1704	128	38	132	7	0	177
40770	26068s (+0.3s)	888	888	64	21	90	6	0	117
40771	26068s (+0.7s)	2780	2780	256	55	168	14	1	238
40772	26069s (+0.9s)	3996	3996	256	81	227	18	0	326
40773	26070s (+0.6s)	1952	1952	128	58	134	9	0	201
40774	26071s (+0.8s)	3240	3240	256	62	199	11	0	272
40775	26071s (+0.3s)	832	832	64	23	79	6	0	108
40776	26071s (+0.5s)	1800	1800	128	37	140	0	8	185
40777	26072s (+0.6s)	2432	2432	256	42	159	0	4	205
40778	26073s (+0.6s)	2428	2428	256	38	165	0	5	208
40779	26073s (+0.6s)	2380	2380	256	38	152	0	8	198
40780	26074s (+0.6s)	2596	2596	256	45	170	0	9	224
40781	26074s (+0.6s)	2496	2496	256	57	149	10	0	216
40782	26075s (+0.8s)	3312	3312	256	84	167	18	0	269
40783	26076s (+0.5s)	1752	1752	128	47	122	8	1	178
40784	26076s (+0.3s)	1136	1136	128	19	100	2	0	121
40785	26077s (+1.0s)	5064	5064	512	83	241	18	0	342
40786	26077s (+0.4s)	1244	1244	128	34	97	8	0	139
40787	26078s (+0.3s)	660	660	64	24	61	5	0	90
40788	26079s (+0.9s)	3588	3588	256	79	206	14	0	299
40789	26079s (+0.6s)	2600	2600	256	50	166	0	9	225
40790	26080s (+0.5s)	1604	1604	128	37	126	0	5	168
40791	26081s (+1.0s)	4012	4012	256	63	255	0	19	337
40792	26081s (+0.8s)	3516	3516	256	73	210	0	15	298
40793	26082s (+0.5s)	1856	1856	128	42	147	0	5	194
40794	26082s (+0.3s)	1044	1044	128	16	93	1	1	111
40795	26083s (+0.5s)	1884	1884	128	42	139	0	9	190
40796	26083s (+0.5s)	1792	1792	128	38	143	2	0	183
40797	26084s (+0.7s)	3204	3204	256	72	174	19	0	265
40798	26085s (+0.9s)	3796	3796	256	90	211	18	0	319
40799	26086s (+0.5s)	1688	1688	128	60	104	9	0	173
Episode	Time	Reward	Score	Highest	L	U	R	D	Steps
40800	26086s (+0.2s)	488	488	32	23	50	5	0	78
40801	26086s (+0.6s)	2556	2556	256	65	146	9	0	220
40802	26087s (+0.8s)	3404	3404	256	55	216	14	1	286
40803	26088s (+0.9s)	3644	3644	256	80	218	15	0	313
40804	26089s (+0.7s)	2904	2904	256	53	171	1	13	238
40805	26089s (+0.4s)	1304	1304	128	27	105	0	5	137
40806	26090s (+0.8s)	3336	3336	256	43	230	0	7	280
40807	26091s (+0.6s)	2148	2148	128	41	149	0	6	196
40808	26091s (+0.7s)	2816	2816	256	57	179	0	11	247
40809	26092s (+0.7s)	2640	2640	256	44	175	0	11	230
40810	26093s (+0.8s)	3208	3208	256	54	200	0	11	265
40811	26093s (+0.7s)	2936	2936	256	44	189	0	13	246
40812	26094s (+0.8s)	3224	3224	256	61	195	0	12	268
40813	26095s (+0.6s)	2508	2508	256	41	165	0	8	214
40814	26095s (+0.6s)	2356	2356	256	42	144	0	12	198
40815	26096s (+0.8s)	3272	3272	256	63	196	0	11	270
40816	26097s (+0.7s)	2824	2824	256	45	194	0	9	248
40817	26098s (+0.6s)	2364	2364	256	42	150	0	8	200
40818	26098s (+0.8s)	3636	3636	256	56	228	0	13	297
40819	26099s (+0.8s)	3588	3588	256	60	212	0	13	285
40820	26100s (+0.5s)	1524	1524	128	46	109	5	0	160
40821	26100s (+0.7s)	2620	2620	256	58	160	11	1	230
40822	26101s (+0.5s)	1660	1660	128	59	108	10	0	177
40823	26102s (+0.8s)	3416	3416	256	77	210	8	0	295
40824	26102s (+0.6s)	1944	1944	128	58	135	6	0	199
40825	26103s (+0.5s)	1636	1636	128	43	125	7	0	175
40826	26103s (+0.6s)	2708	2708	256	68	149	13	0	230
40827	26104s (+0.4s)	1372	1372	128	34	107	5	0	146
40828	26104s (+0.5s)	1500	1500	128	42	107	9	0	158
40829	26105s (+0.8s)	3232	3232	256	64	192	15	0	271
40830	26106s (+0.5s)	1508	1508	128	36	121	4	0	161
40831	26106s (+0.8s)	3220	3220	256	59	198	11	0	268
40832	26107s (+0.6s)	2408	2408	256	54	139	12	0	205
40833	26108s (+0.6s)	2500	2500	256	42	165	0	4	211
40834	26108s (+0.9s)	4024	4024	256	65	247	0	13	325
40835	26109s (+0.4s)	1432	1432	128	28	114	0	1	143
40836	26110s (+0.7s)	3196	3196	256	62	192	0	12	266
40837	26111s (+0.9s)	3776	3776	256	54	245	0	11	310
40838	26111s (+0.4s)	1352	1352	128	20	117	0	7	144
40839	26112s (+0.6s)	2424	2424	128	49	170	0	9	228
40840	26112s (+0.4s)	1440	1440	128	36	109	0	3	148
40841	26113s (+0.8s)	3476	3476	256	66	212	0	10	288
40842	26113s (+0.5s)	1552	1552	64	64	92	14	0	170
40843	26114s (+0.7s)	2688	2688	256	61	158	12	0	231
40844	26115s (+0.5s)	2304	2304	256	42	141	6	0	189
40845	26115s (+0.9s)	3560	3560	256	83	201	20	0	304
40846	26116s (+0.7s)	3148	3148	256	55	191	17	0	263
40847	26117s (+1.1s)	5508	5508	512	84	294	14	0	392
40848	26118s (+0.6s)	1904	1904	128	50	138	7	0	195
40849	26119s (+0.8s)	3532	3532	256	64	208	12	0	284
40850	26119s (+0.6s)	2372	2372	128	59	144	17	0	220
40851	26120s (+0.5s)	1584	1584	128	41	116	7	0	164
40852	26121s (+0.8s)	3400	3400	256	56	211	13	1	281
40853	26121s (+0.5s)	1604	1604	128	43	116	9	0	168
40854	26122s (+0.6s)	2708	2708	256	48	168	10	0	226
40855	26122s (+0.7s)	2832	2832	256	55	184	11	0	250
40856	26123s (+0.3s)	1136	1136	128	31	86	4	0	121
40857	26123s (+0.4s)	1220	1220	128	27	102	5	0	134
40858	26124s (+0.6s)	2228	2228	128	58	141	13	0	212
40859	26124s (+0.7s)	2584	2584	128	56	172	17	0	245
40860	26125s (+0.4s)	1352	1352	128	25	108	6	0	139
40861	26126s (+0.8s)	3264	3264	256	57	197	0	20	274
40862	26126s (+0.4s)	1368	1368	128	30	109	0	4	143
40863	26127s (+0.4s)	1476	1476	128	33	118	0	2	153
40864	26127s (+0.5s)	1676	1676	128	28	137	0	7	172
40865	26128s (+0.9s)	4052	4052	256	76	236	0	21	333
40866	26129s (+0.5s)	2072	2072	128	33	150	0	8	191
40867	26130s (+1.3s)	6296	6296	512	128	298	24	0	450
40868	26131s (+0.9s)	3752	3752	256	82	207	19	0	308
40869	26132s (+0.8s)	3624	3624	256	62	211	15	0	288
40870	26132s (+0.4s)	1352	1352	128	36	100	7	0	143
40871	26133s (+0.8s)	3464	3464	256	73	204	16	0	293
40872	26133s (+0.4s)	1224	1224	64	44	98	6	0	148
40873	26134s (+0.7s)	3048	3048	256	65	168	14	0	247
40874	26135s (+0.6s)	2564	2564	256	51	158	12	0	221
40875	26135s (+0.5s)	1772	1772	128	42	132	6	0	180
40876	26135s (+0.3s)	748	748	64	25	70	4	0	99
40877	26136s (+0.4s)	1432	1432	128	41	105	5	0	151
40878	26136s (+0.4s)	1200	1200	64	44	91	6	2	143
40879	26137s (+0.5s)	1688	1688	128	45	119	9	0	173
40880	26137s (+0.7s)	2916	2916	256	73	159	16	1	249
40881	26138s (+0.8s)	3592	3592	256	68	230	14	0	312
40882	26139s (+0.5s)	1876	1876	128	53	127	12	0	192
40883	26140s (+0.7s)	3268	3268	256	61	198	10	0	269
40884	26140s (+0.3s)	656	656	64	21	64	4	0	89
40885	26140s (+0.7s)	2804	2804	256	53	181	6	0	240
40886	26141s (+0.7s)	2816	2816	256	57	167	14	1	239
40887	26142s (+0.5s)	1760	1760	128	45	124	6	0	175
40888	26142s (+0.8s)	3192	3192	256	68	183	15	0	266
40889	26143s (+0.7s)	2812	2812	256	51	182	13	0	246
40890	26144s (+0.5s)	1720	1720	128	43	126	7	0	176
40891	26144s (+0.7s)	2800	2800	256	45	188	0	10	243
40892	26145s (+0.5s)	1708	1708	128	35	134	0	7	176
40893	26145s (+0.5s)	1780	1780	128	38	133	0	10	181
40894	26146s (+0.8s)	3424	3424	256	78	199	10	0	287
40895	26147s (+0.9s)	3520	3520	256	66	217	13	0	296
40896	26147s (+0.3s)	1040	1040	64	38	77	10	0	125
40897	26148s (+0.9s)	3892	3892	256	74	217	17	0	308
40898	26149s (+0.4s)	1408	1408	128	41	96	8	1	146
40899	26150s (+0.8s)	3524	3524	256	83	198	16	0	297
Episode	Time	Reward	Score	Highest	L	U	R	D	Steps
40900	26150s (+0.8s)	3544	3544	256	61	215	17	1	294
40901	26151s (+0.6s)	2024	2024	128	49	142	13	0	204
40902	26152s (+0.5s)	1796	1796	128	58	112	11	0	181
40903	26152s (+0.6s)	2440	2440	256	54	144	9	0	207
40904	26153s (+0.6s)	2372	2372	128	65	142	14	0	221
40905	26153s (+0.4s)	1252	1252	64	37	94	5	1	137
40906	26154s (+0.7s)	2628	2628	256	51	170	9	1	231
40907	26154s (+0.4s)	1352	1352	128	33	103	7	0	143
40908	26155s (+0.5s)	1632	1632	128	39	130	6	0	175
40909	26155s (+0.6s)	2500	2500	256	62	144	11	0	217
40910	26156s (+0.5s)	1748	1748	128	35	132	0	6	173
40911	26156s (+0.5s)	1832	1832	128	46	131	0	11	188
40912	26157s (+1.0s)	4192	4192	256	66	270	0	14	350
40913	26158s (+0.3s)	984	984	64	22	90	0	5	117
40914	26158s (+0.5s)	1792	1792	128	48	128	6	0	182
40915	26159s (+0.6s)	2420	2420	256	39	156	7	0	202
40916	26159s (+0.4s)	1528	1528	128	42	103	6	0	151
40917	26160s (+0.6s)	2296	2296	128	50	157	9	0	216
40918	26160s (+0.5s)	1812	1812	128	39	137	0	12	188
40919	26161s (+0.4s)	1200	1200	128	28	97	6	0	131
40920	26162s (+0.7s)	3012	3012	256	53	183	12	0	248
40921	26162s (+0.3s)	828	828	64	28	79	3	0	110
40922	26162s (+0.5s)	1768	1768	128	38	130	11	1	180
40923	26163s (+0.5s)	1604	1604	128	51	112	5	0	168
40924	26163s (+0.5s)	2172	2172	256	30	150	8	0	188
40925	26164s (+0.8s)	3544	3544	256	75	215	10	0	300
40926	26165s (+0.8s)	3436	3436	256	73	209	7	0	289
40927	26165s (+0.2s)	456	456	32	23	46	5	0	74
40928	26166s (+0.6s)	2224	2224	128	55	144	12	0	211
40929	26166s (+0.6s)	2500	2500	256	53	159	6	0	218
40930	26167s (+0.5s)	1892	1892	128	44	141	0	7	192
40931	26167s (+0.4s)	1496	1496	128	30	118	0	10	158
40932	26168s (+0.5s)	1752	1752	128	30	142	0	2	174
40933	26168s (+0.4s)	1296	1296	128	25	104	0	11	140
40934	26169s (+0.6s)	1992	1992	128	49	146	6	0	201
40935	26169s (+0.3s)	1036	1036	64	29	90	4	0	123
40936	26170s (+0.8s)	3464	3464	256	73	208	9	0	290
40937	26171s (+1.3s)	6608	6608	512	111	322	24	1	458
40938	26172s (+0.5s)	2104	2104	256	41	126	9	0	176
40939	26173s (+0.8s)	3464	3464	256	68	191	11	1	271
40940	26174s (+0.8s)	3496	3496	256	70	206	17	1	294
40941	26174s (+0.8s)	3596	3596	256	77	207	17	0	301
40942	26175s (+0.8s)	3372	3372	256	69	201	8	1	279
40943	26176s (+1.0s)	5072	5072	512	82	261	20	0	363
40944	26177s (+0.7s)	2816	2816	256	56	183	8	0	247
40945	26178s (+0.6s)	2440	2440	256	57	141	8	0	206
40946	26178s (+0.4s)	1328	1328	128	30	106	1	0	137
40947	26179s (+0.6s)	2140	2140	128	66	124	10	0	200
40948	26179s (+0.8s)	3484	3484	256	69	212	13	0	294
40949	26180s (+0.7s)	2772	2772	256	66	160	15	0	241
40950	26181s (+0.7s)	2988	2988	256	62	190	10	0	262
40951	26182s (+0.9s)	4172	4172	256	91	227	19	0	337
40952	26182s (+0.5s)	2272	2272	256	46	134	10	0	190
40953	26183s (+0.7s)	2904	2904	256	57	182	13	0	252
40954	26183s (+0.4s)	1308	1308	128	35	104	4	0	143
40955	26184s (+0.4s)	1384	1384	128	27	116	3	0	146
40956	26185s (+1.1s)	5172	5172	512	108	237	26	0	371
40957	26186s (+0.6s)	2328	2328	256	34	159	4	0	197
40958	26187s (+1.3s)	6320	6320	512	119	312	23	0	454
40959	26188s (+1.1s)	5768	5768	512	103	284	26	0	413
40960	26188s (+0.4s)	1384	1384	128	31	108	7	0	146
40961	26189s (+0.9s)	4732	4732	512	82	233	13	0	328
40962	26190s (+0.6s)	2680	2680	256	46	173	10	0	229
40963	26191s (+1.2s)	5736	5736	512	107	279	24	0	410
40964	26192s (+0.8s)	3432	3432	256	92	185	14	2	293
40965	26193s (+0.6s)	1884	1884	128	52	135	7	0	194
40966	26193s (+0.6s)	2424	2424	256	56	146	11	0	213
40967	26194s (+0.7s)	3056	3056	256	50	191	7	0	248
40968	26194s (+0.2s)	548	548	64	19	58	2	0	79
40969	26195s (+0.9s)	3600	3600	256	85	208	14	0	307
40970	26196s (+0.6s)	1920	1920	128	52	137	9	0	198
40971	26196s (+0.8s)	3232	3232	256	79	175	16	1	271
40972	26197s (+0.5s)	1396	1396	64	37	112	8	0	157
40973	26197s (+0.5s)	1968	1968	128	52	130	13	0	195
40974	26198s (+0.8s)	3236	3236	256	55	207	9	0	271
40975	26198s (+0.3s)	900	900	64	33	63	11	0	107
40976	26199s (+0.6s)	2164	2164	128	49	156	11	0	216
40977	26200s (+0.9s)	3920	3920	256	70	236	14	0	320
40978	26201s (+0.8s)	3184	3184	256	72	177	15	0	264
40979	26202s (+0.8s)	3368	3368	256	57	217	14	0	288
40980	26202s (+0.3s)	748	748	64	27	69	3	0	99
40981	26202s (+0.5s)	1764	1764	128	35	134	7	0	176
40982	26203s (+0.9s)	3616	3616	256	76	215	15	0	306
40983	26204s (+0.5s)	1508	1508	128	34	123	3	0	160
40984	26204s (+0.3s)	908	908	64	39	71	7	0	117
40985	26204s (+0.4s)	1196	1196	128	25	102	4	0	131
40986	26205s (+0.6s)	2240	2240	128	69	133	13	0	215
40987	26206s (+1.0s)	4836	4836	512	82	243	0	12	337
40988	26207s (+0.6s)	2524	2524	256	47	165	0	10	222
40989	26207s (+0.4s)	1064	1064	64	25	98	0	6	129
40990	26207s (+0.4s)	1308	1308	64	38	103	0	6	147
40991	26208s (+0.7s)	2740	2740	256	44	182	1	7	234
40992	26209s (+0.5s)	1792	1792	128	37	138	0	9	184
40993	26209s (+0.7s)	3072	3072	256	47	191	0	10	248
40994	26210s (+0.5s)	1544	1544	128	33	122	0	9	164
40995	26210s (+0.5s)	1780	1780	128	37	141	0	4	182
40996	26211s (+0.8s)	3320	3320	256	66	200	0	15	281
40997	26212s (+0.5s)	1680	1680	128	33	136	0	3	172
40998	26213s (+0.9s)	4036	4036	256	77	235	0	20	332
40999	26213s (+0.6s)	1932	1932	128	40	155	0	5	200
Episode	Time	Reward	Score	Highest	L	U	R	D	Steps
41000	26214s (+0.7s)	2852	2852	256	48	195	0	8	251
41001	26214s (+0.2s)	656	656	64	13	68	0	5	86
41002	26215s (+0.7s)	2796	2796	256	44	194	0	9	247
41003	26215s (+0.4s)	1328	1328	128	28	102	0	5	135
41004	26216s (+0.5s)	1848	1848	128	39	140	0	7	186
41005	26216s (+0.5s)	1756	1756	128	30	143	0	2	175
41006	26217s (+0.7s)	2836	2836	256	47	186	0	8	241
41007	26218s (+0.7s)	2628	2628	256	41	182	0	9	232
41008	26218s (+0.6s)	2444	2444	256	46	155	0	7	208
41009	26219s (+0.9s)	3552	3552	256	80	208	0	14	302
41010	26220s (+0.3s)	1024	1024	128	18	85	0	5	108
41011	26220s (+0.3s)	872	872	64	26	83	4	0	113
41012	26220s (+0.5s)	1756	1756	128	43	126	10	0	179
41013	26221s (+0.7s)	2808	2808	256	56	179	10	0	245
41014	26222s (+0.9s)	4852	4852	512	92	231	17	0	340
41015	26222s (+0.4s)	1452	1452	128	37	106	5	0	148
41016	26223s (+0.3s)	952	952	128	30	70	3	0	103
41017	26223s (+0.6s)	1988	1988	128	47	157	5	1	210
41018	26224s (+0.5s)	1804	1804	128	42	133	10	0	185
41019	26224s (+0.5s)	1672	1672	128	41	121	7	0	169
41020	26225s (+0.7s)	3204	3204	256	59	192	17	0	268
41021	26226s (+0.7s)	2844	2844	256	67	170	13	0	250
41022	26226s (+0.6s)	2552	2552	256	44	164	7	0	215
41023	26227s (+0.5s)	1516	1516	128	38	121	4	0	163
41024	26227s (+0.4s)	1220	1220	128	32	92	9	0	133
41025	26228s (+0.9s)	4564	4564	512	59	247	11	0	317
41026	26229s (+0.6s)	2504	2504	256	48	158	0	7	213
41027	26230s (+0.9s)	4012	4012	256	65	252	0	15	332
41028	26231s (+0.8s)	3564	3564	256	56	226	0	13	295
41029	26231s (+0.2s)	472	472	64	7	59	0	3	69
41030	26231s (+0.4s)	1388	1388	128	26	107	0	9	142
41031	26232s (+0.8s)	3580	3580	256	65	213	0	13	291
41032	26233s (+1.0s)	4132	4132	256	95	228	16	0	339
41033	26233s (+0.2s)	356	356	32	11	51	1	0	63
41034	26234s (+0.6s)	2660	2660	256	51	167	7	0	225
41035	26234s (+0.5s)	2292	2292	256	51	136	11	0	198
41036	26235s (+0.4s)	1512	1512	128	41	109	7	0	157
41037	26235s (+0.3s)	1224	1224	128	26	92	3	0	121
41038	26236s (+0.8s)	3460	3460	256	80	191	14	0	285
41039	26237s (+0.6s)	2168	2168	128	49	140	13	1	203
41040	26237s (+0.3s)	1052	1052	128	19	89	3	0	111
41041	26238s (+0.6s)	2540	2540	256	69	142	11	0	222
41042	26238s (+0.5s)	1928	1928	128	51	138	11	0	200
41043	26239s (+0.8s)	3384	3384	256	67	201	11	0	279
41044	26239s (+0.4s)	1424	1424	128	27	116	2	0	145
41045	26240s (+0.3s)	928	928	64	24	84	5	0	113
41046	26241s (+1.0s)	4504	4504	256	93	256	19	0	368
41047	26241s (+0.5s)	1596	1596	128	45	113	8	0	166
41048	26242s (+0.8s)	3232	3232	256	64	195	13	0	272
41049	26242s (+0.6s)	2476	2476	256	40	149	12	0	201
41050	26243s (+0.9s)	3864	3864	256	68	236	12	0	316
41051	26244s (+0.5s)	1624	1624	128	49	111	13	0	173
41052	26244s (+0.5s)	1824	1824	128	34	144	0	8	186
41053	26245s (+0.7s)	2948	2948	256	56	190	0	17	263
41054	26246s (+0.5s)	1752	1752	128	33	137	0	8	178
41055	26246s (+0.4s)	1324	1324	128	31	111	0	5	147
41056	26247s (+0.6s)	2616	2616	256	53	160	0	6	219
41057	26247s (+0.6s)	1848	1848	128	38	143	0	11	192
41058	26248s (+0.5s)	1604	1604	128	30	123	0	10	163
41059	26249s (+0.9s)	3900	3900	256	69	229	0	18	316
41060	26250s (+1.0s)	4148	4148	256	71	259	0	10	340
41061	26250s (+0.4s)	1380	1380	128	31	110	0	5	146
41062	26251s (+0.8s)	3496	3496	256	61	215	0	17	293
41063	26252s (+0.6s)	2604	2604	256	44	172	0	10	226
41064	26252s (+0.5s)	1944	1944	128	47	135	7	0	189
41065	26253s (+0.5s)	1744	1744	128	48	123	5	0	176
41066	26254s (+1.1s)	5412	5412	512	96	268	19	0	383
41067	26254s (+0.7s)	2944	2944	256	71	163	9	1	244
41068	26255s (+0.7s)	3008	3008	256	52	179	12	0	243
41069	26256s (+0.9s)	4184	4184	256	93	231	17	0	341
41070	26257s (+1.3s)	6256	6256	512	115	308	27	0	450
41071	26258s (+0.4s)	1504	1504	128	34	109	7	0	150
41072	26258s (+0.5s)	1616	1616	128	36	128	7	0	171
41073	26259s (+0.5s)	1552	1552	128	37	114	8	0	159
41074	26259s (+0.7s)	2816	2816	256	62	170	9	0	241
41075	26260s (+0.3s)	708	708	64	16	75	4	0	95
41076	26260s (+0.4s)	1228	1228	128	29	95	4	0	128
41077	26261s (+0.5s)	1508	1508	128	34	118	8	0	160
41078	26261s (+0.8s)	3416	3416	256	64	208	0	13	285
41079	26262s (+0.4s)	1396	1396	128	21	116	0	6	143
41080	26262s (+0.5s)	1640	1640	128	43	130	0	4	177
41081	26263s (+0.4s)	1380	1380	128	29	104	0	10	143
41082	26263s (+0.6s)	1912	1912	128	40	147	9	0	196
41083	26264s (+0.8s)	3352	3352	256	66	204	14	0	284
41084	26265s (+0.4s)	1224	1224	128	28	100	6	0	134
41085	26265s (+0.4s)	1192	1192	128	32	92	5	1	130
41086	26266s (+0.6s)	2272	2272	128	60	144	12	0	216
41087	26266s (+0.6s)	2876	2876	256	52	176	8	0	236
41088	26268s (+1.4s)	7524	7524	512	146	341	31	1	519
41089	26268s (+0.5s)	1684	1684	128	42	121	9	0	172
41090	26269s (+0.4s)	1288	1288	128	27	105	6	0	138
41091	26270s (+1.1s)	5052	5052	256	115	245	30	1	391
41092	26271s (+1.1s)	5560	5560	512	104	269	20	0	393
41093	26271s (+0.7s)	2456	2456	128	70	143	16	1	230
41094	26272s (+0.4s)	1164	1164	64	36	92	10	0	138
41095	26272s (+0.4s)	1560	1560	128	43	102	9	0	154
41096	26273s (+0.5s)	1708	1708	128	36	132	10	0	178
41097	26274s (+1.0s)	4472	4472	256	104	235	21	0	360
41098	26274s (+0.2s)	628	628	64	14	71	1	0	86
41099	26275s (+0.5s)	1520	1520	128	42	115	0	3	160
Episode	Time	Reward	Score	Highest	L	U	R	D	Steps
41100	26275s (+0.4s)	1280	1280	128	24	105	0	7	136
41101	26276s (+0.6s)	2216	2216	128	38	163	0	8	209
41102	26276s (+0.8s)	3212	3212	256	57	201	0	9	267
41103	26277s (+0.9s)	3660	3660	256	81	209	0	13	303
41104	26278s (+0.5s)	1664	1664	128	37	122	9	0	168
41105	26278s (+0.7s)	2916	2916	256	60	176	12	0	248
41106	26279s (+0.5s)	1676	1676	128	44	117	5	1	167
41107	26280s (+0.8s)	3532	3532	256	60	216	8	0	284
41108	26280s (+0.6s)	2372	2372	128	46	154	0	17	217
41109	26281s (+0.3s)	988	988	64	17	94	0	6	117
41110	26281s (+0.6s)	1940	1940	128	42	152	0	9	203
41111	26282s (+0.5s)	1932	1932	128	34	142	0	10	186
41112	26282s (+0.4s)	1440	1440	128	29	102	0	8	139
41113	26283s (+0.9s)	4016	4016	256	87	220	19	0	326
41114	26284s (+1.3s)	6380	6380	512	126	296	27	0	449
41115	26285s (+0.7s)	2928	2928	256	66	180	12	0	258
41116	26286s (+0.6s)	2312	2312	256	43	147	11	0	201
41117	26287s (+0.9s)	3808	3808	256	69	239	10	0	318
41118	26288s (+1.0s)	4152	4152	256	76	246	14	1	337
41119	26288s (+0.4s)	1360	1360	128	37	109	5	0	151
41120	26289s (+0.6s)	2504	2504	256	57	154	7	0	218
41121	26289s (+0.7s)	2880	2880	256	45	193	10	0	248
41122	26290s (+0.8s)	3152	3152	256	54	196	12	1	263
41123	26291s (+0.6s)	2540	2540	256	44	170	8	0	222
41124	26291s (+0.5s)	1576	1576	128	41	123	4	0	168
41125	26292s (+1.1s)	5712	5712	512	96	291	17	0	404
41126	26293s (+0.4s)	1396	1396	128	25	115	3	0	143
41127	26293s (+0.5s)	1708	1708	128	44	114	10	0	168
41128	26294s (+0.6s)	1900	1900	128	52	135	11	0	198
41129	26294s (+0.4s)	1316	1316	128	40	99	6	0	145
41130	26295s (+0.8s)	3200	3200	256	58	198	12	0	268
41131	26296s (+0.4s)	1344	1344	128	43	99	5	0	147
41132	26296s (+0.7s)	2668	2668	256	50	171	6	0	227
41133	26297s (+0.5s)	2296	2296	256	40	141	9	0	190
41134	26297s (+0.7s)	2660	2660	256	60	166	9	0	235
41135	26298s (+0.7s)	3116	3116	256	60	191	9	0	260
41136	26300s (+1.5s)	7132	7132	512	144	335	27	0	506
41137	26300s (+0.8s)	3108	3108	256	77	169	25	0	271
41138	26301s (+0.9s)	3736	3736	256	83	205	17	0	305
41139	26302s (+0.8s)	3552	3552	256	81	196	18	0	295
41140	26303s (+0.6s)	2236	2236	128	45	156	12	1	214
41141	26303s (+0.7s)	3176	3176	256	55	195	12	0	262
41142	26304s (+0.8s)	3576	3576	256	76	195	14	0	285
41143	26306s (+1.3s)	6116	6116	512	124	290	22	0	436
41144	26306s (+0.5s)	2160	2160	256	34	143	0	6	183
41145	26307s (+0.9s)	3728	3728	256	59	237	0	14	310
41146	26308s (+1.0s)	4500	4500	256	80	274	0	17	371
41147	26308s (+0.4s)	1228	1228	128	19	101	0	5	125
41148	26309s (+0.8s)	3192	3192	256	52	203	0	11	266
41149	26310s (+0.5s)	2388	2388	256	41	150	0	9	200
41150	26310s (+0.5s)	1720	1720	128	37	131	8	0	176
41151	26311s (+0.6s)	2536	2536	256	58	158	5	0	221
41152	26312s (+0.8s)	3368	3368	256	66	198	14	0	278
41153	26313s (+0.9s)	4676	4676	512	82	231	9	0	322
41154	26313s (+0.8s)	3372	3372	256	65	208	13	0	286
41155	26314s (+0.6s)	2792	2792	256	46	167	8	0	221
41156	26315s (+0.6s)	1960	1960	128	46	142	9	0	197
41157	26315s (+0.6s)	1972	1972	128	51	146	9	0	206
41158	26316s (+0.5s)	1652	1652	128	38	123	8	1	170
41159	26317s (+0.8s)	3392	3392	256	69	193	18	0	280
41160	26317s (+0.5s)	1764	1764	128	37	136	4	0	177
41161	26317s (+0.4s)	1464	1464	128	36	114	1	0	151
41162	26318s (+0.7s)	2724	2724	256	58	165	11	0	234
41163	26319s (+0.6s)	2428	2428	256	46	155	9	0	210
41164	26320s (+0.8s)	3464	3464	256	79	193	12	1	285
41165	26320s (+0.8s)	3452	3452	256	73	203	17	0	293
41166	26321s (+0.8s)	3244	3244	256	59	202	13	0	274
41167	26322s (+0.8s)	3160	3160	256	81	174	10	0	265
41168	26322s (+0.4s)	1480	1480	128	31	118	5	0	154
41169	26323s (+0.8s)	3576	3576	256	61	227	13	1	302
41170	26324s (+1.0s)	4152	4152	256	78	249	0	13	340
41171	26325s (+0.9s)	3792	3792	256	72	233	0	12	317
41172	26326s (+0.5s)	2320	2320	256	37	148	0	6	191
41173	26326s (+0.6s)	2108	2108	128	31	155	0	13	199
41174	26327s (+1.1s)	5476	5476	512	89	281	0	14	384
41175	26328s (+1.0s)	4276	4276	256	74	266	0	15	355
41176	26329s (+0.7s)	2904	2904	256	57	184	0	12	253
41177	26330s (+0.9s)	3788	3788	256	67	233	0	14	314
41178	26330s (+0.4s)	1412	1412	128	32	107	0	10	149
41179	26331s (+0.6s)	2416	2416	256	41	155	0	6	202
41180	26332s (+0.8s)	3312	3312	256	69	199	11	1	280
41181	26332s (+0.5s)	1744	1744	128	35	139	8	1	183
41182	26333s (+0.5s)	1580	1580	128	39	116	5	0	160
41183	26333s (+0.6s)	2568	2568	256	49	159	8	0	216
41184	26334s (+0.8s)	3300	3300	256	67	194	15	1	277
41185	26335s (+0.5s)	2232	2232	256	44	134	9	0	187
41186	26336s (+0.7s)	3068	3068	256	59	189	9	0	257
41187	26336s (+0.4s)	1440	1440	128	39	109	7	0	155
41188	26336s (+0.3s)	932	932	64	30	79	5	0	114
41189	26337s (+0.7s)	2636	2636	128	66	176	11	0	253
41190	26337s (+0.3s)	828	828	64	31	73	4	0	108
41191	26338s (+0.6s)	1920	1920	128	55	133	10	0	198
41192	26339s (+1.2s)	5972	5972	512	107	285	24	0	416
41193	26340s (+0.7s)	2216	2216	128	57	158	9	0	224
41194	26340s (+0.5s)	1900	1900	128	44	140	10	0	194
41195	26341s (+0.3s)	1124	1124	128	43	68	8	0	119
41196	26341s (+0.7s)	3116	3116	256	55	191	12	0	258
41197	26342s (+0.4s)	1184	1184	128	29	97	2	0	128
41198	26343s (+1.0s)	4192	4192	256	96	231	23	0	350
41199	26343s (+0.5s)	1656	1656	128	36	122	7	0	165
Episode	Time	Reward	Score	Highest	L	U	R	D	Steps
41200	26344s (+0.4s)	1300	1300	128	33	100	6	0	139
41201	26344s (+0.4s)	1152	1152	128	29	90	6	0	125
41202	26345s (+0.5s)	1784	1784	128	47	128	6	0	181
41203	26345s (+0.7s)	2484	2484	128	57	160	14	1	232
41204	26346s (+0.5s)	1776	1776	128	39	133	7	0	179
41205	26347s (+0.7s)	2900	2900	256	62	164	12	0	238
41206	26347s (+0.7s)	2952	2952	256	59	176	14	0	249
41207	26349s (+1.4s)	6764	6764	512	132	333	24	1	490
41208	26349s (+0.5s)	1748	1748	128	52	111	0	8	171
41209	26350s (+0.6s)	2456	2456	256	43	157	0	7	207
41210	26350s (+0.5s)	1664	1664	128	33	140	0	5	178
41211	26351s (+1.1s)	5476	5476	512	87	282	0	16	385
41212	26352s (+0.4s)	1352	1352	128	45	95	3	0	143
41213	26353s (+0.8s)	2968	2968	256	71	181	11	0	263
41214	26353s (+0.3s)	1012	1012	64	30	85	6	0	121
41215	26353s (+0.4s)	1396	1396	128	39	102	5	0	146
41216	26354s (+0.8s)	3352	3352	256	73	189	16	0	278
41217	26355s (+0.6s)	1908	1908	128	47	132	13	0	192
41218	26355s (+0.5s)	1796	1796	128	59	113	11	0	183
41219	26356s (+0.9s)	3624	3624	256	87	206	15	0	308
41220	26357s (+0.8s)	3456	3456	256	60	220	13	2	295
41221	26358s (+0.8s)	3252	3252	256	57	212	7	0	276
41222	26359s (+1.1s)	4532	4532	256	102	255	18	0	375
41223	26359s (+0.5s)	1788	1788	128	28	151	3	0	182
41224	26360s (+0.2s)	592	592	64	16	63	2	0	81
41225	26361s (+0.9s)	3772	3772	256	85	215	18	0	318
41226	26361s (+0.9s)	3600	3600	256	73	215	14	0	302
41227	26362s (+0.6s)	2344	2344	256	45	139	11	0	195
41228	26363s (+1.1s)	5616	5616	512	92	290	20	0	402
41229	26364s (+0.6s)	2432	2432	256	43	159	0	7	209
41230	26364s (+0.6s)	1920	1920	128	32	159	0	7	198
41231	26365s (+0.6s)	2592	2592	256	53	162	0	8	223
41232	26365s (+0.5s)	1832	1832	128	31	134	0	8	173
41233	26366s (+0.5s)	1784	1784	128	37	136	0	8	181
41234	26366s (+0.5s)	1624	1624	128	34	122	9	1	166
41235	26368s (+1.1s)	5388	5388	512	97	251	25	0	373
41236	26369s (+1.0s)	4136	4136	256	104	224	13	0	341
41237	26369s (+0.7s)	2588	2588	128	57	175	10	0	242
41238	26370s (+1.0s)	4176	4176	256	89	234	18	0	341
41239	26371s (+0.5s)	1484	1484	128	31	118	7	0	156
41240	26371s (+0.5s)	1732	1732	128	49	121	7	0	177
41241	26373s (+1.3s)	6256	6256	512	115	317	18	0	450
41242	26373s (+0.5s)	1748	1748	128	36	134	6	0	176
41243	26374s (+0.9s)	3988	3988	256	76	240	15	0	331
41244	26374s (+0.4s)	1460	1460	128	38	108	7	0	153
41245	26375s (+1.0s)	4104	4104	256	88	226	19	0	333
41246	26377s (+1.3s)	6372	6372	512	108	315	28	0	451
41247	26377s (+0.7s)	3124	3124	256	49	197	9	0	255
41248	26378s (+0.5s)	1680	1680	128	39	125	7	0	171
41249	26378s (+0.5s)	1644	1644	128	50	114	7	0	171
41250	26379s (+0.8s)	2992	2992	256	55	207	7	0	269
41251	26380s (+0.8s)	3212	3212	256	74	179	14	0	267
41252	26381s (+0.9s)	3972	3972	256	92	218	17	0	327
41253	26382s (+0.8s)	3552	3552	256	76	207	12	0	295
41254	26382s (+0.5s)	1880	1880	128	54	125	11	0	190
41255	26383s (+0.6s)	2528	2528	256	50	151	16	0	217
41256	26383s (+0.7s)	2860	2860	256	78	154	11	0	243
41257	26384s (+0.9s)	4048	4048	256	93	225	16	0	334
41258	26385s (+0.6s)	1912	1912	128	49	138	9	0	196
41259	26386s (+0.6s)	2500	2500	256	47	156	8	0	211
41260	26386s (+0.6s)	2412	2412	128	62	154	10	0	226
41261	26387s (+0.7s)	2812	2812	256	74	159	13	0	246
41262	26388s (+0.8s)	3656	3656	256	71	215	11	0	297
41263	26388s (+0.7s)	2908	2908	256	61	183	9	0	253
41264	26389s (+0.6s)	2624	2624	256	57	154	11	0	222
41265	26390s (+0.6s)	2604	2604	256	59	158	9	0	226
41266	26391s (+0.8s)	3520	3520	256	63	228	8	0	299
41267	26391s (+0.7s)	2812	2812	256	53	181	11	0	245
41268	26392s (+0.8s)	3400	3400	256	64	208	14	0	286
41269	26393s (+0.8s)	3196	3196	256	67	198	12	0	277
41270	26393s (+0.5s)	1672	1672	128	36	128	6	0	170
41271	26394s (+0.4s)	1312	1312	64	43	96	8	0	147
41272	26394s (+0.6s)	2600	2600	256	55	160	10	0	225
41273	26395s (+0.5s)	1940	1940	128	46	150	7	0	203
41274	26395s (+0.4s)	1512	1512	128	47	108	6	0	161
41275	26396s (+0.7s)	3048	3048	256	56	176	14	1	247
41276	26397s (+0.4s)	1384	1384	128	23	109	0	13	145
41277	26397s (+0.5s)	1712	1712	128	42	124	0	4	170
41278	26398s (+0.5s)	1800	1800	128	40	135	9	0	184
41279	26398s (+0.7s)	2524	2524	128	61	167	9	0	237
41280	26399s (+0.7s)	3056	3056	256	71	175	13	0	259
41281	26400s (+0.7s)	2720	2720	256	62	164	9	0	235
41282	26401s (+0.9s)	3916	3916	256	79	224	15	0	318
41283	26401s (+0.5s)	1800	1800	128	50	127	7	0	184
41284	26402s (+0.8s)	3184	3184	256	59	193	12	0	264
41285	26403s (+0.6s)	2660	2660	256	59	156	1	9	225
41286	26403s (+0.8s)	3228	3228	256	59	195	0	15	269
41287	26404s (+0.8s)	3548	3548	256	62	224	0	15	301
41288	26404s (+0.3s)	868	868	64	33	72	7	0	112
41289	26405s (+0.9s)	4072	4072	256	95	214	18	0	327
41290	26406s (+0.7s)	2796	2796	256	47	186	9	0	242
41291	26407s (+0.9s)	3956	3956	256	74	236	0	18	328
41292	26408s (+0.8s)	3272	3272	256	49	216	0	16	281
41293	26408s (+0.4s)	1448	1448	128	24	123	0	5	152
41294	26409s (+0.4s)	1596	1596	128	28	122	0	6	156
41295	26410s (+0.9s)	4580	4580	512	74	219	17	0	310
41296	26410s (+0.4s)	1236	1236	128	39	88	7	0	134
41297	26410s (+0.3s)	740	740	64	26	68	5	0	99
41298	26411s (+0.8s)	3364	3364	256	60	206	12	0	278
41299	26411s (+0.2s)	456	456	32	17	54	4	0	75
Episode	Time	Reward	Score	Highest	L	U	R	D	Steps
41300	26412s (+0.3s)	992	992	64	33	79	5	0	117
41301	26412s (+0.5s)	1860	1860	128	38	145	0	3	186
41302	26413s (+0.9s)	3740	3740	256	57	232	0	12	301
41303	26414s (+0.6s)	1936	1936	128	41	153	0	8	202
41304	26414s (+0.5s)	1792	1792	128	44	131	0	8	183
41305	26415s (+0.3s)	1016	1016	128	17	88	0	4	109
41306	26415s (+0.6s)	1916	1916	128	50	135	12	0	197
41307	26415s (+0.3s)	884	884	64	27	83	2	0	112
41308	26416s (+1.0s)	4268	4268	256	84	253	20	0	357
41309	26417s (+0.7s)	2908	2908	256	63	158	17	0	238
41310	26418s (+0.8s)	3440	3440	256	86	188	11	0	285
41311	26419s (+0.7s)	2908	2908	256	56	173	11	0	240
41312	26419s (+0.7s)	3200	3200	256	83	165	15	0	263
41313	26420s (+0.8s)	3556	3556	256	73	198	16	1	288
41314	26421s (+1.2s)	6056	6056	512	96	318	18	0	432
41315	26422s (+0.6s)	2620	2620	256	67	150	8	0	225
41316	26423s (+0.4s)	1480	1480	128	45	100	9	0	154
41317	26424s (+1.1s)	4516	4516	256	96	258	17	0	371
41318	26424s (+0.5s)	1552	1552	128	44	113	10	0	167
41319	26425s (+0.8s)	3212	3212	256	81	174	16	0	271
41320	26425s (+0.6s)	2452	2452	256	54	148	8	0	210
41321	26426s (+0.6s)	2584	2584	256	58	152	11	0	221
41322	26427s (+0.7s)	2648	2648	128	61	186	8	1	256
41323	26428s (+0.7s)	2800	2800	256	60	172	11	0	243
41324	26428s (+0.5s)	1820	1820	128	46	133	10	0	189
41325	26428s (+0.3s)	824	824	64	16	77	3	0	96
41326	26429s (+0.6s)	1976	1976	128	54	145	7	1	207
41327	26430s (+1.0s)	4292	4292	256	100	238	14	0	352
41328	26431s (+0.9s)	3920	3920	256	83	215	21	0	319
41329	26431s (+0.5s)	1572	1572	128	43	114	8	0	165
41330	26432s (+0.9s)	3896	3896	256	104	207	17	0	328
41331	26433s (+0.3s)	900	900	64	24	81	5	0	110
41332	26433s (+0.7s)	3060	3060	256	58	184	18	0	260
41333	26434s (+0.4s)	1416	1416	128	31	111	9	0	151
41334	26434s (+0.3s)	736	736	64	25	66	5	0	96
41335	26435s (+0.8s)	3252	3252	256	61	206	9	0	276
41336	26435s (+0.5s)	1816	1816	128	46	136	6	0	188
41337	26436s (+0.6s)	2364	2364	128	55	152	12	0	219
41338	26437s (+1.1s)	5864	5864	512	101	278	22	0	401
41339	26438s (+0.5s)	1868	1868	128	44	130	10	0	184
41340	26439s (+0.8s)	3536	3536	256	65	211	12	0	288
41341	26440s (+1.1s)	4668	4668	256	119	251	17	0	387
41342	26441s (+0.9s)	3608	3608	256	69	222	14	0	305
41343	26441s (+0.5s)	1568	1568	128	37	116	11	0	164
41344	26442s (+0.6s)	2248	2248	128	60	144	13	0	217
41345	26442s (+0.7s)	2764	2764	256	61	165	13	0	239
41346	26443s (+0.7s)	2716	2716	128	76	160	11	0	247
41347	26444s (+0.8s)	3768	3768	256	63	225	15	0	303
41348	26444s (+0.3s)	760	760	64	19	79	5	0	103
41349	26445s (+0.5s)	1496	1496	128	24	127	0	7	158
41350	26446s (+0.8s)	3368	3368	256	66	209	0	14	289
41351	26446s (+0.6s)	2616	2616	256	49	158	10	1	218
41352	26447s (+0.3s)	756	756	64	27	71	3	0	101
41353	26447s (+0.7s)	3028	3028	256	54	181	10	2	247
41354	26448s (+0.7s)	2852	2852	256	58	178	8	0	244
41355	26449s (+0.8s)	3412	3412	256	82	196	14	0	292
41356	26449s (+0.6s)	2488	2488	128	49	170	13	1	233
41357	26450s (+0.6s)	1936	1936	128	50	140	8	0	198
41358	26451s (+0.8s)	3328	3328	256	84	181	15	0	280
41359	26452s (+0.9s)	3716	3716	256	78	219	18	0	315
41360	26452s (+0.5s)	1804	1804	128	42	136	8	0	186
41361	26453s (+0.9s)	4048	4048	256	102	213	19	0	334
41362	26454s (+0.5s)	2056	2056	128	51	133	8	0	192
41363	26455s (+1.1s)	5420	5420	512	86	278	13	0	377
41364	26455s (+0.4s)	1024	1024	64	31	88	8	0	127
41365	26456s (+0.8s)	3384	3384	256	63	202	11	0	276
41366	26457s (+0.6s)	2564	2564	256	51	156	10	0	217
41367	26457s (+0.7s)	3184	3184	256	66	189	15	0	270
41368	26458s (+0.7s)	2776	2776	256	65	159	10	0	234
41369	26459s (+0.8s)	3460	3460	256	69	211	11	0	291
41370	26459s (+0.4s)	1440	1440	128	31	113	5	1	150
41371	26460s (+0.5s)	1804	1804	128	53	121	11	0	185
41372	26460s (+0.3s)	704	704	64	18	74	1	0	93
41373	26460s (+0.4s)	1528	1528	128	35	113	5	0	153
41374	26462s (+1.3s)	6660	6660	512	127	308	21	0	456
41375	26462s (+0.3s)	856	856	64	21	87	3	0	111
41376	26463s (+0.5s)	1764	1764	128	44	125	9	0	178
41377	26463s (+0.5s)	2224	2224	256	44	136	11	0	191
41378	26464s (+0.7s)	3152	3152	256	71	173	13	0	257
41379	26465s (+0.8s)	3236	3236	256	69	182	14	1	266
41380	26465s (+0.4s)	1464	1464	128	35	109	7	0	151
41381	26466s (+0.4s)	1308	1308	128	26	100	0	8	134
41382	26466s (+0.9s)	3852	3852	256	70	233	0	11	314
41383	26467s (+0.7s)	2652	2652	256	43	178	0	12	233
41384	26468s (+0.6s)	2068	2068	128	37	146	0	11	194
41385	26468s (+0.7s)	2992	2992	256	55	180	0	14	249
41386	26469s (+0.5s)	1684	1684	128	27	131	0	8	166
41387	26469s (+0.3s)	708	708	64	12	80	0	3	95
41388	26470s (+0.6s)	2360	2360	256	41	149	0	10	200
41389	26471s (+0.8s)	3468	3468	256	68	206	0	13	287
41390	26471s (+0.6s)	2188	2188	128	46	147	0	11	204
41391	26472s (+0.6s)	2416	2416	128	45	161	0	15	221
41392	26473s (+0.9s)	4844	4844	512	81	231	16	1	329
41393	26473s (+0.5s)	1580	1580	128	42	123	8	0	173
41394	26474s (+0.3s)	744	744	64	16	78	5	0	99
41395	26474s (+0.8s)	3428	3428	256	56	218	10	1	285
41396	26475s (+0.6s)	2668	2668	256	43	174	10	0	227
41397	26475s (+0.4s)	976	976	64	30	85	8	0	123
41398	26476s (+0.8s)	3332	3332	256	78	197	9	0	284
41399	26477s (+0.5s)	1692	1692	128	39	131	5	0	175
Episode	Time	Reward	Score	Highest	L	U	R	D	Steps
41400	26477s (+0.3s)	1172	1172	128	16	103	0	4	123
41401	26478s (+0.6s)	2420	2420	256	41	156	0	9	206
41402	26478s (+0.6s)	2572	2572	256	40	170	0	9	219
41403	26479s (+0.4s)	1296	1296	128	16	112	1	3	132
41404	26479s (+0.5s)	1656	1656	128	29	131	0	6	166
41405	26479s (+0.2s)	304	304	32	10	42	0	6	58
41406	26480s (+1.0s)	4268	4268	256	80	258	0	19	357
41407	26481s (+0.6s)	2080	2080	128	54	139	11	0	204
41408	26482s (+0.8s)	3544	3544	256	78	211	11	0	300
41409	26482s (+0.4s)	1348	1348	128	37	103	8	0	148
41410	26483s (+0.8s)	3528	3528	256	84	182	16	0	282
41411	26484s (+0.9s)	3628	3628	256	73	226	10	0	309
41412	26485s (+0.6s)	2604	2604	256	52	166	8	0	226
41413	26485s (+0.7s)	2688	2688	128	70	169	18	0	257
41414	26486s (+0.3s)	768	768	64	15	86	3	0	104
41415	26486s (+0.4s)	1504	1504	128	41	110	7	1	159
41416	26487s (+0.6s)	1908	1908	128	43	147	5	0	195
41417	26487s (+0.6s)	1908	1908	128	41	146	8	0	195
41418	26488s (+0.4s)	1392	1392	128	29	111	6	0	146
41419	26489s (+0.9s)	4020	4020	256	78	241	8	0	327
41420	26489s (+0.7s)	2640	2640	256	57	168	8	0	233
41421	26490s (+0.4s)	1336	1336	128	29	106	4	0	139
41422	26490s (+0.7s)	2616	2616	128	71	162	15	0	248
41423	26491s (+0.4s)	1380	1380	128	27	112	6	0	145
41424	26492s (+0.8s)	3424	3424	256	72	201	14	0	287
41425	26492s (+0.9s)	3860	3860	256	62	228	19	0	309
41426	26493s (+0.8s)	3208	3208	256	58	192	15	0	265
41427	26494s (+0.6s)	2496	2496	256	45	162	9	0	216
41428	26494s (+0.3s)	716	716	64	18	72	0	4	94
41429	26494s (+0.3s)	672	672	64	19	67	0	4	90
41430	26495s (+0.4s)	1176	1176	128	33	84	0	9	126
41431	26495s (+0.7s)	2776	2776	256	63	157	16	0	236
41432	26496s (+0.7s)	3096	3096	256	57	188	13	0	258
41433	26497s (+1.0s)	4200	4200	256	99	230	16	0	345
41434	26498s (+0.4s)	1372	1372	128	40	92	6	0	138
41435	26498s (+0.2s)	324	324	32	10	46	3	0	59
41436	26498s (+0.4s)	1188	1188	64	41	93	10	0	144
41437	26499s (+0.7s)	2992	2992	256	66	168	15	1	250
41438	26499s (+0.4s)	1344	1344	128	28	105	4	0	137
41439	26500s (+1.0s)	4256	4256	256	99	236	19	0	354
41440	26501s (+0.9s)	3816	3816	256	79	215	12	0	306
41441	26502s (+0.5s)	1616	1616	128	48	117	6	0	171
41442	26502s (+0.7s)	3048	3048	256	61	185	9	0	255
41443	26503s (+0.8s)	3416	3416	256	61	212	11	0	284
41444	26504s (+0.4s)	1388	1388	128	30	104	7	0	141
41445	26504s (+0.6s)	2108	2108	128	40	149	0	10	199
41446	26505s (+0.4s)	1300	1300	128	27	104	5	0	136
41447	26506s (+0.9s)	3984	3984	256	77	229	15	0	321
41448	26507s (+1.1s)	5436	5436	512	85	273	22	0	380
41449	26508s (+1.1s)	4508	4508	256	87	266	20	0	373
41450	26509s (+0.8s)	3692	3692	256	87	197	14	1	299
41451	26509s (+0.3s)	880	880	64	22	88	5	0	115
41452	26509s (+0.3s)	912	912	64	28	88	3	0	119
41453	26510s (+0.3s)	916	916	64	30	84	6	0	120
41454	26510s (+0.5s)	1752	1752	128	31	142	5	0	178
41455	26511s (+0.6s)	2512	2512	256	51	159	0	9	219
41456	26511s (+0.4s)	1316	1316	128	19	113	0	3	135
41457	26511s (+0.3s)	1076	1076	128	25	85	0	9	119
41458	26512s (+0.6s)	2588	2588	256	50	162	0	10	222
41459	26513s (+0.7s)	3108	3108	256	54	185	0	18	257
41460	26514s (+0.7s)	3152	3152	256	57	190	13	0	260
41461	26514s (+0.2s)	516	516	32	20	58	1	0	79
41462	26515s (+0.9s)	3560	3560	256	58	235	11	0	304
41463	26516s (+0.9s)	3900	3900	256	95	216	18	0	329
41464	26516s (+0.2s)	432	432	32	15	48	0	1	64
41465	26516s (+0.6s)	2340	2340	256	50	150	9	0	209
41466	26517s (+0.3s)	944	944	64	29	84	3	0	116
41467	26518s (+0.8s)	3352	3352	256	71	199	14	0	284
41468	26518s (+0.9s)	3552	3552	256	63	230	9	0	302
41469	26519s (+0.7s)	3088	3088	256	52	184	16	0	252
41470	26520s (+1.0s)	5220	5220	512	94	247	22	0	363
41471	26521s (+0.7s)	3132	3132	256	55	180	15	2	252
41472	26521s (+0.5s)	1652	1652	128	33	128	8	0	169
41473	26522s (+0.3s)	748	748	64	20	78	1	0	99
41474	26523s (+0.9s)	3988	3988	256	81	234	16	0	331
41475	26524s (+0.8s)	3512	3512	256	76	207	14	0	297
41476	26524s (+0.4s)	1296	1296	128	32	99	9	0	140
41477	26524s (+0.4s)	1460	1460	128	22	124	3	1	150
41478	26525s (+0.8s)	3588	3588	256	58	219	10	0	287
41479	26526s (+0.4s)	1400	1400	128	36	107	7	0	150
41480	26526s (+0.5s)	1656	1656	128	54	115	7	0	176
41481	26527s (+0.7s)	2956	2956	256	56	185	9	0	250
41482	26528s (+0.8s)	3424	3424	256	78	200	8	0	286
41483	26528s (+0.5s)	1892	1892	128	42	143	6	0	191
41484	26529s (+1.0s)	4140	4140	256	98	218	19	0	335
41485	26530s (+0.4s)	1324	1324	128	33	100	13	0	146
41486	26530s (+0.8s)	3464	3464	256	74	193	17	1	285
41487	26531s (+0.6s)	2360	2360	128	78	128	13	0	219
41488	26532s (+0.8s)	3400	3400	256	85	185	19	0	289
41489	26533s (+0.9s)	3616	3616	256	72	224	10	0	306
41490	26533s (+0.3s)	1008	1008	128	18	85	4	0	107
41491	26534s (+0.8s)	3220	3220	256	59	195	11	0	265
41492	26535s (+0.7s)	2748	2748	128	77	172	12	0	261
41493	26535s (+0.6s)	2420	2420	256	54	145	10	0	209
41494	26536s (+0.5s)	1768	1768	128	36	137	6	1	180
41495	26536s (+0.3s)	976	976	64	27	86	7	0	120
41496	26537s (+0.7s)	2752	2752	256	51	176	10	0	237
41497	26538s (+0.9s)	3532	3532	256	73	216	13	0	302
41498	26538s (+0.5s)	1776	1776	128	37	138	7	0	182
41499	26539s (+0.5s)	1492	1492	128	43	115	5	0	163
Episode	Time	Reward	Score	Highest	L	U	R	D	Steps
41500	26539s (+0.8s)	3292	3292	256	71	186	17	0	274
41501	26540s (+1.0s)	4372	4372	256	104	244	16	0	364
41502	26541s (+0.3s)	904	904	64	29	83	5	0	117
41503	26541s (+0.4s)	1500	1500	128	39	108	7	0	154
41504	26542s (+0.3s)	772	772	64	16	77	0	8	101
41505	26542s (+0.4s)	1624	1624	128	25	130	0	8	163
41506	26542s (+0.4s)	1076	1076	64	39	86	7	0	132
41507	26543s (+0.7s)	2536	2536	128	58	171	12	0	241
41508	26543s (+0.3s)	816	816	64	29	72	4	0	105
41509	26544s (+0.6s)	2104	2104	128	55	134	9	0	198
41510	26545s (+0.8s)	3244	3244	256	71	184	12	0	267
41511	26545s (+0.3s)	920	920	64	26	86	3	0	115
41512	26546s (+0.6s)	2532	2532	256	54	152	10	1	217
41513	26546s (+0.4s)	1556	1556	128	33	114	7	1	155
41514	26547s (+1.0s)	4104	4104	256	82	235	17	0	334
41515	26548s (+0.9s)	4144	4144	256	87	231	19	1	338
41516	26548s (+0.4s)	1424	1424	128	33	107	0	5	145
41517	26549s (+1.0s)	4252	4252	256	101	236	12	0	349
41518	26550s (+0.8s)	3232	3232	256	75	188	8	0	271
41519	26551s (+0.8s)	3504	3504	256	71	196	14	0	281
41520	26551s (+0.5s)	1636	1636	128	47	116	7	0	170
41521	26552s (+0.7s)	2860	2860	256	63	167	16	0	246
41522	26553s (+0.7s)	3196	3196	256	63	190	9	0	262
41523	26554s (+1.0s)	4260	4260	256	103	236	16	0	355
41524	26555s (+0.6s)	2528	2528	256	46	159	8	0	213
41525	26555s (+0.5s)	1860	1860	128	60	118	11	0	189
41526	26556s (+0.8s)	3308	3308	256	62	211	11	0	284
41527	26557s (+1.0s)	4232	4232	256	104	224	16	0	344
41528	26558s (+0.7s)	3056	3056	256	51	188	10	0	249
41529	26559s (+1.2s)	5776	5776	512	102	297	16	0	415
41530	26560s (+1.0s)	4208	4208	256	87	246	14	0	347
41531	26560s (+0.4s)	1228	1228	128	33	93	7	0	133
41532	26561s (+0.9s)	3940	3940	256	85	225	15	0	325
41533	26562s (+0.5s)	1644	1644	128	46	120	12	0	178
41534	26562s (+0.5s)	1832	1832	128	43	140	5	0	188
41535	26563s (+0.6s)	2752	2752	256	61	164	10	0	235
41536	26563s (+0.5s)	1500	1500	128	32	123	4	0	159
41537	26564s (+0.7s)	2768	2768	256	57	171	10	1	239
41538	26565s (+0.7s)	2936	2936	256	76	173	11	0	260
41539	26565s (+0.4s)	1360	1360	128	40	103	8	0	151
41540	26566s (+0.7s)	2928	2928	256	62	167	16	0	245
41541	26566s (+0.3s)	876	876	64	30	78	6	0	114
41542	26567s (+0.8s)	2884	2884	128	93	166	12	0	271
41543	26568s (+0.6s)	2388	2388	256	47	150	8	0	205
41544	26568s (+0.4s)	1020	1020	64	26	93	3	1	123
41545	26569s (+0.6s)	2468	2468	256	49	155	9	1	214
41546	26569s (+0.4s)	1088	1088	64	25	94	4	0	123
41547	26570s (+0.9s)	3604	3604	256	67	219	17	0	303
41548	26570s (+0.6s)	1868	1868	128	47	146	4	0	197
41549	26571s (+0.6s)	2092	2092	128	50	154	6	0	210
41550	26572s (+0.7s)	2844	2844	256	58	171	13	0	242
41551	26573s (+0.9s)	3824	3824	256	83	218	18	0	319
41552	26573s (+0.5s)	1732	1732	128	53	113	7	0	173
41553	26574s (+0.6s)	2524	2524	256	57	154	11	0	222
41554	26574s (+0.7s)	3144	3144	256	52	195	1	10	258
41555	26576s (+1.1s)	5612	5612	512	95	288	0	18	401
41556	26576s (+0.8s)	3328	3328	256	78	187	0	9	274
41557	26577s (+0.4s)	1180	1180	64	35	100	0	7	142
41558	26577s (+0.4s)	1516	1516	128	30	121	0	5	156
41559	26578s (+0.6s)	2564	2564	256	48	160	0	13	221
41560	26578s (+0.4s)	1504	1504	128	37	119	0	3	159
41561	26579s (+0.7s)	2740	2740	256	51	176	0	7	234
41562	26580s (+0.6s)	2336	2336	256	50	135	0	13	198
41563	26580s (+0.6s)	2480	2480	256	48	158	6	0	212
41564	26581s (+0.7s)	2808	2808	256	77	141	20	0	238
41565	26582s (+0.6s)	2564	2564	256	56	153	11	0	220
41566	26582s (+0.4s)	1436	1436	128	40	102	6	0	148
41567	26582s (+0.4s)	1052	1052	64	21	102	3	1	127
41568	26583s (+0.7s)	3072	3072	256	63	188	7	1	259
41569	26584s (+0.7s)	2780	2780	256	62	165	11	0	238
41570	26584s (+0.5s)	1788	1788	128	40	136	7	0	183
41571	26585s (+1.1s)	4660	4660	256	115	250	22	0	387
41572	26586s (+0.5s)	1644	1644	128	43	117	8	0	168
41573	26586s (+0.5s)	1540	1540	128	37	119	7	1	164
41574	26587s (+1.1s)	4568	4568	256	99	257	20	0	376
41575	26588s (+0.4s)	1296	1296	128	26	110	4	0	140
41576	26589s (+0.7s)	3260	3260	256	75	184	9	0	268
41577	26589s (+0.9s)	3892	3892	256	100	214	17	0	331
41578	26590s (+0.8s)	3492	3492	256	55	226	0	11	292
41579	26591s (+0.8s)	3512	3512	256	58	227	0	9	294
41580	26592s (+0.7s)	3120	3120	256	52	194	0	13	259
41581	26593s (+0.9s)	3848	3848	256	64	234	0	17	315
41582	26594s (+0.9s)	3912	3912	256	63	235	0	20	318
41583	26594s (+0.2s)	476	476	32	11	55	0	7	73
41584	26594s (+0.5s)	1712	1712	128	38	127	0	8	173
41585	26595s (+0.3s)	1068	1068	128	21	85	0	4	110
41586	26596s (+1.3s)	6312	6312	512	118	311	23	0	452
41587	26597s (+0.7s)	2324	2324	128	65	157	13	0	235
41588	26598s (+1.0s)	4192	4192	256	77	245	21	0	343
41589	26599s (+0.9s)	3552	3552	256	75	212	15	0	302
41590	26599s (+0.5s)	1560	1560	128	47	114	7	0	168
41591	26600s (+0.7s)	2852	2852	256	71	148	18	0	237
41592	26601s (+1.0s)	4212	4212	256	87	243	18	0	348
41593	26601s (+0.4s)	1488	1488	128	38	111	6	0	155
41594	26602s (+1.0s)	4300	4300	256	86	252	19	1	358
41595	26603s (+1.0s)	4392	4392	256	103	244	20	0	367
41596	26604s (+0.6s)	1856	1856	128	35	154	5	0	194
41597	26604s (+0.6s)	2048	2048	128	56	133	10	0	199
41598	26605s (+0.4s)	1312	1312	128	33	105	6	0	144
41599	26605s (+0.6s)	2476	2476	256	70	132	13	0	215
Episode	Time	Reward	Score	Highest	L	U	R	D	Steps
41600	26606s (+0.9s)	3768	3768	256	75	221	12	0	308
41601	26607s (+0.6s)	2180	2180	128	55	139	11	0	205
41602	26608s (+0.6s)	2260	2260	256	48	140	12	0	200
41603	26608s (+0.5s)	1524	1524	128	42	115	7	0	164
41604	26609s (+0.8s)	3592	3592	256	68	221	11	0	300
41605	26610s (+1.0s)	5264	5264	512	112	234	18	0	364
41606	26610s (+0.5s)	1676	1676	128	40	126	8	0	174
41607	26611s (+0.3s)	760	760	64	19	77	6	0	102
41608	26611s (+0.5s)	1676	1676	128	40	125	6	0	171
41609	26612s (+0.3s)	908	908	64	34	79	5	0	118
41610	26612s (+0.8s)	3368	3368	256	69	191	14	0	274
41611	26613s (+0.7s)	2876	2876	256	62	177	6	0	245
41612	26613s (+0.3s)	780	780	64	23	78	3	0	104
41613	26614s (+0.4s)	1496	1496	128	38	112	8	0	158
41614	26614s (+0.5s)	1820	1820	128	46	125	11	1	183
41615	26615s (+0.9s)	3944	3944	256	81	223	18	0	322
41616	26616s (+0.6s)	1964	1964	128	54	131	14	0	199
41617	26617s (+0.9s)	3696	3696	256	89	204	18	0	311
41618	26617s (+0.5s)	1496	1496	128	41	110	0	7	158
41619	26618s (+0.6s)	2632	2632	256	47	164	0	11	222
41620	26618s (+0.3s)	1136	1136	128	21	96	0	5	122
41621	26619s (+0.7s)	2556	2556	128	44	191	0	10	245
41622	26619s (+0.5s)	1776	1776	128	49	123	0	8	180
41623	26620s (+0.2s)	300	300	32	8	44	0	3	55
41624	26620s (+0.3s)	1200	1200	128	23	93	0	6	122
41625	26621s (+0.7s)	3012	3012	256	45	187	0	11	243
41626	26621s (+0.5s)	1572	1572	64	42	125	9	0	176
41627	26622s (+0.9s)	3804	3804	256	84	220	17	1	322
41628	26623s (+0.6s)	2600	2600	256	53	161	5	0	219
41629	26623s (+0.5s)	1588	1588	128	39	116	9	0	164
41630	26624s (+0.6s)	2328	2328	128	51	163	11	0	225
41631	26625s (+0.7s)	2864	2864	256	80	157	9	1	247
41632	26625s (+0.5s)	1712	1712	128	37	136	6	0	179
41633	26626s (+1.1s)	5704	5704	512	101	280	21	0	402
41634	26627s (+1.0s)	4220	4220	256	91	242	13	0	346
41635	26628s (+0.6s)	2136	2136	128	52	147	14	0	213
41636	26629s (+0.8s)	3148	3148	256	61	187	18	0	266
41637	26629s (+0.6s)	2704	2704	256	56	158	14	0	228
41638	26630s (+0.6s)	2488	2488	256	47	154	12	0	213
41639	26630s (+0.5s)	1844	1844	128	54	120	11	0	185
41640	26631s (+0.7s)	2620	2620	256	47	166	0	17	230
41641	26632s (+0.7s)	2708	2708	256	56	163	0	11	230
41642	26632s (+0.5s)	2152	2152	256	30	149	5	0	184
41643	26633s (+0.4s)	1512	1512	128	45	109	7	0	161
41644	26634s (+1.0s)	4324	4324	256	82	248	25	0	355
41645	26635s (+0.9s)	3888	3888	256	92	209	17	0	318
41646	26635s (+0.7s)	2824	2824	256	60	174	8	0	242
41647	26636s (+0.3s)	892	892	64	28	83	7	0	118
41648	26637s (+0.8s)	3380	3380	256	76	204	11	0	291
41649	26637s (+0.5s)	1784	1784	128	48	123	10	0	181
41650	26637s (+0.3s)	1120	1120	128	34	78	6	0	118
41651	26638s (+0.8s)	3460	3460	256	58	220	0	13	291
41652	26639s (+1.0s)	5316	5316	512	78	276	0	13	367
41653	26640s (+0.5s)	1652	1652	128	36	141	0	2	179
41654	26641s (+0.8s)	3396	3396	256	52	220	0	11	283
41655	26641s (+0.8s)	3208	3208	256	55	205	0	9	269
41656	26642s (+0.8s)	3352	3352	256	56	217	0	11	284
41657	26643s (+0.4s)	1160	1160	128	21	98	0	5	124
41658	26643s (+0.5s)	1776	1776	128	46	128	0	5	179
41659	26643s (+0.3s)	668	668	64	14	75	2	0	91
41660	26644s (+0.5s)	1756	1756	128	34	138	6	0	178
41661	26644s (+0.5s)	1712	1712	128	54	115	6	0	175
41662	26645s (+0.9s)	3980	3980	256	89	218	22	0	329
41663	26646s (+0.5s)	1540	1540	128	32	126	6	0	164
41664	26646s (+0.5s)	1668	1668	128	40	125	8	0	173
41665	26647s (+0.6s)	2592	2592	256	55	158	11	0	224
41666	26648s (+0.8s)	3440	3440	256	81	200	10	0	291
41667	26649s (+0.8s)	3488	3488	256	76	208	9	0	293
41668	26650s (+0.9s)	3676	3676	256	72	215	15	0	302
41669	26650s (+0.9s)	3992	3992	256	90	222	19	1	332
41670	26651s (+0.5s)	1520	1520	128	36	121	6	0	163
41671	26652s (+0.7s)	2576	2576	128	60	172	11	0	243
41672	26652s (+0.8s)	3424	3424	256	68	201	16	1	286
41673	26653s (+0.6s)	2600	2600	256	48	166	12	0	226
41674	26654s (+0.6s)	2304	2304	128	63	148	8	0	219
41675	26654s (+0.4s)	1320	1320	128	40	100	5	0	145
41676	26655s (+0.3s)	1144	1144	128	19	101	4	0	124
41677	26655s (+0.6s)	2400	2400	128	58	158	10	1	227
41678	26656s (+0.4s)	1164	1164	64	30	100	9	0	139
41679	26656s (+0.3s)	800	800	64	21	81	5	0	107
41680	26657s (+0.6s)	2060	2060	128	45	150	11	0	206
41681	26657s (+0.5s)	1948	1948	128	42	132	10	0	184
41682	26658s (+0.5s)	1888	1888	128	59	121	12	0	192
41683	26658s (+0.5s)	1728	1728	128	45	114	14	0	173
41684	26659s (+0.5s)	1752	1752	128	39	131	0	8	178
41685	26659s (+0.6s)	2516	2516	256	40	170	0	4	214
41686	26660s (+1.0s)	4220	4220	256	87	246	16	0	349
41687	26661s (+0.8s)	2840	2840	128	72	180	12	1	265
41688	26662s (+0.7s)	2764	2764	256	51	176	11	0	238
41689	26662s (+0.7s)	2928	2928	256	55	190	0	13	258
41690	26663s (+0.3s)	928	928	64	17	85	0	5	107
41691	26663s (+0.5s)	1744	1744	128	45	120	11	0	176
41692	26664s (+0.8s)	3516	3516	256	66	214	13	0	293
41693	26664s (+0.3s)	892	892	64	34	71	9	0	114
41694	26665s (+0.4s)	1400	1400	128	37	102	5	0	144
41695	26665s (+0.6s)	2656	2656	256	51	167	0	6	224
41696	26666s (+0.9s)	3936	3936	256	64	246	0	13	323
41697	26667s (+0.5s)	1812	1812	128	34	139	0	15	188
41698	26667s (+0.4s)	1348	1348	128	22	116	0	4	142
41699	26668s (+1.1s)	5440	5440	512	87	278	0	16	381
Episode	Time	Reward	Score	Highest	L	U	R	D	Steps
41700	26669s (+0.5s)	1564	1564	64	39	117	0	12	168
41701	26670s (+0.6s)	2520	2520	256	51	162	8	0	221
41702	26670s (+0.5s)	1904	1904	128	51	138	5	0	194
41703	26671s (+0.7s)	2484	2484	128	63	160	9	0	232
41704	26671s (+0.4s)	1060	1060	64	32	91	6	0	129
41705	26672s (+0.6s)	1924	1924	128	46	149	4	0	199
41706	26672s (+0.7s)	3108	3108	256	48	201	8	0	257
41707	26673s (+0.4s)	1180	1180	128	38	81	9	0	128
41708	26673s (+0.6s)	1952	1952	128	48	146	7	0	201
41709	26674s (+0.5s)	1892	1892	128	65	118	7	1	191
41710	26674s (+0.5s)	1696	1696	128	42	125	9	0	176
41711	26675s (+0.4s)	1464	1464	128	33	111	7	0	151
41712	26676s (+0.7s)	2872	2872	256	67	164	14	0	245
41713	26676s (+0.9s)	3660	3660	256	91	193	12	0	296
41714	26677s (+0.3s)	740	740	64	20	75	3	0	98
41715	26677s (+0.8s)	3188	3188	256	62	199	5	0	266
41716	26678s (+0.7s)	3080	3080	256	64	177	13	0	254
41717	26679s (+0.7s)	2912	2912	256	70	173	11	0	254
41718	26679s (+0.3s)	936	936	64	33	78	7	0	118
41719	26680s (+0.5s)	1912	1912	128	47	141	8	0	196
41720	26681s (+1.2s)	6140	6140	512	81	336	0	16	433
41721	26681s (+0.3s)	936	936	64	23	88	0	4	115
41722	26682s (+0.6s)	2488	2488	256	56	147	0	11	214
41723	26683s (+0.8s)	3520	3520	256	62	218	0	14	294
41724	26683s (+0.7s)	2612	2612	256	44	172	0	12	228
41725	26685s (+1.2s)	6204	6204	512	80	324	0	18	422
41726	26685s (+0.5s)	1756	1756	128	33	136	0	10	179
41727	26686s (+0.9s)	3876	3876	256	81	221	0	13	315
41728	26687s (+0.7s)	2788	2788	256	58	169	0	13	240
41729	26687s (+0.6s)	2540	2540	256	49	163	0	10	222
41730	26688s (+0.7s)	2880	2880	256	50	180	0	8	238
41731	26688s (+0.3s)	748	748	64	23	73	0	4	100
41732	26689s (+0.9s)	3680	3680	256	71	229	0	14	314
41733	26690s (+0.9s)	3664	3664	256	59	224	0	15	298
41734	26691s (+0.8s)	3428	3428	256	54	220	0	15	289
41735	26692s (+1.1s)	4572	4572	256	99	261	14	0	374
41736	26693s (+0.7s)	2616	2616	256	47	172	10	0	229
41737	26693s (+0.7s)	2776	2776	256	67	157	13	0	237
41738	26694s (+0.8s)	3724	3724	256	77	214	11	0	302
41739	26695s (+0.3s)	820	820	64	28	74	4	0	106
41740	26695s (+0.5s)	1748	1748	128	35	138	5	0	178
41741	26696s (+0.6s)	2260	2260	128	64	136	13	0	213
41742	26697s (+0.9s)	3696	3696	256	80	217	14	0	311
41743	26697s (+0.3s)	932	932	64	41	64	6	0	111
41744	26698s (+0.8s)	3348	3348	256	54	221	8	0	283
41745	26699s (+1.0s)	4268	4268	256	100	241	16	0	357
41746	26699s (+0.6s)	1940	1940	128	55	130	15	0	200
41747	26700s (+0.8s)	3480	3480	256	53	225	9	1	288
41748	26701s (+0.6s)	2528	2528	256	51	160	8	0	219
41749	26701s (+0.5s)	1592	1592	128	43	116	7	0	166
41750	26702s (+0.7s)	2984	2984	256	72	181	14	0	267
41751	26703s (+0.8s)	3328	3328	256	73	197	8	0	278
41752	26703s (+0.6s)	1924	1924	128	55	136	8	0	199
41753	26704s (+1.0s)	5292	5292	512	98	254	19	0	371
41754	26705s (+1.0s)	4052	4052	256	94	218	23	0	335
41755	26706s (+0.8s)	3524	3524	256	90	189	21	0	300
41756	26707s (+0.9s)	3808	3808	256	73	231	14	0	318
41757	26708s (+0.4s)	1268	1268	128	35	100	5	0	140
41758	26709s (+1.0s)	4100	4100	256	87	235	17	0	339
41759	26709s (+0.6s)	2412	2412	128	64	144	17	1	226
41760	26710s (+1.0s)	5208	5208	512	94	269	12	0	375
41761	26711s (+0.9s)	4604	4604	512	77	217	18	0	312
41762	26711s (+0.2s)	488	488	32	17	57	4	0	78
41763	26712s (+0.9s)	3808	3808	256	103	205	14	0	322
41764	26713s (+0.5s)	1504	1504	128	34	120	5	0	159
41765	26713s (+0.3s)	940	940	64	30	81	8	0	119
41766	26714s (+0.6s)	2704	2704	256	53	168	8	0	229
41767	26715s (+0.7s)	3072	3072	256	60	182	11	0	253
41768	26715s (+0.4s)	1340	1340	128	40	94	6	0	140
41769	26715s (+0.6s)	2328	2328	256	35	153	0	8	196
41770	26716s (+0.5s)	1596	1596	128	33	130	0	4	167
41771	26717s (+0.7s)	2744	2744	256	39	184	0	11	234
41772	26717s (+0.7s)	3152	3152	256	58	195	0	10	263
41773	26718s (+0.3s)	844	844	64	18	83	0	6	107
41774	26718s (+0.7s)	3116	3116	256	49	190	0	15	254
41775	26719s (+0.7s)	3216	3216	256	59	196	0	12	267
41776	26720s (+0.7s)	2708	2708	256	55	164	0	10	229
41777	26721s (+1.0s)	4232	4232	256	87	244	17	0	348
41778	26722s (+0.8s)	3536	3536	256	74	204	13	0	291
41779	26722s (+0.5s)	1700	1700	128	49	119	8	0	176
41780	26723s (+0.9s)	3636	3636	256	95	198	19	0	312
41781	26723s (+0.4s)	1172	1172	64	37	97	6	0	140
41782	26724s (+0.5s)	1648	1648	128	38	131	0	9	178
41783	26725s (+0.7s)	2804	2804	256	54	177	0	8	239
41784	26726s (+1.1s)	5728	5728	512	119	271	19	1	410
41785	26726s (+0.6s)	2204	2204	256	53	134	5	0	192
41786	26727s (+0.5s)	1620	1620	128	28	128	5	0	161
41787	26727s (+0.3s)	932	932	64	30	86	7	0	123
41788	26727s (+0.2s)	588	588	64	26	48	5	0	79
41789	26729s (+1.3s)	6312	6312	512	111	317	24	0	452
41790	26729s (+0.5s)	1792	1792	128	34	142	0	6	182
41791	26730s (+0.8s)	3188	3188	256	51	202	0	12	265
41792	26731s (+0.6s)	2544	2544	256	44	164	0	9	217
41793	26731s (+0.8s)	3216	3216	256	64	189	0	13	266
41794	26732s (+0.9s)	3648	3648	256	79	213	17	1	310
41795	26733s (+0.3s)	772	772	64	24	77	4	0	105
41796	26733s (+0.7s)	2984	2984	256	63	180	9	0	252
41797	26734s (+0.4s)	1012	1012	64	29	86	0	7	122
41798	26735s (+0.8s)	2852	2852	128	86	175	13	0	274
41799	26735s (+0.5s)	1896	1896	128	38	144	7	0	189
Episode	Time	Reward	Score	Highest	L	U	R	D	Steps
41800	26736s (+1.0s)	4020	4020	256	86	230	18	0	334
41801	26736s (+0.4s)	1168	1168	64	40	90	9	0	139
41802	26737s (+0.4s)	1416	1416	128	32	110	7	0	149
41803	26737s (+0.6s)	2408	2408	256	41	157	9	0	207
41804	26738s (+0.6s)	2448	2448	256	45	147	11	0	203
41805	26739s (+1.0s)	4220	4220	256	84	242	19	0	345
41806	26740s (+1.0s)	4220	4220	256	92	241	16	1	350
41807	26741s (+0.6s)	2024	2024	128	61	128	12	1	202
41808	26741s (+0.5s)	1660	1660	128	46	123	7	1	177
41809	26742s (+0.6s)	1956	1956	128	51	137	8	0	196
41810	26742s (+0.2s)	340	340	32	16	44	2	0	62
41811	26743s (+1.3s)	6496	6496	512	116	323	24	0	463
41812	26744s (+0.5s)	1772	1772	128	38	133	6	0	177
41813	26745s (+0.8s)	3440	3440	256	73	207	11	0	291
41814	26745s (+0.9s)	3696	3696	256	74	222	11	0	307
41815	26746s (+1.0s)	4232	4232	256	93	241	14	0	348
41816	26747s (+0.6s)	2324	2324	256	37	150	7	0	194
41817	26747s (+0.5s)	1700	1700	128	51	107	10	1	169
41818	26748s (+0.9s)	4868	4868	512	81	241	16	0	338
41819	26749s (+0.7s)	2952	2952	256	63	180	15	1	259
41820	26750s (+0.6s)	2520	2520	256	55	146	5	0	206
41821	26751s (+1.0s)	4240	4240	256	104	233	17	0	354
41822	26751s (+0.6s)	2620	2620	256	67	145	9	0	221
41823	26752s (+0.2s)	556	556	64	14	60	4	0	78
41824	26752s (+0.4s)	1352	1352	128	37	104	8	0	149
41825	26753s (+0.8s)	3320	3320	256	67	196	13	1	277
41826	26754s (+0.7s)	2884	2884	256	63	160	15	0	238
41827	26754s (+0.5s)	1784	1784	128	43	135	6	1	185
41828	26754s (+0.3s)	716	716	64	16	77	1	0	94
41829	26755s (+0.7s)	3148	3148	256	66	180	13	0	259
41830	26756s (+0.7s)	2912	2912	256	72	166	16	0	254
41831	26757s (+0.8s)	3536	3536	256	72	214	12	0	298
41832	26757s (+0.6s)	2308	2308	128	64	148	12	0	224
41833	26759s (+1.3s)	6128	6128	512	134	283	22	0	439
41834	26759s (+0.7s)	2924	2924	256	54	195	8	0	257
41835	26760s (+1.1s)	4652	4652	256	107	261	17	0	385
41836	26761s (+0.6s)	2540	2540	256	54	155	13	0	222
41837	26762s (+0.9s)	4632	4632	512	68	237	13	0	318
41838	26763s (+0.6s)	2580	2580	256	60	149	10	1	220
41839	26764s (+1.0s)	5184	5184	512	100	242	18	0	360
41840	26764s (+0.6s)	1924	1924	128	44	147	8	0	199
41841	26765s (+0.5s)	1624	1624	128	47	119	7	0	173
41842	26765s (+0.7s)	3204	3204	256	61	196	12	0	269
41843	26766s (+0.8s)	3232	3232	256	70	182	19	1	272
41844	26767s (+0.6s)	2320	2320	128	64	144	15	0	223
41845	26767s (+0.4s)	1300	1300	128	21	108	2	0	131
41846	26768s (+0.4s)	1468	1468	128	34	112	6	0	152
41847	26769s (+1.3s)	6316	6316	512	112	319	22	0	453
41848	26769s (+0.5s)	1752	1752	128	46	122	10	0	178
41849	26770s (+0.8s)	4344	4344	512	60	218	12	1	291
41850	26771s (+0.6s)	2240	2240	128	50	148	11	0	209
41851	26772s (+0.8s)	3460	3460	256	64	218	9	0	291
41852	26772s (+0.7s)	3080	3080	256	60	175	16	0	251
41853	26773s (+0.4s)	1304	1304	128	37	91	5	2	135
41854	26774s (+0.9s)	3656	3656	256	100	190	16	0	306
41855	26774s (+0.6s)	2592	2592	256	53	151	9	1	214
41856	26775s (+0.3s)	684	684	64	21	68	4	0	93
41857	26775s (+0.5s)	1796	1796	128	37	142	5	0	184
41858	26777s (+1.4s)	7416	7416	512	142	336	30	0	508
41859	26777s (+0.7s)	2596	2596	128	63	167	18	0	248
41860	26778s (+0.7s)	2952	2952	256	69	186	9	0	264
41861	26779s (+1.2s)	5624	5624	512	96	289	18	1	404
41862	26780s (+0.8s)	3416	3416	256	62	211	12	0	285
41863	26780s (+0.4s)	1468	1468	128	28	114	9	0	151
41864	26781s (+0.2s)	296	296	32	12	40	4	0	56
41865	26782s (+1.2s)	5624	5624	512	114	274	16	0	404
41866	26782s (+0.4s)	1176	1176	64	35	101	5	0	141
41867	26783s (+0.8s)	3156	3156	256	65	187	16	0	268
41868	26784s (+1.4s)	6612	6612	512	130	324	25	0	479
41869	26785s (+0.5s)	2108	2108	256	41	129	7	0	177
41870	26786s (+0.6s)	2436	2436	128	68	151	8	0	227
41871	26787s (+1.2s)	5840	5840	512	110	297	19	0	426
41872	26787s (+0.7s)	3080	3080	256	79	173	8	0	260
41873	26788s (+0.4s)	1264	1264	64	35	104	8	0	147
41874	26789s (+0.7s)	2912	2912	256	57	190	7	0	254
41875	26789s (+0.9s)	3712	3712	256	68	210	16	1	295
41876	26790s (+0.3s)	1136	1136	128	23	95	4	0	122
41877	26790s (+0.5s)	1840	1840	128	46	138	6	0	190
41878	26791s (+0.8s)	3404	3404	256	83	183	15	1	282
41879	26792s (+0.8s)	3240	3240	256	58	204	11	0	273
41880	26792s (+0.5s)	1760	1760	128	40	134	6	0	180
41881	26793s (+0.7s)	2512	2512	128	66	157	11	0	234
41882	26793s (+0.3s)	860	860	64	38	65	8	0	111
41883	26794s (+0.7s)	2932	2932	256	60	175	9	0	244
41884	26795s (+0.9s)	3956	3956	256	106	201	21	0	328
41885	26796s (+0.6s)	1940	1940	128	52	139	7	0	198
41886	26797s (+0.8s)	3400	3400	256	63	214	0	14	291
41887	26797s (+0.6s)	1936	1936	128	42	153	0	7	202
41888	26798s (+0.6s)	2768	2768	256	52	164	9	0	225
41889	26799s (+1.1s)	5156	5156	512	107	238	24	0	369
41890	26799s (+0.5s)	1540	1540	128	45	114	2	0	161
41891	26800s (+1.1s)	4632	4632	256	102	269	21	0	392
41892	26801s (+0.7s)	3120	3120	256	52	195	13	0	260
41893	26802s (+0.4s)	1324	1324	128	24	107	5	0	136
41894	26802s (+0.3s)	1120	1120	128	26	88	4	0	118
41895	26802s (+0.5s)	1868	1868	128	48	134	8	0	190
41896	26803s (+0.4s)	1528	1528	128	33	113	8	0	154
41897	26804s (+0.9s)	3908	3908	256	69	235	13	0	317
41898	26804s (+0.4s)	1472	1472	128	33	112	7	0	152
41899	26805s (+0.7s)	2596	2596	128	74	158	15	1	248
Episode	Time	Reward	Score	Highest	L	U	R	D	Steps
41900	26806s (+0.8s)	3192	3192	256	71	181	14	0	266
41901	26806s (+0.5s)	1824	1824	128	51	125	14	0	190
41902	26807s (+0.5s)	1792	1792	128	54	121	8	0	183
41903	26807s (+0.5s)	1876	1876	128	56	118	18	0	192
41904	26808s (+0.7s)	3188	3188	256	70	185	10	0	265
41905	26809s (+0.8s)	3468	3468	256	73	202	16	0	291
41906	26809s (+0.5s)	1784	1784	128	49	123	14	0	186
41907	26810s (+0.3s)	1112	1112	128	42	68	9	0	119
41908	26810s (+0.5s)	2220	2220	256	41	147	3	0	191
41909	26811s (+0.3s)	744	744	64	27	70	2	0	99
41910	26811s (+0.2s)	632	632	64	14	72	2	0	88
41911	26811s (+0.3s)	920	920	64	38	77	5	0	120
41912	26812s (+0.6s)	2456	2456	256	52	152	7	0	211
41913	26812s (+0.5s)	1716	1716	128	48	114	11	0	173
41914	26813s (+0.8s)	3464	3464	256	78	199	15	0	292
41915	26814s (+0.5s)	1512	1512	128	42	112	8	0	162
41916	26815s (+1.2s)	6208	6208	512	107	309	21	1	438
41917	26816s (+0.7s)	2776	2776	256	55	176	7	0	238
41918	26817s (+1.0s)	4452	4452	256	103	249	14	0	366
41919	26818s (+1.1s)	5568	5568	512	93	274	22	0	389
41920	26818s (+0.4s)	1504	1504	128	32	117	4	0	153
41921	26819s (+0.5s)	1896	1896	128	37	156	4	0	197
41922	26819s (+0.5s)	1496	1496	128	49	102	6	1	158
41923	26820s (+0.7s)	3040	3040	256	76	169	13	1	259
41924	26821s (+0.6s)	2476	2476	256	44	165	6	0	215
41925	26821s (+0.6s)	1932	1932	128	43	152	6	0	201
41926	26822s (+0.7s)	2776	2776	256	59	165	17	0	241
41927	26823s (+0.7s)	2928	2928	256	60	189	9	0	258
41928	26823s (+0.9s)	3988	3988	256	85	233	13	0	331
41929	26824s (+0.6s)	2472	2472	128	57	162	13	1	233
41930	26825s (+0.6s)	2464	2464	256	48	151	9	0	208
41931	26825s (+0.6s)	2632	2632	256	48	176	4	0	228
41932	26826s (+0.6s)	2544	2544	256	66	148	9	0	223
41933	26827s (+0.6s)	2492	2492	256	54	151	10	0	215
41934	26827s (+0.4s)	1464	1464	128	47	92	9	0	148
41935	26827s (+0.4s)	1436	1436	128	33	110	5	0	148
41936	26828s (+0.4s)	1228	1228	128	28	101	5	0	134
41937	26828s (+0.6s)	2788	2788	256	49	167	10	1	227
41938	26829s (+0.4s)	1180	1180	64	37	99	6	0	142
41939	26830s (+0.7s)	2788	2788	256	62	168	9	0	239
41940	26830s (+0.4s)	1444	1444	128	35	105	0	10	150
41941	26831s (+0.8s)	3160	3160	256	56	194	0	14	264
41942	26832s (+1.0s)	4100	4100	256	68	257	0	19	344
41943	26832s (+0.3s)	768	768	64	17	71	0	4	92
41944	26833s (+0.8s)	3484	3484	256	67	211	11	1	290
41945	26834s (+0.7s)	2944	2944	256	53	180	14	0	247
41946	26834s (+0.9s)	3744	3744	256	87	201	23	0	311
41947	26835s (+0.5s)	1540	1540	128	39	121	4	0	164
41948	26835s (+0.5s)	1812	1812	128	39	143	6	0	188
41949	26836s (+0.4s)	1180	1180	64	36	100	6	0	142
41950	26836s (+0.4s)	1152	1152	128	35	85	7	0	127
41951	26837s (+0.5s)	1796	1796	128	40	133	11	0	184
41952	26838s (+0.7s)	2908	2908	256	53	184	11	0	248
41953	26838s (+0.5s)	1560	1560	128	39	118	5	0	162
41954	26839s (+1.1s)	4536	4536	256	111	249	16	0	376
41955	26840s (+0.9s)	3884	3884	256	67	242	12	0	321
41956	26840s (+0.4s)	1284	1284	128	34	96	7	0	137
41957	26841s (+0.4s)	1960	1960	256	31	122	5	0	158
41958	26841s (+0.4s)	1452	1452	128	28	120	4	0	152
41959	26842s (+0.5s)	1764	1764	128	28	147	2	0	177
41960	26842s (+0.7s)	2652	2652	256	45	182	0	6	233
41961	26843s (+0.7s)	2808	2808	256	48	179	0	14	241
41962	26844s (+0.6s)	2632	2632	256	51	157	0	11	219
41963	26844s (+0.5s)	1636	1636	128	29	128	0	7	164
41964	26845s (+0.5s)	1808	1808	128	38	140	0	9	187
41965	26845s (+0.3s)	1080	1080	128	24	87	0	8	119
41966	26846s (+1.0s)	4332	4332	256	90	250	17	0	357
41967	26847s (+0.5s)	1672	1672	128	55	106	9	0	170
41968	26847s (+0.8s)	3848	3848	256	85	212	15	0	312
41969	26848s (+0.6s)	2020	2020	128	54	133	13	0	200
41970	26849s (+0.6s)	2144	2144	128	42	163	9	1	215
41971	26849s (+0.7s)	2924	2924	256	54	194	9	0	257
41972	26850s (+0.3s)	1080	1080	128	20	93	6	0	119
41973	26850s (+0.6s)	2160	2160	128	62	140	13	0	215
41974	26851s (+0.8s)	3772	3772	256	71	213	16	2	302
41975	26852s (+0.4s)	1488	1488	128	29	122	4	0	155
41976	26852s (+0.8s)	3444	3444	256	72	194	18	1	285
41977	26853s (+0.5s)	1772	1772	128	42	119	11	0	172
41978	26853s (+0.5s)	1600	1600	128	40	118	9	0	167
41979	26854s (+0.9s)	4024	4024	256	86	232	14	0	332
41980	26855s (+0.3s)	1088	1088	128	21	95	4	0	120
41981	26856s (+0.9s)	3648	3648	256	80	220	9	0	309
41982	26857s (+1.5s)	7304	7304	512	151	327	31	0	509
41983	26858s (+0.6s)	2468	2468	256	47	151	11	0	209
41984	26858s (+0.3s)	876	876	64	21	89	4	0	114
41985	26859s (+0.8s)	3420	3420	256	75	200	11	0	286
41986	26860s (+0.8s)	3364	3364	256	69	200	18	0	287
41987	26860s (+0.5s)	1828	1828	128	34	147	4	0	185
41988	26861s (+0.9s)	3584	3584	256	77	220	13	0	310
41989	26862s (+1.0s)	4400	4400	256	93	258	18	0	369
41990	26862s (+0.4s)	1480	1480	128	32	115	8	0	155
41991	26864s (+1.1s)	4648	4648	256	107	261	20	0	388
41992	26864s (+0.5s)	1764	1764	128	40	132	5	0	177
41993	26865s (+0.8s)	3364	3364	256	78	197	12	0	287
41994	26865s (+0.4s)	1416	1416	128	38	97	10	0	145
41995	26866s (+0.5s)	1832	1832	128	30	150	0	7	187
41996	26866s (+0.5s)	1656	1656	128	28	131	0	7	166
41997	26867s (+0.9s)	3580	3580	256	77	210	15	0	302
41998	26868s (+0.9s)	4664	4664	512	86	213	16	0	315
41999	26869s (+1.4s)	6684	6684	512	122	330	29	0	481
Episode	Time	Reward	Score	Highest	L	U	R	D	Steps
42000	26870s (+0.4s)	1388	1388	128	30	111	6	0	147
42001	26870s (+0.3s)	856	856	64	34	70	6	0	110
42002	26871s (+0.6s)	1920	1920	128	54	134	10	0	198
42003	26872s (+0.7s)	2760	2760	256	53	177	7	0	237
42004	26872s (+0.6s)	1996	1996	128	54	141	11	0	206
42005	26873s (+0.4s)	1484	1484	128	28	123	4	0	155
42006	26873s (+0.9s)	3568	3568	256	76	219	11	0	306
42007	26874s (+0.5s)	1620	1620	128	40	128	4	0	172
42008	26875s (+0.5s)	1904	1904	128	45	139	10	0	194
42009	26875s (+0.5s)	1728	1728	128	29	138	6	0	173
42010	26876s (+0.8s)	3624	3624	256	75	212	10	1	298
42011	26877s (+0.8s)	3232	3232	256	70	189	12	0	271
42012	26877s (+0.5s)	1504	1504	128	43	107	9	0	159
42013	26878s (+0.6s)	2060	2060	128	50	142	14	0	206
42014	26878s (+0.4s)	1472	1472	128	23	127	1	1	152
42015	26879s (+0.7s)	3076	3076	256	47	193	0	14	254
42016	26879s (+0.5s)	1672	1672	128	39	124	0	6	169
42017	26880s (+0.2s)	604	604	64	19	59	0	4	82
42018	26880s (+0.8s)	3340	3340	256	60	210	0	11	281
42019	26881s (+0.4s)	1300	1300	128	28	97	6	0	131
42020	26881s (+0.3s)	704	704	64	23	67	4	0	94
42021	26882s (+1.0s)	4504	4504	256	87	252	14	1	354
42022	26883s (+0.9s)	3872	3872	256	83	220	16	0	319
42023	26884s (+0.6s)	2132	2132	128	44	156	12	0	212
42024	26884s (+0.4s)	1424	1424	128	35	105	5	0	145
42025	26885s (+1.2s)	5900	5900	512	116	294	18	1	429
42026	26886s (+0.7s)	2900	2900	256	57	182	12	0	251
42027	26887s (+0.7s)	2928	2928	256	60	171	13	0	244
42028	26888s (+1.2s)	6332	6332	512	121	283	25	0	429
42029	26889s (+0.8s)	3520	3520	256	79	199	13	0	291
42030	26889s (+0.5s)	1908	1908	128	50	138	7	0	195
42031	26890s (+1.1s)	5444	5444	512	91	272	17	0	380
42032	26891s (+0.5s)	1700	1700	128	52	114	6	0	172
42033	26891s (+0.4s)	1412	1412	128	31	112	6	0	149
42034	26892s (+0.5s)	1908	1908	128	45	145	5	0	195
42035	26892s (+0.6s)	1920	1920	128	51	142	5	0	198
42036	26893s (+0.5s)	1900	1900	128	47	135	11	0	193
42037	26894s (+0.6s)	1920	1920	128	57	127	14	0	198
42038	26894s (+0.7s)	2544	2544	128	72	154	10	0	236
42039	26895s (+0.7s)	2740	2740	256	62	159	12	0	233
42040	26896s (+0.7s)	3068	3068	256	59	177	16	0	252
42041	26896s (+0.7s)	2592	2592	128	65	165	13	0	243
42042	26897s (+0.4s)	1492	1492	128	40	105	12	0	157
42043	26897s (+0.5s)	1904	1904	128	47	138	0	9	194
42044	26898s (+0.5s)	1728	1728	128	28	138	0	7	173
42045	26898s (+0.6s)	1916	1916	128	49	139	0	9	197
42046	26899s (+0.7s)	2804	2804	256	50	180	0	9	239
42047	26900s (+0.8s)	3356	3356	256	44	229	0	12	285
42048	26901s (+0.5s)	1784	1784	128	37	141	0	4	182
42049	26901s (+0.5s)	1648	1648	128	38	120	10	0	168
42050	26901s (+0.4s)	1512	1512	128	38	107	10	0	155
42051	26902s (+0.4s)	1408	1408	128	32	113	7	0	152
42052	26903s (+1.1s)	5596	5596	512	92	283	22	0	397
42053	26904s (+0.6s)	1972	1972	128	57	131	12	0	200
42054	26904s (+0.8s)	3476	3476	256	78	196	20	0	294
42055	26905s (+0.5s)	1600	1600	128	31	122	5	1	159
42056	26905s (+0.4s)	1344	1344	128	36	102	4	0	142
42057	26906s (+0.6s)	2260	2260	256	41	151	6	0	198
42058	26907s (+0.7s)	2828	2828	256	54	190	6	0	250
42059	26908s (+0.9s)	4156	4156	256	79	247	16	0	342
42060	26908s (+0.5s)	1552	1552	128	40	119	4	0	163
42061	26909s (+1.0s)	4152	4152	256	73	252	15	0	340
42062	26909s (+0.4s)	1352	1352	128	32	108	8	0	148
42063	26910s (+0.5s)	1488	1488	128	28	123	5	0	156
42064	26911s (+1.0s)	4296	4296	256	86	240	23	0	349
42065	26912s (+0.7s)	2904	2904	256	64	179	9	0	252
42066	26912s (+0.5s)	1752	1752	128	51	119	7	1	178
42067	26913s (+0.7s)	2588	2588	128	62	173	10	0	245
42068	26913s (+0.4s)	1520	1520	128	38	114	7	0	159
42069	26914s (+0.3s)	1124	1124	128	24	98	0	0	122
42070	26914s (+0.2s)	572	572	64	16	59	3	0	78
42071	26914s (+0.4s)	1496	1496	128	42	107	8	0	157
42072	26915s (+0.9s)	3812	3812	256	82	210	16	0	308
42073	26916s (+0.5s)	2248	2248	256	27	157	0	5	189
42074	26916s (+0.2s)	340	340	32	12	41	0	4	57
42075	26917s (+0.7s)	2624	2624	256	49	176	0	6	231
42076	26917s (+0.8s)	3368	3368	256	60	215	0	13	288
42077	26918s (+0.7s)	2756	2756	256	64	161	0	11	236
42078	26919s (+0.6s)	2760	2760	256	47	182	0	4	233
42079	26919s (+0.5s)	1808	1808	128	32	145	0	11	188
42080	26919s (+0.3s)	724	724	64	21	71	5	0	97
42081	26920s (+0.4s)	1464	1464	128	32	118	4	0	154
42082	26921s (+1.0s)	4248	4248	256	101	229	22	0	352
42083	26922s (+0.8s)	3224	3224	256	63	194	12	0	269
42084	26923s (+0.8s)	3280	3280	256	80	184	13	1	278
42085	26923s (+0.9s)	4056	4056	256	87	226	13	1	327
42086	26924s (+0.5s)	1604	1604	128	48	113	7	0	168
42087	26924s (+0.5s)	1864	1864	128	45	134	10	0	189
42088	26925s (+0.3s)	880	880	64	33	74	8	0	115
42089	26925s (+0.5s)	1408	1408	64	51	103	6	0	160
42090	26926s (+0.5s)	1760	1760	128	43	125	8	0	176
42091	26927s (+0.8s)	3456	3456	256	73	195	15	0	283
42092	26927s (+0.2s)	572	572	64	21	52	5	0	78
42093	26927s (+0.5s)	1668	1668	128	58	113	8	0	179
42094	26928s (+0.9s)	3964	3964	256	87	227	11	0	325
42095	26929s (+0.7s)	2920	2920	256	66	179	11	0	256
42096	26930s (+0.6s)	1992	1992	128	47	141	13	0	201
42097	26930s (+0.7s)	2800	2800	256	60	161	15	0	236
42098	26931s (+0.6s)	2460	2460	256	38	164	9	0	211
42099	26931s (+0.5s)	1820	1820	128	57	121	11	1	190
Episode	Time	Reward	Score	Highest	L	U	R	D	Steps
42100	26932s (+0.5s)	1664	1664	128	44	115	8	1	168
42101	26933s (+1.0s)	4192	4192	256	106	212	20	0	338
42102	26934s (+0.8s)	3604	3604	256	56	221	14	0	291
42103	26934s (+0.5s)	1680	1680	128	44	133	5	0	182
42104	26935s (+0.7s)	3008	3008	256	56	186	10	0	252
42105	26936s (+0.6s)	2524	2524	256	44	164	10	0	218
42106	26937s (+1.0s)	4136	4136	256	94	228	18	1	341
42107	26937s (+0.8s)	3548	3548	256	64	223	14	0	301
42108	26938s (+0.5s)	1744	1744	128	40	129	0	8	177
42109	26939s (+0.7s)	3204	3204	256	83	173	8	0	264
42110	26939s (+0.8s)	3360	3360	256	83	194	10	0	287
42111	26940s (+0.4s)	1416	1416	64	51	98	8	0	157
42112	26941s (+0.8s)	3404	3404	256	62	208	13	0	283
42113	26941s (+0.5s)	1800	1800	128	43	132	9	1	185
42114	26942s (+0.5s)	1860	1860	128	43	132	13	0	188
42115	26942s (+0.6s)	2592	2592	256	59	154	11	0	224
42116	26943s (+0.2s)	624	624	64	16	64	3	0	83
42117	26943s (+0.8s)	3552	3552	256	74	205	16	0	295
42118	26944s (+0.6s)	2572	2572	256	56	158	11	0	225
42119	26945s (+0.6s)	2504	2504	256	48	154	14	2	218
42120	26945s (+0.4s)	1920	1920	256	29	119	7	0	155
42121	26946s (+0.7s)	2924	2924	256	64	183	9	1	257
42122	26947s (+0.6s)	2296	2296	128	49	156	9	0	214
42123	26947s (+0.6s)	1900	1900	128	38	148	6	1	193
42124	26948s (+0.8s)	3532	3532	256	79	204	13	1	297
42125	26949s (+0.9s)	3888	3888	256	88	210	18	0	316
42126	26949s (+0.6s)	2340	2340	256	38	152	6	0	196
42127	26950s (+0.7s)	2836	2836	256	45	184	7	1	237
42128	26951s (+0.5s)	1688	1688	128	37	129	7	0	173
42129	26951s (+0.5s)	1648	1648	128	36	123	10	0	169
42130	26952s (+0.4s)	1408	1408	128	37	103	5	0	145
42131	26952s (+0.5s)	1652	1652	128	34	125	10	1	170
42132	26953s (+0.7s)	3212	3212	256	75	166	18	0	259
42133	26954s (+0.9s)	3984	3984	256	89	219	15	0	323
42134	26954s (+0.5s)	1612	1612	128	51	110	9	0	170
42135	26955s (+0.6s)	2464	2464	256	50	147	12	0	209
42136	26955s (+0.5s)	1540	1540	128	37	122	4	1	164
42137	26957s (+1.3s)	6736	6736	512	129	306	28	0	463
42138	26957s (+0.6s)	2560	2560	256	54	149	12	0	215
42139	26958s (+0.8s)	3196	3196	256	61	197	9	0	267
42140	26958s (+0.5s)	1496	1496	128	41	110	7	0	158
42141	26959s (+0.9s)	3648	3648	256	54	236	0	14	304
42142	26960s (+0.4s)	1040	1040	64	37	81	0	6	124
42143	26960s (+0.6s)	2668	2668	256	40	174	0	8	222
42144	26961s (+0.7s)	2940	2940	256	76	171	11	0	258
42145	26962s (+0.9s)	3572	3572	256	65	219	15	1	300
42146	26963s (+0.7s)	2944	2944	256	66	173	13	0	252
42147	26963s (+0.7s)	3052	3052	256	73	186	5	0	264
42148	26964s (+0.3s)	760	760	64	22	72	5	0	99
42149	26964s (+0.3s)	904	904	64	27	82	7	0	116
42150	26964s (+0.4s)	1328	1328	128	25	110	3	0	138
42151	26965s (+0.3s)	1088	1088	128	28	84	8	0	120
42152	26966s (+1.1s)	5620	5620	512	91	301	11	0	403
42153	26966s (+0.4s)	1320	1320	64	43	101	6	0	150
42154	26967s (+0.7s)	2904	2904	256	49	196	0	8	253
42155	26968s (+0.8s)	3356	3356	256	52	222	0	11	285
42156	26969s (+0.9s)	3956	3956	256	61	249	0	14	324
42157	26969s (+0.3s)	984	984	64	16	97	0	3	116
42158	26970s (+0.5s)	1660	1660	128	35	136	0	6	177
42159	26970s (+0.8s)	2944	2944	256	51	203	0	8	262
42160	26971s (+0.5s)	1620	1620	128	47	119	6	0	172
42161	26972s (+0.6s)	2224	2224	128	60	144	8	0	212
42162	26972s (+0.7s)	2836	2836	256	59	172	12	1	244
42163	26973s (+0.7s)	3048	3048	256	66	177	14	0	257
42164	26974s (+0.7s)	2788	2788	256	51	181	9	0	241
42165	26975s (+0.9s)	3792	3792	256	70	234	10	0	314
42166	26975s (+0.4s)	1060	1060	64	36	87	6	0	129
42167	26975s (+0.5s)	1744	1744	128	48	119	9	0	176
42168	26976s (+0.4s)	1328	1328	128	27	110	2	0	139
42169	26976s (+0.5s)	1876	1876	128	47	132	8	0	187
42170	26977s (+1.1s)	5580	5580	512	102	271	20	0	393
42171	26978s (+0.5s)	1752	1752	128	37	130	0	6	173
42172	26979s (+0.5s)	1784	1784	128	38	135	0	9	182
42173	26979s (+0.5s)	1828	1828	128	31	127	0	14	172
42174	26980s (+0.7s)	3008	3008	256	69	177	1	8	255
42175	26980s (+0.7s)	2760	2760	256	46	177	0	12	235
42176	26981s (+0.5s)	1928	1928	128	41	133	11	1	186
42177	26981s (+0.5s)	1620	1620	128	41	119	6	0	166
42178	26982s (+0.4s)	1488	1488	128	33	113	10	0	156
42179	26983s (+0.9s)	3988	3988	256	66	238	17	0	321
42180	26984s (+0.8s)	3368	3368	256	54	212	13	0	279
42181	26984s (+0.5s)	1528	1528	64	47	113	8	0	168
42182	26985s (+0.9s)	3664	3664	256	86	210	18	0	314
42183	26986s (+0.7s)	2796	2796	256	70	155	17	0	242
42184	26986s (+0.4s)	992	992	64	30	90	7	0	127
42185	26987s (+0.6s)	2424	2424	256	48	150	11	0	209
42186	26987s (+0.5s)	1720	1720	128	40	129	6	0	175
42187	26988s (+0.6s)	2468	2468	256	39	160	10	0	209
42188	26988s (+0.5s)	1768	1768	128	39	132	10	0	181
42189	26989s (+0.3s)	880	880	64	22	77	0	7	106
42190	26989s (+0.4s)	1240	1240	64	29	104	0	8	141
42191	26990s (+0.5s)	1796	1796	128	43	130	0	11	184
42192	26990s (+0.6s)	2756	2756	256	47	175	0	11	233
42193	26991s (+0.5s)	1564	1564	128	38	125	6	0	169
42194	26991s (+0.6s)	2284	2284	128	63	142	10	0	215
42195	26992s (+0.9s)	3812	3812	256	65	246	13	0	324
42196	26993s (+0.7s)	2804	2804	256	58	177	9	0	244
42197	26993s (+0.6s)	1932	1932	128	45	149	7	0	201
42198	26994s (+0.9s)	3820	3820	256	78	229	14	0	321
42199	26995s (+0.7s)	3148	3148	256	57	196	9	0	262
Episode	Time	Reward	Score	Highest	L	U	R	D	Steps
42200	26996s (+0.9s)	3968	3968	256	85	231	10	0	326
42201	26997s (+0.5s)	2260	2260	256	37	147	6	0	190
42202	26997s (+0.4s)	1368	1368	128	25	110	7	0	142
42203	26998s (+1.0s)	4476	4476	256	101	243	21	0	365
42204	26999s (+0.6s)	2472	2472	256	59	144	7	0	210
42205	26999s (+0.5s)	1896	1896	128	43	138	11	0	192
42206	27000s (+0.7s)	2708	2708	256	64	165	8	0	237
42207	27000s (+0.4s)	1484	1484	128	34	116	5	0	155
42208	27001s (+0.8s)	3540	3540	256	68	213	12	0	293
42209	27002s (+0.3s)	828	828	64	21	80	4	0	105
42210	27002s (+0.3s)	656	656	64	20	64	5	0	89
42211	27002s (+0.6s)	2416	2416	256	58	134	20	0	212
42212	27003s (+0.9s)	3628	3628	256	92	206	11	0	309
42213	27004s (+0.7s)	2796	2796	256	51	180	0	11	242
42214	27005s (+0.6s)	2632	2632	256	37	186	0	9	232
42215	27005s (+0.6s)	2532	2532	256	47	160	0	9	216
42216	27006s (+0.8s)	3208	3208	256	73	185	0	11	269
42217	27007s (+0.4s)	1600	1600	128	23	126	0	9	158
42218	27007s (+0.6s)	2028	2028	128	41	148	0	13	202
42219	27008s (+0.4s)	1436	1436	128	28	112	0	8	148
42220	27008s (+0.4s)	1192	1192	64	40	95	5	0	140
42221	27009s (+1.2s)	6052	6052	512	116	286	29	0	431
42222	27010s (+0.7s)	2788	2788	256	51	179	10	0	240
42223	27011s (+0.8s)	3484	3484	256	68	211	11	0	290
42224	27011s (+0.5s)	1728	1728	128	40	130	2	0	172
42225	27012s (+0.4s)	1188	1188	128	25	97	6	0	128
42226	27012s (+0.7s)	3160	3160	256	61	191	10	0	262
42227	27013s (+0.8s)	3300	3300	256	69	194	12	0	275
42228	27014s (+0.9s)	3612	3612	256	81	206	19	0	306
42229	27015s (+0.5s)	1828	1828	128	41	143	7	0	191
42230	27015s (+0.4s)	1176	1176	64	34	100	7	0	141
42231	27015s (+0.4s)	1220	1220	128	33	95	5	0	133
42232	27016s (+0.5s)	1788	1788	128	50	122	10	0	182
42233	27016s (+0.5s)	1612	1612	128	45	114	11	0	170
42234	27017s (+0.6s)	2068	2068	128	39	157	11	1	208
42235	27018s (+0.7s)	2576	2576	128	59	168	16	0	243
42236	27019s (+1.4s)	6796	6796	512	130	324	31	1	486
42237	27020s (+0.7s)	2924	2924	256	56	189	11	1	257
42238	27021s (+1.3s)	6504	6504	512	124	316	28	0	468
42239	27022s (+0.8s)	3356	3356	256	67	202	7	0	276
42240	27022s (+0.5s)	1624	1624	128	32	126	11	0	169
42241	27023s (+0.5s)	2196	2196	256	42	137	0	11	190
42242	27023s (+0.5s)	1800	1800	128	35	140	0	10	185
42243	27024s (+0.4s)	1460	1460	128	34	109	0	6	149
42244	27025s (+0.7s)	3104	3104	256	50	194	0	12	256
42245	27025s (+0.7s)	2816	2816	256	39	182	0	13	234
42246	27026s (+0.7s)	3184	3184	256	58	192	0	14	264
42247	27027s (+0.7s)	3192	3192	256	62	195	0	10	267
42248	27027s (+0.6s)	2028	2028	128	43	141	0	9	193
42249	27028s (+0.8s)	3416	3416	256	56	219	0	10	285
42250	27029s (+0.4s)	1332	1332	128	27	108	0	3	138
42251	27030s (+1.0s)	4168	4168	256	66	259	0	16	341
42252	27030s (+0.3s)	972	972	128	18	79	0	5	102
42253	27030s (+0.4s)	1444	1444	128	32	107	0	8	147
42254	27031s (+0.5s)	1644	1644	128	36	118	0	10	164
42255	27031s (+0.6s)	2648	2648	256	52	170	0	9	231
42256	27032s (+0.6s)	2484	2484	256	39	158	0	10	207
42257	27033s (+0.7s)	2916	2916	256	57	176	12	0	245
42258	27033s (+0.5s)	2096	2096	256	36	139	5	0	180
42259	27034s (+0.5s)	1780	1780	128	57	116	7	0	180
42260	27034s (+0.6s)	2328	2328	256	40	148	7	0	195
42261	27035s (+0.9s)	3664	3664	256	76	215	9	0	300
42262	27036s (+0.4s)	1476	1476	128	30	120	3	0	153
42263	27036s (+0.6s)	2232	2232	128	56	147	10	0	213
42264	27037s (+0.9s)	3864	3864	256	72	227	17	0	316
42265	27038s (+1.0s)	4072	4072	256	92	230	18	0	340
42266	27039s (+0.5s)	1608	1608	128	40	118	10	1	169
42267	27039s (+0.6s)	2468	2468	256	55	140	15	0	210
42268	27040s (+0.5s)	1868	1868	128	47	132	11	0	190
42269	27041s (+0.8s)	3436	3436	256	70	208	12	0	290
42270	27041s (+0.6s)	2504	2504	256	52	156	7	0	215
42271	27042s (+0.7s)	2484	2484	128	58	162	12	0	232
42272	27042s (+0.5s)	1804	1804	128	55	124	7	0	186
42273	27043s (+0.8s)	3248	3248	256	61	201	12	0	274
42274	27044s (+0.4s)	1156	1156	64	42	88	6	0	136
42275	27044s (+0.3s)	584	584	32	17	72	1	0	90
42276	27045s (+0.8s)	3548	3548	256	64	217	12	0	293
42277	27045s (+0.5s)	1768	1768	128	43	129	9	1	182
42278	27046s (+0.4s)	1436	1436	128	27	117	5	0	149
42279	27046s (+0.4s)	1340	1340	128	32	100	8	0	140
42280	27047s (+0.7s)	3044	3044	256	62	176	9	0	247
42281	27047s (+0.5s)	2012	2012	256	47	109	7	0	163
42282	27048s (+0.9s)	3956	3956	256	76	230	17	0	323
42283	27049s (+0.9s)	3988	3988	256	82	232	17	0	331
42284	27050s (+0.5s)	1776	1776	128	36	134	8	1	179
42285	27050s (+0.7s)	2948	2948	256	65	186	7	0	258
42286	27051s (+0.4s)	1492	1492	128	25	128	0	3	156
42287	27051s (+0.5s)	2008	2008	256	31	123	0	10	164
42288	27052s (+0.8s)	3324	3324	256	61	212	0	15	288
42289	27052s (+0.2s)	524	524	32	18	58	0	4	80
42290	27053s (+0.3s)	680	680	64	15	69	0	5	89
42291	27053s (+0.6s)	2596	2596	256	54	161	9	0	224
42292	27054s (+0.5s)	2196	2196	256	62	120	8	0	190
42293	27055s (+1.0s)	4236	4236	256	103	224	22	0	349
42294	27056s (+1.1s)	4512	4512	256	103	248	23	0	374
42295	27057s (+0.6s)	2332	2332	128	53	162	11	1	227
42296	27057s (+0.7s)	3132	3132	256	69	180	14	0	263
42297	27058s (+0.7s)	2884	2884	256	61	179	12	0	252
42298	27058s (+0.4s)	1152	1152	64	30	102	4	0	136
42299	27059s (+0.8s)	3220	3220	256	70	192	11	0	273
Episode	Time	Reward	Score	Highest	L	U	R	D	Steps
42300	27060s (+0.4s)	1148	1148	64	35	98	5	0	138
42301	27060s (+0.4s)	1524	1524	128	41	113	6	0	160
42302	27060s (+0.4s)	1312	1312	128	35	92	6	0	133
42303	27061s (+0.2s)	536	536	64	17	54	2	0	73
42304	27061s (+0.8s)	3348	3348	256	50	213	9	0	272
42305	27062s (+0.3s)	876	876	64	26	81	7	0	114
42306	27062s (+0.4s)	1236	1236	128	30	101	6	0	137
42307	27063s (+1.2s)	6184	6184	512	108	294	15	1	418
42308	27064s (+0.6s)	1940	1940	128	48	148	7	0	203
42309	27064s (+0.3s)	868	868	64	22	86	4	0	112
42310	27065s (+0.7s)	3104	3104	256	63	178	14	0	255
42311	27065s (+0.4s)	1312	1312	128	22	118	3	0	143
42312	27066s (+0.7s)	3140	3140	256	47	201	0	11	259
42313	27067s (+0.8s)	3244	3244	256	69	190	0	15	274
42314	27067s (+0.5s)	1632	1632	128	34	132	0	9	175
42315	27068s (+0.5s)	1608	1608	128	35	126	0	8	169
42316	27069s (+0.8s)	3212	3212	256	49	206	0	10	265
42317	27069s (+0.4s)	1192	1192	128	20	106	0	5	131
42318	27070s (+0.7s)	2736	2736	256	44	177	0	12	233
42319	27070s (+0.5s)	2260	2260	256	37	144	0	6	187
42320	27071s (+0.6s)	2380	2380	128	47	162	0	14	223
42321	27071s (+0.3s)	872	872	64	23	84	0	4	111
42322	27072s (+0.6s)	2504	2504	256	58	146	10	0	214
42323	27072s (+0.6s)	1884	1884	128	34	151	0	9	194
42324	27073s (+0.4s)	1228	1228	64	43	85	11	0	139
42325	27074s (+0.7s)	2952	2952	256	68	172	13	0	253
42326	27074s (+0.6s)	1928	1928	128	46	148	6	0	200
42327	27075s (+0.7s)	2768	2768	256	61	164	10	1	236
42328	27076s (+0.7s)	3180	3180	256	67	185	10	1	263
42329	27076s (+0.5s)	1800	1800	128	39	135	11	0	185
42330	27076s (+0.4s)	1492	1492	128	32	117	7	0	156
42331	27077s (+0.8s)	3240	3240	256	86	183	19	0	288
42332	27078s (+0.9s)	3708	3708	256	73	221	0	11	305
42333	27079s (+0.3s)	912	912	64	20	88	0	2	110
42334	27079s (+0.5s)	1864	1864	128	32	152	0	5	189
42335	27080s (+0.6s)	2760	2760	256	53	167	13	0	233
42336	27080s (+0.4s)	1524	1524	128	32	116	8	1	157
42337	27081s (+0.6s)	2208	2208	128	43	156	8	0	207
42338	27082s (+0.9s)	3644	3644	256	80	216	15	0	311
42339	27082s (+0.5s)	1644	1644	128	46	115	12	0	173
42340	27083s (+0.9s)	3992	3992	256	75	229	18	0	322
42341	27084s (+0.6s)	2576	2576	256	39	167	6	1	213
42342	27084s (+0.5s)	1688	1688	128	45	116	12	0	173
42343	27085s (+0.4s)	1248	1248	64	34	104	6	0	144
42344	27085s (+0.2s)	480	480	32	17	56	3	0	76
42345	27086s (+0.8s)	3292	3292	256	93	165	18	0	276
42346	27086s (+0.8s)	3408	3408	256	87	188	12	0	287
42347	27087s (+0.4s)	1456	1456	128	32	119	2	0	153
42348	27087s (+0.5s)	1776	1776	128	42	124	13	0	179
42349	27088s (+0.5s)	1668	1668	128	39	122	5	0	166
42350	27088s (+0.2s)	444	444	32	11	57	3	1	72
42351	27089s (+0.9s)	3568	3568	256	66	220	13	0	299
42352	27090s (+0.6s)	2144	2144	128	56	141	10	0	207
42353	27090s (+0.7s)	2784	2784	256	60	167	9	0	236
42354	27091s (+0.5s)	1604	1604	128	39	119	10	0	168
42355	27091s (+0.3s)	948	948	64	38	68	10	0	116
42356	27092s (+0.5s)	1816	1816	128	45	125	12	0	182
42357	27093s (+0.9s)	3976	3976	256	64	245	0	19	328
42358	27093s (+0.8s)	3284	3284	256	47	207	0	15	269
42359	27094s (+0.3s)	1096	1096	128	27	86	0	4	117
42360	27094s (+0.4s)	1392	1392	128	29	106	0	7	142
42361	27095s (+0.5s)	1640	1640	128	42	118	7	0	167
42362	27095s (+0.9s)	3624	3624	256	73	219	12	1	305
42363	27096s (+0.4s)	1132	1132	64	34	91	9	0	134
42364	27097s (+1.0s)	4300	4300	256	99	241	17	0	357
42365	27098s (+0.9s)	3568	3568	256	88	199	12	0	299
42366	27099s (+1.0s)	4232	4232	256	82	250	16	0	348
42367	27099s (+0.4s)	1348	1348	128	51	83	3	0	137
42368	27100s (+0.7s)	2912	2912	256	55	189	10	0	254
42369	27100s (+0.6s)	1916	1916	128	43	148	0	6	197
42370	27101s (+0.4s)	1536	1536	128	45	107	10	0	162
42371	27101s (+0.5s)	1604	1604	128	34	134	0	1	169
42372	27102s (+0.9s)	3856	3856	256	55	249	0	11	315
42373	27103s (+0.8s)	3512	3512	256	63	213	0	17	293
42374	27104s (+0.8s)	3568	3568	256	67	212	0	11	290
42375	27105s (+0.8s)	3364	3364	256	63	215	0	9	287
42376	27105s (+0.6s)	2424	2424	256	60	139	0	11	210
42377	27106s (+0.6s)	2480	2480	256	51	152	0	8	211
42378	27106s (+0.5s)	1668	1668	128	37	129	0	13	179
42379	27107s (+0.8s)	3332	3332	256	57	202	0	21	280
42380	27108s (+1.0s)	4192	4192	256	72	254	0	23	349
42381	27109s (+0.4s)	1468	1468	128	33	111	0	11	155
42382	27109s (+0.6s)	2652	2652	256	49	171	0	13	233
42383	27110s (+0.7s)	3036	3036	256	53	193	7	1	254
42384	27111s (+0.9s)	3660	3660	256	75	227	11	0	313
42385	27111s (+0.5s)	1824	1824	128	44	132	8	0	184
42386	27112s (+0.5s)	2100	2100	256	31	139	2	0	172
42387	27112s (+0.3s)	864	864	64	27	77	7	0	111
42388	27113s (+0.8s)	3128	3128	256	73	173	15	1	262
42389	27114s (+1.1s)	5640	5640	512	105	263	25	1	394
42390	27115s (+1.2s)	6152	6152	512	120	283	27	0	430
42391	27116s (+0.6s)	1936	1936	128	39	148	9	0	196
42392	27116s (+0.5s)	1888	1888	128	49	133	8	0	190
42393	27117s (+0.7s)	2832	2832	256	65	162	12	0	239
42394	27118s (+0.5s)	1692	1692	128	30	134	10	0	174
42395	27118s (+0.6s)	2576	2576	256	49	153	8	0	210
42396	27119s (+1.0s)	4220	4220	256	95	233	17	0	345
42397	27120s (+0.5s)	1792	1792	128	43	131	9	0	183
42398	27121s (+0.8s)	3476	3476	256	64	213	11	0	288
42399	27121s (+0.7s)	2740	2740	256	75	144	14	0	233
Episode	Time	Reward	Score	Highest	L	U	R	D	Steps
42400	27122s (+0.9s)	3904	3904	256	71	239	12	0	322
42401	27123s (+0.4s)	1348	1348	128	28	102	7	0	137
42402	27124s (+0.9s)	3720	3720	256	90	214	22	1	327
42403	27124s (+0.5s)	1752	1752	128	47	122	9	0	178
42404	27125s (+0.7s)	2988	2988	256	64	172	10	1	247
42405	27126s (+1.4s)	6792	6792	512	135	335	26	0	496
42406	27127s (+0.6s)	2480	2480	256	55	152	10	0	217
42407	27127s (+0.3s)	772	772	64	22	74	3	0	99
42408	27128s (+0.6s)	2108	2108	128	59	140	12	0	211
42409	27128s (+0.7s)	2484	2484	128	67	157	8	1	233
42410	27129s (+0.4s)	1480	1480	128	39	105	9	0	153
42411	27130s (+0.7s)	2968	2968	256	59	179	10	0	248
42412	27130s (+0.4s)	1224	1224	128	33	93	7	0	133
42413	27131s (+0.6s)	2616	2616	256	45	159	15	0	219
42414	27131s (+0.4s)	1180	1180	128	26	99	3	0	128
42415	27131s (+0.5s)	1772	1772	128	45	126	11	0	182
42416	27132s (+0.6s)	2488	2488	256	57	148	12	1	218
42417	27133s (+0.8s)	3440	3440	256	62	214	14	0	290
42418	27134s (+1.4s)	6532	6532	512	117	327	27	0	471
42419	27135s (+0.9s)	3564	3564	256	90	189	19	0	298
42420	27136s (+0.8s)	3292	3292	256	70	202	9	0	281
42421	27137s (+0.8s)	3368	3368	256	63	212	13	0	288
42422	27138s (+0.9s)	3628	3628	256	80	212	17	0	309
42423	27139s (+0.8s)	3396	3396	256	61	209	10	0	280
42424	27139s (+0.5s)	2160	2160	256	32	141	0	9	182
42425	27139s (+0.2s)	620	620	64	16	57	0	6	79
42426	27140s (+0.8s)	3220	3220	256	71	190	11	0	272
42427	27141s (+0.7s)	3120	3120	256	68	177	13	1	259
42428	27141s (+0.6s)	2404	2404	256	40	158	7	0	205
42429	27142s (+0.5s)	1712	1712	128	45	117	8	0	170
42430	27142s (+0.6s)	1956	1956	128	45	146	8	1	200
42431	27143s (+0.2s)	388	388	32	19	43	2	0	64
42432	27143s (+0.7s)	2896	2896	256	67	172	11	0	250
42433	27144s (+0.5s)	2228	2228	256	44	140	7	0	191
42434	27145s (+0.6s)	2664	2664	256	54	162	11	0	227
42435	27145s (+0.4s)	1400	1400	128	36	107	3	0	146
42436	27146s (+0.7s)	2796	2796	256	62	167	13	0	242
42437	27147s (+0.9s)	3968	3968	256	74	245	12	0	331
42438	27147s (+0.8s)	3404	3404	256	83	192	12	0	287
42439	27148s (+1.0s)	4084	4084	256	88	235	20	0	343
42440	27149s (+0.5s)	1868	1868	128	38	148	4	0	190
42441	27150s (+0.6s)	2520	2520	256	60	144	11	0	215
42442	27150s (+0.9s)	3528	3528	256	76	202	19	0	297
42443	27151s (+0.8s)	3236	3236	256	73	183	16	0	272
42444	27152s (+0.8s)	3184	3184	256	67	186	12	0	265
42445	27152s (+0.3s)	868	868	64	32	75	6	0	113
42446	27153s (+0.6s)	1896	1896	128	44	141	8	0	193
42447	27153s (+0.3s)	892	892	64	30	79	5	0	114
42448	27154s (+0.5s)	1860	1860	128	54	126	8	0	188
42449	27154s (+0.7s)	2720	2720	256	48	170	11	0	229
42450	27155s (+0.8s)	3360	3360	256	60	201	14	0	275
42451	27156s (+0.6s)	2576	2576	256	57	160	7	0	224
42452	27157s (+1.0s)	4268	4268	256	84	257	16	0	357
42453	27157s (+0.3s)	800	800	64	26	77	4	0	107
42454	27158s (+0.6s)	2000	2000	128	48	143	10	2	203
42455	27159s (+1.0s)	4084	4084	256	105	219	14	0	338
42456	27159s (+0.6s)	1920	1920	128	45	144	8	1	198
42457	27160s (+0.7s)	2716	2716	256	39	182	0	11	232
42458	27161s (+0.7s)	2820	2820	256	40	195	0	7	242
42459	27161s (+0.3s)	832	832	64	20	84	0	4	108
42460	27162s (+0.8s)	3412	3412	256	76	206	0	12	294
42461	27163s (+1.1s)	5536	5536	512	127	240	27	2	396
42462	27164s (+0.5s)	1832	1832	128	46	132	8	0	186
42463	27164s (+0.7s)	2896	2896	256	50	178	9	0	237
42464	27165s (+0.5s)	1888	1888	128	52	128	10	0	190
42465	27166s (+0.7s)	3372	3372	256	71	192	11	0	274
42466	27166s (+0.8s)	3448	3448	256	64	206	15	0	285
42467	27167s (+0.3s)	1052	1052	64	31	91	4	0	126
42468	27167s (+0.8s)	3488	3488	256	77	200	14	0	291
42469	27168s (+0.3s)	1192	1192	128	26	92	3	0	121
42470	27168s (+0.5s)	1912	1912	128	43	146	7	0	196
42471	27169s (+0.6s)	1904	1904	128	50	137	7	0	194
42472	27170s (+0.9s)	4052	4052	256	80	234	12	0	326
42473	27171s (+1.0s)	4220	4220	256	114	213	19	0	346
42474	27171s (+0.4s)	1384	1384	128	31	106	9	0	146
42475	27172s (+0.7s)	2744	2744	256	59	170	12	0	241
42476	27173s (+0.7s)	2736	2736	256	59	174	6	0	239
42477	27174s (+0.8s)	3392	3392	256	61	208	0	15	284
42478	27174s (+0.9s)	3996	3996	256	56	260	0	17	333
42479	27175s (+0.5s)	1728	1728	128	27	143	0	7	177
42480	27176s (+0.8s)	3348	3348	256	63	210	7	0	280
42481	27177s (+0.8s)	3244	3244	256	67	192	14	0	273
42482	27177s (+0.7s)	2828	2828	256	55	175	11	0	241
42483	27178s (+0.4s)	1384	1384	128	30	112	4	0	146
42484	27178s (+0.4s)	1412	1412	128	48	95	6	0	149
42485	27179s (+0.7s)	2920	2920	256	65	178	13	0	256
42486	27179s (+0.3s)	796	796	64	14	89	3	0	106
42487	27180s (+0.7s)	3204	3204	256	71	185	12	1	269
42488	27181s (+0.9s)	3732	3732	256	77	212	19	0	308
42489	27182s (+0.8s)	3184	3184	256	64	191	9	0	264
42490	27182s (+0.6s)	2204	2204	128	61	139	10	0	210
42491	27183s (+0.7s)	3128	3128	256	68	177	15	1	261
42492	27184s (+0.7s)	2856	2856	256	56	180	9	0	245
42493	27184s (+0.8s)	3204	3204	256	52	198	10	1	261
42494	27185s (+0.7s)	2680	2680	256	52	164	14	0	230
42495	27186s (+0.6s)	1908	1908	128	55	130	10	0	195
42496	27186s (+0.5s)	1816	1816	128	39	144	6	0	189
42497	27187s (+0.7s)	2956	2956	256	41	198	11	0	250
42498	27188s (+1.2s)	6128	6128	512	115	284	28	1	428
42499	27189s (+0.6s)	2536	2536	256	41	175	5	0	221
Episode	Time	Reward	Score	Highest	L	U	R	D	Steps
42500	27189s (+0.6s)	2508	2508	256	38	155	11	0	204
42501	27190s (+0.7s)	3212	3212	256	62	191	18	0	271
42502	27191s (+0.9s)	4196	4196	256	93	234	17	0	344
42503	27192s (+0.9s)	3508	3508	256	63	217	17	0	297
42504	27192s (+0.6s)	1944	1944	128	52	142	10	0	204
42505	27193s (+0.7s)	2836	2836	256	71	156	14	0	241
42506	27194s (+0.7s)	2820	2820	256	66	173	9	0	248
42507	27194s (+0.6s)	2512	2512	256	52	149	11	0	212
42508	27195s (+0.9s)	4176	4176	256	87	233	19	0	339
42509	27196s (+0.4s)	1152	1152	64	30	103	3	0	136
42510	27196s (+0.5s)	1636	1636	128	51	116	9	0	176
42511	27197s (+0.5s)	1752	1752	128	47	117	13	1	178
42512	27198s (+0.9s)	3696	3696	256	95	200	16	0	311
42513	27198s (+0.4s)	1260	1260	128	47	82	6	0	135
42514	27198s (+0.4s)	1192	1192	64	37	102	6	0	145
42515	27199s (+0.7s)	2620	2620	256	48	174	0	7	229
42516	27200s (+0.7s)	2756	2756	256	43	184	0	10	237
42517	27201s (+0.8s)	3180	3180	256	59	190	0	14	263
42518	27201s (+0.6s)	2540	2540	256	37	165	0	14	216
42519	27202s (+0.5s)	1840	1840	128	55	120	11	1	187
42520	27203s (+0.9s)	3996	3996	256	70	241	12	0	323
42521	27203s (+0.8s)	3324	3324	256	63	208	8	0	279
42522	27204s (+0.3s)	904	904	64	25	83	6	0	114
42523	27204s (+0.7s)	2788	2788	256	58	171	11	0	240
42524	27205s (+0.7s)	2508	2508	128	56	171	8	0	235
42525	27206s (+0.5s)	1628	1628	128	48	118	7	0	173
42526	27206s (+0.5s)	1664	1664	128	43	117	7	0	167
42527	27207s (+0.5s)	1544	1544	128	40	122	3	0	165
42528	27207s (+0.8s)	3376	3376	256	68	200	12	1	281
42529	27208s (+0.7s)	2724	2724	256	60	155	17	1	233
42530	27209s (+0.5s)	1784	1784	128	44	132	9	0	185
42531	27209s (+0.5s)	1924	1924	128	47	134	8	0	189
42532	27210s (+0.8s)	3476	3476	256	67	213	13	0	293
42533	27211s (+0.8s)	3544	3544	256	65	221	14	0	300
42534	27211s (+0.4s)	1184	1184	64	34	103	6	0	143
42535	27212s (+0.8s)	3532	3532	256	69	212	13	1	295
42536	27213s (+0.5s)	1628	1628	128	44	123	6	0	173
42537	27213s (+0.3s)	912	912	64	23	84	4	0	111
42538	27214s (+0.8s)	3204	3204	256	70	184	15	0	269
42539	27214s (+0.4s)	1240	1240	64	50	84	8	0	142
42540	27215s (+0.8s)	3612	3612	256	79	203	13	0	295
42541	27216s (+0.7s)	2568	2568	128	68	164	12	0	244
42542	27217s (+0.8s)	3624	3624	256	64	219	11	0	294
42543	27217s (+0.6s)	2404	2404	256	38	161	0	5	204
42544	27218s (+0.7s)	2932	2932	256	60	187	0	12	259
42545	27218s (+0.5s)	1708	1708	128	33	123	0	11	167
42546	27219s (+0.4s)	1456	1456	128	33	109	0	10	152
42547	27219s (+0.6s)	2420	2420	256	47	149	0	6	202
42548	27220s (+0.4s)	1048	1048	64	29	92	0	5	126
42549	27221s (+0.8s)	3424	3424	256	56	220	11	0	287
42550	27221s (+0.6s)	2364	2364	128	51	160	7	0	218
42551	27222s (+0.6s)	2320	2320	128	57	155	11	0	223
42552	27222s (+0.3s)	748	748	64	20	78	2	0	100
42553	27223s (+0.5s)	1604	1604	128	41	120	6	1	168
42554	27223s (+0.5s)	1616	1616	128	38	128	5	0	171
42555	27224s (+0.8s)	3556	3556	256	69	217	12	0	298
42556	27225s (+0.6s)	2252	2252	128	57	152	8	0	217
42557	27225s (+0.3s)	916	916	64	40	72	7	0	119
42558	27226s (+0.7s)	3044	3044	256	63	181	0	12	256
42559	27226s (+0.5s)	1624	1624	128	34	133	0	6	173
42560	27227s (+1.0s)	4968	4968	512	77	249	0	17	343
42561	27227s (+0.2s)	572	572	64	13	63	0	2	78
42562	27228s (+0.6s)	1948	1948	128	64	129	7	0	200
42563	27228s (+0.2s)	420	420	32	12	51	4	0	67
42564	27229s (+0.3s)	828	828	64	26	79	3	0	108
42565	27229s (+0.6s)	1876	1876	128	36	148	9	0	193
42566	27230s (+1.1s)	5488	5488	512	83	290	0	18	391
42567	27231s (+0.6s)	2532	2532	256	44	169	0	11	224
42568	27232s (+0.8s)	3256	3256	256	55	207	0	15	277
42569	27232s (+0.2s)	584	584	64	15	63	0	3	81
42570	27232s (+0.2s)	528	528	64	17	58	0	2	77
42571	27233s (+1.1s)	4540	4540	256	97	260	19	0	376
42572	27234s (+0.7s)	3072	3072	256	78	167	18	0	263
42573	27234s (+0.2s)	496	496	32	16	63	1	0	80
42574	27235s (+0.6s)	2596	2596	256	59	154	11	0	224
42575	27235s (+0.6s)	1956	1956	128	54	146	7	0	207
42576	27236s (+1.0s)	4336	4336	256	84	255	19	0	358
42577	27237s (+0.7s)	2920	2920	256	67	178	11	0	256
42578	27238s (+1.1s)	5728	5728	512	108	282	20	0	410
42579	27239s (+0.6s)	2704	2704	256	55	165	9	0	229
42580	27240s (+0.7s)	2992	2992	256	67	153	18	1	239
42581	27240s (+0.5s)	1900	1900	128	49	133	11	0	193
42582	27241s (+0.8s)	3244	3244	256	74	182	17	0	273
42583	27242s (+0.6s)	2436	2436	256	47	145	13	0	205
42584	27242s (+0.4s)	1492	1492	128	37	109	10	0	156
42585	27243s (+0.5s)	1904	1904	128	47	131	16	0	194
42586	27243s (+0.6s)	2596	2596	256	49	162	13	0	224
42587	27244s (+0.7s)	2860	2860	256	70	159	17	0	246
42588	27245s (+0.9s)	3540	3540	256	80	202	17	0	299
42589	27245s (+0.7s)	2812	2812	256	50	179	5	0	234
42590	27246s (+0.7s)	2640	2640	256	63	164	7	0	234
42591	27247s (+0.5s)	1876	1876	128	47	120	11	0	178
42592	27247s (+0.5s)	1848	1848	128	44	133	9	0	186
42593	27248s (+1.0s)	4584	4584	256	97	260	19	0	376
42594	27249s (+0.8s)	3288	3288	256	52	208	8	1	269
42595	27250s (+0.7s)	2648	2648	128	74	162	16	0	252
42596	27250s (+0.5s)	1492	1492	128	30	120	7	0	157
42597	27251s (+0.4s)	1548	1548	128	37	111	7	0	155
42598	27251s (+0.2s)	468	468	32	15	53	5	1	74
42599	27252s (+1.0s)	4220	4220	256	81	252	13	0	346
Episode	Time	Reward	Score	Highest	L	U	R	D	Steps
42600	27252s (+0.4s)	1496	1496	128	43	99	12	0	154
42601	27253s (+0.5s)	1684	1684	128	44	121	7	1	173
42602	27253s (+0.5s)	1772	1772	128	39	132	8	0	179
42603	27254s (+0.8s)	3228	3228	256	65	189	16	0	270
42604	27255s (+0.6s)	2580	2580	256	57	158	10	0	225
42605	27255s (+0.5s)	1780	1780	128	46	129	6	0	181
42606	27256s (+0.7s)	2448	2448	128	56	163	9	0	228
42607	27257s (+0.8s)	3568	3568	256	75	208	15	0	298
42608	27257s (+0.5s)	1708	1708	128	35	130	4	0	169
42609	27258s (+0.7s)	2968	2968	256	75	157	17	1	250
42610	27258s (+0.4s)	1380	1380	128	34	100	5	1	140
42611	27259s (+0.5s)	1920	1920	128	42	146	10	0	198
42612	27259s (+0.4s)	1460	1460	128	44	99	6	0	149
42613	27260s (+0.4s)	1332	1332	128	20	111	7	0	138
42614	27261s (+0.9s)	3696	3696	256	81	212	18	0	311
42615	27261s (+0.4s)	1300	1300	128	30	100	2	0	132
42616	27262s (+0.8s)	3560	3560	256	68	211	17	0	296
42617	27263s (+0.6s)	2540	2540	128	63	159	13	0	235
42618	27263s (+0.4s)	1320	1320	128	24	109	1	2	136
42619	27264s (+0.5s)	1944	1944	128	47	133	13	0	193
42620	27264s (+0.8s)	2900	2900	128	75	176	20	1	272
42621	27265s (+0.8s)	3400	3400	256	56	217	0	9	282
42622	27266s (+0.4s)	1348	1348	128	26	99	0	13	138
42623	27266s (+0.5s)	1856	1856	128	37	145	0	6	188
42624	27267s (+0.8s)	3220	3220	256	55	197	0	17	269
42625	27268s (+0.7s)	2760	2760	256	39	188	0	8	235
42626	27268s (+0.5s)	1616	1616	128	42	116	0	4	162
42627	27269s (+0.9s)	3764	3764	256	94	198	15	0	307
42628	27269s (+0.5s)	1836	1836	128	47	131	6	0	184
42629	27270s (+0.6s)	2300	2300	128	65	141	12	0	218
42630	27271s (+0.6s)	2640	2640	256	53	167	5	0	225
42631	27271s (+0.3s)	900	900	64	39	73	4	0	116
42632	27272s (+0.6s)	2528	2528	256	51	163	9	0	223
42633	27272s (+0.8s)	3336	3336	256	61	206	13	0	280
42634	27273s (+0.5s)	1800	1800	128	56	122	7	0	185
42635	27274s (+0.6s)	2160	2160	128	57	136	8	0	201
42636	27274s (+0.7s)	2868	2868	256	54	194	7	0	255
42637	27275s (+0.6s)	2624	2624	256	65	147	10	0	222
42638	27276s (+0.7s)	2720	2720	128	69	171	15	0	255
42639	27276s (+0.6s)	2332	2332	128	59	151	11	0	221
42640	27277s (+0.9s)	3632	3632	256	83	210	13	0	306
42641	27278s (+0.9s)	4088	4088	256	72	249	8	0	329
42642	27279s (+0.5s)	1936	1936	128	46	138	7	0	191
42643	27279s (+0.6s)	1960	1960	128	53	141	9	0	203
42644	27280s (+0.4s)	1248	1248	128	29	97	7	0	133
42645	27280s (+0.6s)	2860	2860	256	43	181	9	0	233
42646	27281s (+0.5s)	1840	1840	128	55	130	9	0	194
42647	27282s (+0.7s)	2712	2712	256	66	146	18	0	230
42648	27282s (+0.8s)	3208	3208	256	65	185	15	0	265
42649	27283s (+0.5s)	1856	1856	128	43	134	9	0	186
42650	27284s (+0.7s)	3008	3008	256	50	175	14	1	240
42651	27284s (+0.4s)	1168	1168	128	32	90	7	0	129
42652	27285s (+0.8s)	3308	3308	256	67	195	17	0	279
42653	27286s (+1.0s)	4924	4924	512	98	235	14	0	347
42654	27286s (+0.7s)	2760	2760	256	70	151	12	0	233
42655	27287s (+0.4s)	1208	1208	128	26	98	7	0	131
42656	27288s (+0.9s)	3968	3968	256	84	230	11	1	326
42657	27288s (+0.5s)	1860	1860	128	43	122	9	1	175
42658	27290s (+1.3s)	6476	6476	512	148	288	30	0	466
42659	27290s (+0.3s)	840	840	64	24	67	5	0	96
42660	27290s (+0.5s)	1888	1888	128	44	137	9	0	190
42661	27291s (+0.5s)	1808	1808	128	43	132	6	1	182
42662	27291s (+0.3s)	916	916	64	32	75	3	0	110
42663	27292s (+0.9s)	3628	3628	256	97	195	18	0	310
42664	27293s (+0.5s)	1828	1828	128	47	126	8	0	181
42665	27293s (+0.5s)	1580	1580	128	57	100	6	0	163
42666	27294s (+0.9s)	3612	3612	256	92	200	14	0	306
42667	27295s (+1.2s)	5844	5844	512	110	280	18	0	408
42668	27296s (+1.0s)	4064	4064	256	91	228	15	0	334
42669	27297s (+0.9s)	4004	4004	256	95	211	18	0	324
42670	27297s (+0.4s)	1056	1056	64	35	88	5	0	128
42671	27298s (+0.3s)	1108	1108	128	18	99	0	0	117
42672	27298s (+0.6s)	1920	1920	128	48	141	9	0	198
42673	27299s (+0.7s)	3112	3112	256	85	158	13	1	257
42674	27300s (+1.2s)	5820	5820	512	100	306	15	0	421
42675	27301s (+1.0s)	4756	4756	512	92	223	17	0	332
42676	27302s (+0.9s)	3844	3844	256	93	212	19	0	324
42677	27303s (+0.5s)	1716	1716	128	40	128	8	0	176
42678	27303s (+0.8s)	3144	3144	256	73	185	15	0	273
42679	27304s (+0.7s)	2728	2728	256	69	153	15	0	237
42680	27305s (+0.7s)	2784	2784	256	61	169	9	0	239
42681	27305s (+0.6s)	2408	2408	128	56	166	7	0	229
42682	27306s (+0.4s)	1320	1320	64	39	109	5	0	153
42683	27306s (+0.4s)	1356	1356	128	27	112	4	0	143
42684	27307s (+0.8s)	3416	3416	256	61	217	0	7	285
42685	27308s (+0.4s)	1168	1168	64	28	103	0	8	139
42686	27308s (+0.9s)	3768	3768	256	84	209	15	0	308
42687	27309s (+1.0s)	4312	4312	256	93	236	23	0	352
42688	27310s (+0.5s)	1436	1436	128	40	112	6	0	158
42689	27310s (+0.5s)	2092	2092	256	37	133	4	0	174
42690	27311s (+0.7s)	2860	2860	256	57	178	12	0	247
42691	27312s (+0.4s)	1444	1444	128	25	123	2	0	150
42692	27313s (+1.0s)	4344	4344	256	98	241	21	0	360
42693	27313s (+0.7s)	3016	3016	256	71	169	18	0	258
42694	27314s (+0.5s)	1660	1660	128	39	120	8	0	167
42695	27314s (+0.5s)	1796	1796	128	48	130	6	0	184
42696	27315s (+0.7s)	2816	2816	256	50	189	8	0	247
42697	27316s (+0.6s)	2512	2512	256	61	145	13	1	220
42698	27316s (+0.4s)	1296	1296	128	39	101	6	0	146
42699	27317s (+0.4s)	988	988	64	33	88	5	0	126
Episode	Time	Reward	Score	Highest	L	U	R	D	Steps
42700	27317s (+0.7s)	2920	2920	256	58	188	9	1	256
42701	27318s (+0.4s)	1480	1480	128	38	110	6	0	154
42702	27318s (+0.7s)	2840	2840	256	54	182	0	17	253
42703	27319s (+0.7s)	2860	2860	256	46	188	0	12	246
42704	27320s (+0.8s)	3396	3396	256	50	226	0	14	290
42705	27321s (+0.5s)	1928	1928	128	42	135	0	10	187
42706	27321s (+0.6s)	2360	2360	256	44	147	0	8	199
42707	27321s (+0.3s)	996	996	64	22	88	0	8	118
42708	27322s (+0.5s)	1800	1800	128	39	137	0	9	185
42709	27323s (+0.6s)	1912	1912	128	36	152	0	9	197
42710	27323s (+0.9s)	3576	3576	256	57	229	0	14	300
42711	27324s (+0.3s)	940	940	64	28	76	0	7	111
42712	27324s (+0.4s)	1444	1444	128	31	115	0	4	150
42713	27325s (+0.3s)	948	948	64	25	90	6	0	121
42714	27325s (+0.8s)	3220	3220	256	66	192	14	0	272
42715	27326s (+0.3s)	1256	1256	128	36	85	4	0	125
42716	27326s (+0.4s)	1572	1572	128	32	119	8	0	159
42717	27327s (+0.6s)	2068	2068	128	54	144	6	0	204
42718	27328s (+1.0s)	4180	4180	256	89	233	18	0	340
42719	27328s (+0.6s)	1912	1912	128	41	147	8	0	196
42720	27329s (+0.7s)	3164	3164	256	65	178	14	1	258
42721	27330s (+0.6s)	2432	2432	256	38	158	9	0	205
42722	27330s (+0.7s)	3116	3116	256	51	193	8	1	253
42723	27331s (+0.8s)	3564	3564	256	68	219	10	1	298
42724	27332s (+0.4s)	1468	1468	128	33	112	6	0	151
42725	27332s (+0.7s)	3036	3036	256	59	182	13	0	254
42726	27333s (+0.8s)	3476	3476	256	74	200	13	1	288
42727	27334s (+0.7s)	2732	2732	256	50	179	0	10	239
42728	27335s (+0.7s)	2876	2876	256	33	203	0	5	241
42729	27335s (+0.7s)	2836	2836	256	50	166	0	14	230
42730	27336s (+0.3s)	696	696	64	12	77	0	2	91
42731	27336s (+0.5s)	1636	1636	128	40	121	0	15	176
42732	27336s (+0.4s)	1168	1168	128	23	96	0	5	124
42733	27337s (+0.4s)	1328	1328	128	28	106	0	4	138
42734	27337s (+0.5s)	1572	1572	128	30	119	0	12	161
42735	27338s (+0.9s)	3676	3676	256	69	222	15	0	306
42736	27339s (+0.7s)	2736	2736	128	64	170	17	0	251
42737	27340s (+0.8s)	3396	3396	256	64	202	15	0	281
42738	27341s (+0.8s)	3508	3508	256	75	202	19	0	296
42739	27341s (+0.6s)	2336	2336	256	45	145	8	0	198
42740	27342s (+0.7s)	2864	2864	256	62	171	13	0	246
42741	27342s (+0.5s)	1824	1824	128	42	141	7	0	190
42742	27343s (+0.4s)	1472	1472	128	32	121	6	0	159
42743	27344s (+0.8s)	3500	3500	256	72	204	17	1	294
42744	27344s (+0.5s)	1804	1804	128	35	147	4	0	186
42745	27345s (+0.8s)	3208	3208	256	69	184	12	0	265
42746	27346s (+1.0s)	4032	4032	256	88	227	16	0	331
42747	27346s (+0.5s)	1596	1596	128	45	111	10	0	166
42748	27347s (+0.9s)	3776	3776	256	98	205	12	0	315
42749	27348s (+0.4s)	1320	1320	128	31	110	4	0	145
42750	27349s (+0.7s)	3176	3176	256	61	190	11	0	262
42751	27349s (+0.6s)	2456	2456	128	54	165	12	0	231
42752	27350s (+0.9s)	4752	4752	512	88	223	21	0	332
42753	27351s (+0.7s)	2900	2900	256	46	194	10	1	251
42754	27352s (+1.0s)	4244	4244	256	87	248	16	0	351
42755	27353s (+0.8s)	3492	3492	256	79	202	10	1	292
42756	27353s (+0.6s)	2432	2432	256	45	150	10	0	205
42757	27354s (+0.6s)	2732	2732	256	69	146	16	0	231
42758	27355s (+0.7s)	3232	3232	256	80	176	14	1	271
42759	27355s (+0.5s)	1672	1672	128	41	117	11	0	169
42760	27356s (+0.7s)	2876	2876	256	59	179	11	0	249
42761	27356s (+0.3s)	872	872	64	27	79	7	0	113
42762	27357s (+0.7s)	2840	2840	256	47	189	7	0	243
42763	27357s (+0.5s)	1644	1644	128	47	117	9	0	173
42764	27358s (+0.8s)	3480	3480	256	83	193	13	0	289
42765	27359s (+0.7s)	2776	2776	256	76	142	19	0	237
42766	27359s (+0.5s)	1604	1604	128	44	113	8	0	165
42767	27360s (+0.6s)	2192	2192	128	59	150	10	0	219
42768	27361s (+0.5s)	2076	2076	128	56	120	10	0	186
42769	27361s (+0.7s)	3088	3088	256	77	165	14	1	257
42770	27362s (+0.7s)	2692	2692	256	80	139	9	1	229
42771	27362s (+0.2s)	624	624	64	19	64	0	3	86
42772	27363s (+0.5s)	1596	1596	128	39	123	0	4	166
42773	27363s (+0.6s)	2176	2176	128	55	136	12	1	204
42774	27364s (+1.0s)	4124	4124	256	94	225	19	0	338
42775	27365s (+0.6s)	2632	2632	256	59	163	11	0	233
42776	27365s (+0.3s)	908	908	64	21	83	5	0	109
42777	27366s (+1.1s)	4616	4616	256	99	262	23	0	384
42778	27367s (+0.4s)	1064	1064	64	36	87	7	0	130
42779	27367s (+0.8s)	3340	3340	256	58	206	0	17	281
42780	27368s (+0.2s)	664	664	64	16	68	0	4	88
42781	27368s (+0.7s)	2988	2988	256	58	173	16	0	247
42782	27369s (+0.6s)	2324	2324	256	41	148	6	0	195
42783	27370s (+0.9s)	3524	3524	256	62	225	9	0	296
42784	27371s (+0.9s)	4024	4024	256	75	234	16	0	325
42785	27371s (+0.2s)	484	484	32	16	54	1	0	71
42786	27372s (+0.8s)	3532	3532	256	71	191	14	0	276
42787	27372s (+0.5s)	1612	1612	128	47	117	6	0	170
42788	27373s (+0.4s)	1148	1148	128	23	97	4	0	124
42789	27373s (+0.4s)	1040	1040	64	32	86	6	1	125
42790	27374s (+0.5s)	1628	1628	128	45	117	12	0	174
42791	27374s (+0.7s)	2472	2472	128	66	156	12	0	234
42792	27375s (+0.8s)	3148	3148	256	60	184	19	0	263
42793	27375s (+0.3s)	672	672	64	27	61	5	0	93
42794	27376s (+0.3s)	900	900	64	23	93	4	0	120
42795	27376s (+0.6s)	2668	2668	256	55	163	8	1	227
42796	27377s (+0.9s)	3992	3992	256	60	249	0	23	332
42797	27378s (+0.5s)	1660	1660	128	38	116	0	13	167
42798	27378s (+0.3s)	688	688	64	18	68	0	5	91
42799	27379s (+0.8s)	3192	3192	256	55	196	0	15	266
Episode	Time	Reward	Score	Highest	L	U	R	D	Steps
42800	27379s (+0.6s)	2576	2576	256	33	177	0	10	220
42801	27380s (+0.8s)	3240	3240	256	61	197	0	15	273
42802	27381s (+0.5s)	1516	1516	128	25	129	0	8	162
42803	27381s (+0.7s)	3012	3012	256	41	204	0	10	255
42804	27382s (+0.8s)	3304	3304	256	54	219	0	11	284
42805	27383s (+1.0s)	4236	4236	256	103	226	20	0	349
42806	27384s (+0.6s)	2384	2384	256	33	167	5	0	205
42807	27385s (+0.9s)	4088	4088	256	66	258	0	11	335
42808	27385s (+0.5s)	1816	1816	128	37	142	0	10	189
42809	27386s (+0.8s)	3264	3264	256	54	215	0	9	278
42810	27387s (+0.8s)	3364	3364	256	50	222	0	15	287
42811	27388s (+0.7s)	3172	3172	256	71	173	14	0	258
42812	27388s (+0.7s)	3136	3136	256	71	177	15	0	263
42813	27389s (+0.5s)	1904	1904	128	51	129	7	0	187
42814	27390s (+0.7s)	2772	2772	256	51	175	10	0	236
42815	27390s (+0.4s)	1476	1476	128	34	107	3	0	144
42816	27390s (+0.4s)	1480	1480	128	42	103	8	1	154
42817	27391s (+0.7s)	2700	2700	256	62	156	10	0	228
42818	27392s (+0.6s)	2064	2064	128	56	139	11	1	207
42819	27392s (+0.6s)	1904	1904	128	50	136	8	0	194
42820	27393s (+0.6s)	2104	2104	128	51	140	7	0	198
42821	27394s (+1.4s)	7040	7040	512	112	348	0	26	486
42822	27395s (+0.8s)	3500	3500	256	71	199	0	14	284
42823	27395s (+0.4s)	1388	1388	128	28	116	0	4	148
42824	27396s (+0.5s)	1604	1604	128	39	124	0	5	168
42825	27396s (+0.5s)	1796	1796	128	38	139	0	7	184
42826	27397s (+0.5s)	1752	1752	128	36	131	0	11	178
42827	27398s (+0.6s)	1948	1948	128	57	126	11	0	194
42828	27398s (+0.5s)	1728	1728	128	37	127	8	1	173
42829	27399s (+0.5s)	1580	1580	128	41	113	8	0	162
42830	27399s (+0.5s)	1812	1812	128	45	131	7	0	183
42831	27400s (+0.7s)	2904	2904	256	62	181	9	0	252
42832	27400s (+0.4s)	1176	1176	64	30	106	5	0	141
42833	27401s (+1.0s)	4332	4332	256	80	259	18	0	357
42834	27402s (+0.7s)	3176	3176	256	63	186	13	0	262
42835	27403s (+0.7s)	3068	3068	256	69	172	11	0	252
42836	27403s (+0.5s)	1884	1884	128	56	121	13	0	190
42837	27404s (+0.8s)	3132	3132	256	79	174	10	0	263
42838	27404s (+0.6s)	2344	2344	256	45	147	6	0	198
42839	27405s (+0.3s)	780	780	64	29	72	5	0	106
42840	27406s (+0.7s)	3224	3224	256	57	197	10	0	264
42841	27407s (+1.0s)	4296	4296	256	91	247	14	0	352
42842	27407s (+0.8s)	3116	3116	256	87	169	13	0	269
42843	27408s (+0.6s)	2468	2468	256	35	172	6	0	213
42844	27409s (+0.6s)	2524	2524	128	58	158	15	0	231
42845	27409s (+0.7s)	2824	2824	256	53	179	0	12	244
42846	27410s (+0.6s)	2048	2048	128	38	155	0	10	203
42847	27410s (+0.6s)	1904	1904	128	45	141	8	0	194
42848	27411s (+0.6s)	2784	2784	256	67	150	12	0	229
42849	27412s (+0.9s)	3832	3832	256	82	224	13	0	319
42850	27413s (+1.0s)	4340	4340	256	95	239	25	0	359
42851	27414s (+0.5s)	2232	2232	256	40	136	9	0	185
42852	27414s (+0.6s)	2664	2664	256	53	164	8	0	225
42853	27415s (+0.4s)	1020	1020	64	25	95	2	0	122
42854	27415s (+0.5s)	1788	1788	128	41	133	9	0	183
42855	27415s (+0.3s)	820	820	64	22	86	4	0	112
42856	27416s (+1.0s)	4164	4164	256	96	226	15	0	337
42857	27417s (+0.8s)	3124	3124	256	64	198	9	1	272
42858	27418s (+0.9s)	3960	3960	256	75	238	11	0	324
42859	27419s (+0.8s)	3332	3332	256	67	201	11	0	279
42860	27420s (+0.9s)	3648	3648	256	81	205	18	0	304
42861	27421s (+0.7s)	2508	2508	128	61	162	15	0	238
42862	27421s (+0.3s)	860	860	64	27	80	4	0	111
42863	27421s (+0.3s)	876	876	64	29	79	7	0	115
42864	27422s (+0.4s)	1036	1036	64	32	83	0	9	124
42865	27422s (+0.7s)	3028	3028	256	48	199	0	10	257
42866	27423s (+0.4s)	1020	1020	64	29	90	0	5	124
42867	27423s (+0.7s)	2884	2884	256	60	182	0	10	252
42868	27424s (+0.6s)	2640	2640	256	43	170	0	12	225
42869	27425s (+0.5s)	1888	1888	128	39	146	0	7	192
42870	27425s (+0.4s)	1192	1192	128	19	104	0	7	130
42871	27426s (+0.8s)	3284	3284	256	77	180	15	0	272
42872	27426s (+0.6s)	2580	2580	256	68	140	15	1	224
42873	27427s (+0.5s)	1868	1868	128	47	135	9	0	191
42874	27428s (+0.8s)	3476	3476	256	81	198	15	1	295
42875	27428s (+0.3s)	864	864	64	27	80	4	0	111
42876	27428s (+0.4s)	956	956	64	31	90	4	0	125
42877	27429s (+0.5s)	1548	1548	128	35	112	12	0	159
42878	27430s (+1.2s)	5772	5772	512	104	287	23	0	414
42879	27431s (+0.4s)	1108	1108	64	25	95	6	0	126
42880	27431s (+0.4s)	1048	1048	64	28	95	4	0	127
42881	27432s (+0.7s)	2800	2800	256	56	176	10	1	243
42882	27433s (+0.9s)	3980	3980	256	82	230	17	0	329
42883	27433s (+0.7s)	2768	2768	256	51	176	8	0	235
42884	27434s (+0.7s)	3268	3268	256	68	195	12	0	275
42885	27435s (+0.8s)	3348	3348	256	69	206	8	0	283
42886	27435s (+0.6s)	2920	2920	256	62	160	11	0	233
42887	27436s (+0.7s)	2848	2848	128	83	164	15	0	262
42888	27437s (+0.4s)	1444	1444	128	42	99	8	0	149
42889	27437s (+0.8s)	3340	3340	256	64	205	12	0	281
42890	27438s (+0.4s)	1480	1480	128	35	112	6	0	153
42891	27439s (+0.7s)	2940	2940	256	61	191	9	0	261
42892	27439s (+0.4s)	1520	1520	128	45	103	8	1	157
42893	27440s (+0.8s)	3428	3428	256	68	206	13	0	287
42894	27440s (+0.6s)	2096	2096	128	54	137	16	0	207
42895	27442s (+1.1s)	5544	5544	512	95	279	16	0	390
42896	27442s (+0.7s)	2864	2864	256	56	170	7	0	233
42897	27443s (+1.0s)	4228	4228	256	110	219	18	0	347
42898	27444s (+0.4s)	1172	1172	64	40	95	5	0	140
42899	27444s (+0.7s)	3016	3016	256	65	167	10	0	242
Episode	Time	Reward	Score	Highest	L	U	R	D	Steps
42900	27446s (+1.2s)	5996	5996	512	114	300	23	0	437
42901	27446s (+0.5s)	1520	1520	128	33	119	7	0	159
42902	27447s (+0.5s)	1608	1608	128	36	128	5	0	169
42903	27447s (+0.5s)	1728	1728	128	35	134	0	5	174
42904	27448s (+0.7s)	2764	2764	256	57	171	0	11	239
42905	27448s (+0.6s)	2500	2500	256	61	147	0	8	216
42906	27449s (+0.7s)	2736	2736	256	53	166	0	14	233
42907	27449s (+0.3s)	848	848	64	15	91	0	3	109
42908	27450s (+0.3s)	596	596	32	20	66	0	3	89
42909	27450s (+0.7s)	3144	3144	256	53	196	0	12	261
42910	27451s (+0.7s)	3184	3184	256	39	214	0	11	264
42911	27452s (+0.6s)	2076	2076	128	47	145	0	14	206
42912	27453s (+0.8s)	3568	3568	256	69	210	16	1	296
42913	27453s (+0.4s)	1344	1344	128	37	105	5	0	147
42914	27453s (+0.5s)	1648	1648	128	38	124	10	0	172
42915	27455s (+1.1s)	5668	5668	512	101	275	23	1	400
42916	27455s (+0.8s)	3416	3416	256	67	198	19	1	285
42917	27456s (+0.6s)	2364	2364	128	62	147	10	0	219
42918	27456s (+0.4s)	1120	1120	64	33	93	5	1	132
42919	27457s (+0.4s)	1500	1500	128	37	116	5	0	158
42920	27458s (+0.9s)	4028	4028	256	72	240	0	14	326
42921	27459s (+0.8s)	3252	3252	256	61	202	0	12	275
42922	27459s (+0.6s)	2108	2108	128	40	150	0	9	199
42923	27460s (+0.8s)	3244	3244	256	62	199	0	13	274
42924	27461s (+0.5s)	1732	1732	128	39	128	0	6	173
42925	27461s (+0.8s)	3612	3612	256	71	217	18	0	306
42926	27462s (+0.7s)	3056	3056	256	72	165	13	0	250
42927	27463s (+0.5s)	1860	1860	128	42	139	7	0	188
42928	27463s (+0.8s)	3492	3492	256	66	224	9	0	299
42929	27464s (+1.0s)	4060	4060	256	87	233	15	0	335
42930	27465s (+0.5s)	1688	1688	128	46	119	8	0	173
42931	27465s (+0.5s)	1608	1608	128	38	119	11	1	169
42932	27467s (+1.4s)	6920	6920	512	130	320	28	0	478
42933	27467s (+0.4s)	1044	1044	64	32	87	6	0	125
42934	27468s (+0.6s)	2528	2528	256	56	150	12	0	218
42935	27469s (+0.7s)	2796	2796	256	71	159	12	0	242
42936	27469s (+0.5s)	1744	1744	128	40	128	8	0	176
42937	27469s (+0.4s)	1440	1440	128	35	108	6	0	149
42938	27470s (+0.5s)	1852	1852	128	35	146	0	6	187
42939	27470s (+0.4s)	992	992	64	35	79	0	9	123
42940	27471s (+0.4s)	1368	1368	128	29	111	0	4	144
42941	27471s (+0.6s)	2616	2616	256	40	173	0	10	223
42942	27472s (+0.6s)	1952	1952	128	36	161	0	8	205
42943	27473s (+0.8s)	3372	3372	256	64	204	0	11	279
42944	27474s (+0.8s)	3516	3516	256	58	210	0	15	283
42945	27474s (+0.4s)	1480	1480	128	34	115	0	5	154
42946	27475s (+0.7s)	3196	3196	256	66	187	0	10	263
42947	27475s (+0.6s)	2620	2620	256	31	183	0	7	221
42948	27476s (+0.8s)	3292	3292	256	65	207	0	9	281
42949	27477s (+0.4s)	1452	1452	128	25	115	0	2	142
42950	27477s (+0.5s)	1744	1744	128	30	142	0	4	176
42951	27478s (+0.8s)	3348	3348	256	51	218	0	14	283
42952	27478s (+0.4s)	1352	1352	64	28	119	0	7	154
42953	27479s (+0.4s)	1164	1164	128	23	98	0	7	128
42954	27479s (+0.6s)	2240	2240	128	36	167	0	12	215
42955	27480s (+1.0s)	5280	5280	512	88	254	0	16	358
42956	27481s (+0.4s)	1180	1180	64	35	98	9	0	142
42957	27481s (+0.6s)	2696	2696	256	50	168	14	1	233
42958	27482s (+0.4s)	1428	1428	128	28	114	5	0	147
42959	27483s (+0.8s)	3316	3316	256	73	186	11	0	270
42960	27483s (+0.5s)	1872	1872	128	43	140	7	0	190
42961	27484s (+0.8s)	3572	3572	256	87	190	18	1	296
42962	27484s (+0.4s)	1392	1392	128	34	98	7	0	139
42963	27485s (+1.0s)	4016	4016	256	92	220	21	0	333
42964	27486s (+0.3s)	820	820	64	24	76	0	5	105
42965	27487s (+1.0s)	4256	4256	256	77	254	0	23	354
42966	27487s (+0.5s)	1588	1588	128	24	131	0	4	159
42967	27488s (+0.5s)	1800	1800	128	37	139	0	9	185
42968	27489s (+1.2s)	5808	5808	512	101	301	16	0	418
42969	27490s (+0.7s)	2908	2908	256	73	152	15	0	240
42970	27490s (+0.7s)	2896	2896	256	67	175	13	0	255
42971	27491s (+0.4s)	1120	1120	64	34	90	8	0	132
42972	27491s (+0.6s)	2312	2312	128	56	154	11	0	221
42973	27492s (+0.3s)	892	892	64	20	84	3	0	107
42974	27492s (+0.5s)	1692	1692	128	44	122	8	0	174
42975	27493s (+0.5s)	2160	2160	256	39	139	10	0	188
42976	27493s (+0.7s)	3028	3028	256	67	180	10	0	257
42977	27494s (+0.5s)	1684	1684	128	46	120	6	0	172
42978	27495s (+0.6s)	1920	1920	128	51	137	10	0	198
42979	27495s (+1.0s)	4156	4156	256	89	236	18	2	345
42980	27496s (+0.4s)	1416	1416	128	29	113	7	0	149
42981	27497s (+1.3s)	6640	6640	512	129	319	33	0	481
42982	27498s (+0.3s)	684	684	64	27	64	3	0	94
42983	27498s (+0.7s)	2644	2644	256	37	193	9	0	239
42984	27499s (+0.5s)	1556	1556	128	45	105	7	0	157
42985	27500s (+0.9s)	3980	3980	256	73	241	15	0	329
42986	27500s (+0.4s)	1048	1048	64	40	78	8	0	126
42987	27501s (+0.9s)	4040	4040	256	80	233	15	0	328
42988	27501s (+0.6s)	2572	2572	256	52	154	11	1	218
42989	27502s (+0.4s)	1204	1204	128	32	97	5	0	134
42990	27502s (+0.5s)	1628	1628	128	29	136	0	9	174
42991	27503s (+0.7s)	2744	2744	256	54	170	0	10	234
42992	27503s (+0.2s)	460	460	64	9	55	0	2	66
42993	27504s (+0.5s)	1580	1580	128	39	120	0	3	162
42994	27504s (+0.5s)	1668	1668	128	39	133	0	7	179
42995	27505s (+0.5s)	1972	1972	128	35	154	0	8	197
42996	27505s (+0.4s)	1444	1444	128	26	117	1	7	151
42997	27506s (+0.4s)	1184	1184	128	23	101	0	4	128
42998	27507s (+1.4s)	6620	6620	512	117	337	23	0	477
42999	27507s (+0.5s)	1772	1772	128	45	124	9	0	178
Episode	Time	Reward	Score	Highest	L	U	R	D	Steps
43000	27508s (+0.5s)	1580	1580	128	40	114	8	0	162
43001	27508s (+0.5s)	1624	1624	128	32	124	7	0	163
43002	27509s (+1.0s)	4220	4220	256	95	235	19	0	349
43003	27511s (+1.1s)	4608	4608	256	108	252	21	0	381
43004	27511s (+0.4s)	1392	1392	128	33	104	7	0	144
43005	27511s (+0.5s)	2248	2248	256	38	138	11	0	187
43006	27512s (+0.8s)	3124	3124	256	75	179	15	0	269
43007	27513s (+0.9s)	3988	3988	256	88	227	16	0	331
43008	27514s (+0.9s)	3928	3928	256	77	229	15	0	321
43009	27515s (+0.9s)	3920	3920	256	87	216	15	1	319
43010	27516s (+0.6s)	1916	1916	128	52	135	10	0	197
43011	27516s (+0.6s)	2712	2712	256	56	161	10	0	227
43012	27517s (+1.0s)	4304	4304	256	87	252	15	0	354
43013	27518s (+0.8s)	3368	3368	256	57	220	11	0	288
43014	27519s (+1.0s)	4144	4144	256	87	240	15	0	342
43015	27520s (+0.7s)	2932	2932	256	58	174	12	0	244
43016	27521s (+1.1s)	5396	5396	512	89	270	21	1	381
43017	27521s (+0.4s)	1324	1324	128	31	102	9	0	142
43018	27522s (+0.7s)	2372	2372	128	69	147	14	0	230
43019	27522s (+0.4s)	932	932	64	26	91	6	0	123
43020	27523s (+0.5s)	1800	1800	128	36	143	5	0	184
43021	27523s (+0.5s)	1696	1696	128	49	119	8	0	176
43022	27524s (+0.4s)	1300	1300	128	39	96	7	0	142
43023	27524s (+0.5s)	2220	2220	256	54	124	12	0	190
43024	27525s (+0.5s)	1588	1588	128	33	123	1	4	161
43025	27525s (+0.3s)	1124	1124	128	20	97	0	3	120
43026	27526s (+0.4s)	1520	1520	128	42	109	0	5	156
43027	27526s (+0.4s)	1472	1472	128	24	122	0	6	152
43028	27527s (+0.5s)	1668	1668	128	43	119	7	0	169
43029	27527s (+0.7s)	2452	2452	128	65	157	17	0	239
43030	27528s (+0.4s)	1180	1180	64	42	91	9	0	142
43031	27528s (+0.7s)	3080	3080	256	64	179	12	0	255
43032	27529s (+0.6s)	1888	1888	128	45	139	11	0	195
43033	27529s (+0.3s)	1048	1048	128	25	84	3	0	112
43034	27530s (+0.8s)	3208	3208	256	56	201	0	13	270
43035	27531s (+0.9s)	3940	3940	256	69	242	0	13	324
43036	27532s (+0.9s)	3832	3832	256	61	238	0	12	311
43037	27533s (+1.0s)	3988	3988	256	62	258	0	16	336
43038	27533s (+0.5s)	1772	1772	128	44	124	0	12	180
43039	27534s (+0.9s)	4048	4048	256	95	228	13	0	336
43040	27535s (+0.5s)	1588	1588	128	35	122	8	0	165
43041	27535s (+0.3s)	756	756	64	20	79	3	0	102
43042	27535s (+0.4s)	1412	1412	128	35	109	8	0	152
43043	27536s (+0.8s)	3244	3244	256	52	214	8	0	274
43044	27537s (+0.7s)	2832	2832	256	45	193	0	8	246
43045	27538s (+0.5s)	1772	1772	128	28	143	0	8	179
43046	27538s (+0.3s)	764	764	64	22	76	0	5	103
43047	27538s (+0.5s)	1788	1788	128	39	137	0	6	182
43048	27539s (+0.3s)	696	696	64	19	70	3	0	92
43049	27539s (+0.8s)	3416	3416	256	52	221	12	0	285
43050	27540s (+0.8s)	3528	3528	256	76	207	12	1	296
43051	27541s (+0.5s)	1676	1676	128	43	130	8	0	181
43052	27542s (+0.8s)	3484	3484	256	80	195	14	0	289
43053	27542s (+0.4s)	1308	1308	128	30	106	6	0	142
43054	27542s (+0.4s)	1340	1340	128	23	112	3	0	138
43055	27543s (+0.6s)	1900	1900	128	38	148	7	0	193
43056	27544s (+0.5s)	1724	1724	128	31	140	0	5	176
43057	27544s (+0.3s)	804	804	64	14	84	0	5	103
43058	27545s (+0.9s)	4128	4128	256	72	249	0	15	336
43059	27546s (+0.8s)	3524	3524	256	60	219	0	16	295
43060	27546s (+0.9s)	3860	3860	256	66	237	0	13	316
43061	27547s (+0.5s)	1804	1804	128	49	130	0	7	186
43062	27548s (+0.9s)	3900	3900	256	77	232	0	16	325
43063	27549s (+0.7s)	3144	3144	256	58	197	10	0	265
43064	27549s (+0.4s)	1428	1428	128	32	114	6	0	152
43065	27550s (+0.6s)	2216	2216	128	52	152	9	0	213
43066	27551s (+0.8s)	3428	3428	256	64	215	9	0	288
43067	27551s (+0.6s)	2280	2280	128	72	137	14	0	223
43068	27552s (+0.5s)	1760	1760	128	51	122	7	0	180
43069	27552s (+0.7s)	2968	2968	256	64	189	10	0	263
43070	27553s (+0.7s)	3116	3116	256	70	177	11	2	260
43071	27554s (+1.0s)	4220	4220	256	98	231	20	0	349
43072	27555s (+0.8s)	3516	3516	256	88	183	22	0	293
43073	27555s (+0.3s)	872	872	64	27	80	6	0	113
43074	27556s (+0.8s)	3532	3532	256	75	209	13	0	297
43075	27557s (+0.5s)	1616	1616	128	44	119	8	0	171
43076	27558s (+1.3s)	6380	6380	512	123	300	31	0	454
43077	27559s (+0.6s)	1900	1900	128	56	131	8	0	195
43078	27559s (+0.8s)	3324	3324	256	57	214	6	0	277
43079	27560s (+0.5s)	1880	1880	128	43	140	10	0	193
43080	27560s (+0.5s)	1796	1796	128	56	121	7	1	185
43081	27561s (+0.5s)	1568	1568	64	52	108	9	0	169
43082	27562s (+0.7s)	2896	2896	256	57	176	18	0	251
43083	27562s (+0.8s)	3236	3236	256	64	190	15	0	269
43084	27563s (+0.4s)	1448	1448	128	31	116	3	0	150
43085	27564s (+0.7s)	2832	2832	256	45	184	8	0	237
43086	27564s (+0.7s)	3032	3032	256	55	187	10	1	253
43087	27565s (+1.0s)	4044	4044	256	89	228	16	0	333
43088	27566s (+0.5s)	2188	2188	256	48	132	7	0	187
43089	27566s (+0.6s)	2368	2368	256	36	154	0	11	201
43090	27567s (+0.5s)	1696	1696	128	39	121	0	9	169
43091	27568s (+0.8s)	3460	3460	256	60	220	0	15	295
43092	27568s (+0.4s)	1620	1620	128	35	118	7	1	161
43093	27569s (+0.7s)	2988	2988	256	56	174	13	1	244
43094	27569s (+0.6s)	2736	2736	256	53	172	7	0	232
43095	27570s (+0.5s)	2260	2260	256	43	142	9	0	194
43096	27571s (+0.8s)	3504	3504	256	72	204	18	1	295
43097	27572s (+0.8s)	3292	3292	256	60	203	11	0	274
43098	27572s (+0.6s)	1912	1912	128	43	146	7	0	196
43099	27573s (+0.5s)	1864	1864	128	43	134	9	0	186
Episode	Time	Reward	Score	Highest	L	U	R	D	Steps
43100	27573s (+0.3s)	720	720	32	28	70	4	1	103
43101	27574s (+0.6s)	2348	2348	128	60	153	12	0	225
43102	27574s (+0.4s)	1328	1328	128	31	100	6	0	137
43103	27575s (+0.5s)	1616	1616	128	39	115	8	0	162
43104	27575s (+0.7s)	2976	2976	256	59	187	0	10	256
43105	27576s (+0.8s)	3780	3780	256	72	214	0	16	302
43106	27577s (+0.7s)	3032	3032	256	47	182	0	14	243
43107	27577s (+0.4s)	1464	1464	128	31	117	0	6	154
43108	27578s (+0.8s)	3328	3328	256	55	209	0	14	278
43109	27578s (+0.4s)	1152	1152	64	28	99	0	10	137
43110	27579s (+0.9s)	3968	3968	256	65	244	0	17	326
43111	27580s (+0.6s)	2500	2500	256	36	168	0	8	212
43112	27581s (+0.7s)	2796	2796	256	53	175	0	14	242
43113	27581s (+0.7s)	2832	2832	256	44	185	0	12	241
43114	27582s (+0.5s)	1612	1612	128	32	132	6	0	170
43115	27583s (+0.6s)	2540	2540	256	54	158	10	0	222
43116	27583s (+0.5s)	1720	1720	128	44	127	5	0	176
43117	27584s (+0.6s)	2296	2296	256	37	155	5	1	198
43118	27584s (+0.3s)	980	980	128	27	74	3	0	104
43119	27585s (+0.6s)	2516	2516	256	43	165	8	0	216
43120	27585s (+0.6s)	2460	2460	256	41	160	11	0	212
43121	27586s (+1.0s)	4272	4272	256	88	248	22	0	358
43122	27587s (+0.4s)	920	920	64	31	86	0	3	120
43123	27588s (+1.0s)	4004	4004	256	73	243	0	19	335
43124	27588s (+0.5s)	1780	1780	128	34	142	1	5	182
43125	27588s (+0.4s)	1048	1048	64	21	99	0	5	125
43126	27589s (+0.8s)	3356	3356	256	60	217	0	9	286
43127	27590s (+0.5s)	1732	1732	128	39	126	9	0	174
43128	27591s (+0.9s)	3968	3968	256	80	233	14	0	327
43129	27592s (+1.2s)	5808	5808	512	101	299	22	0	422
43130	27592s (+0.6s)	1996	1996	128	47	137	11	0	195
43131	27593s (+0.5s)	1744	1744	128	39	131	6	0	176
43132	27594s (+0.6s)	2424	2424	256	45	156	9	0	210
43133	27594s (+0.5s)	1804	1804	128	49	126	10	0	185
43134	27595s (+0.7s)	3216	3216	256	65	191	11	0	267
43135	27596s (+1.0s)	4344	4344	256	96	248	15	0	359
43136	27596s (+0.4s)	1248	1248	128	32	97	5	0	134
43137	27597s (+0.9s)	3744	3744	256	77	217	17	0	311
43138	27597s (+0.3s)	892	892	64	23	90	5	0	118
43139	27598s (+0.5s)	1540	1540	128	26	125	0	7	158
43140	27598s (+0.4s)	1312	1312	128	26	105	0	10	141
43141	27599s (+0.4s)	1584	1584	128	36	116	9	0	161
43142	27599s (+0.6s)	2544	2544	256	47	160	9	0	216
43143	27600s (+0.6s)	2256	2256	128	52	147	9	0	208
43144	27601s (+1.3s)	6364	6364	512	130	291	29	0	450
43145	27602s (+1.0s)	4192	4192	256	97	226	20	0	343
43146	27603s (+1.1s)	4704	4704	256	109	270	18	0	397
43147	27604s (+0.6s)	2444	2444	128	63	158	13	0	234
43148	27604s (+0.4s)	1420	1420	64	42	108	5	0	155
43149	27605s (+0.6s)	1892	1892	128	41	147	7	0	195
43150	27605s (+0.4s)	1128	1128	64	32	95	7	0	134
43151	27606s (+0.5s)	1832	1832	128	47	129	9	0	185
43152	27607s (+0.6s)	2152	2152	128	60	137	12	0	209
43153	27608s (+0.9s)	4152	4152	256	100	225	15	0	340
43154	27609s (+1.1s)	4512	4512	256	122	232	20	0	374
43155	27609s (+0.5s)	1608	1608	128	40	121	8	0	169
43156	27610s (+1.4s)	6864	6864	512	141	307	30	0	478
43157	27611s (+0.5s)	2084	2084	256	36	131	4	0	171
43158	27612s (+1.3s)	6616	6616	512	138	287	23	0	448
43159	27613s (+0.4s)	1456	1456	128	27	121	5	0	153
43160	27613s (+0.6s)	2580	2580	256	64	144	16	0	224
43161	27614s (+0.5s)	1512	1512	128	31	119	7	0	157
43162	27615s (+0.7s)	3136	3136	256	57	194	9	0	260
43163	27615s (+0.7s)	2792	2792	256	59	173	10	0	242
43164	27616s (+0.9s)	3644	3644	256	78	220	15	0	313
43165	27617s (+0.8s)	3376	3376	256	57	210	0	13	280
43166	27618s (+0.9s)	4084	4084	256	62	237	1	13	313
43167	27618s (+0.5s)	1616	1616	128	31	125	0	5	161
43168	27619s (+0.8s)	3304	3304	256	52	219	0	12	283
43169	27620s (+0.6s)	2156	2156	128	39	155	0	12	206
43170	27620s (+0.7s)	2824	2824	256	55	174	0	19	248
43171	27621s (+0.6s)	2624	2624	256	48	172	0	12	232
43172	27621s (+0.4s)	1432	1432	128	25	115	0	8	148
43173	27623s (+1.0s)	4420	4420	256	99	247	18	0	364
43174	27623s (+0.5s)	1684	1684	128	33	127	5	0	165
43175	27624s (+0.8s)	3240	3240	256	70	189	14	0	273
43176	27624s (+0.6s)	1880	1880	128	41	145	7	1	194
43177	27625s (+0.6s)	2320	2320	128	69	151	13	0	233
43178	27626s (+0.7s)	2852	2852	256	65	165	13	1	244
43179	27627s (+0.8s)	3248	3248	256	80	184	11	0	275
43180	27627s (+0.9s)	4048	4048	256	76	244	14	0	334
43181	27628s (+0.8s)	3516	3516	256	92	191	15	0	298
43182	27629s (+0.7s)	2800	2800	256	54	178	10	0	242
43183	27629s (+0.5s)	1524	1524	128	33	122	5	0	160
43184	27630s (+0.5s)	1780	1780	128	39	134	7	0	180
43185	27630s (+0.3s)	1012	1012	128	17	91	0	0	108
43186	27631s (+0.6s)	2300	2300	128	54	151	9	0	214
43187	27631s (+0.3s)	888	888	64	32	74	7	0	113
43188	27632s (+0.7s)	2904	2904	256	71	173	8	0	252
43189	27633s (+0.7s)	2480	2480	128	67	148	16	0	231
43190	27633s (+0.8s)	3216	3216	256	51	205	0	11	267
43191	27634s (+0.6s)	2344	2344	256	32	160	0	7	199
43192	27635s (+0.9s)	3996	3996	256	72	242	0	18	332
43193	27635s (+0.5s)	1780	1780	128	37	134	0	9	180
43194	27636s (+0.5s)	1656	1656	128	25	137	0	5	167
43195	27636s (+0.4s)	1168	1168	64	26	108	0	5	139
43196	27637s (+0.4s)	1216	1216	128	24	105	0	5	134
43197	27637s (+0.7s)	2796	2796	256	56	172	0	15	243
43198	27638s (+0.9s)	4028	4028	256	80	228	17	0	325
43199	27639s (+0.5s)	1792	1792	128	42	132	9	0	183
Episode	Time	Reward	Score	Highest	L	U	R	D	Steps
43200	27640s (+0.7s)	2932	2932	256	69	175	15	0	259
43201	27640s (+0.8s)	3300	3300	256	79	179	17	1	276
43202	27641s (+0.5s)	1636	1636	128	40	117	4	0	161
43203	27641s (+0.4s)	1500	1500	128	47	102	9	0	158
43204	27642s (+0.6s)	2196	2196	128	56	145	7	0	208
43205	27642s (+0.5s)	1772	1772	128	52	117	10	0	179
43206	27643s (+0.3s)	916	916	64	37	76	7	0	120
43207	27644s (+0.8s)	3416	3416	256	63	204	17	1	285
43208	27644s (+0.5s)	1804	1804	128	47	135	0	4	186
43209	27644s (+0.4s)	1236	1236	128	34	95	0	8	137
43210	27645s (+0.6s)	2460	2460	256	41	160	0	8	209
43211	27646s (+0.5s)	1608	1608	128	34	129	0	6	169
43212	27646s (+0.5s)	1804	1804	128	42	138	0	6	186
43213	27647s (+1.0s)	5276	5276	512	78	274	0	16	368
43214	27648s (+0.8s)	2936	2936	256	51	204	0	5	260
43215	27649s (+0.7s)	3192	3192	256	63	190	0	9	262
43216	27649s (+0.4s)	1160	1160	128	20	100	0	3	123
43217	27650s (+0.5s)	1604	1604	128	46	117	5	0	168
43218	27650s (+0.3s)	1024	1024	64	36	82	6	0	124
43219	27651s (+1.0s)	4236	4236	256	77	256	15	1	349
43220	27652s (+0.6s)	2488	2488	256	64	144	8	0	216
43221	27652s (+0.7s)	2624	2624	256	54	167	10	0	231
43222	27653s (+0.3s)	776	776	64	21	75	0	3	99
43223	27653s (+0.4s)	1420	1420	128	26	119	6	0	151
43224	27653s (+0.5s)	1856	1856	128	52	124	8	0	184
43225	27654s (+0.5s)	1768	1768	128	41	130	10	0	181
43226	27655s (+0.7s)	2952	2952	256	50	189	10	0	249
43227	27655s (+0.8s)	3344	3344	256	56	214	12	0	282
43228	27656s (+0.8s)	3192	3192	256	92	172	14	0	278
43229	27657s (+0.7s)	3108	3108	256	78	165	14	0	257
43230	27658s (+0.8s)	3316	3316	256	72	197	11	0	280
43231	27658s (+0.5s)	1584	1584	128	51	103	9	0	163
43232	27659s (+0.6s)	2692	2692	256	52	162	11	1	226
43233	27660s (+1.0s)	4004	4004	256	89	223	22	1	335
43234	27661s (+0.8s)	3360	3360	256	61	202	10	0	273
43235	27662s (+0.9s)	4040	4040	256	97	217	19	0	333
43236	27662s (+0.8s)	3208	3208	256	58	196	13	0	267
43237	27663s (+0.8s)	3396	3396	256	87	178	12	0	277
43238	27664s (+0.9s)	4036	4036	256	83	233	16	0	332
43239	27665s (+0.4s)	1172	1172	64	43	88	9	0	140
43240	27665s (+0.4s)	1420	1420	128	30	111	5	0	146
43241	27665s (+0.4s)	1124	1124	128	24	94	5	0	123
43242	27666s (+0.7s)	2676	2676	256	42	185	0	12	239
43243	27667s (+0.8s)	3424	3424	256	67	208	0	12	287
43244	27668s (+0.8s)	3364	3364	256	58	205	0	15	278
43245	27668s (+0.6s)	2396	2396	128	60	154	8	0	222
43246	27669s (+0.6s)	2476	2476	256	45	155	12	0	212
43247	27669s (+0.3s)	824	824	64	24	84	4	0	112
43248	27670s (+0.8s)	3360	3360	256	59	219	7	0	285
43249	27670s (+0.4s)	1360	1360	128	32	106	3	0	141
43250	27671s (+0.7s)	2472	2472	128	70	143	16	0	229
43251	27672s (+0.5s)	1892	1892	128	54	128	9	0	191
43252	27673s (+0.9s)	4092	4092	256	89	221	17	0	327
43253	27674s (+0.9s)	4764	4764	512	79	239	15	1	334
43254	27674s (+0.5s)	1752	1752	128	47	115	12	0	174
43255	27675s (+0.6s)	2600	2600	256	46	168	11	0	225
43256	27675s (+0.8s)	3400	3400	256	84	184	17	0	285
43257	27676s (+0.4s)	1108	1108	64	26	99	6	0	131
43258	27676s (+0.5s)	1816	1816	128	35	140	7	0	182
43259	27677s (+0.7s)	3180	3180	256	77	173	17	1	268
43260	27678s (+1.0s)	4472	4472	256	104	250	15	0	369
43261	27679s (+0.7s)	2632	2632	128	79	158	15	0	252
43262	27680s (+1.1s)	5508	5508	512	88	285	19	0	392
43263	27680s (+0.3s)	848	848	64	25	87	2	0	114
43264	27681s (+0.6s)	2400	2400	256	45	145	11	0	201
43265	27681s (+0.5s)	1720	1720	128	59	107	11	0	177
43266	27682s (+0.5s)	2300	2300	256	43	140	9	0	192
43267	27682s (+0.6s)	2356	2356	256	50	141	6	0	197
43268	27683s (+0.5s)	1500	1500	128	34	117	6	1	158
43269	27684s (+0.6s)	2100	2100	128	63	136	13	0	212
43270	27684s (+0.9s)	3804	3804	256	87	217	17	0	321
43271	27685s (+0.5s)	1808	1808	128	39	132	9	0	180
43272	27686s (+0.7s)	2724	2724	128	71	167	17	0	255
43273	27687s (+1.2s)	6040	6040	512	100	300	16	2	418
43274	27687s (+0.5s)	1716	1716	128	49	119	6	0	174
43275	27688s (+0.6s)	2500	2500	256	43	166	8	0	217
43276	27689s (+0.8s)	3384	3384	256	62	216	9	0	287
43277	27689s (+0.3s)	760	760	64	26	73	3	0	102
43278	27690s (+0.7s)	2832	2832	256	58	171	11	0	240
43279	27690s (+0.4s)	1456	1456	128	26	115	0	8	149
43280	27691s (+0.9s)	3748	3748	256	55	233	0	15	303
43281	27692s (+0.6s)	2496	2496	256	44	165	0	7	216
43282	27692s (+0.7s)	2792	2792	256	47	181	0	13	241
43283	27693s (+0.8s)	3252	3252	256	50	205	0	10	265
43284	27694s (+0.3s)	876	876	64	27	78	0	3	108
43285	27694s (+0.3s)	868	868	64	34	73	0	6	113
43286	27695s (+0.9s)	3944	3944	256	72	236	12	0	320
43287	27695s (+0.7s)	2700	2700	256	41	179	7	0	227
43288	27696s (+0.4s)	1272	1272	128	28	92	4	1	125
43289	27696s (+0.5s)	1528	1528	128	36	117	7	1	161
43290	27697s (+0.8s)	3512	3512	256	65	217	14	0	296
43291	27698s (+0.4s)	1496	1496	128	30	110	9	0	149
43292	27698s (+0.6s)	2652	2652	256	54	161	12	0	227
43293	27699s (+0.5s)	1772	1772	128	36	140	3	0	179
43294	27700s (+0.9s)	3588	3588	256	66	226	12	0	304
43295	27700s (+0.6s)	2456	2456	256	43	161	7	0	211
43296	27701s (+0.5s)	2212	2212	256	60	119	10	0	189
43297	27701s (+0.6s)	2216	2216	128	51	146	11	1	209
43298	27702s (+0.6s)	2364	2364	256	46	148	5	0	199
43299	27702s (+0.4s)	1268	1268	128	22	100	4	0	126
Episode	Time	Reward	Score	Highest	L	U	R	D	Steps
43300	27703s (+0.9s)	3972	3972	256	97	212	18	0	327
43301	27704s (+0.8s)	3288	3288	256	62	196	14	0	272
43302	27705s (+0.6s)	2564	2564	256	46	163	7	1	217
43303	27705s (+0.7s)	2968	2968	256	63	173	12	0	248
43304	27706s (+0.5s)	1556	1556	128	43	117	7	0	167
43305	27706s (+0.5s)	1528	1528	128	36	116	9	0	161
43306	27707s (+0.7s)	2996	2996	256	52	190	0	14	256
43307	27708s (+0.8s)	3528	3528	256	54	232	0	10	296
43308	27708s (+0.5s)	1788	1788	128	38	142	0	3	183
43309	27709s (+0.5s)	1616	1616	128	41	124	0	6	171
43310	27709s (+0.3s)	844	844	64	20	77	0	5	102
43311	27710s (+0.8s)	3244	3244	256	64	200	0	10	274
43312	27711s (+0.8s)	3348	3348	256	59	211	0	12	282
43313	27711s (+0.3s)	812	812	64	21	70	0	7	98
43314	27711s (+0.4s)	1408	1408	128	39	106	4	0	149
43315	27712s (+0.7s)	2820	2820	256	68	164	16	0	248
43316	27713s (+0.5s)	1780	1780	128	44	131	7	0	182
43317	27714s (+1.1s)	4636	4636	256	110	257	21	1	389
43318	27715s (+0.8s)	3500	3500	256	80	200	13	1	294
43319	27715s (+0.8s)	3372	3372	256	61	217	11	0	289
43320	27716s (+0.6s)	2356	2356	128	61	143	14	0	218
43321	27717s (+1.1s)	5372	5372	512	92	261	22	0	375
43322	27718s (+0.8s)	3660	3660	256	64	224	9	0	297
43323	27719s (+0.6s)	2164	2164	128	48	147	6	0	201
43324	27719s (+0.5s)	1804	1804	128	53	122	5	0	180
43325	27720s (+0.5s)	1776	1776	128	35	127	11	0	173
43326	27721s (+0.9s)	4196	4196	256	100	220	25	0	345
43327	27721s (+0.8s)	3448	3448	256	73	197	13	0	283
43328	27722s (+1.0s)	4308	4308	256	91	242	22	0	355
43329	27723s (+0.6s)	1996	1996	128	39	157	6	0	202
43330	27723s (+0.5s)	1600	1600	128	35	122	0	10	167
43331	27724s (+0.6s)	2144	2144	128	41	152	0	11	204
43332	27725s (+0.9s)	3716	3716	256	64	230	0	12	306
43333	27725s (+0.3s)	668	668	64	14	73	0	2	89
43334	27726s (+0.8s)	3656	3656	256	57	228	0	13	298
43335	27727s (+0.7s)	2980	2980	256	55	178	0	10	243
43336	27728s (+1.0s)	4056	4056	256	73	246	17	0	336
43337	27728s (+0.5s)	2148	2148	256	40	133	9	0	182
43338	27729s (+0.5s)	1768	1768	128	43	128	7	0	178
43339	27729s (+0.4s)	1456	1456	128	32	114	7	0	153
43340	27730s (+0.7s)	2948	2948	256	66	166	16	0	248
43341	27730s (+0.5s)	1620	1620	128	46	114	12	0	172
43342	27731s (+0.7s)	2848	2848	256	59	169	12	0	240
43343	27732s (+0.8s)	3460	3460	256	53	224	11	0	288
43344	27733s (+0.8s)	3332	3332	256	67	197	15	0	279
43345	27733s (+0.4s)	1436	1436	128	31	117	6	0	154
43346	27734s (+0.7s)	2992	2992	256	64	178	9	0	251
43347	27734s (+0.5s)	1784	1784	128	42	130	9	0	181
43348	27735s (+0.3s)	712	712	64	13	73	0	8	94
43349	27735s (+0.8s)	3404	3404	256	48	233	0	11	292
43350	27736s (+0.4s)	1548	1548	128	30	123	0	6	159
43351	27737s (+0.8s)	3284	3284	256	55	208	0	10	273
43352	27737s (+0.6s)	2400	2400	256	49	148	0	8	205
43353	27738s (+1.0s)	4344	4344	256	62	275	0	19	356
43354	27739s (+0.5s)	1628	1628	128	23	136	0	5	164
43355	27740s (+0.8s)	3536	3536	256	58	228	0	12	298
43356	27740s (+0.4s)	1300	1300	128	26	99	6	0	131
43357	27740s (+0.4s)	1456	1456	128	24	124	4	0	152
43358	27741s (+0.5s)	1796	1796	128	47	128	9	0	184
43359	27742s (+0.7s)	2956	2956	256	67	180	13	0	260
43360	27743s (+1.0s)	4340	4340	256	101	241	17	0	359
43361	27743s (+0.3s)	888	888	64	22	89	3	0	114
43362	27744s (+0.6s)	2572	2572	256	51	160	8	0	219
43363	27744s (+0.3s)	892	892	64	31	79	5	0	115
43364	27745s (+0.5s)	1616	1616	128	37	121	7	0	165
43365	27745s (+0.4s)	1324	1324	128	27	104	5	0	136
43366	27746s (+0.7s)	2624	2624	256	48	169	13	1	231
43367	27746s (+0.5s)	1624	1624	128	40	117	12	0	169
43368	27747s (+0.7s)	2632	2632	128	70	167	14	0	251
43369	27747s (+0.6s)	2420	2420	256	38	161	9	0	208
43370	27748s (+0.6s)	2044	2044	128	55	140	9	0	204
43371	27749s (+1.2s)	6476	6476	512	101	321	0	20	442
43372	27750s (+0.8s)	3416	3416	256	56	220	0	13	289
43373	27751s (+0.5s)	1596	1596	128	33	124	0	9	166
43374	27751s (+0.2s)	632	632	64	19	61	0	7	87
43375	27751s (+0.3s)	992	992	64	16	95	0	6	117
43376	27752s (+0.8s)	3560	3560	256	73	210	14	0	297
43377	27752s (+0.4s)	1416	1416	128	34	108	7	0	149
43378	27753s (+0.7s)	3172	3172	256	70	181	10	0	261
43379	27754s (+0.3s)	796	796	64	28	71	5	0	104
43380	27754s (+0.4s)	1484	1484	128	31	120	4	0	155
43381	27754s (+0.5s)	1540	1540	128	42	117	5	0	164
43382	27755s (+0.6s)	2572	2572	256	61	152	10	0	223
43383	27756s (+0.6s)	2392	2392	256	44	146	12	0	202
43384	27756s (+0.3s)	1052	1052	128	24	82	7	0	113
43385	27757s (+0.7s)	2788	2788	256	62	159	18	0	239
43386	27757s (+0.5s)	1740	1740	128	39	126	8	0	173
43387	27758s (+0.5s)	1812	1812	128	34	137	0	10	181
43388	27758s (+0.4s)	1224	1224	64	39	97	0	12	148
43389	27759s (+0.9s)	3704	3704	256	71	221	0	21	313
43390	27760s (+0.7s)	2888	2888	128	85	164	16	0	265
43391	27760s (+0.7s)	2588	2588	128	52	161	16	0	229
43392	27761s (+0.5s)	1792	1792	128	46	124	13	0	183
43393	27761s (+0.4s)	1428	1428	128	43	97	6	0	146
43394	27762s (+0.5s)	1608	1608	128	36	125	8	0	169
43395	27763s (+0.8s)	3308	3308	256	76	187	16	0	279
43396	27763s (+0.7s)	2732	2732	256	58	164	9	0	231
43397	27764s (+0.9s)	3672	3672	256	82	211	12	0	305
43398	27765s (+0.5s)	1844	1844	128	36	143	6	0	185
43399	27766s (+1.1s)	5340	5340	512	102	253	17	0	372
Episode	Time	Reward	Score	Highest	L	U	R	D	Steps
43400	27766s (+0.7s)	2432	2432	128	66	144	14	0	224
43401	27767s (+0.6s)	2472	2472	256	42	164	8	0	214
43402	27767s (+0.3s)	788	788	64	30	65	6	0	101
43403	27768s (+0.4s)	1292	1292	128	25	100	4	1	130
43404	27768s (+0.5s)	1828	1828	128	42	132	10	0	184
43405	27769s (+0.7s)	2984	2984	256	45	186	0	12	243
43406	27770s (+0.9s)	3744	3744	256	74	220	0	12	306
43407	27770s (+0.4s)	1328	1328	128	24	111	0	3	138
43408	27771s (+0.8s)	3448	3448	256	50	228	0	15	293
43409	27772s (+0.6s)	2408	2408	256	48	147	0	8	203
43410	27772s (+0.4s)	1208	1208	128	26	95	0	4	125
43411	27773s (+0.4s)	1468	1468	128	27	119	0	8	154
43412	27773s (+0.7s)	2912	2912	256	60	172	0	13	245
43413	27774s (+0.7s)	2692	2692	256	41	183	0	9	233
43414	27774s (+0.6s)	2208	2208	128	54	144	0	14	212
43415	27775s (+0.3s)	724	724	64	20	72	0	3	95
43416	27775s (+0.6s)	2548	2548	256	50	160	6	2	218
43417	27776s (+0.6s)	2100	2100	128	60	140	10	0	210
43418	27777s (+0.6s)	2204	2204	128	62	150	9	1	222
43419	27777s (+0.3s)	1032	1032	128	27	75	6	0	108
43420	27778s (+0.7s)	2944	2944	256	81	170	11	0	262
43421	27779s (+0.9s)	3964	3964	256	83	226	16	0	325
43422	27779s (+0.7s)	2752	2752	256	63	163	13	0	239
43423	27781s (+1.5s)	7576	7576	512	148	351	30	0	529
43424	27782s (+0.8s)	3264	3264	256	61	205	12	0	278
43425	27782s (+0.5s)	1532	1532	128	32	126	4	0	162
43426	27783s (+0.6s)	2164	2164	128	53	140	10	0	203
43427	27783s (+0.7s)	3144	3144	256	67	184	9	0	260
43428	27784s (+0.7s)	2928	2928	256	71	172	10	0	253
43429	27785s (+0.4s)	1176	1176	64	29	97	6	0	132
43430	27785s (+0.5s)	2116	2116	256	45	129	4	0	178
43431	27786s (+0.6s)	2556	2556	256	47	174	5	0	226
43432	27786s (+0.7s)	3128	3128	256	65	172	17	0	254
43433	27787s (+0.5s)	1840	1840	128	53	128	9	0	190
43434	27788s (+0.9s)	3928	3928	256	80	223	13	0	316
43435	27788s (+0.6s)	2368	2368	128	55	153	12	0	220
43436	27789s (+0.5s)	2036	2036	128	48	126	13	0	187
43437	27790s (+0.8s)	3248	3248	256	75	182	18	0	275
43438	27790s (+0.3s)	744	744	64	18	77	3	0	98
43439	27791s (+1.1s)	4628	4628	256	122	241	22	1	386
43440	27792s (+0.7s)	2980	2980	256	54	186	11	0	251
43441	27793s (+0.7s)	2880	2880	256	69	171	7	0	247
43442	27794s (+1.0s)	4252	4252	256	93	244	12	0	349
43443	27794s (+0.4s)	1420	1420	128	29	112	4	0	145
43444	27795s (+0.7s)	2884	2884	256	61	175	16	0	252
43445	27795s (+0.6s)	1984	1984	128	58	130	11	0	199
43446	27796s (+0.6s)	2424	2424	128	53	164	12	0	229
43447	27797s (+0.8s)	3484	3484	256	60	223	8	0	291
43448	27798s (+0.8s)	3512	3512	256	90	187	15	0	292
43449	27799s (+1.2s)	5812	5812	512	100	292	21	0	413
43450	27799s (+0.5s)	1724	1724	128	51	107	12	1	171
43451	27800s (+0.5s)	2012	2012	256	35	125	6	0	166
43452	27800s (+0.4s)	1488	1488	128	37	109	9	1	156
43453	27801s (+0.6s)	1924	1924	128	66	123	10	0	199
43454	27801s (+0.6s)	1940	1940	128	47	146	10	0	203
43455	27802s (+0.8s)	3368	3368	256	79	192	12	0	283
43456	27803s (+0.9s)	3848	3848	256	83	207	22	0	312
43457	27805s (+1.5s)	7556	7556	512	150	352	26	0	528
43458	27805s (+0.6s)	2300	2300	128	56	159	12	0	227
43459	27806s (+0.7s)	3072	3072	256	52	189	12	0	253
43460	27806s (+0.3s)	904	904	64	34	78	5	0	117
43461	27807s (+0.4s)	1076	1076	64	29	93	7	0	129
43462	27807s (+0.5s)	1728	1728	128	56	118	9	0	183
43463	27808s (+0.8s)	3440	3440	256	70	202	19	0	291
43464	27809s (+0.5s)	1500	1500	128	39	116	4	0	159
43465	27810s (+0.9s)	3904	3904	256	102	207	21	1	331
43466	27810s (+0.4s)	1452	1452	128	39	108	4	0	151
43467	27811s (+0.7s)	2820	2820	256	48	189	5	0	242
43468	27811s (+0.5s)	1892	1892	128	47	133	11	0	191
43469	27812s (+0.8s)	3332	3332	256	73	198	8	0	279
43470	27813s (+1.0s)	5048	5048	512	106	233	19	0	358
43471	27814s (+0.7s)	2900	2900	256	57	189	5	0	251
43472	27814s (+0.7s)	3052	3052	256	60	184	8	0	252
43473	27815s (+0.3s)	936	936	64	28	80	5	1	114
43474	27815s (+0.5s)	1724	1724	128	38	131	8	0	177
43475	27816s (+0.3s)	928	928	64	32	77	4	0	113
43476	27816s (+0.8s)	3196	3196	256	78	170	14	0	262
43477	27817s (+0.4s)	1440	1440	128	44	99	6	0	149
43478	27817s (+0.6s)	1908	1908	128	47	144	4	0	195
43479	27818s (+0.5s)	1816	1816	128	43	129	10	0	182
43480	27819s (+0.8s)	3428	3428	256	79	189	13	0	281
43481	27820s (+0.8s)	3620	3620	256	79	197	16	0	292
43482	27821s (+0.9s)	4028	4028	256	94	204	21	0	319
43483	27821s (+0.4s)	1348	1348	64	33	110	6	0	149
43484	27822s (+0.6s)	2356	2356	256	47	144	7	0	198
43485	27822s (+0.5s)	1508	1508	128	35	118	7	0	160
43486	27823s (+0.6s)	1980	1980	128	56	145	7	0	208
43487	27823s (+0.6s)	1920	1920	128	47	142	9	0	198
43488	27824s (+0.6s)	2704	2704	256	53	174	8	0	235
43489	27825s (+0.8s)	3216	3216	256	67	186	13	0	266
43490	27825s (+0.7s)	2876	2876	256	66	168	16	0	250
43491	27826s (+0.9s)	3808	3808	256	92	211	19	1	323
43492	27827s (+0.5s)	1664	1664	128	41	120	6	1	168
43493	27828s (+0.8s)	3400	3400	256	68	207	11	0	286
43494	27828s (+0.9s)	4312	4312	256	100	233	20	0	353
43495	27829s (+0.9s)	4780	4780	512	72	244	18	0	334
43496	27830s (+0.5s)	1760	1760	128	42	129	7	1	179
43497	27830s (+0.4s)	1496	1496	128	38	114	6	0	158
43498	27831s (+1.0s)	4216	4216	256	99	227	23	0	349
43499	27832s (+0.6s)	2372	2372	128	56	152	12	1	221
Episode	Time	Reward	Score	Highest	L	U	R	D	Steps
43500	27833s (+0.7s)	2764	2764	256	54	175	9	0	238
43501	27833s (+0.4s)	1164	1164	64	38	94	6	0	138
43502	27833s (+0.4s)	1216	1216	128	39	77	7	0	123
43503	27834s (+0.6s)	2708	2708	256	49	154	8	1	212
43504	27835s (+0.6s)	2356	2356	256	50	148	8	0	206
43505	27836s (+1.1s)	5344	5344	512	110	249	17	0	376
43506	27836s (+0.8s)	3044	3044	256	79	165	20	1	265
43507	27837s (+0.3s)	876	876	64	21	89	4	0	114
43508	27838s (+0.8s)	3236	3236	256	64	191	16	0	271
43509	27838s (+0.4s)	1460	1460	128	33	113	7	0	153
43510	27838s (+0.3s)	900	900	64	25	79	6	0	110
43511	27839s (+0.4s)	1180	1180	128	32	95	4	0	131
43512	27840s (+1.0s)	4064	4064	256	88	237	13	0	338
43513	27840s (+0.5s)	1588	1588	128	35	124	5	0	164
43514	27841s (+0.6s)	1996	1996	128	68	122	10	1	201
43515	27841s (+0.3s)	808	808	64	21	83	5	0	109
43516	27841s (+0.3s)	1052	1052	64	35	86	6	0	127
43517	27842s (+0.4s)	1060	1060	64	34	87	7	0	128
43518	27843s (+1.0s)	5260	5260	512	87	259	16	0	362
43519	27844s (+0.8s)	3240	3240	256	57	208	9	0	274
43520	27844s (+0.4s)	1024	1024	64	31	86	4	0	121
43521	27845s (+1.0s)	4320	4320	256	75	268	15	0	358
43522	27846s (+0.7s)	2972	2972	256	64	176	10	0	250
43523	27846s (+0.6s)	2520	2520	256	51	156	9	1	217
43524	27847s (+0.7s)	2924	2924	256	67	182	8	0	257
43525	27848s (+0.8s)	3200	3200	256	75	175	14	0	264
43526	27849s (+1.0s)	4332	4332	256	97	239	25	0	361
43527	27850s (+0.6s)	2736	2736	256	50	165	10	0	225
43528	27850s (+0.5s)	1640	1640	128	31	132	4	0	167
43529	27851s (+1.0s)	4488	4488	256	106	223	20	0	349
43530	27851s (+0.4s)	1064	1064	64	37	86	7	0	130
43531	27852s (+0.5s)	1568	1568	128	33	122	5	0	160
43532	27853s (+1.0s)	4964	4964	512	109	215	17	1	342
43533	27853s (+0.5s)	1500	1500	128	28	128	3	0	159
43534	27854s (+0.4s)	1444	1444	128	49	100	7	0	156
43535	27855s (+0.9s)	3552	3552	256	93	185	19	0	297
43536	27855s (+0.3s)	1056	1056	128	27	81	5	0	113
43537	27856s (+0.8s)	3464	3464	256	75	195	15	0	285
43538	27856s (+0.3s)	668	668	64	23	64	2	0	89
43539	27857s (+0.7s)	3044	3044	256	67	175	14	0	256
43540	27857s (+0.5s)	1804	1804	128	43	136	6	0	185
43541	27858s (+0.7s)	2720	2720	256	53	170	0	9	232
43542	27858s (+0.3s)	732	732	64	14	81	0	1	96
43543	27859s (+0.3s)	980	980	64	20	88	0	6	114
43544	27859s (+0.7s)	2884	2884	256	80	150	18	0	248
43545	27860s (+0.8s)	3168	3168	256	64	185	14	1	264
43546	27861s (+0.5s)	1520	1520	128	45	112	6	0	163
43547	27861s (+0.7s)	2796	2796	256	49	185	7	0	241
43548	27862s (+0.4s)	1476	1476	128	33	117	3	0	153
43549	27862s (+0.4s)	1356	1356	128	27	107	7	0	141
43550	27863s (+0.8s)	3168	3168	256	66	181	17	0	264
43551	27864s (+1.0s)	5116	5116	512	114	234	14	0	362
43552	27865s (+0.8s)	4256	4256	512	68	201	11	0	280
43553	27866s (+0.7s)	2916	2916	256	65	178	12	0	255
43554	27866s (+0.4s)	1316	1316	128	21	116	4	0	141
43555	27867s (+0.8s)	3236	3236	256	78	185	10	0	273
43556	27867s (+0.5s)	1512	1512	128	38	115	8	0	161
43557	27868s (+0.6s)	2080	2080	128	58	137	7	0	202
43558	27869s (+1.1s)	5200	5200	512	92	263	18	0	373
43559	27870s (+0.9s)	3908	3908	256	82	220	18	0	320
43560	27870s (+0.6s)	2048	2048	128	46	141	17	1	205
43561	27871s (+0.3s)	696	696	64	28	58	5	0	91
43562	27871s (+0.7s)	2664	2664	128	69	163	13	0	245
43563	27872s (+0.8s)	3440	3440	256	78	185	20	1	284
43564	27873s (+0.9s)	3864	3864	256	95	203	19	0	317
43565	27874s (+0.6s)	1984	1984	128	55	137	11	0	203
43566	27874s (+0.3s)	852	852	64	24	87	4	0	115
43567	27875s (+0.9s)	4204	4204	256	94	233	18	1	346
43568	27875s (+0.3s)	868	868	64	30	75	7	0	112
43569	27876s (+0.5s)	1620	1620	128	28	129	5	0	162
43570	27876s (+0.4s)	1500	1500	128	29	115	0	9	153
43571	27877s (+0.4s)	1408	1408	128	32	110	0	3	145
43572	27877s (+0.4s)	1388	1388	128	29	110	0	5	144
43573	27878s (+0.7s)	2840	2840	256	53	186	0	9	248
43574	27878s (+0.7s)	2920	2920	256	51	192	0	13	256
43575	27879s (+0.3s)	812	812	64	16	80	0	5	101
43576	27879s (+0.2s)	324	324	32	8	48	0	3	59
43577	27880s (+1.4s)	6956	6956	512	105	351	0	25	481
43578	27881s (+0.5s)	1792	1792	128	44	130	0	9	183
43579	27881s (+0.4s)	1260	1260	128	19	111	0	3	133
43580	27882s (+0.8s)	3220	3220	256	63	197	0	8	268
43581	27882s (+0.4s)	1452	1452	128	34	112	0	5	151
43582	27883s (+0.2s)	384	384	32	14	45	0	4	63
43583	27883s (+0.6s)	2552	2552	256	43	163	0	10	216
43584	27884s (+0.5s)	1644	1644	128	38	124	6	0	168
43585	27884s (+0.5s)	1720	1720	128	40	127	4	0	171
43586	27885s (+1.2s)	6036	6036	512	121	281	25	0	427
43587	27886s (+0.8s)	3328	3328	256	81	183	16	0	280
43588	27887s (+0.6s)	2240	2240	128	60	146	17	0	223
43589	27888s (+1.0s)	4340	4340	256	100	242	21	0	363
43590	27888s (+0.4s)	1408	1408	128	37	107	7	1	152
43591	27889s (+0.5s)	1760	1760	128	46	125	9	0	180
43592	27890s (+0.8s)	3440	3440	256	78	194	18	0	290
43593	27890s (+0.5s)	1676	1676	128	39	127	8	0	174
43594	27891s (+0.6s)	1924	1924	128	46	145	8	0	199
43595	27891s (+0.7s)	2616	2616	256	47	174	8	0	229
43596	27892s (+0.5s)	1572	1572	128	51	113	6	0	170
43597	27893s (+0.8s)	3344	3344	256	57	206	13	0	276
43598	27893s (+0.4s)	1060	1060	64	28	91	9	1	129
43599	27894s (+1.1s)	5724	5724	512	96	291	15	0	402
Episode	Time	Reward	Score	Highest	L	U	R	D	Steps
43600	27895s (+0.6s)	2012	2012	128	67	119	12	0	198
43601	27895s (+0.4s)	1364	1364	128	38	106	7	0	151
43602	27896s (+0.4s)	1372	1372	128	33	105	5	0	143
43603	27897s (+0.9s)	3816	3816	256	87	202	19	1	309
43604	27898s (+0.9s)	4012	4012	256	98	216	16	0	330
43605	27898s (+0.5s)	1616	1616	128	42	124	5	0	171
43606	27899s (+0.5s)	1800	1800	128	36	139	0	11	186
43607	27899s (+0.5s)	1532	1532	128	32	121	0	9	162
43608	27900s (+0.6s)	2584	2584	256	51	158	0	12	221
43609	27900s (+0.5s)	1928	1928	128	45	135	0	10	190
43610	27901s (+0.7s)	3048	3048	256	53	193	0	17	263
43611	27901s (+0.4s)	1168	1168	64	26	105	0	8	139
43612	27902s (+0.3s)	648	648	64	15	70	0	6	91
43613	27902s (+0.3s)	836	836	64	28	71	0	10	109
43614	27903s (+0.6s)	2084	2084	128	58	139	0	7	204
43615	27903s (+0.7s)	3180	3180	256	43	215	0	6	264
43616	27904s (+0.9s)	3828	3828	256	65	243	0	12	320
43617	27905s (+0.9s)	3584	3584	256	71	229	10	0	310
43618	27905s (+0.4s)	1240	1240	128	34	91	7	0	132
43619	27906s (+0.9s)	3960	3960	256	72	240	16	1	329
43620	27907s (+0.6s)	2376	2376	256	58	139	10	0	207
43621	27907s (+0.4s)	1184	1184	64	41	93	9	0	143
43622	27908s (+0.7s)	2800	2800	256	45	189	9	0	243
43623	27908s (+0.4s)	1272	1272	128	26	97	7	0	130
43624	27909s (+0.5s)	1660	1660	128	44	131	2	0	177
43625	27910s (+0.9s)	3904	3904	256	94	215	22	0	331
43626	27911s (+0.8s)	3544	3544	256	89	198	13	0	300
43627	27912s (+0.9s)	3844	3844	256	87	220	17	0	324
43628	27913s (+1.0s)	4288	4288	256	83	248	20	0	351
43629	27913s (+0.7s)	2816	2816	256	56	174	11	0	241
43630	27914s (+0.7s)	2904	2904	256	67	170	15	0	252
43631	27914s (+0.3s)	776	776	64	24	73	6	0	103
43632	27915s (+0.5s)	1716	1716	128	42	119	12	0	173
43633	27915s (+0.5s)	1664	1664	128	40	117	10	0	167
43634	27916s (+0.6s)	1864	1864	128	63	119	14	0	196
43635	27917s (+1.1s)	5600	5600	512	86	292	0	20	398
43636	27918s (+0.5s)	1516	1516	128	33	118	0	6	157
43637	27918s (+0.6s)	1816	1816	128	44	136	0	9	189
43638	27919s (+0.6s)	1944	1944	128	43	141	10	0	194
43639	27920s (+0.9s)	3964	3964	256	76	229	20	0	325
43640	27920s (+0.4s)	1236	1236	128	34	94	9	0	137
43641	27920s (+0.4s)	1124	1124	64	32	92	6	0	130
43642	27921s (+0.6s)	1904	1904	128	54	134	7	0	195
43643	27922s (+0.8s)	3172	3172	256	49	200	0	17	266
43644	27923s (+1.2s)	5788	5788	512	92	305	0	21	418
43645	27924s (+0.7s)	2988	2988	256	45	185	0	14	244
43646	27925s (+0.8s)	3268	3268	256	74	199	8	0	281
43647	27925s (+0.6s)	1828	1828	128	51	134	7	0	192
43648	27926s (+0.6s)	2116	2116	128	52	145	12	0	209
43649	27926s (+0.8s)	3276	3276	256	65	205	7	0	277
43650	27927s (+0.9s)	3656	3656	256	75	225	11	1	312
43651	27928s (+0.5s)	1768	1768	128	47	126	4	0	177
43652	27928s (+0.4s)	1272	1272	64	42	97	8	2	149
43653	27929s (+0.7s)	2996	2996	256	68	167	14	0	249
43654	27930s (+0.6s)	2340	2340	256	46	141	8	0	195
43655	27930s (+0.5s)	1792	1792	128	46	129	8	0	183
43656	27931s (+1.0s)	5344	5344	512	87	265	20	0	372
43657	27932s (+0.8s)	3620	3620	256	70	207	16	0	293
43658	27932s (+0.3s)	892	892	64	23	90	2	0	115
43659	27933s (+0.7s)	3132	3132	256	57	190	9	0	256
43660	27933s (+0.3s)	764	764	64	23	68	3	1	95
43661	27934s (+1.0s)	4920	4920	512	88	252	12	0	352
43662	27935s (+0.6s)	2308	2308	256	47	147	6	0	200
43663	27936s (+0.6s)	1924	1924	128	55	139	5	0	199
43664	27936s (+0.6s)	1924	1924	128	53	135	8	0	196
43665	27937s (+0.8s)	3264	3264	256	65	200	7	0	272
43666	27937s (+0.6s)	2044	2044	128	59	127	12	0	198
43667	27938s (+0.6s)	1932	1932	128	56	132	13	0	201
43668	27939s (+0.6s)	2148	2148	128	51	143	10	0	204
43669	27939s (+0.7s)	3168	3168	256	65	186	9	1	261
43670	27940s (+0.2s)	444	444	32	16	51	2	0	69
43671	27941s (+1.0s)	4224	4224	256	88	240	18	0	346
43672	27941s (+0.7s)	2756	2756	256	49	174	0	10	233
43673	27942s (+0.4s)	1308	1308	128	24	105	0	5	134
43674	27942s (+0.5s)	1812	1812	128	41	135	0	6	182
43675	27943s (+0.8s)	3384	3384	256	58	211	0	13	282
43676	27944s (+0.5s)	1804	1804	128	44	134	0	8	186
43677	27944s (+0.8s)	3228	3228	256	47	214	0	9	270
43678	27945s (+0.5s)	1820	1820	128	45	136	8	0	189
43679	27945s (+0.4s)	1476	1476	128	35	116	4	0	155
43680	27946s (+0.6s)	1960	1960	128	54	126	17	0	197
43681	27947s (+0.7s)	2520	2520	128	63	165	9	0	237
43682	27948s (+1.0s)	4272	4272	256	76	257	15	0	348
43683	27949s (+1.3s)	6504	6504	512	148	296	24	0	468
43684	27949s (+0.4s)	1324	1324	128	29	110	7	0	146
43685	27950s (+0.4s)	1420	1420	128	36	102	6	0	144
43686	27950s (+0.6s)	2556	2556	256	61	148	10	0	219
43687	27951s (+0.5s)	1732	1732	128	46	121	6	0	173
43688	27952s (+0.7s)	2500	2500	128	59	169	8	0	236
43689	27952s (+0.6s)	2548	2548	256	46	161	0	11	218
43690	27952s (+0.3s)	796	796	64	27	73	0	6	106
43691	27953s (+0.6s)	2760	2760	256	51	158	0	12	221
43692	27954s (+0.7s)	3212	3212	256	51	193	0	17	261
43693	27955s (+1.0s)	4308	4308	256	78	267	0	17	362
43694	27956s (+0.6s)	2508	2508	256	39	168	0	11	218
43695	27956s (+0.8s)	3388	3388	256	52	232	0	9	293
43696	27957s (+0.5s)	1608	1608	128	33	128	0	8	169
43697	27957s (+0.6s)	2408	2408	256	53	140	9	1	203
43698	27958s (+0.8s)	3396	3396	256	65	209	11	0	285
43699	27959s (+0.5s)	1840	1840	128	54	133	7	0	194
Episode	Time	Reward	Score	Highest	L	U	R	D	Steps
43700	27959s (+0.3s)	1128	1128	128	27	92	3	0	122
43701	27960s (+0.8s)	3356	3356	256	71	189	15	0	275
43702	27960s (+0.5s)	1876	1876	128	46	138	5	0	189
43703	27961s (+1.0s)	4024	4024	256	79	241	15	0	335
43704	27962s (+0.8s)	3388	3388	256	69	204	10	0	283
43705	27963s (+0.5s)	1528	1528	128	42	112	7	0	161
43706	27963s (+0.5s)	1572	1572	128	45	115	5	0	165
43707	27964s (+0.6s)	1916	1916	128	53	131	13	0	197
43708	27964s (+0.4s)	1488	1488	128	41	107	8	0	156
43709	27965s (+0.7s)	2852	2852	256	68	164	12	0	244
43710	27966s (+0.8s)	3388	3388	256	64	207	11	0	282
43711	27966s (+0.5s)	1824	1824	128	48	135	7	0	190
43712	27967s (+0.9s)	3988	3988	256	82	230	19	0	331
43713	27968s (+0.7s)	3072	3072	256	61	184	8	0	253
43714	27968s (+0.4s)	1432	1432	128	26	116	5	0	147
43715	27969s (+0.5s)	1584	1584	128	34	124	0	5	163
43716	27970s (+0.7s)	2704	2704	256	52	172	0	11	235
43717	27970s (+0.8s)	3184	3184	256	58	204	0	16	278
43718	27971s (+0.2s)	568	568	32	22	57	0	7	86
43719	27971s (+0.6s)	1924	1924	128	54	137	8	0	199
43720	27972s (+0.5s)	1620	1620	128	51	104	7	0	162
43721	27972s (+0.8s)	3444	3444	256	70	209	12	1	292
43722	27973s (+0.4s)	1492	1492	128	22	129	5	1	157
43723	27973s (+0.5s)	2304	2304	256	53	126	11	0	190
43724	27974s (+0.9s)	3996	3996	256	79	229	15	0	323
43725	27975s (+0.6s)	2716	2716	256	63	147	11	0	221
43726	27976s (+0.8s)	3448	3448	256	66	213	10	0	289
43727	27977s (+0.9s)	3608	3608	256	73	218	14	0	305
43728	27978s (+0.8s)	3380	3380	256	71	198	11	0	280
43729	27978s (+0.9s)	3824	3824	256	98	205	16	0	319
43730	27979s (+0.8s)	3264	3264	256	66	199	14	0	279
43731	27980s (+0.8s)	3352	3352	256	72	199	12	1	284
43732	27981s (+0.5s)	1816	1816	128	43	139	7	0	189
43733	27981s (+0.5s)	1724	1724	128	34	131	8	0	173
43734	27982s (+0.5s)	1540	1540	128	42	116	5	0	163
43735	27983s (+1.0s)	4140	4140	256	88	228	22	0	338
43736	27983s (+0.5s)	1504	1504	128	39	116	5	0	160
43737	27984s (+1.0s)	5304	5304	512	84	266	17	0	367
43738	27985s (+0.5s)	1720	1720	128	45	119	7	0	171
43739	27985s (+0.7s)	2732	2732	256	43	182	8	0	233
43740	27986s (+0.8s)	4508	4508	512	82	203	13	0	298
43741	27987s (+0.5s)	1796	1796	128	37	139	7	0	183
43742	27988s (+1.0s)	4232	4232	256	102	225	21	0	348
43743	27988s (+0.7s)	2916	2916	256	55	171	14	0	240
43744	27989s (+1.0s)	4228	4228	256	76	256	15	0	347
43745	27990s (+0.8s)	3452	3452	256	77	193	16	1	287
43746	27991s (+0.4s)	1428	1428	128	25	114	6	1	146
43747	27991s (+0.5s)	1764	1764	128	47	126	3	0	176
43748	27992s (+0.4s)	1356	1356	128	35	103	11	0	149
43749	27992s (+0.2s)	624	624	64	13	71	2	0	86
43750	27992s (+0.6s)	2488	2488	256	67	143	8	0	218
43751	27993s (+0.8s)	3500	3500	256	76	207	12	0	295
43752	27994s (+0.8s)	3188	3188	256	46	206	0	13	265
43753	27995s (+0.8s)	3340	3340	256	46	222	0	13	281
43754	27996s (+1.0s)	5060	5060	512	70	268	0	17	355
43755	27996s (+0.3s)	1012	1012	64	28	85	0	8	121
43756	27997s (+0.8s)	3368	3368	256	62	203	0	13	278
43757	27998s (+0.6s)	1952	1952	128	34	161	0	10	205
43758	27998s (+0.8s)	3212	3212	256	65	190	11	0	266
43759	27999s (+0.7s)	2604	2604	256	50	171	5	0	226
43760	28000s (+0.7s)	2892	2892	256	47	185	15	0	247
43761	28000s (+0.4s)	1328	1328	64	43	102	7	0	152
43762	28001s (+0.5s)	1724	1724	128	47	117	9	0	173
43763	28001s (+0.4s)	1112	1112	64	23	96	10	2	131
43764	28001s (+0.5s)	1392	1392	64	38	108	10	0	156
43765	28002s (+0.7s)	2900	2900	256	62	181	8	0	251
43766	28003s (+0.9s)	3764	3764	256	83	212	17	0	312
43767	28004s (+0.8s)	3384	3384	256	69	207	16	0	292
43768	28005s (+1.2s)	5916	5916	512	134	253	27	0	414
43769	28006s (+1.1s)	5596	5596	512	94	276	21	0	391
43770	28007s (+0.3s)	1004	1004	128	12	97	1	0	110
43771	28007s (+0.5s)	2300	2300	256	45	135	10	0	190
43772	28008s (+0.7s)	2908	2908	256	57	178	8	0	243
43773	28008s (+0.5s)	1836	1836	128	56	122	9	0	187
43774	28009s (+0.7s)	2740	2740	256	47	178	8	0	233
43775	28010s (+1.1s)	4528	4528	256	112	242	24	0	378
43776	28011s (+0.9s)	3588	3588	256	76	216	14	0	306
43777	28012s (+0.8s)	2932	2932	128	79	179	15	1	274
43778	28013s (+0.8s)	3492	3492	256	76	205	11	0	292
43779	28013s (+0.8s)	3400	3400	256	69	198	13	0	280
43780	28015s (+1.1s)	4516	4516	256	109	247	19	0	375
43781	28015s (+0.4s)	1320	1320	128	39	91	5	1	136
43782	28016s (+0.7s)	2524	2524	128	61	165	9	0	235
43783	28016s (+0.5s)	1504	1504	128	43	109	7	0	159
43784	28017s (+0.7s)	2992	2992	256	62	171	11	0	244
43785	28017s (+0.6s)	1984	1984	128	53	133	13	0	199
43786	28018s (+0.3s)	900	900	64	28	87	1	0	116
43787	28018s (+0.7s)	2824	2824	256	67	159	15	0	241
43788	28019s (+0.6s)	2404	2404	256	53	142	7	1	203
43789	28020s (+1.0s)	4276	4276	256	92	239	21	0	352
43790	28021s (+0.8s)	3132	3132	256	63	195	6	0	264
43791	28021s (+0.5s)	1844	1844	128	55	112	13	1	181
43792	28022s (+0.5s)	1608	1608	128	42	118	9	0	169
43793	28022s (+0.5s)	1516	1516	128	50	107	6	0	163
43794	28023s (+0.5s)	1836	1836	128	32	144	0	7	183
43795	28023s (+0.4s)	1144	1144	64	22	106	0	6	134
43796	28024s (+0.7s)	2804	2804	256	56	174	0	7	237
43797	28025s (+0.7s)	2952	2952	256	54	198	0	12	264
43798	28025s (+0.6s)	1920	1920	128	46	147	5	0	198
43799	28026s (+0.6s)	2260	2260	128	51	144	12	1	208
Episode	Time	Reward	Score	Highest	L	U	R	D	Steps
43800	28026s (+0.7s)	2812	2812	256	80	153	12	0	245
43801	28027s (+0.4s)	1104	1104	64	27	95	7	0	129
43802	28028s (+0.8s)	3428	3428	256	70	198	20	1	289
43803	28028s (+0.5s)	1536	1536	128	29	129	5	0	163
43804	28029s (+0.9s)	3840	3840	256	83	228	15	0	326
43805	28030s (+0.8s)	3484	3484	256	64	215	11	0	290
43806	28030s (+0.6s)	1944	1944	128	48	148	8	0	204
43807	28031s (+0.4s)	1352	1352	128	29	107	4	0	140
43808	28032s (+0.8s)	3244	3244	256	73	184	17	0	274
43809	28032s (+0.5s)	1848	1848	128	43	136	7	0	186
43810	28033s (+0.8s)	3244	3244	256	69	193	12	0	274
43811	28034s (+0.8s)	3200	3200	256	73	181	13	1	268
43812	28035s (+0.7s)	3148	3148	256	77	167	13	0	257
43813	28035s (+0.8s)	3392	3392	256	60	219	11	0	290
43814	28036s (+0.5s)	1576	1576	128	34	120	7	0	161
43815	28037s (+0.7s)	2896	2896	256	53	193	9	0	255
43816	28037s (+0.6s)	1924	1924	128	51	142	6	0	199
43817	28038s (+0.8s)	3488	3488	256	60	222	8	0	290
43818	28039s (+1.0s)	4280	4280	256	80	251	22	0	353
43819	28040s (+0.7s)	2664	2664	256	51	172	7	0	230
43820	28040s (+0.5s)	2232	2232	256	44	140	10	0	194
43821	28041s (+0.4s)	1192	1192	128	25	99	3	0	127
43822	28041s (+0.8s)	3228	3228	256	67	193	10	0	270
43823	28042s (+0.6s)	2544	2544	256	54	159	9	0	222
43824	28043s (+0.9s)	3720	3720	256	83	213	9	1	306
43825	28043s (+0.5s)	1488	1488	128	29	123	5	0	157
43826	28044s (+0.5s)	1472	1472	128	39	112	8	0	159
43827	28044s (+0.6s)	1912	1912	128	46	145	6	0	197
43828	28045s (+0.6s)	2032	2032	128	49	138	13	0	200
43829	28045s (+0.5s)	1688	1688	128	47	120	6	0	173
43830	28046s (+0.8s)	3244	3244	256	64	202	8	0	274
43831	28047s (+0.5s)	1700	1700	128	31	130	9	0	170
43832	28047s (+0.5s)	1928	1928	128	34	142	0	10	186
43833	28048s (+0.5s)	1564	1564	64	41	116	0	10	167
43834	28048s (+0.3s)	1144	1144	128	21	94	0	8	123
43835	28049s (+0.8s)	3656	3656	256	65	224	0	12	301
43836	28050s (+0.6s)	2168	2168	128	59	131	12	0	202
43837	28050s (+0.8s)	3524	3524	256	71	202	8	0	281
43838	28051s (+0.5s)	1776	1776	128	45	125	9	0	179
43839	28051s (+0.5s)	1548	1548	128	40	119	7	0	166
43840	28052s (+0.7s)	2812	2812	256	59	178	8	0	245
43841	28053s (+0.7s)	2808	2808	256	48	188	6	0	242
43842	28053s (+0.5s)	2264	2264	256	35	148	8	0	191
43843	28054s (+0.2s)	656	656	64	12	74	0	0	86
43844	28054s (+0.8s)	3136	3136	256	65	189	9	0	263
43845	28055s (+0.4s)	1472	1472	128	42	102	8	0	152
43846	28055s (+0.5s)	1700	1700	128	44	122	9	1	176
43847	28057s (+1.2s)	6056	6056	512	90	326	16	0	432
43848	28057s (+1.0s)	4156	4156	256	77	245	0	19	341
43849	28058s (+0.9s)	3944	3944	256	76	232	0	12	320
43850	28059s (+0.7s)	2832	2832	256	47	197	0	6	250
43851	28060s (+0.8s)	3488	3488	256	48	215	0	14	277
43852	28060s (+0.3s)	928	928	64	22	81	0	7	110
43853	28061s (+0.5s)	1544	1544	128	39	107	0	12	158
43854	28062s (+0.8s)	3476	3476	256	67	207	0	14	288
43855	28062s (+0.7s)	2888	2888	256	51	175	0	12	238
43856	28063s (+0.5s)	1808	1808	128	42	136	0	8	186
43857	28064s (+0.8s)	3464	3464	256	77	198	0	16	291
43858	28064s (+0.8s)	3272	3272	256	55	208	0	11	274
43859	28065s (+0.8s)	3464	3464	256	62	212	0	15	289
43860	28066s (+0.4s)	1580	1580	128	33	117	0	10	160
43861	28066s (+0.6s)	2228	2228	128	43	164	0	9	216
43862	28067s (+0.2s)	608	608	64	17	62	0	4	83
43863	28067s (+0.8s)	3324	3324	256	52	220	0	6	278
43864	28068s (+0.9s)	3976	3976	256	58	252	0	19	329
43865	28069s (+0.4s)	1452	1452	128	28	117	0	5	150
43866	28069s (+0.6s)	2496	2496	256	47	158	0	8	213
43867	28070s (+0.4s)	1028	1028	64	27	92	0	4	123
43868	28070s (+0.6s)	2736	2736	256	56	162	10	0	228
43869	28071s (+0.7s)	3208	3208	256	69	173	13	0	255
43870	28072s (+0.8s)	2904	2904	128	82	175	15	0	272
43871	28072s (+0.7s)	2796	2796	256	72	158	12	0	242
43872	28073s (+0.5s)	1844	1844	128	37	139	9	0	185
43873	28074s (+0.5s)	1864	1864	128	46	136	7	0	189
43874	28074s (+0.8s)	3348	3348	256	75	193	11	0	279
43875	28075s (+0.7s)	2896	2896	256	53	190	7	0	250
43876	28076s (+0.7s)	3092	3092	256	78	167	16	0	261
43877	28076s (+0.5s)	2212	2212	256	48	129	7	0	184
43878	28077s (+0.6s)	2508	2508	256	60	142	11	1	214
43879	28078s (+0.9s)	3836	3836	256	71	224	16	0	311
43880	28078s (+0.6s)	2112	2112	128	59	140	11	0	210
43881	28079s (+0.8s)	3112	3112	256	62	194	11	0	267
43882	28080s (+0.6s)	2636	2636	256	63	150	11	0	224
43883	28081s (+0.7s)	2776	2776	256	57	160	10	1	228
43884	28081s (+0.3s)	920	920	64	27	75	5	0	107
43885	28081s (+0.4s)	1212	1212	64	33	103	6	0	142
43886	28082s (+0.6s)	2492	2492	256	42	166	6	1	215
43887	28082s (+0.3s)	780	780	64	29	69	5	0	103
43888	28083s (+0.3s)	900	900	64	25	91	4	0	120
43889	28083s (+0.8s)	3520	3520	256	93	184	22	0	299
43890	28084s (+0.4s)	1252	1252	64	44	97	7	0	148
43891	28085s (+0.9s)	3636	3636	256	84	209	18	1	312
43892	28085s (+0.7s)	3152	3152	256	69	171	15	1	256
43893	28086s (+0.6s)	2532	2532	256	47	161	7	0	215
43894	28086s (+0.5s)	1648	1648	128	38	122	4	0	164
43895	28087s (+0.5s)	1784	1784	128	55	118	12	0	185
43896	28088s (+0.7s)	3200	3200	256	71	180	13	0	264
43897	28089s (+0.8s)	3348	3348	256	74	197	16	0	287
43898	28090s (+1.2s)	6192	6192	512	96	328	15	0	439
43899	28091s (+1.0s)	4268	4268	256	87	238	21	0	346
Episode	Time	Reward	Score	Highest	L	U	R	D	Steps
43900	28091s (+0.3s)	944	944	128	25	76	5	0	106
43901	28092s (+0.7s)	2896	2896	256	62	178	14	0	254
43902	28093s (+1.2s)	5756	5756	512	119	267	24	0	410
43903	28093s (+0.3s)	736	736	64	22	70	5	0	97
43904	28094s (+0.6s)	2592	2592	256	49	156	9	0	214
43905	28095s (+0.8s)	3416	3416	256	68	200	17	0	285
43906	28096s (+0.7s)	2900	2900	256	59	187	10	0	256
43907	28096s (+0.6s)	2436	2436	256	48	152	5	0	205
43908	28097s (+0.4s)	1268	1268	64	54	86	8	0	148
43909	28097s (+0.8s)	3248	3248	256	63	203	8	1	275
43910	28099s (+1.6s)	7868	7868	512	159	355	39	0	553
43911	28099s (+0.5s)	1728	1728	128	29	139	4	0	172
43912	28100s (+0.4s)	1400	1400	128	45	92	9	0	146
43913	28101s (+0.9s)	3752	3752	256	101	200	13	0	314
43914	28101s (+0.7s)	2948	2948	256	51	189	8	0	248
43915	28102s (+0.8s)	3324	3324	256	62	209	11	0	282
43916	28103s (+0.6s)	2068	2068	128	61	129	9	0	199
43917	28103s (+0.4s)	1200	1200	128	35	91	6	0	132
43918	28104s (+0.4s)	1176	1176	128	28	92	7	0	127
43919	28104s (+0.3s)	940	940	64	28	80	6	0	114
43920	28105s (+0.5s)	1788	1788	128	43	131	8	0	182
43921	28105s (+0.4s)	1548	1548	128	28	123	3	0	154
43922	28106s (+0.6s)	1928	1928	128	53	137	10	0	200
43923	28106s (+0.9s)	3548	3548	256	89	201	11	0	301
43924	28107s (+0.8s)	3204	3204	256	69	181	16	0	266
43925	28108s (+1.1s)	4592	4592	256	103	258	21	0	382
43926	28109s (+0.5s)	1828	1828	128	49	121	8	0	178
43927	28109s (+0.6s)	2536	2536	256	49	167	5	0	221
43928	28110s (+1.0s)	4176	4176	256	80	252	14	0	346
43929	28111s (+1.1s)	5400	5400	512	90	271	15	1	377
43930	28113s (+1.0s)	5116	5116	512	88	252	21	1	362
43931	28113s (+0.8s)	3208	3208	256	65	192	13	0	270
43932	28114s (+0.5s)	1676	1676	128	42	134	5	0	181
43933	28115s (+0.9s)	3684	3684	256	85	205	13	0	303
43934	28116s (+1.0s)	4200	4200	256	81	248	16	0	345
43935	28116s (+0.4s)	1432	1432	128	37	111	5	0	153
43936	28117s (+0.5s)	1728	1728	128	41	127	5	0	173
43937	28117s (+0.6s)	2464	2464	128	57	161	10	0	228
43938	28118s (+0.3s)	676	676	64	19	66	3	0	88
43939	28118s (+0.5s)	2356	2356	256	39	145	8	0	192
43940	28119s (+0.5s)	1796	1796	128	44	134	6	0	184
43941	28119s (+0.8s)	3448	3448	256	69	200	17	0	286
43942	28120s (+0.6s)	2508	2508	256	40	161	8	0	209
43943	28121s (+0.5s)	1804	1804	128	55	121	9	1	186
43944	28121s (+0.7s)	2740	2740	256	52	178	9	0	239
43945	28122s (+0.7s)	2912	2912	256	47	186	10	1	244
43946	28123s (+1.1s)	4564	4564	256	118	235	18	0	371
43947	28124s (+0.8s)	3164	3164	256	63	193	7	0	263
43948	28124s (+0.5s)	1660	1660	128	39	120	12	0	171
43949	28125s (+0.8s)	3396	3396	256	71	195	14	0	280
43950	28126s (+0.8s)	3248	3248	256	72	197	17	0	286
43951	28127s (+0.8s)	3392	3392	256	68	200	10	1	279
43952	28127s (+0.3s)	1000	1000	128	24	76	4	0	104
43953	28127s (+0.5s)	1672	1672	128	45	116	8	1	170
43954	28128s (+0.4s)	1456	1456	128	24	123	5	0	152
43955	28128s (+0.4s)	1472	1472	128	26	119	7	1	153
43956	28129s (+0.4s)	1456	1456	128	33	115	0	5	153
43957	28129s (+0.6s)	2684	2684	256	50	165	0	16	231
43958	28130s (+0.7s)	3252	3252	256	59	196	0	12	267
43959	28131s (+0.7s)	2784	2784	256	41	188	0	8	237
43960	28132s (+0.8s)	3244	3244	256	52	206	0	15	273
43961	28132s (+0.4s)	1208	1208	128	26	103	0	5	134
43962	28133s (+0.7s)	2816	2816	256	75	154	0	14	243
43963	28134s (+0.8s)	3532	3532	256	51	220	0	14	285
43964	28134s (+0.5s)	1804	1804	128	34	139	0	13	186
43965	28134s (+0.4s)	1196	1196	64	33	108	5	0	146
43966	28135s (+0.6s)	1928	1928	128	47	145	8	0	200
43967	28136s (+0.5s)	1532	1532	128	32	123	7	0	162
43968	28136s (+0.8s)	3412	3412	256	76	200	12	0	288
43969	28137s (+0.8s)	3460	3460	256	75	203	13	0	291
43970	28138s (+0.9s)	4772	4772	512	88	231	17	0	336
43971	28139s (+0.5s)	2136	2136	256	44	133	8	0	185
43972	28139s (+0.7s)	2836	2836	256	68	168	16	0	252
43973	28140s (+1.0s)	4328	4328	256	99	245	17	0	361
43974	28141s (+0.7s)	2460	2460	128	58	155	14	0	227
43975	28142s (+0.6s)	1964	1964	128	47	150	7	0	204
43976	28142s (+0.7s)	2824	2824	256	54	182	13	0	249
43977	28143s (+0.8s)	3124	3124	256	80	172	19	1	272
43978	28144s (+0.3s)	784	784	64	28	72	5	0	105
43979	28144s (+0.6s)	2080	2080	128	47	150	10	0	207
43980	28145s (+0.5s)	1524	1524	128	36	115	9	0	160
43981	28145s (+0.6s)	1856	1856	128	57	125	10	0	192
43982	28147s (+1.3s)	6432	6432	512	111	334	17	0	462
43983	28147s (+0.7s)	3068	3068	256	61	174	17	0	252
43984	28148s (+0.5s)	1780	1780	128	55	111	11	0	177
43985	28148s (+0.4s)	1176	1176	128	36	90	5	0	131
43986	28149s (+0.8s)	3276	3276	256	83	170	17	0	270
43987	28149s (+0.5s)	1884	1884	128	61	116	16	0	193
43988	28150s (+0.4s)	1164	1164	64	33	100	5	0	138
43989	28150s (+0.4s)	1484	1484	128	44	103	8	0	155
43990	28151s (+0.5s)	1832	1832	128	48	128	10	0	186
43991	28151s (+0.4s)	1312	1312	128	25	104	6	0	135
43992	28152s (+0.4s)	1472	1472	128	36	108	7	0	151
43993	28152s (+0.3s)	712	712	64	15	74	4	0	93
43994	28153s (+0.8s)	3344	3344	256	78	192	12	0	282
43995	28154s (+1.2s)	6332	6332	512	100	307	21	0	428
43996	28155s (+1.0s)	4140	4140	256	87	232	18	0	337
43997	28156s (+0.8s)	3820	3820	256	72	221	12	1	306
43998	28157s (+0.7s)	2960	2960	256	62	172	14	1	249
43999	28157s (+0.6s)	2688	2688	256	53	153	12	0	218
Episode	Time	Reward	Score	Highest	L	U	R	D	Steps
44000	28158s (+0.8s)	3240	3240	256	62	201	9	0	272
44001	28158s (+0.5s)	1672	1672	128	48	108	14	0	170
44002	28159s (+0.5s)	1808	1808	128	52	127	8	0	187
44003	28160s (+0.6s)	2184	2184	128	60	134	13	0	207
44004	28161s (+1.5s)	7540	7540	512	159	344	28	1	532
44005	28162s (+1.1s)	4640	4640	256	114	242	26	0	382
44006	28163s (+0.3s)	864	864	64	26	78	8	0	112
44007	28163s (+0.8s)	3332	3332	256	51	208	0	10	269
44008	28164s (+0.6s)	2292	2292	256	40	144	0	12	196
44009	28164s (+0.5s)	1788	1788	128	42	134	0	6	182
44010	28165s (+0.4s)	1316	1316	128	24	104	0	6	134
44011	28166s (+0.8s)	3276	3276	256	50	217	0	10	277
44012	28166s (+0.5s)	1660	1660	128	36	124	0	7	167
44013	28167s (+0.5s)	1836	1836	128	40	141	0	9	190
44014	28167s (+0.5s)	2252	2252	256	35	144	0	10	189
44015	28168s (+0.4s)	1412	1412	128	32	106	5	1	144
44016	28168s (+0.4s)	1484	1484	128	31	120	5	0	156
44017	28168s (+0.4s)	1180	1180	128	30	94	4	0	128
44018	28169s (+0.4s)	1476	1476	128	42	104	7	0	153
44019	28169s (+0.3s)	900	900	64	32	78	7	0	117
44020	28170s (+0.7s)	2976	2976	256	57	184	10	0	251
44021	28170s (+0.6s)	1952	1952	128	59	133	9	0	201
44022	28171s (+0.5s)	1520	1520	128	38	113	0	8	159
44023	28172s (+0.9s)	3980	3980	256	89	223	0	17	329
44024	28173s (+0.7s)	2436	2436	128	43	178	0	11	232
44025	28173s (+0.5s)	1676	1676	128	35	139	0	6	180
44026	28174s (+0.5s)	1820	1820	128	44	138	0	4	186
44027	28174s (+0.3s)	756	756	64	27	66	0	8	101
44028	28174s (+0.6s)	1908	1908	128	41	147	7	0	195
44029	28175s (+0.6s)	2668	2668	256	60	157	10	0	227
44030	28176s (+1.2s)	6212	6212	512	132	274	30	0	436
44031	28177s (+0.8s)	3492	3492	256	74	204	14	0	292
44032	28178s (+0.7s)	3004	3004	256	47	190	10	0	247
44033	28179s (+0.9s)	3760	3760	256	93	208	17	0	318
44034	28179s (+0.5s)	1892	1892	128	43	143	5	0	191
44035	28180s (+0.4s)	1284	1284	128	39	94	7	1	141
44036	28180s (+0.2s)	620	620	64	24	57	4	0	85
44037	28181s (+0.5s)	1896	1896	128	40	143	9	0	192
44038	28181s (+0.9s)	3512	3512	256	83	199	15	0	297
44039	28182s (+0.7s)	2484	2484	128	72	153	13	1	239
44040	28183s (+0.5s)	1892	1892	128	53	131	7	0	191
44041	28183s (+0.7s)	2648	2648	256	71	154	7	0	232
44042	28184s (+0.4s)	1456	1456	128	47	100	6	0	153
44043	28185s (+0.8s)	3156	3156	256	73	177	12	0	262
44044	28185s (+0.4s)	1508	1508	128	31	123	3	0	157
44045	28185s (+0.4s)	1520	1520	128	31	120	5	0	156
44046	28186s (+0.8s)	3328	3328	256	64	211	8	0	283
44047	28187s (+0.7s)	2880	2880	256	51	190	6	0	247
44048	28187s (+0.2s)	640	640	64	16	65	3	0	84
44049	28188s (+0.6s)	2444	2444	128	63	148	12	0	223
44050	28188s (+0.5s)	1868	1868	128	58	122	11	0	191
44051	28189s (+0.8s)	3244	3244	256	82	184	8	0	274
44052	28190s (+0.6s)	2636	2636	256	65	144	14	0	223
44053	28190s (+0.5s)	1636	1636	128	45	121	10	0	176
44054	28191s (+0.5s)	1784	1784	128	40	136	5	0	181
44055	28191s (+0.5s)	1684	1684	128	50	112	10	0	172
44056	28192s (+0.4s)	1188	1188	128	31	94	4	0	129
44057	28192s (+0.4s)	1480	1480	128	35	114	5	0	154
44058	28193s (+0.7s)	2820	2820	256	56	173	13	0	242
44059	28193s (+0.5s)	1604	1604	128	35	124	9	0	168
44060	28194s (+0.3s)	816	816	64	26	73	6	0	105
44061	28194s (+0.9s)	3508	3508	256	81	202	16	1	300
44062	28195s (+0.5s)	1788	1788	128	45	131	0	6	182
44063	28195s (+0.4s)	1244	1244	128	22	103	0	4	129
44064	28196s (+0.5s)	1900	1900	128	34	150	0	10	194
44065	28196s (+0.5s)	1612	1612	128	38	124	0	8	170
44066	28197s (+0.3s)	1056	1056	64	29	92	6	0	127
44067	28197s (+0.3s)	980	980	64	25	84	5	1	115
44068	28198s (+0.9s)	3652	3652	256	90	203	16	1	310
44069	28198s (+0.5s)	2004	2004	128	52	130	10	1	193
44070	28199s (+0.8s)	3448	3448	256	68	201	16	0	285
44071	28200s (+0.8s)	3216	3216	256	63	193	13	0	269
44072	28201s (+0.8s)	3228	3228	256	52	206	12	0	270
44073	28202s (+0.7s)	2788	2788	256	58	174	9	0	241
44074	28202s (+0.5s)	1800	1800	128	37	141	7	0	185
44075	28203s (+0.5s)	1852	1852	128	54	131	8	0	193
44076	28203s (+0.3s)	848	848	64	28	76	8	0	112
44077	28204s (+1.2s)	5616	5616	512	87	294	0	22	403
44078	28205s (+0.8s)	3508	3508	256	60	216	0	16	292
44079	28206s (+0.8s)	2976	2976	256	55	201	0	9	265
44080	28206s (+0.6s)	2492	2492	256	51	154	0	9	214
44081	28207s (+0.5s)	1920	1920	128	35	152	0	5	192
44082	28207s (+0.5s)	1596	1596	128	32	126	0	8	166
44083	28208s (+0.5s)	1872	1872	128	42	139	0	5	186
44084	28208s (+0.6s)	2620	2620	256	47	164	0	9	220
44085	28209s (+0.5s)	1936	1936	128	43	129	0	15	187
44086	28209s (+0.3s)	980	980	64	18	92	4	0	114
44087	28210s (+0.5s)	1588	1588	128	35	120	8	1	164
44088	28211s (+0.8s)	3212	3212	256	66	192	8	0	266
44089	28212s (+1.0s)	4124	4124	256	97	221	20	0	338
44090	28212s (+0.3s)	876	876	64	27	73	5	0	105
44091	28213s (+0.8s)	3496	3496	256	67	204	11	0	282
44092	28213s (+0.3s)	880	880	64	25	83	7	0	115
44093	28214s (+0.7s)	2820	2820	256	72	158	13	0	243
44094	28214s (+0.8s)	3336	3336	256	73	200	8	0	281
44095	28215s (+0.9s)	4036	4036	256	94	218	18	1	331
44096	28216s (+0.9s)	3980	3980	256	63	245	10	0	318
44097	28217s (+0.9s)	3648	3648	256	89	202	20	0	311
44098	28218s (+0.9s)	4112	4112	256	81	226	22	1	330
44099	28219s (+0.4s)	1452	1452	128	49	93	9	0	151
Episode	Time	Reward	Score	Highest	L	U	R	D	Steps
44100	28219s (+0.5s)	1816	1816	128	46	137	6	0	189
44101	28220s (+0.4s)	1312	1312	128	40	99	5	0	144
44102	28220s (+0.7s)	3112	3112	256	59	187	11	0	257
44103	28221s (+0.5s)	1580	1580	128	45	110	12	0	167
44104	28221s (+0.7s)	3004	3004	256	67	177	10	0	254
44105	28222s (+0.4s)	1176	1176	64	38	95	8	0	141
44106	28223s (+1.0s)	4244	4244	256	98	235	18	0	351
44107	28223s (+0.6s)	2072	2072	128	49	150	10	0	209
44108	28224s (+0.7s)	3144	3144	256	67	182	10	0	259
44109	28225s (+0.5s)	1776	1776	128	36	135	12	0	183
44110	28225s (+0.3s)	796	796	64	27	73	6	1	107
44111	28226s (+0.6s)	2376	2376	256	43	153	10	1	207
44112	28226s (+0.6s)	2436	2436	256	57	141	11	0	209
44113	28227s (+0.8s)	3424	3424	256	80	186	14	0	280
44114	28228s (+0.5s)	1556	1556	128	36	116	10	0	162
44115	28228s (+0.6s)	2232	2232	128	54	150	9	0	213
44116	28228s (+0.2s)	388	388	32	22	39	5	0	66
44117	28229s (+0.8s)	3192	3192	256	62	190	14	0	266
44118	28230s (+0.7s)	3028	3028	256	63	171	8	0	242
44119	28231s (+0.9s)	4296	4296	256	92	244	16	0	352
44120	28231s (+0.6s)	2232	2232	128	72	136	17	0	225
44121	28232s (+0.6s)	2432	2432	256	62	134	11	0	207
44122	28232s (+0.2s)	540	540	64	14	56	4	0	74
44123	28233s (+0.5s)	1604	1604	128	44	117	7	0	168
44124	28233s (+0.3s)	704	704	64	21	70	3	0	94
44125	28233s (+0.5s)	1932	1932	128	50	132	8	0	190
44126	28235s (+1.1s)	5432	5432	512	104	249	25	0	378
44127	28235s (+0.5s)	1664	1664	128	48	122	8	0	178
44128	28235s (+0.4s)	1168	1168	64	34	96	9	0	139
44129	28236s (+0.8s)	3484	3484	256	78	201	15	0	294
44130	28237s (+0.5s)	1612	1612	128	31	129	0	7	167
44131	28238s (+0.8s)	3372	3372	256	57	212	0	20	289
44132	28238s (+0.7s)	2744	2744	256	44	185	0	5	234
44133	28239s (+0.6s)	2676	2676	256	44	178	0	7	229
44134	28239s (+0.3s)	888	888	64	26	87	0	5	118
44135	28240s (+0.3s)	1144	1144	128	23	95	0	2	120
44136	28240s (+0.7s)	3076	3076	256	67	171	11	0	249
44137	28241s (+0.4s)	1576	1576	128	42	115	5	0	162
44138	28242s (+1.1s)	4588	4588	256	93	264	20	0	377
44139	28242s (+0.6s)	2404	2404	256	50	147	9	0	206
44140	28243s (+0.5s)	2288	2288	256	46	142	6	1	195
44141	28244s (+0.5s)	2100	2100	256	40	133	4	0	177
44142	28244s (+0.4s)	1520	1520	128	46	103	10	0	159
44143	28245s (+0.7s)	3076	3076	256	70	170	10	0	250
44144	28245s (+0.4s)	1404	1404	128	34	109	7	0	150
44145	28246s (+0.5s)	1524	1524	128	33	122	9	0	164
44146	28246s (+0.3s)	968	968	64	29	81	0	7	117
44147	28246s (+0.5s)	1668	1668	128	37	128	4	0	169
44148	28247s (+0.9s)	3804	3804	256	74	230	0	17	321
44149	28248s (+0.3s)	748	748	64	15	82	2	0	99
44150	28249s (+1.0s)	4096	4096	256	91	236	19	0	346
44151	28249s (+0.6s)	2472	2472	256	53	145	11	0	209
44152	28250s (+0.8s)	3568	3568	256	89	190	20	0	299
44153	28251s (+1.0s)	4316	4316	256	95	244	18	0	357
44154	28252s (+0.5s)	1688	1688	128	34	130	10	0	174
44155	28252s (+0.7s)	3040	3040	256	53	194	8	0	255
44156	28253s (+0.6s)	2316	2316	256	54	140	9	0	203
44157	28253s (+0.6s)	2432	2432	256	40	156	8	1	205
44158	28254s (+0.7s)	2804	2804	256	52	183	9	0	244
44159	28255s (+0.4s)	1220	1220	128	30	96	7	0	133
44160	28255s (+0.9s)	4008	4008	256	94	214	21	0	329
44161	28256s (+0.6s)	2492	2492	256	52	154	8	0	214
44162	28257s (+0.7s)	2564	2564	128	56	167	15	2	240
44163	28257s (+0.3s)	1084	1084	128	21	89	0	6	116
44164	28258s (+0.4s)	1484	1484	128	31	121	0	4	156
44165	28259s (+1.0s)	4160	4160	256	68	258	0	16	342
44166	28259s (+0.2s)	376	376	32	10	51	1	0	62
44167	28260s (+0.9s)	3804	3804	256	86	214	17	0	317
44168	28260s (+0.5s)	1748	1748	128	49	119	9	0	177
44169	28261s (+0.6s)	2512	2512	256	47	160	9	0	216
44170	28261s (+0.4s)	1648	1648	128	30	127	7	0	164
44171	28262s (+0.6s)	2380	2380	128	63	148	14	1	226
44172	28262s (+0.5s)	1916	1916	128	40	146	0	11	197
44173	28263s (+0.7s)	3064	3064	256	71	163	0	17	251
44174	28264s (+0.4s)	1368	1368	128	34	103	0	5	142
44175	28264s (+0.7s)	3184	3184	256	51	199	0	11	261
44176	28265s (+0.4s)	1196	1196	128	34	91	0	5	130
44177	28265s (+0.3s)	724	724	64	12	79	0	4	95
44178	28266s (+0.8s)	3404	3404	256	50	230	0	7	287
44179	28266s (+0.6s)	2732	2732	256	53	169	0	16	238
44180	28267s (+0.6s)	2240	2240	128	49	155	0	11	215
44181	28268s (+0.5s)	1728	1728	128	39	128	0	10	177
44182	28268s (+0.6s)	2572	2572	256	59	154	10	0	223
44183	28269s (+0.5s)	1568	1568	128	41	117	5	0	163
44184	28269s (+0.5s)	1456	1456	64	44	116	7	0	167
44185	28270s (+1.2s)	6164	6164	512	101	306	25	0	432
44186	28271s (+0.7s)	2736	2736	256	45	176	11	0	232
44187	28271s (+0.3s)	664	664	64	22	65	3	0	90
44188	28272s (+0.6s)	2140	2140	128	60	142	12	0	214
44189	28273s (+0.7s)	2840	2840	256	65	166	15	0	246
44190	28273s (+0.8s)	3748	3748	256	80	211	12	0	303
44191	28274s (+0.7s)	3196	3196	256	63	193	11	0	267
44192	28275s (+0.6s)	1924	1924	128	59	131	10	0	200
44193	28275s (+0.5s)	1916	1916	128	43	130	10	0	183
44194	28276s (+0.8s)	3540	3540	256	61	218	13	0	292
44195	28277s (+0.4s)	1176	1176	64	33	106	2	0	141
44196	28277s (+0.5s)	1864	1864	128	40	146	4	0	190
44197	28278s (+0.5s)	1596	1596	128	42	113	11	0	166
44198	28278s (+0.7s)	3060	3060	256	67	165	14	0	246
44199	28279s (+0.7s)	2848	2848	256	44	201	0	5	250
Episode	Time	Reward	Score	Highest	L	U	R	D	Steps
44200	28280s (+0.7s)	2640	2640	256	63	159	0	8	230
44201	28280s (+0.4s)	1424	1424	128	26	113	0	6	145
44202	28281s (+0.5s)	1600	1600	128	30	127	0	7	164
44203	28281s (+0.7s)	2940	2940	256	43	185	0	10	238
44204	28282s (+0.5s)	1876	1876	128	31	139	0	8	178
44205	28283s (+0.9s)	3960	3960	256	64	245	0	15	324
44206	28283s (+0.5s)	1556	1556	128	40	126	2	0	168
44207	28284s (+0.7s)	2812	2812	256	64	165	15	1	245
44208	28285s (+0.7s)	2964	2964	256	54	187	10	1	252
44209	28285s (+0.2s)	684	684	64	17	70	2	0	89
44210	28285s (+0.4s)	1080	1080	64	32	94	7	0	133
44211	28286s (+1.2s)	5928	5928	512	122	295	15	0	432
44212	28287s (+0.2s)	556	556	32	19	62	2	0	83
44213	28287s (+0.6s)	2160	2160	128	56	147	12	0	215
44214	28288s (+0.7s)	3148	3148	256	72	175	13	0	260
44215	28289s (+0.7s)	2828	2828	256	71	164	8	0	243
44216	28289s (+0.7s)	2916	2916	256	63	181	11	0	255
44217	28290s (+0.6s)	2492	2492	256	41	157	10	0	208
44218	28291s (+0.7s)	2808	2808	256	59	175	11	0	245
44219	28291s (+0.5s)	1636	1636	128	31	126	8	0	165
44220	28292s (+0.4s)	1180	1180	64	42	86	14	0	142
44221	28292s (+0.8s)	3488	3488	256	63	218	10	0	291
44222	28293s (+0.7s)	3152	3152	256	60	194	8	0	262
44223	28294s (+0.4s)	1172	1172	64	43	92	5	0	140
44224	28294s (+0.8s)	3312	3312	256	58	206	15	0	279
44225	28295s (+0.5s)	1524	1524	128	31	126	6	0	163
44226	28296s (+0.7s)	2896	2896	256	62	176	12	0	250
44227	28296s (+0.5s)	1900	1900	128	46	143	0	4	193
44228	28297s (+0.5s)	1780	1780	128	33	140	0	7	180
44229	28297s (+0.4s)	1536	1536	128	29	124	0	4	157
44230	28298s (+0.5s)	1772	1772	128	36	131	0	11	178
44231	28298s (+0.4s)	1164	1164	128	26	92	0	7	125
44232	28299s (+0.9s)	3916	3916	256	68	233	0	16	317
44233	28299s (+0.3s)	992	992	64	36	75	0	6	117
44234	28300s (+0.5s)	1920	1920	128	40	140	1	8	189
44235	28300s (+0.5s)	2264	2264	256	33	145	0	6	184
44236	28301s (+1.0s)	4252	4252	256	107	219	27	0	353
44237	28302s (+0.7s)	2656	2656	256	52	163	9	1	225
44238	28303s (+0.6s)	1932	1932	128	42	151	8	0	201
44239	28303s (+0.7s)	2344	2344	128	71	140	17	1	229
44240	28304s (+0.5s)	1788	1788	128	41	132	9	0	182
44241	28304s (+0.3s)	916	916	64	38	80	2	0	120
44242	28305s (+0.5s)	1640	1640	128	37	122	8	0	167
44243	28305s (+0.2s)	444	444	64	15	45	3	0	63
44244	28305s (+0.6s)	2568	2568	256	57	141	14	0	212
44245	28306s (+0.3s)	696	696	64	14	77	1	0	92
44246	28306s (+0.5s)	1496	1496	128	33	120	5	0	158
44247	28307s (+0.4s)	1500	1500	128	41	104	8	0	153
44248	28307s (+0.4s)	1468	1468	128	37	107	6	0	150
44249	28308s (+0.9s)	4056	4056	256	98	220	15	0	333
44250	28309s (+0.7s)	3200	3200	256	67	190	11	0	268
44251	28310s (+0.8s)	3248	3248	256	67	194	13	0	274
44252	28310s (+0.7s)	2924	2924	256	69	178	10	0	257
44253	28311s (+0.5s)	2172	2172	256	41	137	7	0	185
44254	28311s (+0.5s)	1888	1888	128	45	137	8	0	190
44255	28312s (+0.9s)	4008	4008	256	88	230	18	0	336
44256	28313s (+0.7s)	3128	3128	256	71	174	16	0	261
44257	28314s (+0.8s)	3448	3448	256	89	187	16	1	293
44258	28315s (+0.8s)	3376	3376	256	68	203	14	0	285
44259	28315s (+0.4s)	1208	1208	64	37	107	5	0	149
44260	28316s (+0.8s)	3500	3500	256	66	213	14	0	293
44261	28316s (+0.4s)	1176	1176	64	28	108	5	0	141
44262	28317s (+0.5s)	1628	1628	128	41	121	7	0	169
44263	28317s (+0.5s)	1752	1752	128	52	118	9	0	179
44264	28318s (+0.5s)	1796	1796	128	33	129	0	8	170
44265	28318s (+0.3s)	956	956	64	27	84	0	4	115
44266	28319s (+0.6s)	1900	1900	128	48	138	0	7	193
44267	28320s (+0.7s)	3180	3180	256	53	191	0	15	259
44268	28320s (+0.8s)	3628	3628	256	69	221	0	18	308
44269	28321s (+0.6s)	2220	2220	128	44	150	0	7	201
44270	28322s (+0.6s)	1984	1984	128	35	162	0	12	209
44271	28322s (+0.7s)	2424	2424	128	52	167	0	13	232
44272	28323s (+0.4s)	1504	1504	128	35	118	0	6	159
44273	28323s (+0.5s)	1660	1660	128	32	134	0	11	177
44274	28324s (+0.4s)	1556	1556	128	32	112	0	9	153
44275	28324s (+0.7s)	3224	3224	256	54	209	0	7	270
44276	28325s (+0.9s)	3848	3848	256	70	240	0	13	323
44277	28326s (+0.4s)	1512	1512	128	35	104	0	6	145
44278	28326s (+0.4s)	1536	1536	128	42	105	5	1	153
44279	28327s (+0.5s)	1604	1604	128	34	126	8	0	168
44280	28328s (+1.0s)	4220	4220	256	95	232	19	0	346
44281	28328s (+0.4s)	1020	1020	64	27	93	4	0	124
44282	28328s (+0.5s)	1808	1808	128	44	133	10	0	187
44283	28330s (+1.2s)	6252	6252	512	108	309	20	0	437
44284	28331s (+0.8s)	3336	3336	256	66	203	9	0	278
44285	28331s (+0.9s)	3624	3624	256	73	221	14	0	308
44286	28332s (+0.6s)	2064	2064	128	66	133	8	0	207
44287	28332s (+0.4s)	1300	1300	128	39	95	6	0	140
44288	28333s (+0.4s)	1328	1328	128	30	103	0	5	138
44289	28333s (+0.4s)	1160	1160	64	31	99	0	5	135
44290	28334s (+0.6s)	2416	2416	256	41	155	0	12	208
44291	28334s (+0.5s)	2140	2140	256	54	123	0	6	183
44292	28335s (+1.0s)	4120	4120	256	78	245	0	14	337
44293	28336s (+0.6s)	2536	2536	256	37	167	0	11	215
44294	28337s (+0.6s)	2708	2708	256	50	167	0	12	229
44295	28337s (+0.6s)	2448	2448	256	35	166	0	7	208
44296	28338s (+0.8s)	3616	3616	256	62	214	0	16	292
44297	28339s (+0.5s)	1844	1844	128	30	135	0	15	180
44298	28339s (+0.8s)	3212	3212	256	71	181	0	14	266
44299	28340s (+0.4s)	1244	1244	128	26	104	0	7	137
Episode	Time	Reward	Score	Highest	L	U	R	D	Steps
44300	28340s (+0.4s)	1136	1136	64	35	96	0	7	138
44301	28341s (+1.1s)	5744	5744	512	86	297	0	19	402
44302	28342s (+0.9s)	3524	3524	256	55	231	0	11	297
44303	28343s (+0.7s)	2844	2844	256	43	198	0	8	249
44304	28343s (+0.5s)	1812	1812	128	40	138	0	6	184
44305	28344s (+0.7s)	3132	3132	256	44	204	0	8	256
44306	28345s (+0.8s)	3212	3212	256	63	195	0	8	266
44307	28345s (+0.5s)	1568	1568	128	33	127	0	6	166
44308	28346s (+0.9s)	3876	3876	256	60	249	0	11	320
44309	28347s (+0.7s)	2944	2944	256	55	183	0	19	257
44310	28348s (+0.6s)	2376	2376	256	36	152	0	8	196
44311	28348s (+0.9s)	3792	3792	256	53	249	0	13	315
44312	28349s (+0.4s)	1284	1284	128	19	109	0	3	131
44313	28350s (+0.9s)	3976	3976	256	56	255	0	17	328
44314	28351s (+0.8s)	3328	3328	256	64	202	0	12	278
44315	28351s (+0.5s)	2092	2092	256	38	135	0	4	177
44316	28351s (+0.4s)	1348	1348	128	27	106	0	7	140
44317	28352s (+0.6s)	1932	1932	128	36	157	0	8	201
44318	28353s (+0.9s)	3972	3972	256	59	254	0	15	328
44319	28353s (+0.2s)	648	648	64	21	58	0	6	85
44320	28354s (+0.8s)	3468	3468	256	66	197	12	0	275
44321	28355s (+0.6s)	2664	2664	256	49	165	12	0	226
44322	28355s (+0.4s)	1400	1400	128	42	98	6	0	146
44323	28356s (+0.7s)	3252	3252	256	76	171	22	0	269
44324	28356s (+0.3s)	756	756	64	25	71	5	0	101
44325	28357s (+0.5s)	1940	1940	128	57	129	6	0	192
44326	28357s (+0.4s)	1588	1588	128	37	109	8	0	154
44327	28358s (+0.8s)	3548	3548	256	70	210	14	0	294
44328	28359s (+0.7s)	2808	2808	256	60	173	11	0	244
44329	28359s (+0.6s)	1932	1932	128	55	138	8	0	201
44330	28360s (+0.5s)	1628	1628	128	43	126	4	1	174
44331	28360s (+0.6s)	2212	2212	256	37	154	4	0	195
44332	28361s (+0.3s)	716	716	64	15	76	5	0	96
44333	28361s (+0.4s)	1268	1268	128	28	103	3	1	135
44334	28362s (+0.8s)	3240	3240	256	49	212	11	0	272
44335	28362s (+0.6s)	1940	1940	128	46	150	7	0	203
44336	28364s (+1.3s)	6376	6376	512	113	316	19	0	448
44337	28364s (+0.4s)	1352	1352	128	40	101	8	0	149
44338	28365s (+0.4s)	1308	1308	64	36	102	8	1	147
44339	28365s (+0.4s)	1192	1192	128	28	100	3	0	131
44340	28366s (+0.8s)	3080	3080	256	55	197	12	0	264
44341	28366s (+0.6s)	1948	1948	128	54	140	11	0	205
44342	28367s (+0.4s)	1516	1516	128	36	109	8	0	153
44343	28367s (+0.7s)	2920	2920	256	68	174	14	0	256
44344	28368s (+1.1s)	5264	5264	512	90	264	21	0	375
44345	28369s (+0.7s)	2940	2940	256	60	179	8	0	247
44346	28370s (+0.9s)	4384	4384	256	99	225	14	1	339
44347	28371s (+0.9s)	4008	4008	256	71	248	12	0	331
44348	28371s (+0.2s)	620	620	64	25	53	7	0	85
44349	28372s (+0.7s)	2588	2588	128	64	161	17	0	242
44350	28373s (+0.7s)	2948	2948	256	59	183	10	0	252
44351	28374s (+0.8s)	3472	3472	256	88	184	19	1	292
44352	28374s (+0.6s)	2604	2604	256	54	165	7	0	226
44353	28375s (+0.4s)	1352	1352	128	33	105	5	0	143
44354	28376s (+0.9s)	3880	3880	256	84	222	14	0	320
44355	28376s (+0.4s)	1096	1096	64	30	100	3	0	133
44356	28377s (+1.2s)	5888	5888	512	103	291	19	0	413
44357	28378s (+0.6s)	1816	1816	128	44	139	6	0	189
44358	28378s (+0.6s)	2240	2240	128	49	152	14	0	215
44359	28379s (+0.5s)	1636	1636	128	43	111	11	0	165
44360	28379s (+0.4s)	1188	1188	64	36	99	5	0	140
44361	28380s (+0.8s)	3216	3216	256	74	190	11	0	275
44362	28381s (+0.6s)	2428	2428	256	56	143	6	0	205
44363	28381s (+0.5s)	1604	1604	128	39	123	6	0	168
44364	28382s (+0.7s)	2472	2472	128	63	162	10	1	236
44365	28383s (+0.8s)	3404	3404	256	63	207	0	16	286
44366	28383s (+0.5s)	1756	1756	128	29	143	0	7	179
44367	28384s (+0.8s)	3364	3364	256	68	205	14	0	287
44368	28384s (+0.4s)	1540	1540	128	42	115	6	0	163
44369	28385s (+0.3s)	976	976	64	31	79	4	0	114
44370	28385s (+0.8s)	3488	3488	256	76	197	17	1	291
44371	28386s (+0.9s)	3788	3788	256	83	214	21	0	318
44372	28387s (+0.7s)	2916	2916	256	66	182	7	0	255
44373	28388s (+0.8s)	3564	3564	256	88	192	18	0	298
44374	28389s (+1.0s)	4120	4120	256	94	227	17	0	338
44375	28390s (+0.6s)	2440	2440	256	44	153	10	0	207
44376	28390s (+0.5s)	1520	1520	128	37	119	6	1	163
44377	28390s (+0.5s)	1636	1636	128	47	110	7	1	165
44378	28391s (+0.4s)	1284	1284	128	32	93	7	1	133
44379	28391s (+0.4s)	1416	1416	128	28	108	7	0	143
44380	28391s (+0.1s)	252	252	32	13	32	0	5	50
44381	28392s (+0.5s)	2328	2328	256	33	157	0	5	195
44382	28393s (+1.0s)	4256	4256	256	79	246	17	1	343
44383	28394s (+1.4s)	6552	6552	512	139	306	27	1	473
44384	28395s (+0.4s)	1128	1128	128	22	97	3	0	122
44385	28395s (+0.2s)	588	588	64	17	59	0	3	79
44386	28396s (+0.8s)	3256	3256	256	49	218	0	7	274
44387	28397s (+0.8s)	3648	3648	256	60	221	0	12	293
44388	28397s (+0.8s)	3568	3568	256	64	210	0	17	291
44389	28398s (+0.8s)	3232	3232	256	59	198	0	13	270
44390	28399s (+1.0s)	5208	5208	512	74	267	1	20	362
44391	28400s (+0.5s)	1712	1712	128	27	147	0	5	179
44392	28400s (+0.6s)	2592	2592	256	47	169	0	7	223
44393	28401s (+0.5s)	1944	1944	128	39	134	6	1	180
44394	28402s (+0.6s)	2512	2512	128	54	172	9	0	235
44395	28402s (+0.6s)	2808	2808	256	51	169	11	0	231
44396	28403s (+0.4s)	1488	1488	128	38	113	5	0	156
44397	28404s (+1.0s)	5236	5236	512	78	269	20	0	367
44398	28404s (+0.6s)	1988	1988	128	52	148	10	0	210
44399	28405s (+0.7s)	3160	3160	256	57	197	11	0	265
Episode	Time	Reward	Score	Highest	L	U	R	D	Steps
44400	28406s (+0.8s)	3328	3328	256	75	192	11	0	278
44401	28407s (+0.8s)	3232	3232	256	74	182	15	0	271
44402	28407s (+0.4s)	1348	1348	128	19	121	2	0	142
44403	28408s (+0.5s)	1840	1840	128	42	136	10	0	188
44404	28408s (+0.5s)	1580	1580	128	38	120	5	0	163
44405	28409s (+0.7s)	3100	3100	256	45	194	0	10	249
44406	28409s (+0.7s)	2812	2812	256	65	167	0	15	247
44407	28410s (+0.5s)	1844	1844	128	53	128	8	0	189
44408	28411s (+1.1s)	5464	5464	512	89	274	17	1	381
44409	28411s (+0.3s)	816	816	64	33	65	7	0	105
44410	28412s (+0.4s)	1328	1328	128	34	104	0	2	140
44411	28412s (+0.4s)	1012	1012	64	24	94	0	5	123
44412	28413s (+0.5s)	1780	1780	128	46	128	0	7	181
44413	28413s (+0.8s)	3388	3388	256	52	220	0	12	284
44414	28414s (+0.8s)	3352	3352	256	49	209	0	16	274
44415	28415s (+0.6s)	2700	2700	256	48	169	0	11	228
44416	28415s (+0.5s)	1760	1760	128	30	145	0	4	179
44417	28416s (+0.8s)	3228	3228	256	53	208	0	10	271
44418	28417s (+0.9s)	3796	3796	256	60	237	0	18	315
44419	28417s (+0.4s)	1096	1096	64	32	82	0	14	128
44420	28418s (+0.9s)	3848	3848	256	62	235	0	16	313
44421	28419s (+0.5s)	1748	1748	128	41	125	0	11	177
44422	28419s (+0.5s)	1796	1796	128	55	117	12	0	184
44423	28420s (+0.3s)	964	964	64	26	92	4	0	122
44424	28421s (+0.8s)	3516	3516	256	70	202	18	1	291
44425	28421s (+0.3s)	816	816	64	30	72	9	0	111
44426	28421s (+0.6s)	2436	2436	256	44	154	10	0	208
44427	28422s (+0.4s)	1484	1484	128	37	110	7	0	154
44428	28422s (+0.5s)	1660	1660	128	45	125	7	0	177
44429	28423s (+0.8s)	3420	3420	256	65	206	14	1	286
44430	28424s (+0.5s)	1444	1444	64	38	116	6	0	160
44431	28424s (+0.7s)	2984	2984	256	59	200	8	0	267
44432	28425s (+0.4s)	1328	1328	128	52	83	12	0	147
44433	28426s (+1.0s)	5124	5124	512	106	220	23	0	349
44434	28427s (+1.0s)	4080	4080	256	84	236	17	0	337
44435	28428s (+0.7s)	2516	2516	128	66	163	10	0	239
44436	28428s (+0.9s)	3876	3876	256	97	213	18	0	328
44437	28429s (+1.0s)	4488	4488	256	90	255	22	1	368
44438	28430s (+0.6s)	1984	1984	128	41	152	6	0	199
44439	28431s (+0.6s)	2460	2460	256	56	144	11	0	211
44440	28431s (+0.5s)	1460	1460	64	41	114	9	0	164
44441	28432s (+0.5s)	2248	2248	256	46	137	5	0	188
44442	28432s (+0.6s)	1904	1904	128	52	131	11	0	194
44443	28433s (+0.7s)	2920	2920	256	56	175	10	0	241
44444	28433s (+0.4s)	1432	1432	128	34	105	8	0	147
44445	28434s (+0.4s)	1484	1484	128	30	117	8	0	155
44446	28435s (+1.0s)	4068	4068	256	85	233	21	0	339
44447	28436s (+1.1s)	5436	5436	512	97	264	17	0	378
44448	28437s (+0.7s)	2612	2612	256	44	176	8	0	228
44449	28437s (+0.6s)	1936	1936	128	45	137	14	0	196
44450	28438s (+0.7s)	2328	2328	128	64	151	13	1	229
44451	28438s (+0.5s)	1552	1552	128	39	113	7	0	159
44452	28439s (+0.8s)	3400	3400	256	86	194	16	0	296
44453	28440s (+0.7s)	2900	2900	256	56	178	17	0	251
44454	28441s (+0.9s)	3656	3656	256	84	212	16	0	312
44455	28442s (+0.8s)	3468	3468	256	75	205	12	0	292
44456	28442s (+0.7s)	2912	2912	256	61	178	15	0	254
44457	28443s (+0.7s)	2528	2528	128	60	165	13	0	238
44458	28444s (+0.9s)	3552	3552	256	84	202	16	0	302
44459	28445s (+0.8s)	3508	3508	256	81	204	11	0	296
44460	28445s (+0.8s)	3476	3476	256	69	204	15	0	288
44461	28446s (+0.5s)	2176	2176	256	52	120	6	0	178
44462	28447s (+0.8s)	3508	3508	256	75	198	13	0	286
44463	28447s (+0.7s)	2760	2760	256	51	178	8	0	237
44464	28448s (+0.5s)	1536	1536	128	43	113	7	0	163
44465	28449s (+0.9s)	3620	3620	256	85	210	13	0	308
44466	28449s (+0.6s)	2612	2612	256	48	163	8	0	219
44467	28450s (+0.2s)	616	616	64	25	51	6	1	83
44468	28450s (+0.7s)	3020	3020	256	53	179	9	0	241
44469	28451s (+0.7s)	2952	2952	256	64	171	11	0	246
44470	28452s (+0.9s)	3908	3908	256	84	230	13	0	327
44471	28453s (+0.9s)	3596	3596	256	102	180	19	0	301
44472	28454s (+0.7s)	2976	2976	256	66	172	13	0	251
44473	28454s (+0.4s)	1424	1424	128	39	102	6	0	147
44474	28455s (+0.4s)	1504	1504	128	38	116	6	0	160
44475	28455s (+0.4s)	1324	1324	128	25	109	3	0	137
44476	28456s (+0.7s)	3044	3044	256	66	175	10	0	251
44477	28456s (+0.4s)	1524	1524	128	36	120	4	0	160
44478	28457s (+0.8s)	3492	3492	256	81	188	23	0	292
44479	28458s (+1.0s)	5292	5292	512	97	251	16	0	364
44480	28459s (+0.8s)	3376	3376	256	66	213	11	0	290
44481	28459s (+0.5s)	1796	1796	128	53	124	7	0	184
44482	28460s (+0.6s)	2000	2000	128	46	134	12	1	193
44483	28460s (+0.4s)	1500	1500	128	41	100	8	0	149
44484	28461s (+0.6s)	2308	2308	256	53	139	9	0	201
44485	28462s (+0.8s)	3304	3304	256	69	193	15	0	277
44486	28462s (+0.4s)	1348	1348	128	38	83	11	1	133
44487	28462s (+0.4s)	1224	1224	128	30	87	8	0	125
44488	28463s (+1.0s)	4216	4216	256	85	240	19	0	344
44489	28464s (+0.5s)	1600	1600	128	46	116	5	0	167
44490	28464s (+0.5s)	1548	1548	128	43	120	3	0	166
44491	28465s (+0.5s)	1624	1624	128	46	115	11	0	172
44492	28465s (+0.5s)	1640	1640	128	43	122	8	0	173
44493	28466s (+0.4s)	1500	1500	128	35	119	5	0	159
44494	28466s (+0.5s)	1672	1672	128	42	121	7	0	170
44495	28467s (+0.6s)	2588	2588	256	55	161	10	0	226
44496	28468s (+0.6s)	2140	2140	128	56	153	11	1	221
44497	28468s (+0.5s)	1540	1540	128	32	124	7	0	163
44498	28469s (+0.7s)	3016	3016	256	81	152	12	1	246
44499	28470s (+0.8s)	3484	3484	256	71	205	19	0	295
Episode	Time	Reward	Score	Highest	L	U	R	D	Steps
44500	28470s (+0.7s)	2644	2644	256	41	183	0	7	231
44501	28471s (+0.5s)	1584	1584	128	37	122	0	5	164
44502	28471s (+0.4s)	1384	1384	128	25	117	0	5	147
44503	28472s (+0.3s)	976	976	64	31	86	6	0	123
44504	28472s (+0.6s)	2324	2324	128	64	151	6	0	221
44505	28473s (+0.5s)	1624	1624	128	46	108	9	0	163
44506	28474s (+1.0s)	4320	4320	256	96	243	19	0	358
44507	28475s (+0.9s)	3636	3636	256	63	234	14	0	311
44508	28475s (+0.5s)	1904	1904	128	46	142	6	0	194
44509	28476s (+0.9s)	3980	3980	256	88	227	18	0	333
44510	28476s (+0.4s)	1332	1332	128	33	110	6	0	149
44511	28477s (+0.5s)	1804	1804	128	31	141	0	14	186
44512	28478s (+0.8s)	3168	3168	256	63	188	16	0	267
44513	28478s (+0.6s)	2700	2700	256	52	172	11	0	235
44514	28479s (+0.7s)	3000	3000	256	51	186	10	0	247
44515	28480s (+0.5s)	1804	1804	128	39	139	7	0	185
44516	28481s (+1.0s)	4032	4032	256	92	219	20	1	332
44517	28482s (+1.0s)	5152	5152	512	102	248	16	0	366
44518	28483s (+1.1s)	5228	5228	512	90	260	16	0	366
44519	28484s (+1.0s)	4252	4252	256	83	246	17	0	346
44520	28484s (+0.5s)	1832	1832	128	44	129	13	0	186
44521	28484s (+0.2s)	536	536	32	29	52	4	0	85
44522	28485s (+0.5s)	1856	1856	128	39	142	6	0	187
44523	28486s (+0.5s)	1792	1792	128	47	130	6	0	183
44524	28486s (+0.6s)	2424	2424	256	46	147	9	0	202
44525	28487s (+1.0s)	4220	4220	256	97	232	17	0	346
44526	28488s (+0.8s)	3268	3268	256	69	191	9	0	269
44527	28488s (+0.4s)	1532	1532	128	31	115	10	0	156
44528	28489s (+0.6s)	2492	2492	256	52	157	7	0	216
44529	28489s (+0.5s)	1616	1616	128	42	121	8	0	171
44530	28490s (+0.8s)	3212	3212	256	71	182	12	0	265
44531	28491s (+0.4s)	1040	1040	64	33	89	6	0	128
44532	28491s (+0.6s)	1976	1976	128	64	124	9	0	197
44533	28492s (+0.9s)	3596	3596	256	73	226	9	0	308
44534	28492s (+0.5s)	1612	1612	128	39	125	6	0	170
44535	28493s (+0.6s)	2336	2336	128	49	165	0	11	225
44536	28494s (+0.7s)	2828	2828	256	57	182	0	10	249
44537	28495s (+0.7s)	2780	2780	256	51	173	0	15	239
44538	28495s (+0.5s)	2256	2256	256	35	147	0	4	186
44539	28496s (+0.5s)	1532	1532	128	30	126	0	10	166
44540	28496s (+0.8s)	3476	3476	256	58	227	0	10	295
44541	28497s (+0.8s)	3496	3496	256	70	213	0	10	293
44542	28498s (+0.3s)	1136	1136	128	17	99	0	3	119
44543	28498s (+0.7s)	2824	2824	256	52	187	0	10	249
44544	28499s (+0.6s)	2452	2452	128	46	176	0	9	231
44545	28499s (+0.4s)	1352	1352	128	25	108	0	7	140
44546	28500s (+0.6s)	2556	2556	256	47	156	0	14	217
44547	28501s (+0.9s)	3972	3972	256	69	239	0	19	327
44548	28501s (+0.4s)	1116	1116	64	25	100	0	7	132
44549	28501s (+0.2s)	392	392	32	14	43	0	5	62
44550	28503s (+1.1s)	5488	5488	512	90	276	21	0	387
44551	28503s (+0.4s)	1292	1292	128	27	104	7	0	138
44552	28504s (+0.7s)	3164	3164	256	65	188	11	0	264
44553	28504s (+0.6s)	1940	1940	128	55	135	8	0	198
44554	28505s (+0.5s)	1604	1604	128	40	118	9	1	168
44555	28505s (+0.6s)	1924	1924	128	49	143	4	0	196
44556	28506s (+0.6s)	2100	2100	128	59	130	11	1	201
44557	28507s (+0.7s)	3176	3176	256	69	185	8	1	263
44558	28508s (+0.9s)	3844	3844	256	77	224	11	0	312
44559	28508s (+0.5s)	1752	1752	128	46	123	9	0	178
44560	28509s (+0.6s)	2248	2248	128	54	144	13	0	211
44561	28509s (+0.6s)	2060	2060	128	44	155	7	0	206
44562	28510s (+0.4s)	1452	1452	128	31	110	7	0	148
44563	28510s (+0.5s)	1980	1980	128	48	137	8	0	193
44564	28511s (+0.5s)	1724	1724	128	36	125	9	1	171
44565	28511s (+0.4s)	1184	1184	64	35	100	8	0	143
44566	28512s (+0.5s)	1676	1676	128	29	130	7	0	166
44567	28513s (+0.8s)	3472	3472	256	74	199	15	0	288
44568	28513s (+0.5s)	1720	1720	128	39	129	2	0	170
44569	28514s (+0.8s)	3420	3420	256	67	202	10	0	279
44570	28514s (+0.6s)	2620	2620	256	46	178	6	0	230
44571	28515s (+0.8s)	3316	3316	256	59	202	10	0	271
44572	28516s (+1.1s)	4632	4632	256	108	261	15	0	384
44573	28517s (+0.8s)	3348	3348	256	74	199	10	0	283
44574	28518s (+0.4s)	1252	1252	128	25	95	6	0	126
44575	28518s (+0.5s)	1764	1764	128	34	138	4	1	177
44576	28519s (+0.5s)	1900	1900	128	31	133	9	0	173
44577	28519s (+0.8s)	3524	3524	256	73	210	17	0	300
44578	28520s (+0.7s)	2876	2876	256	42	203	5	0	250
44579	28521s (+0.7s)	2836	2836	128	67	179	17	1	264
44580	28521s (+0.6s)	2500	2500	256	54	150	8	0	212
44581	28523s (+1.1s)	5640	5640	512	105	276	19	0	400
44582	28523s (+0.6s)	2380	2380	128	54	161	7	0	222
44583	28524s (+0.6s)	2100	2100	128	44	140	12	0	196
44584	28525s (+1.0s)	4236	4236	256	93	238	14	0	345
44585	28525s (+0.4s)	1452	1452	128	40	103	9	0	152
44586	28526s (+0.6s)	1964	1964	128	61	130	13	0	204
44587	28526s (+0.5s)	2060	2060	128	37	152	3	0	192
44588	28527s (+0.8s)	3492	3492	256	81	199	13	0	293
44589	28528s (+0.5s)	1852	1852	128	48	129	8	2	187
44590	28528s (+0.6s)	1912	1912	128	44	143	9	0	196
44591	28530s (+1.3s)	6604	6604	512	131	296	31	0	458
44592	28530s (+0.5s)	1712	1712	128	42	129	8	0	179
44593	28531s (+0.6s)	2420	2420	256	39	156	8	0	203
44594	28531s (+0.5s)	1824	1824	128	52	132	6	1	191
44595	28532s (+0.7s)	2896	2896	256	65	179	10	0	254
44596	28533s (+0.8s)	3236	3236	256	65	189	11	0	265
44597	28534s (+0.7s)	2844	2844	256	71	161	10	0	242
44598	28534s (+1.0s)	4184	4184	256	102	222	18	0	342
44599	28536s (+1.1s)	5480	5480	512	113	244	26	0	383
Episode	Time	Reward	Score	Highest	L	U	R	D	Steps
44600	28536s (+0.7s)	2900	2900	256	54	186	12	0	252
44601	28537s (+0.5s)	1680	1680	128	56	106	10	0	172
44602	28538s (+0.9s)	3636	3636	256	85	205	17	0	307
44603	28538s (+0.5s)	1920	1920	128	47	143	8	0	198
44604	28539s (+0.7s)	2524	2524	128	62	162	11	0	235
44605	28540s (+0.7s)	2868	2868	256	77	160	11	0	248
44606	28540s (+0.7s)	2932	2932	256	64	167	13	0	244
44607	28541s (+0.6s)	2532	2532	256	52	162	6	0	220
44608	28542s (+0.8s)	3256	3256	256	62	198	10	0	270
44609	28542s (+0.4s)	1236	1236	128	33	96	4	0	133
44610	28543s (+0.4s)	1448	1448	128	35	109	6	0	150
44611	28543s (+0.6s)	2060	2060	128	44	146	16	0	206
44612	28544s (+0.6s)	2188	2188	128	54	146	6	1	207
44613	28544s (+0.5s)	1784	1784	128	50	118	13	0	181
44614	28545s (+0.6s)	2492	2492	256	59	146	10	1	216
44615	28546s (+0.7s)	3096	3096	256	60	187	11	0	258
44616	28546s (+0.8s)	3168	3168	256	76	190	10	0	276
44617	28547s (+0.9s)	3980	3980	256	73	245	11	0	329
44618	28548s (+0.5s)	1792	1792	128	44	129	10	0	183
44619	28548s (+0.6s)	2256	2256	128	62	141	16	0	219
44620	28549s (+0.5s)	1784	1784	128	41	134	5	1	181
44621	28550s (+0.6s)	2400	2400	256	59	140	9	0	208
44622	28550s (+0.4s)	1408	1408	64	52	93	7	0	152
44623	28551s (+0.5s)	1692	1692	128	36	129	9	0	174
44624	28551s (+0.6s)	2540	2540	256	55	152	8	0	215
44625	28552s (+0.4s)	1316	1316	128	26	113	5	0	144
44626	28552s (+0.8s)	3540	3540	256	56	227	15	1	299
44627	28553s (+0.6s)	2384	2384	256	45	153	0	5	203
44628	28553s (+0.4s)	1392	1392	64	38	111	0	7	156
44629	28554s (+0.5s)	1556	1556	128	32	122	0	8	162
44630	28555s (+0.7s)	2220	2220	128	62	159	0	7	228
44631	28555s (+0.2s)	660	660	64	13	70	0	4	87
44632	28556s (+0.8s)	3256	3256	256	64	202	11	0	277
44633	28556s (+0.4s)	1344	1344	128	34	109	4	0	147
44634	28557s (+0.4s)	1372	1372	128	41	101	7	0	149
44635	28557s (+0.8s)	3360	3360	256	71	192	12	0	275
44636	28558s (+0.8s)	3500	3500	256	66	218	10	0	294
44637	28559s (+0.7s)	2912	2912	256	53	194	7	0	254
44638	28559s (+0.4s)	1228	1228	128	29	98	2	0	129
44639	28560s (+0.8s)	3220	3220	256	67	191	11	0	269
44640	28561s (+1.2s)	6000	6000	512	124	267	27	0	418
44641	28562s (+0.9s)	3996	3996	256	82	224	17	0	323
44642	28563s (+0.6s)	2360	2360	256	45	154	3	0	202
44643	28564s (+1.0s)	4328	4328	256	97	239	19	1	356
44644	28564s (+0.3s)	956	956	64	40	80	5	0	125
44645	28565s (+0.8s)	3320	3320	256	79	184	18	0	281
44646	28565s (+0.2s)	616	616	64	23	54	6	0	83
44647	28566s (+0.5s)	1812	1812	128	46	131	11	0	188
44648	28566s (+0.6s)	2416	2416	256	54	140	8	0	202
44649	28567s (+0.6s)	2364	2364	128	58	149	11	0	218
44650	28567s (+0.4s)	1456	1456	128	34	116	3	0	153
44651	28568s (+0.7s)	3152	3152	256	62	186	12	0	260
44652	28569s (+0.8s)	3544	3544	256	73	214	13	0	300
44653	28569s (+0.3s)	1172	1172	128	21	95	4	1	121
44654	28570s (+0.8s)	3256	3256	256	66	195	10	1	272
44655	28571s (+1.0s)	4340	4340	256	94	244	20	1	359
44656	28571s (+0.5s)	1504	1504	128	42	111	6	0	159
44657	28572s (+0.6s)	2352	2352	256	53	136	8	0	197
44658	28572s (+0.4s)	1420	1420	128	46	99	6	0	151
44659	28573s (+0.8s)	3212	3212	256	73	184	12	1	270
44660	28574s (+0.5s)	1816	1816	128	46	133	9	0	188
44661	28574s (+0.7s)	3048	3048	256	54	185	8	0	247
44662	28575s (+0.8s)	3292	3292	256	66	203	12	0	281
44663	28576s (+0.5s)	1564	1564	128	44	109	8	0	161
44664	28577s (+1.0s)	4004	4004	256	76	247	12	0	335
44665	28577s (+0.6s)	2104	2104	128	41	147	9	0	197
44666	28578s (+0.6s)	2444	2444	256	37	167	3	0	207
44667	28578s (+0.5s)	1868	1868	128	43	139	9	0	191
44668	28579s (+0.3s)	788	788	64	28	71	6	0	105
44669	28579s (+0.4s)	1432	1432	128	33	111	3	0	147
44670	28580s (+0.8s)	3308	3308	256	65	200	13	0	278
44671	28581s (+0.8s)	3208	3208	256	60	197	10	0	267
44672	28581s (+0.4s)	1252	1252	128	26	106	6	0	138
44673	28582s (+0.8s)	3288	3288	256	82	181	15	2	280
44674	28583s (+0.9s)	3620	3620	256	88	207	12	0	307
44675	28584s (+1.0s)	4212	4212	256	85	245	18	0	348
44676	28584s (+0.4s)	1260	1260	128	26	103	6	0	135
44677	28585s (+0.7s)	3064	3064	256	61	176	13	0	250
44678	28586s (+1.0s)	5356	5356	512	118	234	19	0	371
44679	28587s (+0.7s)	2436	2436	128	55	160	0	17	232
44680	28587s (+0.5s)	1572	1572	128	43	114	7	0	164
44681	28588s (+0.7s)	2688	2688	256	43	181	9	0	233
44682	28588s (+0.6s)	2464	2464	256	60	138	10	0	208
44683	28589s (+0.8s)	3544	3544	256	83	196	20	1	300
44684	28590s (+1.0s)	4096	4096	256	79	253	9	0	341
44685	28590s (+0.2s)	456	456	32	19	50	2	0	71
44686	28591s (+0.3s)	1124	1124	128	28	86	5	0	119
44687	28591s (+0.5s)	1864	1864	128	51	127	11	0	189
44688	28591s (+0.3s)	680	680	64	27	62	5	0	94
44689	28592s (+0.4s)	1404	1404	128	33	107	4	0	144
44690	28592s (+0.5s)	1900	1900	128	30	154	0	10	194
44691	28593s (+0.7s)	2980	2980	256	55	192	0	9	256
44692	28594s (+0.7s)	2964	2964	256	55	190	0	12	257
44693	28595s (+0.7s)	2824	2824	256	38	198	0	12	248
44694	28596s (+0.9s)	3824	3824	256	62	247	0	8	317
44695	28596s (+0.9s)	3736	3736	256	64	228	0	14	306
44696	28598s (+1.1s)	5648	5648	512	97	278	20	0	395
44697	28598s (+0.4s)	1336	1336	128	24	108	7	0	139
44698	28599s (+0.6s)	2184	2184	128	51	148	6	1	206
44699	28599s (+0.4s)	1372	1372	128	35	103	6	0	144
Episode	Time	Reward	Score	Highest	L	U	R	D	Steps
44700	28599s (+0.4s)	1480	1480	128	36	115	4	0	155
44701	28600s (+0.9s)	3988	3988	256	88	224	19	0	331
44702	28601s (+0.5s)	1588	1588	128	41	115	8	0	164
44703	28601s (+0.5s)	1608	1608	128	36	123	0	10	169
44704	28602s (+0.9s)	3548	3548	256	63	219	0	19	301
44705	28603s (+0.8s)	3476	3476	256	63	220	0	12	295
44706	28604s (+0.7s)	2608	2608	128	60	175	11	0	246
44707	28604s (+0.6s)	2432	2432	256	51	151	10	0	212
44708	28605s (+0.8s)	3484	3484	256	91	181	15	0	287
44709	28606s (+0.5s)	1776	1776	128	41	128	9	0	178
44710	28607s (+0.8s)	3356	3356	256	66	208	11	0	285
44711	28607s (+0.3s)	976	976	64	30	78	6	0	114
44712	28608s (+0.8s)	3236	3236	256	74	183	15	1	273
44713	28608s (+0.7s)	2608	2608	256	62	155	11	0	228
44714	28609s (+0.6s)	1920	1920	128	45	145	9	0	199
44715	28610s (+0.9s)	4072	4072	256	87	230	23	0	340
44716	28611s (+0.7s)	2744	2744	256	60	166	7	0	233
44717	28611s (+0.6s)	2104	2104	128	48	156	9	0	213
44718	28612s (+0.7s)	2960	2960	256	66	171	10	0	247
44719	28613s (+1.3s)	6108	6108	512	125	287	28	0	440
44720	28614s (+0.9s)	3780	3780	256	75	225	11	0	311
44721	28614s (+0.3s)	876	876	64	26	70	8	1	105
44722	28615s (+0.8s)	3344	3344	256	71	199	12	0	282
44723	28616s (+0.7s)	2956	2956	128	72	177	16	1	266
44724	28616s (+0.5s)	1632	1632	128	32	135	4	1	172
44725	28617s (+0.4s)	1468	1468	128	43	101	7	0	151
44726	28618s (+0.7s)	3112	3112	256	71	173	13	0	257
44727	28618s (+0.6s)	1876	1876	128	52	134	6	0	192
44728	28619s (+0.5s)	1548	1548	128	37	115	8	0	160
44729	28619s (+0.4s)	1416	1416	128	37	102	7	0	146
44730	28620s (+0.8s)	3456	3456	256	56	225	0	9	290
44731	28621s (+0.7s)	3056	3056	256	45	190	0	14	249
44732	28621s (+0.8s)	3196	3196	256	60	198	0	10	268
44733	28622s (+0.8s)	3408	3408	256	53	213	0	17	283
44734	28623s (+0.5s)	1844	1844	128	45	138	0	7	190
44735	28623s (+0.3s)	872	872	64	26	76	0	3	105
44736	28624s (+0.5s)	1776	1776	128	37	138	0	6	181
44737	28625s (+1.2s)	5680	5680	512	89	304	0	20	413
44738	28625s (+0.6s)	2616	2616	256	47	159	0	13	219
44739	28626s (+0.6s)	2228	2228	128	36	168	0	8	212
44740	28627s (+0.6s)	2228	2228	128	43	161	0	8	212
44741	28627s (+0.5s)	1584	1584	128	31	138	0	5	174
44742	28627s (+0.3s)	1004	1004	64	21	94	0	5	120
44743	28628s (+0.6s)	1928	1928	128	47	143	10	0	200
44744	28629s (+0.9s)	3600	3600	256	78	207	17	0	302
44745	28629s (+0.5s)	1560	1560	128	36	115	10	0	161
44746	28630s (+0.5s)	1732	1732	128	44	129	7	0	180
44747	28631s (+0.9s)	4720	4720	512	74	235	16	0	325
44748	28631s (+0.4s)	1332	1332	128	28	114	6	0	148
44749	28632s (+0.7s)	2848	2848	256	60	174	11	0	245
44750	28632s (+0.4s)	1380	1380	128	35	107	3	0	145
44751	28633s (+0.2s)	600	600	64	22	58	4	0	84
44752	28633s (+0.5s)	1636	1636	128	31	129	6	0	166
44753	28634s (+0.5s)	1752	1752	128	42	128	7	1	178
44754	28634s (+0.8s)	3384	3384	256	87	180	15	0	282
44755	28636s (+1.3s)	6220	6220	512	111	308	22	0	441
44756	28637s (+1.1s)	5556	5556	512	103	274	15	0	392
44757	28637s (+0.4s)	1332	1332	128	27	107	4	0	138
44758	28638s (+0.6s)	2492	2492	256	60	143	12	0	215
44759	28638s (+0.4s)	1052	1052	64	35	86	6	0	127
44760	28639s (+1.0s)	4308	4308	256	86	249	20	0	355
44761	28640s (+0.7s)	3024	3024	256	70	165	8	1	244
44762	28641s (+0.7s)	2844	2844	256	66	168	11	0	245
44763	28641s (+0.7s)	2752	2752	256	43	177	0	12	232
44764	28642s (+0.7s)	2792	2792	256	52	182	0	7	241
44765	28642s (+0.3s)	1124	1124	128	19	98	0	2	119
44766	28643s (+0.5s)	1712	1712	128	31	136	0	6	173
44767	28643s (+0.5s)	1644	1644	128	45	109	0	9	163
44768	28644s (+0.7s)	2868	2868	256	63	174	12	0	249
44769	28644s (+0.5s)	1632	1632	128	29	132	4	0	165
44770	28645s (+0.9s)	4040	4040	256	77	238	17	0	332
44771	28646s (+0.4s)	1360	1360	128	39	104	8	0	151
44772	28646s (+0.5s)	1804	1804	128	50	130	6	0	186
44773	28647s (+0.7s)	2496	2496	128	66	157	12	0	235
44774	28648s (+0.6s)	2120	2120	128	54	145	10	0	209
44775	28648s (+0.4s)	1296	1296	128	29	97	4	0	130
44776	28648s (+0.5s)	1844	1844	128	38	141	8	1	188
44777	28649s (+0.6s)	1864	1864	128	51	142	3	0	196
44778	28649s (+0.3s)	700	700	64	14	73	4	1	92
44779	28650s (+0.8s)	3284	3284	256	66	194	11	1	272
44780	28651s (+0.5s)	1812	1812	128	51	124	12	0	187
44781	28651s (+0.5s)	1812	1812	128	55	121	7	0	183
44782	28652s (+0.7s)	2716	2716	256	54	172	6	0	232
44783	28652s (+0.3s)	776	776	64	29	68	4	0	101
44784	28652s (+0.4s)	1024	1024	64	26	95	0	4	125
44785	28653s (+0.3s)	772	772	64	19	77	0	6	102
44786	28653s (+0.7s)	3244	3244	256	72	183	0	15	270
44787	28654s (+0.3s)	1096	1096	128	30	79	0	7	116
44788	28655s (+0.9s)	4256	4256	256	68	240	0	21	329
44789	28656s (+1.2s)	5868	5868	512	105	299	17	0	421
44790	28656s (+0.5s)	2160	2160	256	43	131	13	0	187
44791	28657s (+0.5s)	1812	1812	128	39	142	8	0	189
44792	28658s (+0.6s)	2216	2216	128	57	139	13	0	209
44793	28658s (+0.6s)	2260	2260	128	57	146	6	1	210
44794	28659s (+0.6s)	2676	2676	256	48	161	0	14	223
44795	28660s (+0.9s)	3972	3972	256	67	241	0	19	327
44796	28661s (+0.8s)	3368	3368	256	76	186	15	0	277
44797	28661s (+0.3s)	796	796	64	22	79	5	1	107
44798	28661s (+0.2s)	644	644	64	16	67	0	1	84
44799	28662s (+0.4s)	1140	1140	64	29	99	0	9	137
Episode	Time	Reward	Score	Highest	L	U	R	D	Steps
44800	28662s (+0.9s)	3552	3552	256	76	208	13	0	297
44801	28664s (+1.4s)	6836	6836	512	163	304	23	1	491
44802	28665s (+0.7s)	3188	3188	256	78	174	13	0	265
44803	28665s (+0.5s)	1796	1796	128	43	133	8	0	184
44804	28666s (+0.8s)	3356	3356	256	65	207	13	0	285
44805	28667s (+0.7s)	2876	2876	256	64	174	12	1	251
44806	28667s (+0.6s)	2260	2260	128	62	154	7	0	223
44807	28668s (+0.3s)	980	980	64	28	83	8	0	119
44808	28668s (+0.6s)	1904	1904	128	38	148	8	0	194
44809	28669s (+0.6s)	2552	2552	256	37	180	0	6	223
44810	28670s (+0.8s)	3492	3492	256	77	204	0	11	292
44811	28671s (+0.9s)	3792	3792	256	76	217	0	15	308
44812	28671s (+0.8s)	3288	3288	256	52	216	0	13	281
44813	28672s (+0.5s)	1808	1808	128	35	141	0	8	184
44814	28672s (+0.3s)	856	856	64	26	76	0	8	110
44815	28673s (+0.6s)	2544	2544	256	47	163	0	8	218
44816	28674s (+0.8s)	3352	3352	256	55	216	0	13	284
44817	28674s (+0.2s)	552	552	32	23	53	0	6	82
44818	28674s (+0.5s)	1684	1684	128	33	126	7	1	167
44819	28675s (+0.5s)	1828	1828	128	47	131	10	0	188
44820	28676s (+0.8s)	3516	3516	256	75	211	11	1	298
44821	28676s (+0.6s)	2112	2112	128	51	139	9	0	199
44822	28677s (+0.6s)	2536	2536	256	51	158	11	0	220
44823	28678s (+0.7s)	2764	2764	128	80	162	15	0	257
44824	28679s (+0.8s)	3752	3752	256	72	225	8	0	305
44825	28679s (+0.5s)	1640	1640	128	40	118	5	0	163
44826	28679s (+0.4s)	1180	1180	128	26	94	6	0	126
44827	28680s (+0.4s)	1468	1468	128	29	115	8	0	152
44828	28681s (+0.7s)	2908	2908	256	54	170	12	0	236
44829	28681s (+0.8s)	3332	3332	256	65	201	15	0	281
44830	28682s (+0.8s)	3504	3504	256	65	212	18	0	295
44831	28683s (+0.5s)	1632	1632	128	36	133	6	0	175
44832	28683s (+0.5s)	1900	1900	128	48	136	9	0	193
44833	28684s (+0.7s)	2872	2872	256	77	161	11	0	249
44834	28684s (+0.5s)	1704	1704	128	43	126	5	0	174
44835	28685s (+0.5s)	1616	1616	128	40	118	5	0	163
44836	28685s (+0.4s)	1192	1192	64	34	97	7	0	138
44837	28686s (+0.7s)	3128	3128	256	58	190	13	0	261
44838	28687s (+0.6s)	2784	2784	256	44	171	0	7	222
44839	28687s (+0.5s)	1812	1812	128	45	135	0	8	188
44840	28688s (+0.3s)	684	684	64	23	64	0	2	89
44841	28688s (+0.9s)	4012	4012	256	50	271	0	15	336
44842	28689s (+0.8s)	3236	3236	256	58	203	0	11	272
44843	28690s (+0.6s)	1944	1944	128	58	140	6	0	204
44844	28690s (+0.5s)	1668	1668	128	39	123	10	0	172
44845	28691s (+0.7s)	2784	2784	256	76	150	13	0	239
44846	28692s (+0.5s)	1512	1512	128	43	113	5	0	161
44847	28692s (+0.9s)	4748	4748	512	79	232	20	0	331
44848	28693s (+0.8s)	3760	3760	256	75	221	20	0	316
44849	28694s (+0.3s)	860	860	64	24	83	4	0	111
44850	28694s (+0.8s)	3584	3584	256	75	217	13	0	305
44851	28695s (+0.2s)	604	604	64	13	64	2	0	79
44852	28695s (+0.5s)	1612	1612	128	33	117	10	0	160
44853	28696s (+0.6s)	2488	2488	256	55	141	11	1	208
44854	28696s (+0.4s)	1452	1452	128	44	95	7	1	147
44855	28697s (+0.7s)	2936	2936	256	63	169	16	1	249
44856	28698s (+0.9s)	3692	3692	256	77	216	16	0	309
44857	28698s (+0.4s)	1372	1372	128	30	103	10	0	143
44858	28699s (+1.2s)	6044	6044	512	124	283	27	0	434
44859	28700s (+0.8s)	3460	3460	256	78	200	11	0	289
44860	28701s (+0.4s)	1408	1408	128	26	113	0	9	148
44861	28702s (+1.1s)	5016	5016	256	75	289	0	18	382
44862	28703s (+0.8s)	3476	3476	256	59	217	0	13	289
44863	28703s (+0.5s)	1804	1804	128	28	152	0	3	183
44864	28704s (+0.5s)	1624	1624	128	28	131	0	5	164
44865	28704s (+0.9s)	3796	3796	256	56	248	0	11	315
44866	28705s (+0.5s)	1584	1584	128	33	119	7	0	159
44867	28705s (+0.5s)	1792	1792	128	45	127	11	0	183
44868	28706s (+0.5s)	1828	1828	128	39	136	7	0	182
44869	28707s (+0.9s)	3572	3572	256	78	214	15	0	307
44870	28707s (+0.4s)	1328	1328	128	32	100	6	0	138
44871	28708s (+0.8s)	3228	3228	256	70	191	9	0	270
44872	28709s (+0.5s)	1772	1772	128	54	112	11	1	178
44873	28709s (+0.8s)	2852	2852	128	72	173	19	0	264
44874	28710s (+0.5s)	1836	1836	128	40	139	5	0	184
44875	28710s (+0.5s)	1892	1892	128	42	146	4	0	192
44876	28711s (+0.4s)	1416	1416	128	38	104	6	0	148
44877	28711s (+0.6s)	2192	2192	128	67	129	8	1	205
44878	28712s (+0.5s)	1536	1536	128	40	109	13	0	162
44879	28713s (+0.7s)	2948	2948	256	64	192	7	0	263
44880	28713s (+0.7s)	2608	2608	128	71	166	10	0	247
44881	28714s (+0.7s)	2992	2992	256	67	181	14	1	263
44882	28715s (+0.5s)	2192	2192	256	46	137	6	0	189
44883	28715s (+0.7s)	2632	2632	128	72	149	17	0	238
44884	28716s (+0.9s)	4160	4160	256	81	249	12	0	342
44885	28717s (+0.4s)	1308	1308	128	33	105	5	0	143
44886	28717s (+0.5s)	1496	1496	128	27	127	0	4	158
44887	28718s (+0.7s)	2784	2784	256	55	171	0	13	239
44888	28718s (+0.5s)	1500	1500	128	37	114	7	0	158
44889	28719s (+0.8s)	3660	3660	256	75	211	12	0	298
44890	28720s (+0.6s)	2192	2192	128	53	142	9	0	204
44891	28721s (+1.0s)	4244	4244	256	89	238	18	0	345
44892	28721s (+0.5s)	1604	1604	128	49	109	10	0	168
44893	28722s (+0.4s)	1460	1460	128	37	108	5	0	150
44894	28723s (+1.0s)	4140	4140	256	84	232	22	0	338
44895	28723s (+0.3s)	1004	1004	64	29	83	8	0	120
44896	28724s (+0.9s)	4032	4032	256	89	220	21	0	330
44897	28725s (+0.8s)	3232	3232	256	81	177	12	0	270
44898	28726s (+1.0s)	5032	5032	512	76	255	0	21	352
44899	28726s (+0.3s)	592	592	32	21	61	0	6	88
Episode	Time	Reward	Score	Highest	L	U	R	D	Steps
44900	28727s (+0.7s)	2828	2828	256	70	157	12	0	239
44901	28728s (+1.0s)	4064	4064	256	101	220	17	0	338
44902	28728s (+0.5s)	1692	1692	128	39	130	6	0	175
44903	28729s (+0.9s)	4848	4848	512	73	231	11	0	315
44904	28729s (+0.4s)	1396	1396	128	38	102	9	0	149
44905	28730s (+0.7s)	3172	3172	256	75	173	19	0	267
44906	28731s (+0.8s)	3356	3356	256	58	216	12	0	286
44907	28732s (+0.6s)	2560	2560	256	53	153	14	0	220
44908	28732s (+0.7s)	2980	2980	256	64	184	11	1	260
44909	28733s (+0.8s)	3256	3256	256	72	192	8	0	272
44910	28734s (+0.9s)	3880	3880	256	89	214	22	0	325
44911	28735s (+0.5s)	2076	2076	256	41	124	11	0	176
44912	28736s (+0.9s)	3984	3984	256	83	229	18	0	330
44913	28736s (+0.3s)	1012	1012	64	39	78	4	1	122
44914	28736s (+0.5s)	1604	1604	128	53	106	6	0	165
44915	28737s (+0.3s)	716	716	64	17	77	2	0	96
44916	28738s (+1.1s)	4524	4524	256	105	247	21	0	373
44917	28738s (+0.2s)	564	564	32	20	61	4	0	85
44918	28739s (+0.9s)	3820	3820	256	93	199	14	0	306
44919	28740s (+1.1s)	5572	5572	512	120	257	20	0	397
44920	28741s (+0.5s)	1608	1608	128	43	118	8	0	169
44921	28741s (+0.6s)	1936	1936	128	40	157	5	0	202
44922	28742s (+1.0s)	4336	4336	256	100	237	24	1	362
44923	28743s (+0.4s)	1068	1068	64	24	99	0	7	130
44924	28743s (+0.8s)	3328	3328	256	49	217	0	12	278
44925	28744s (+0.6s)	2332	2332	256	58	129	9	0	196
44926	28744s (+0.5s)	1704	1704	128	36	130	5	0	171
44927	28745s (+0.5s)	1808	1808	128	45	135	7	0	187
44928	28745s (+0.5s)	1604	1604	128	32	118	6	1	157
44929	28746s (+0.9s)	3828	3828	256	72	222	19	0	313
44930	28747s (+0.6s)	2716	2716	256	42	176	0	10	228
44931	28748s (+0.8s)	3244	3244	256	61	190	0	17	268
44932	28748s (+0.3s)	1096	1096	128	21	91	0	5	117
44933	28749s (+0.8s)	3260	3260	256	66	196	16	0	278
44934	28750s (+0.9s)	3748	3748	256	86	211	14	0	311
44935	28750s (+0.6s)	1956	1956	128	57	130	9	0	196
44936	28751s (+0.5s)	1508	1508	128	37	114	9	0	160
44937	28751s (+0.3s)	712	712	64	16	78	1	0	95
44938	28752s (+0.7s)	2952	2952	256	66	170	13	0	249
44939	28753s (+0.9s)	3984	3984	256	79	239	12	0	330
44940	28753s (+0.7s)	2740	2740	256	49	173	11	1	234
44941	28754s (+0.4s)	1476	1476	128	30	115	8	0	153
44942	28754s (+0.4s)	1452	1452	128	39	106	4	0	149
44943	28755s (+0.8s)	3308	3308	256	79	193	12	1	285
44944	28755s (+0.4s)	1344	1344	128	24	109	5	0	138
44945	28757s (+1.1s)	5680	5680	512	105	285	13	0	403
44946	28757s (+0.4s)	1144	1144	128	29	87	0	8	124
44947	28758s (+1.0s)	5040	5040	512	87	250	0	18	355
44948	28758s (+0.3s)	1128	1128	128	18	96	0	6	120
44949	28759s (+0.6s)	2396	2396	256	45	150	0	11	206
44950	28759s (+0.4s)	1040	1040	64	32	87	0	5	124
44951	28760s (+1.0s)	4284	4284	256	99	235	22	0	356
44952	28761s (+0.4s)	1052	1052	64	25	96	6	0	127
44953	28761s (+0.7s)	2800	2800	256	58	176	9	0	243
44954	28763s (+1.2s)	5924	5924	512	107	304	19	0	430
44955	28763s (+0.5s)	1520	1520	128	35	123	5	0	163
44956	28764s (+0.6s)	1932	1932	128	52	140	9	0	201
44957	28765s (+0.9s)	3900	3900	256	73	227	13	1	314
44958	28766s (+0.9s)	3572	3572	256	75	207	15	0	297
44959	28766s (+0.5s)	1920	1920	128	54	121	9	0	184
44960	28766s (+0.2s)	628	628	64	14	67	2	1	84
44961	28767s (+0.4s)	1480	1480	128	41	108	5	0	154
44962	28767s (+0.5s)	1540	1540	128	41	111	9	0	161
44963	28768s (+0.8s)	3252	3252	256	88	169	13	0	270
44964	28769s (+0.6s)	2368	2368	256	42	150	9	0	201
44965	28769s (+0.7s)	2892	2892	256	66	160	14	0	240
44966	28770s (+0.5s)	1644	1644	128	33	131	3	0	167
44967	28770s (+0.4s)	1300	1300	128	32	94	5	0	131
44968	28771s (+0.5s)	1508	1508	128	34	123	3	0	160
44969	28772s (+0.9s)	3980	3980	256	81	234	14	0	329
44970	28772s (+0.5s)	1564	1564	128	39	120	4	0	163
44971	28773s (+0.8s)	3216	3216	256	67	185	14	0	266
44972	28774s (+0.9s)	3816	3816	256	86	219	15	0	320
44973	28774s (+0.2s)	552	552	64	15	63	1	0	79
44974	28775s (+0.6s)	2660	2660	256	68	158	8	0	234
44975	28776s (+0.9s)	4248	4248	256	93	231	22	0	346
44976	28776s (+0.6s)	2732	2732	256	53	172	7	0	232
44977	28776s (+0.2s)	608	608	64	25	57	3	0	85
44978	28777s (+1.0s)	4308	4308	256	89	247	20	0	356
44979	28778s (+0.5s)	1588	1588	128	34	125	5	0	164
44980	28779s (+0.9s)	3636	3636	256	86	206	20	0	312
44981	28780s (+0.7s)	2964	2964	256	53	181	8	0	242
44982	28780s (+0.8s)	3484	3484	256	80	195	15	0	290
44983	28781s (+0.4s)	1316	1316	128	31	99	5	0	135
44984	28781s (+0.5s)	1856	1856	128	47	132	8	0	187
44985	28782s (+0.7s)	3136	3136	256	74	183	10	0	267
44986	28783s (+0.5s)	1740	1740	128	29	148	5	0	182
44987	28783s (+0.6s)	1912	1912	128	46	141	9	0	196
44988	28784s (+0.5s)	1792	1792	128	46	127	10	0	183
44989	28784s (+0.4s)	1348	1348	128	40	95	7	0	142
44990	28785s (+0.5s)	1840	1840	128	47	133	7	0	187
44991	28785s (+0.7s)	2976	2976	256	70	189	6	0	265
44992	28786s (+0.5s)	2244	2244	256	45	134	8	0	187
44993	28786s (+0.5s)	1720	1720	128	42	120	12	0	174
44994	28787s (+0.2s)	416	416	64	5	54	2	0	61
44995	28787s (+0.5s)	1808	1808	128	47	134	6	0	187
44996	28788s (+0.8s)	3588	3588	256	75	224	7	0	306
44997	28789s (+0.8s)	3180	3180	256	72	184	13	0	269
44998	28789s (+0.4s)	1084	1084	64	51	77	2	0	130
44999	28789s (+0.2s)	288	288	32	13	40	2	0	55
Episode	Time	Reward	Score	Highest	L	U	R	D	Steps
45000	28790s (+0.3s)	824	824	64	27	75	5	0	107
45001	28791s (+1.0s)	4108	4108	256	71	250	14	0	335
45002	28791s (+0.4s)	1220	1220	64	32	109	0	6	147
45003	28791s (+0.5s)	1612	1612	128	41	117	0	6	164
45004	28792s (+0.9s)	4056	4056	256	73	242	0	18	333
45005	28793s (+0.3s)	704	704	64	19	68	0	6	93
45006	28793s (+0.1s)	192	192	16	9	30	0	5	44
45007	28793s (+0.6s)	2608	2608	256	41	173	0	13	227
45008	28794s (+0.4s)	1484	1484	128	29	119	0	7	155
45009	28794s (+0.5s)	1568	1568	128	27	132	0	6	165
45010	28795s (+0.6s)	2100	2100	128	57	139	12	0	208
45011	28796s (+0.7s)	3172	3172	256	72	174	15	0	261
45012	28796s (+0.4s)	1396	1396	128	46	100	9	0	155
45013	28797s (+0.5s)	1884	1884	128	57	120	10	0	187
45014	28797s (+0.5s)	2408	2408	256	38	157	5	0	200
45015	28798s (+0.6s)	2280	2280	128	59	150	10	0	219
45016	28799s (+0.7s)	3024	3024	256	56	183	12	0	251
45017	28799s (+0.4s)	1068	1068	64	31	89	9	1	130
45018	28800s (+0.8s)	3256	3256	256	70	196	11	0	277
45019	28801s (+0.9s)	3880	3880	256	85	219	13	0	317
45020	28802s (+0.9s)	3528	3528	256	77	210	10	0	297
45021	28802s (+0.7s)	3104	3104	256	64	174	11	1	250
45022	28803s (+0.9s)	4968	4968	512	103	218	20	1	342
45023	28804s (+0.9s)	3576	3576	256	90	194	18	0	302
45024	28805s (+0.7s)	3096	3096	256	74	173	11	0	258
45025	28805s (+0.5s)	1868	1868	128	41	142	6	0	189
45026	28806s (+0.4s)	1368	1368	128	32	107	3	0	142
45027	28807s (+0.9s)	3628	3628	256	95	194	17	0	306
45028	28807s (+0.5s)	2312	2312	256	52	132	8	0	192
45029	28808s (+0.7s)	2920	2920	256	60	187	9	0	256
45030	28809s (+0.8s)	2972	2972	256	63	196	5	0	264
45031	28809s (+0.7s)	2860	2860	256	64	171	8	0	243
45032	28810s (+0.6s)	2824	2824	256	53	167	14	0	234
45033	28811s (+0.9s)	3852	3852	256	79	215	13	0	307
45034	28812s (+0.9s)	3876	3876	256	98	211	19	0	328
45035	28813s (+0.8s)	3540	3540	256	85	200	8	0	293
45036	28813s (+0.6s)	2260	2260	128	52	159	9	0	220
45037	28814s (+0.7s)	2632	2632	256	52	174	6	1	233
45038	28815s (+0.5s)	1812	1812	128	45	137	6	0	188
45039	28815s (+0.6s)	2408	2408	256	42	147	10	0	199
45040	28816s (+0.7s)	2948	2948	256	82	154	21	0	257
45041	28817s (+1.0s)	4192	4192	256	95	231	17	0	343
45042	28817s (+0.4s)	1496	1496	128	40	102	9	0	151
45043	28818s (+0.5s)	1772	1772	128	48	119	9	0	176
45044	28818s (+0.6s)	1956	1956	128	48	139	10	0	197
45045	28819s (+0.5s)	1656	1656	128	37	121	10	1	169
45046	28819s (+0.4s)	1368	1368	128	42	94	7	0	143
45047	28820s (+0.9s)	3596	3596	256	77	204	20	0	301
45048	28822s (+1.3s)	6552	6552	512	119	328	21	0	468
45049	28822s (+0.8s)	3368	3368	256	64	203	12	0	279
45050	28823s (+0.8s)	3760	3760	256	74	217	15	1	307
45051	28824s (+0.7s)	2860	2860	256	70	161	15	0	246
45052	28825s (+0.7s)	2716	2716	256	51	173	8	0	232
45053	28825s (+0.7s)	2920	2920	256	65	182	9	0	256
45054	28826s (+0.6s)	2352	2352	256	55	140	5	0	200
45055	28826s (+0.5s)	1540	1540	128	32	120	5	0	157
45056	28828s (+1.5s)	7600	7600	512	154	354	30	0	538
45057	28828s (+0.5s)	1900	1900	128	49	132	12	0	193
45058	28829s (+0.5s)	1688	1688	128	31	136	6	1	174
45059	28830s (+0.8s)	3300	3300	256	75	191	10	0	276
45060	28830s (+0.7s)	3112	3112	256	49	200	9	0	258
45061	28831s (+0.7s)	3160	3160	256	57	191	10	0	258
45062	28832s (+1.1s)	5648	5648	512	128	246	21	0	395
45063	28833s (+0.7s)	2996	2996	256	61	183	11	0	255
45064	28833s (+0.5s)	1676	1676	128	39	122	9	0	170
45065	28835s (+1.1s)	4592	4592	256	102	255	25	0	382
45066	28835s (+0.8s)	3520	3520	256	85	198	16	0	299
45067	28836s (+0.7s)	2880	2880	256	50	191	10	0	251
45068	28837s (+0.6s)	1992	1992	128	36	156	12	0	204
45069	28837s (+0.4s)	1480	1480	128	31	117	6	0	154
45070	28838s (+0.5s)	1780	1780	128	42	134	4	0	180
45071	28838s (+0.5s)	1624	1624	128	36	120	6	0	162
45072	28839s (+0.7s)	3184	3184	256	64	193	7	0	264
45073	28840s (+0.6s)	1956	1956	128	45	142	10	0	197
45074	28840s (+0.8s)	3512	3512	256	85	196	16	0	297
45075	28841s (+0.5s)	1740	1740	128	41	128	6	0	175
45076	28842s (+1.1s)	4504	4504	256	95	259	18	0	372
45077	28842s (+0.6s)	2384	2384	256	54	138	6	0	198
45078	28843s (+0.4s)	1192	1192	64	30	99	6	0	135
45079	28843s (+0.6s)	1892	1892	128	43	147	6	0	196
45080	28844s (+0.8s)	3368	3368	256	64	205	9	1	279
45081	28845s (+0.3s)	844	844	64	30	81	3	0	114
45082	28845s (+0.9s)	3676	3676	256	84	210	19	0	313
45083	28846s (+0.5s)	1656	1656	128	41	130	5	0	176
45084	28847s (+0.6s)	2464	2464	256	34	172	8	0	214
45085	28848s (+1.0s)	4196	4196	256	98	224	21	1	344
45086	28848s (+0.7s)	2624	2624	256	66	149	15	0	230
45087	28849s (+0.8s)	3516	3516	256	81	201	12	0	294
45088	28850s (+1.0s)	4232	4232	256	89	248	11	0	348
45089	28850s (+0.3s)	1124	1124	128	31	87	2	0	120
45090	28851s (+0.6s)	2428	2428	256	44	150	9	0	203
45091	28852s (+0.5s)	1920	1920	128	46	129	8	1	184
45092	28852s (+0.5s)	1864	1864	128	60	118	12	0	190
45093	28853s (+0.5s)	1676	1676	128	50	122	9	0	181
45094	28853s (+0.8s)	2960	2960	256	67	188	10	1	266
45095	28855s (+1.2s)	5932	5932	512	124	269	25	0	418
45096	28855s (+0.5s)	1736	1736	128	46	118	10	0	174
45097	28856s (+0.5s)	1840	1840	128	51	135	4	0	190
45098	28856s (+0.8s)	3436	3436	256	66	213	10	0	289
45099	28857s (+0.4s)	1416	1416	128	33	103	4	0	140
Episode	Time	Reward	Score	Highest	L	U	R	D	Steps
45100	28858s (+1.0s)	4056	4056	256	80	237	19	0	336
45101	28859s (+0.8s)	3592	3592	256	88	197	17	0	302
45102	28860s (+0.9s)	3824	3824	256	83	208	15	1	307
45103	28860s (+0.6s)	2392	2392	256	57	129	16	0	202
45104	28861s (+0.4s)	964	964	64	39	85	3	0	127
45105	28861s (+0.4s)	1452	1452	128	30	113	5	0	148
45106	28861s (+0.3s)	1080	1080	128	26	86	7	0	119
45107	28862s (+0.4s)	1392	1392	128	36	104	8	0	148
45108	28862s (+0.6s)	1900	1900	128	45	141	0	8	194
45109	28863s (+0.7s)	2780	2780	256	41	185	0	12	238
45110	28864s (+0.5s)	2172	2172	256	32	151	0	5	188
45111	28864s (+0.5s)	1568	1568	128	31	128	0	5	164
45112	28865s (+0.6s)	2452	2452	256	55	141	0	9	205
45113	28865s (+0.8s)	3412	3412	256	59	207	0	17	283
45114	28866s (+1.0s)	4140	4140	256	61	261	0	17	339
45115	28867s (+0.6s)	2832	2832	256	56	163	0	11	230
45116	28868s (+0.6s)	2344	2344	128	56	143	16	0	215
45117	28868s (+0.4s)	1048	1048	64	31	89	6	0	126
45118	28869s (+0.6s)	2648	2648	256	59	158	10	0	227
45119	28869s (+0.4s)	1268	1268	128	22	108	4	0	134
45120	28870s (+0.6s)	2596	2596	256	45	170	9	0	224
45121	28870s (+0.5s)	1592	1592	128	30	131	4	0	165
45122	28871s (+0.8s)	3392	3392	256	73	200	14	0	287
45123	28871s (+0.3s)	1160	1160	128	23	96	4	0	123
45124	28872s (+0.8s)	3412	3412	256	66	188	14	1	269
45125	28873s (+0.7s)	2848	2848	128	66	182	15	0	263
45126	28874s (+0.7s)	3080	3080	256	63	182	9	0	254
45127	28874s (+0.5s)	1604	1604	128	46	111	11	0	168
45128	28875s (+0.9s)	3956	3956	256	109	194	20	0	323
45129	28875s (+0.4s)	1160	1160	64	36	97	5	0	138
45130	28876s (+0.8s)	3520	3520	256	90	200	9	0	299
45131	28877s (+0.4s)	1352	1352	64	43	101	5	0	149
45132	28877s (+0.6s)	1908	1908	128	38	150	8	0	196
45133	28878s (+0.8s)	3508	3508	256	76	205	15	0	296
45134	28878s (+0.2s)	612	612	64	13	67	3	0	83
45135	28879s (+0.3s)	1068	1068	128	24	83	5	0	112
45136	28879s (+0.7s)	3056	3056	256	70	166	13	0	249
45137	28880s (+0.8s)	3500	3500	256	95	184	15	0	294
45138	28881s (+0.6s)	2416	2416	128	59	155	12	0	226
45139	28881s (+0.6s)	2516	2516	256	44	171	6	0	221
45140	28882s (+0.5s)	1876	1876	128	52	128	12	0	192
45141	28883s (+0.6s)	2372	2372	256	41	153	8	0	202
45142	28883s (+0.4s)	1176	1176	128	25	99	0	3	127
45143	28883s (+0.4s)	1084	1084	64	26	98	0	7	131
45144	28884s (+0.5s)	1772	1772	128	35	133	0	11	179
45145	28885s (+1.0s)	4152	4152	256	74	249	0	18	341
45146	28885s (+0.5s)	1788	1788	128	37	136	0	9	182
45147	28886s (+0.8s)	3260	3260	256	51	212	0	14	277
45148	28887s (+0.7s)	2668	2668	256	48	180	0	9	237
45149	28887s (+0.4s)	1200	1200	128	28	97	6	1	132
45150	28888s (+0.3s)	896	896	64	24	91	4	0	119
45151	28888s (+0.4s)	1188	1188	64	38	93	4	0	135
45152	28889s (+0.6s)	2020	2020	128	53	142	12	0	207
45153	28889s (+0.4s)	1244	1244	128	27	104	7	0	138
45154	28890s (+0.7s)	2748	2748	256	65	168	8	0	241
45155	28891s (+0.8s)	3348	3348	256	67	203	13	0	283
45156	28891s (+0.2s)	600	600	64	13	64	0	4	81
45157	28892s (+0.8s)	3476	3476	256	60	222	0	13	295
45158	28892s (+0.3s)	856	856	64	27	78	5	0	110
45159	28892s (+0.5s)	1844	1844	128	40	139	0	11	190
45160	28893s (+0.5s)	1912	1912	128	39	150	0	7	196
45161	28893s (+0.3s)	788	788	64	22	72	0	7	101
45162	28894s (+0.2s)	564	564	64	13	60	0	4	77
45163	28894s (+0.2s)	612	612	64	17	64	3	0	84
45164	28894s (+0.7s)	2864	2864	256	51	186	9	0	246
45165	28895s (+0.6s)	1964	1964	128	55	136	10	0	201
45166	28896s (+0.7s)	2740	2740	256	51	178	6	0	235
45167	28896s (+0.6s)	2488	2488	256	62	138	13	1	214
45168	28897s (+0.5s)	1652	1652	128	43	113	10	0	166
45169	28898s (+0.8s)	3480	3480	256	64	213	10	1	288
45170	28898s (+0.4s)	1428	1428	128	29	111	6	0	146
45171	28898s (+0.4s)	1360	1360	128	26	113	0	2	141
45172	28899s (+0.7s)	2724	2724	256	40	185	0	9	234
45173	28900s (+0.5s)	1844	1844	128	36	146	0	3	185
45174	28900s (+0.4s)	1128	1128	64	25	102	0	6	133
45175	28901s (+0.7s)	2660	2660	256	44	185	0	6	235
45176	28901s (+0.5s)	2144	2144	256	39	136	0	6	181
45177	28902s (+0.8s)	3728	3728	256	70	223	10	1	304
45178	28903s (+0.5s)	2020	2020	128	52	132	8	1	193
45179	28903s (+0.6s)	2504	2504	256	58	151	9	0	218
45180	28904s (+0.7s)	2868	2868	256	70	163	15	0	248
45181	28905s (+0.7s)	2992	2992	256	67	169	12	0	248
45182	28905s (+0.5s)	1816	1816	128	45	139	4	0	188
45183	28906s (+0.7s)	3192	3192	256	71	180	14	1	266
45184	28907s (+0.7s)	2744	2744	256	67	159	8	0	234
45185	28907s (+0.5s)	1592	1592	128	32	126	2	0	160
45186	28908s (+0.7s)	3040	3040	256	77	170	11	0	258
45187	28909s (+0.7s)	2300	2300	128	61	158	14	0	233
45188	28909s (+0.7s)	3068	3068	256	73	162	13	1	249
45189	28910s (+0.3s)	712	712	64	28	58	9	0	95
45190	28910s (+0.3s)	800	800	64	27	75	5	0	107
45191	28910s (+0.4s)	1328	1328	128	31	98	7	1	137
45192	28911s (+0.4s)	1412	1412	128	32	111	5	0	148
45193	28912s (+0.9s)	4572	4572	512	81	208	19	0	308
45194	28912s (+0.8s)	3356	3356	256	72	198	15	0	285
45195	28913s (+0.6s)	2544	2544	256	54	153	9	0	216
45196	28914s (+0.7s)	2828	2828	256	63	175	11	0	249
45197	28914s (+0.7s)	2908	2908	256	61	160	17	1	239
45198	28916s (+1.3s)	6500	6500	512	112	312	23	0	447
45199	28916s (+0.6s)	2336	2336	256	44	154	5	0	203
Episode	Time	Reward	Score	Highest	L	U	R	D	Steps
45200	28917s (+0.7s)	3168	3168	256	66	180	16	1	263
45201	28918s (+0.7s)	2992	2992	256	57	182	9	0	248
45202	28918s (+0.4s)	1364	1364	128	33	112	6	0	151
45203	28919s (+0.6s)	2476	2476	128	64	153	13	0	230
45204	28919s (+0.4s)	1064	1064	64	37	86	6	0	129
45205	28920s (+0.6s)	2508	2508	256	48	161	9	0	218
45206	28920s (+0.5s)	1816	1816	128	49	126	12	1	188
45207	28921s (+0.7s)	2932	2932	256	53	181	7	1	242
45208	28922s (+0.8s)	3416	3416	256	71	198	14	1	284
45209	28922s (+0.5s)	1760	1760	128	44	125	11	0	180
45210	28923s (+0.9s)	3796	3796	256	77	229	14	0	320
45211	28924s (+0.3s)	952	952	64	29	82	6	1	118
45212	28924s (+0.4s)	1156	1156	128	33	82	7	0	122
45213	28924s (+0.4s)	1428	1428	128	38	99	8	0	145
45214	28925s (+0.6s)	2500	2500	256	49	157	10	0	216
45215	28926s (+0.8s)	3336	3336	256	56	203	10	0	269
45216	28927s (+0.8s)	3400	3400	256	68	198	13	1	280
45217	28927s (+0.7s)	3152	3152	256	54	192	10	0	256
45218	28928s (+0.8s)	3528	3528	256	76	207	13	0	296
45219	28929s (+0.7s)	2720	2720	128	57	182	9	0	248
45220	28929s (+0.4s)	1164	1164	64	33	100	5	0	138
45221	28930s (+0.5s)	1572	1572	128	43	110	12	0	165
45222	28930s (+0.6s)	2280	2280	128	46	152	11	1	210
45223	28931s (+0.8s)	3224	3224	256	56	201	12	0	269
45224	28931s (+0.2s)	324	324	32	14	40	4	0	58
45225	28932s (+0.6s)	2488	2488	256	42	162	10	0	214
45226	28933s (+0.7s)	2652	2652	256	60	165	13	0	238
45227	28934s (+1.1s)	5536	5536	512	91	275	22	0	388
45228	28934s (+0.5s)	1596	1596	128	37	121	0	9	167
45229	28935s (+0.4s)	1336	1336	128	24	108	0	7	139
45230	28936s (+0.8s)	3448	3448	256	55	220	0	14	289
45231	28936s (+0.3s)	960	960	128	27	74	0	5	106
45232	28937s (+0.7s)	2916	2916	256	55	194	0	7	256
45233	28938s (+1.0s)	4332	4332	256	95	232	30	0	357
45234	28938s (+0.6s)	1848	1848	128	53	134	5	0	192
45235	28939s (+0.5s)	1612	1612	128	37	126	7	0	170
45236	28939s (+0.7s)	2536	2536	128	75	153	12	0	240
45237	28940s (+0.7s)	2940	2940	256	60	179	15	0	254
45238	28941s (+0.5s)	2180	2180	256	49	128	8	0	185
45239	28941s (+0.5s)	1868	1868	128	42	132	7	0	181
45240	28942s (+0.7s)	3076	3076	256	67	175	12	0	254
45241	28943s (+0.7s)	2576	2576	128	62	165	11	0	238
45242	28943s (+0.8s)	3504	3504	256	70	214	11	0	295
45243	28944s (+0.3s)	824	824	64	32	70	5	0	107
45244	28945s (+0.9s)	3824	3824	256	80	219	8	0	307
45245	28946s (+0.9s)	3648	3648	256	67	232	12	0	311
45246	28946s (+0.8s)	3396	3396	256	85	179	16	0	280
45247	28947s (+0.6s)	1948	1948	128	28	160	0	7	195
45248	28948s (+0.6s)	1928	1928	128	47	145	8	0	200
45249	28948s (+0.7s)	2572	2572	128	62	175	9	0	246
45250	28949s (+0.8s)	3492	3492	256	55	224	13	0	292
45251	28950s (+0.8s)	3332	3332	256	64	206	0	13	283
45252	28950s (+0.4s)	1516	1516	128	36	113	0	7	156
45253	28951s (+0.4s)	1488	1488	128	38	110	0	8	156
45254	28951s (+0.4s)	1360	1360	128	25	110	0	8	143
45255	28951s (+0.2s)	424	424	32	17	47	0	4	68
45256	28952s (+0.6s)	2612	2612	256	50	168	0	7	225
45257	28953s (+0.6s)	2572	2572	256	50	162	0	11	223
45258	28953s (+0.6s)	2480	2480	256	36	164	1	5	206
45259	28954s (+0.8s)	3472	3472	256	67	207	0	13	287
45260	28955s (+0.4s)	1420	1420	128	26	115	0	5	146
45261	28955s (+0.3s)	1060	1060	128	35	73	7	0	115
45262	28955s (+0.5s)	1788	1788	128	38	138	6	0	182
45263	28956s (+0.8s)	3372	3372	256	56	216	0	12	284
45264	28957s (+0.7s)	2628	2628	128	51	186	0	11	248
45265	28958s (+0.6s)	2188	2188	128	40	153	0	13	206
45266	28958s (+0.9s)	3984	3984	256	91	222	18	0	331
45267	28959s (+0.5s)	2088	2088	128	46	139	9	0	194
45268	28959s (+0.5s)	1512	1512	128	42	111	7	1	161
45269	28960s (+0.3s)	1016	1016	64	28	87	5	0	120
45270	28961s (+0.8s)	3340	3340	256	70	200	11	0	281
45271	28961s (+0.5s)	1628	1628	128	51	116	7	0	174
45272	28962s (+1.0s)	4204	4204	256	80	243	23	0	346
45273	28963s (+0.6s)	2408	2408	256	58	134	8	0	200
45274	28963s (+0.6s)	2132	2132	128	54	142	8	0	204
45275	28964s (+1.1s)	4572	4572	256	104	255	18	0	377
45276	28965s (+1.0s)	4284	4284	256	87	253	16	0	356
45277	28966s (+0.6s)	2620	2620	256	41	177	9	0	227
45278	28967s (+0.5s)	1620	1620	128	49	114	9	0	172
45279	28967s (+0.8s)	3520	3520	256	67	211	17	0	295
45280	28968s (+0.6s)	2484	2484	256	48	156	9	0	213
45281	28969s (+0.9s)	3768	3768	256	72	213	14	0	299
45282	28969s (+0.2s)	336	336	32	10	45	1	0	56
45283	28970s (+0.8s)	3200	3200	256	58	201	10	0	269
45284	28970s (+0.6s)	2312	2312	256	37	147	8	0	192
45285	28971s (+1.0s)	4884	4884	512	94	238	16	0	348
45286	28972s (+0.8s)	3304	3304	256	60	206	10	0	276
45287	28973s (+0.5s)	1516	1516	128	40	114	5	0	159
45288	28973s (+0.4s)	1396	1396	128	28	112	2	1	143
45289	28974s (+0.7s)	3052	3052	256	67	170	11	0	248
45290	28974s (+0.6s)	1920	1920	128	48	142	8	0	198
45291	28975s (+0.8s)	3408	3408	256	74	197	12	0	283
45292	28976s (+0.4s)	1168	1168	64	34	97	8	0	139
45293	28976s (+0.6s)	2372	2372	128	83	127	14	1	225
45294	28977s (+0.5s)	2196	2196	256	39	146	5	0	190
45295	28977s (+0.4s)	1040	1040	64	32	87	5	0	124
45296	28978s (+0.5s)	2180	2180	256	34	148	0	5	187
45297	28978s (+0.4s)	1416	1416	128	28	117	0	6	151
45298	28979s (+1.1s)	5464	5464	512	90	275	0	16	381
45299	28980s (+0.5s)	1760	1760	128	28	150	0	3	181
Episode	Time	Reward	Score	Highest	L	U	R	D	Steps
45300	28980s (+0.7s)	2868	2868	256	44	181	0	9	234
45301	28981s (+0.3s)	924	924	64	20	85	0	7	112
45302	28981s (+0.7s)	3104	3104	256	51	195	0	10	256
45303	28982s (+0.5s)	1624	1624	128	30	126	0	8	164
45304	28982s (+0.5s)	1764	1764	128	47	125	8	0	180
45305	28983s (+0.8s)	3488	3488	256	68	201	16	0	285
45306	28984s (+0.8s)	3404	3404	256	72	215	10	0	297
45307	28985s (+0.5s)	1836	1836	128	54	127	8	0	189
45308	28985s (+0.4s)	1328	1328	128	31	101	5	0	137
45309	28986s (+0.9s)	4868	4868	512	93	229	15	0	337
45310	28987s (+0.8s)	3492	3492	256	83	198	12	0	293
45311	28987s (+0.7s)	2872	2872	256	61	162	10	1	234
45312	28988s (+0.5s)	1688	1688	128	46	117	10	0	173
45313	28989s (+0.6s)	2408	2408	256	49	149	8	0	206
45314	28989s (+0.8s)	3252	3252	256	70	192	14	0	276
45315	28990s (+0.7s)	2780	2780	256	62	165	10	1	238
45316	28990s (+0.4s)	1424	1424	128	37	103	12	0	152
45317	28991s (+1.0s)	4256	4256	256	84	251	16	0	351
45318	28992s (+0.7s)	2372	2372	128	70	146	14	0	230
45319	28993s (+0.6s)	2428	2428	256	37	164	7	0	208
45320	28993s (+0.4s)	1488	1488	128	36	108	12	0	156
45321	28994s (+0.8s)	3368	3368	256	59	223	6	0	288
45322	28995s (+0.6s)	1884	1884	128	38	149	7	0	194
45323	28995s (+0.3s)	876	876	64	26	82	0	7	115
45324	28996s (+0.8s)	3708	3708	256	62	225	0	13	300
45325	28996s (+0.7s)	2788	2788	256	49	182	0	9	240
45326	28997s (+0.9s)	3964	3964	256	86	218	15	0	319
45327	28998s (+0.8s)	3304	3304	256	72	203	16	0	291
45328	28999s (+0.5s)	1832	1832	128	43	134	11	0	188
45329	29000s (+0.9s)	3736	3736	256	94	197	18	2	311
45330	29000s (+0.5s)	1732	1732	128	35	131	7	0	173
45331	29001s (+0.9s)	3888	3888	256	84	228	11	0	323
45332	29002s (+1.0s)	4376	4376	256	106	237	25	0	368
45333	29003s (+1.1s)	4532	4532	256	97	256	22	0	375
45334	29004s (+0.4s)	1116	1116	64	32	101	5	0	138
45335	29004s (+0.4s)	1548	1548	128	40	109	4	0	153
45336	29005s (+1.0s)	5156	5156	512	97	256	14	0	367
45337	29006s (+0.8s)	3416	3416	256	81	188	16	0	285
45338	29006s (+0.4s)	1408	1408	128	29	107	5	1	142
45339	29007s (+0.6s)	2076	2076	128	45	157	8	0	210
45340	29007s (+0.3s)	708	708	64	23	65	5	1	94
45341	29008s (+0.7s)	2804	2804	256	59	166	10	0	235
45342	29009s (+1.0s)	4280	4280	256	70	266	0	19	355
45343	29009s (+0.5s)	1732	1732	128	33	137	0	7	177
45344	29010s (+0.5s)	1844	1844	128	34	147	0	11	192
45345	29011s (+0.8s)	3508	3508	256	66	215	0	10	291
45346	29011s (+0.5s)	1864	1864	128	47	137	0	6	190
45347	29012s (+0.6s)	2476	2476	256	42	164	0	6	212
45348	29013s (+0.6s)	2636	2636	256	50	163	8	0	221
45349	29013s (+0.7s)	2896	2896	256	53	174	9	0	236
45350	29014s (+0.5s)	1836	1836	128	48	132	9	1	190
45351	29014s (+0.5s)	1808	1808	128	44	140	2	0	186
45352	29015s (+0.8s)	3400	3400	256	62	203	16	0	281
45353	29016s (+0.8s)	3304	3304	256	67	193	17	0	277
45354	29017s (+0.6s)	2252	2252	128	52	159	6	0	217
45355	29017s (+0.4s)	976	976	64	28	90	5	0	123
45356	29018s (+1.0s)	4312	4312	256	95	240	21	0	356
45357	29019s (+1.0s)	4272	4272	256	98	230	20	0	348
45358	29020s (+0.8s)	3536	3536	256	85	182	21	0	288
45359	29020s (+0.4s)	1188	1188	128	29	97	3	0	129
45360	29021s (+0.8s)	3380	3380	256	79	182	15	0	276
45361	29022s (+0.8s)	3444	3444	256	68	199	14	0	281
45362	29022s (+0.4s)	1304	1304	128	44	89	9	0	142
45363	29023s (+0.8s)	3368	3368	256	81	182	15	0	278
45364	29023s (+0.5s)	1912	1912	128	42	143	11	0	196
45365	29024s (+0.5s)	2092	2092	256	33	136	3	0	172
45366	29024s (+0.5s)	2364	2364	256	49	138	10	2	199
45367	29025s (+0.4s)	1128	1128	64	23	102	0	5	130
45368	29025s (+0.4s)	1360	1360	128	22	119	0	0	141
45369	29026s (+0.9s)	3996	3996	256	75	231	20	0	326
45370	29027s (+1.0s)	4092	4092	256	86	241	12	1	340
45371	29028s (+1.0s)	4052	4052	256	90	227	18	0	335
45372	29029s (+0.7s)	2868	2868	256	69	159	13	0	241
45373	29029s (+0.5s)	1808	1808	128	40	141	6	0	187
45374	29030s (+0.5s)	1500	1500	128	41	110	7	0	158
45375	29030s (+0.6s)	2664	2664	256	53	165	12	0	230
45376	29032s (+1.2s)	5888	5888	512	125	275	24	2	426
45377	29032s (+0.5s)	1756	1756	128	39	134	2	0	175
45378	29033s (+0.6s)	2576	2576	256	64	144	16	0	224
45379	29034s (+0.9s)	3680	3680	256	73	227	17	0	317
45380	29035s (+0.7s)	3120	3120	256	62	189	17	0	268
45381	29035s (+0.6s)	2608	2608	256	45	173	9	0	227
45382	29036s (+0.6s)	2424	2424	256	51	143	9	0	203
45383	29036s (+0.7s)	2776	2776	256	57	166	14	0	237
45384	29037s (+0.6s)	2476	2476	256	48	155	9	0	212
45385	29038s (+0.6s)	2208	2208	128	68	129	14	0	211
45386	29038s (+0.4s)	1460	1460	128	34	108	9	0	151
45387	29039s (+0.8s)	3364	3364	256	63	206	9	0	278
45388	29040s (+0.7s)	3128	3128	256	60	182	11	1	254
45389	29040s (+0.4s)	1416	1416	128	39	105	9	0	153
45390	29041s (+0.8s)	3392	3392	256	65	202	12	0	279
45391	29042s (+0.7s)	3128	3128	256	56	186	13	0	255
45392	29042s (+0.8s)	3504	3504	256	77	205	12	1	295
45393	29043s (+0.5s)	1684	1684	128	39	128	6	0	173
45394	29043s (+0.3s)	772	772	64	29	67	5	0	101
45395	29044s (+0.8s)	3344	3344	256	91	187	13	0	291
45396	29045s (+0.9s)	3888	3888	256	77	222	13	0	312
45397	29046s (+0.6s)	2308	2308	128	43	170	7	0	220
45398	29046s (+0.5s)	1828	1828	128	49	126	9	0	184
45399	29047s (+0.4s)	1484	1484	128	41	105	9	0	155
Episode	Time	Reward	Score	Highest	L	U	R	D	Steps
45400	29047s (+0.5s)	1636	1636	128	23	142	1	0	166
45401	29048s (+1.0s)	4160	4160	256	88	240	19	0	347
45402	29049s (+0.7s)	2828	2828	256	65	165	13	0	243
45403	29049s (+0.5s)	1732	1732	128	37	132	8	1	178
45404	29050s (+0.4s)	1492	1492	128	36	112	9	0	157
45405	29051s (+0.9s)	3800	3800	256	62	240	0	11	313
45406	29051s (+0.3s)	688	688	64	12	76	0	2	90
45407	29051s (+0.5s)	1664	1664	128	40	117	0	11	168
45408	29052s (+0.5s)	1788	1788	128	35	140	0	8	183
45409	29053s (+0.7s)	2796	2796	256	46	184	0	12	242
45410	29053s (+0.6s)	2252	2252	128	49	158	10	1	218
45411	29054s (+0.6s)	2028	2028	128	53	133	12	0	198
45412	29054s (+0.6s)	2404	2404	256	50	148	5	0	203
45413	29055s (+0.7s)	2932	2932	256	68	181	10	0	259
45414	29056s (+0.4s)	1564	1564	128	32	114	7	0	153
45415	29056s (+0.3s)	912	912	64	25	79	5	0	109
45416	29056s (+0.5s)	1804	1804	128	33	147	0	6	186
45417	29057s (+0.5s)	1520	1520	128	33	121	0	5	159
45418	29057s (+0.4s)	1248	1248	128	18	119	0	2	139
45419	29058s (+0.7s)	3012	3012	256	50	191	0	12	253
45420	29058s (+0.3s)	1092	1092	128	22	89	0	5	116
45421	29060s (+1.3s)	6456	6456	512	89	346	0	23	458
45422	29060s (+0.7s)	2804	2804	256	61	175	0	8	244
45423	29061s (+0.5s)	1720	1720	128	39	127	0	7	173
45424	29061s (+0.4s)	1128	1128	64	29	92	1	8	130
45425	29062s (+0.6s)	2648	2648	256	50	164	0	12	226
45426	29063s (+0.7s)	2844	2844	256	46	191	0	12	249
45427	29064s (+0.9s)	3948	3948	256	73	233	0	16	322
45428	29064s (+0.4s)	1588	1588	128	38	118	0	8	164
45429	29065s (+0.5s)	1632	1632	128	43	118	13	0	174
45430	29066s (+1.2s)	5808	5808	512	106	296	20	0	422
45431	29066s (+0.4s)	1460	1460	128	31	116	6	1	154
45432	29067s (+0.5s)	1664	1664	128	62	108	7	1	178
45433	29067s (+0.5s)	1720	1720	128	36	130	6	1	173
45434	29068s (+0.6s)	2516	2516	256	57	153	10	0	220
45435	29068s (+0.4s)	1180	1180	64	41	94	7	0	142
45436	29069s (+0.6s)	2372	2372	256	58	128	8	0	194
45437	29069s (+0.5s)	1740	1740	128	45	126	5	0	176
45438	29070s (+0.4s)	1068	1068	64	26	97	8	0	131
45439	29070s (+0.7s)	2564	2564	128	61	161	18	0	240
45440	29071s (+0.8s)	3336	3336	256	70	201	9	0	280
45441	29072s (+0.4s)	1484	1484	128	37	114	4	0	155
45442	29073s (+1.0s)	4288	4288	256	96	234	21	0	351
45443	29073s (+0.5s)	1800	1800	128	37	126	7	0	170
45444	29074s (+0.5s)	1800	1800	128	50	124	11	0	185
45445	29074s (+0.3s)	1028	1028	64	23	94	5	0	122
45446	29074s (+0.4s)	1232	1232	128	36	84	7	1	128
45447	29075s (+0.9s)	3816	3816	256	70	223	0	17	310
45448	29076s (+0.5s)	1720	1720	128	37	133	0	11	181
45449	29076s (+0.5s)	1824	1824	128	30	137	0	9	176
45450	29077s (+0.4s)	1024	1024	64	23	97	0	5	125
45451	29078s (+0.8s)	3336	3336	256	57	214	0	9	280
45452	29079s (+1.0s)	5068	5068	512	104	247	0	12	363
45453	29080s (+1.2s)	5756	5756	512	73	316	0	21	410
45454	29080s (+0.5s)	1604	1604	128	40	123	5	0	168
45455	29081s (+0.3s)	968	968	64	18	94	4	0	116
45456	29082s (+1.3s)	6488	6488	512	111	333	25	1	470
45457	29082s (+0.5s)	1500	1500	128	43	108	8	0	159
45458	29083s (+0.6s)	2604	2604	256	48	165	13	0	226
45459	29084s (+0.7s)	3216	3216	256	62	186	10	1	259
45460	29084s (+0.6s)	2660	2660	256	41	175	0	9	225
45461	29085s (+0.7s)	3076	3076	256	53	189	0	12	254
45462	29085s (+0.3s)	748	748	64	18	78	0	4	100
45463	29086s (+0.4s)	1460	1460	128	25	128	0	0	153
45464	29086s (+0.5s)	1820	1820	128	41	142	3	0	186
45465	29087s (+0.6s)	2276	2276	128	60	146	12	0	218
45466	29088s (+0.8s)	3252	3252	256	70	194	12	0	276
45467	29089s (+0.8s)	3496	3496	256	82	201	10	0	293
45468	29089s (+0.6s)	1904	1904	128	43	143	8	0	194
45469	29090s (+0.5s)	1780	1780	128	46	120	11	0	177
45470	29090s (+0.4s)	1516	1516	128	35	117	7	0	159
45471	29091s (+0.6s)	2496	2496	256	53	153	10	0	216
45472	29091s (+0.5s)	1624	1624	128	43	125	5	0	173
45473	29093s (+1.5s)	7496	7496	512	141	349	34	0	524
45474	29093s (+0.5s)	1804	1804	128	41	138	6	0	185
45475	29094s (+0.4s)	1092	1092	64	32	92	6	0	130
45476	29094s (+0.4s)	996	996	64	30	94	4	0	128
45477	29095s (+1.3s)	6732	6732	512	137	323	21	0	481
45478	29096s (+0.4s)	1340	1340	128	32	108	6	0	146
45479	29097s (+1.1s)	5412	5412	512	108	250	21	1	380
45480	29098s (+0.7s)	2456	2456	128	69	159	9	0	237
45481	29098s (+0.6s)	1936	1936	128	51	143	8	0	202
45482	29099s (+1.0s)	4592	4592	256	112	250	23	0	385
45483	29100s (+0.6s)	1916	1916	128	55	130	12	0	197
45484	29100s (+0.6s)	2256	2256	128	63	139	17	0	219
45485	29101s (+0.6s)	2460	2460	256	49	155	8	0	212
45486	29101s (+0.3s)	940	940	64	27	82	0	6	115
45487	29102s (+0.4s)	1228	1228	64	27	114	0	8	149
45488	29103s (+0.8s)	3376	3376	256	52	216	0	13	281
45489	29103s (+0.4s)	1304	1304	128	38	96	0	5	139
45490	29104s (+0.9s)	3700	3700	256	91	203	18	0	312
45491	29104s (+0.4s)	1260	1260	128	27	112	3	0	142
45492	29105s (+0.3s)	792	792	64	33	69	4	0	106
45493	29105s (+0.7s)	2900	2900	256	69	176	11	0	256
45494	29106s (+0.8s)	3632	3632	256	78	200	18	0	296
45495	29107s (+0.8s)	3212	3212	256	66	189	13	0	268
45496	29108s (+0.8s)	2992	2992	256	72	184	7	0	263
45497	29108s (+0.5s)	1640	1640	128	48	121	8	0	177
45498	29109s (+0.6s)	2252	2252	128	60	140	9	2	211
45499	29110s (+1.0s)	4284	4284	256	101	223	25	1	350
Episode	Time	Reward	Score	Highest	L	U	R	D	Steps
45500	29110s (+0.4s)	1368	1368	128	28	112	6	0	146
45501	29111s (+0.8s)	3308	3308	256	61	200	14	0	275
45502	29112s (+0.6s)	2220	2220	128	56	146	11	1	214
45503	29112s (+0.4s)	1240	1240	64	31	102	9	0	142
45504	29113s (+0.7s)	3044	3044	256	70	170	14	2	256
45505	29113s (+0.2s)	632	632	64	14	71	2	0	87
45506	29114s (+0.9s)	4892	4892	512	79	244	16	0	339
45507	29115s (+1.0s)	4524	4524	256	110	247	15	1	373
45508	29116s (+0.7s)	3088	3088	256	62	181	9	0	252
45509	29117s (+0.7s)	2500	2500	128	92	132	13	0	237
45510	29117s (+0.8s)	3324	3324	256	79	197	6	0	282
45511	29118s (+0.5s)	1676	1676	128	43	132	6	0	181
45512	29119s (+0.7s)	2688	2688	256	67	156	8	0	231
45513	29119s (+0.4s)	988	988	64	37	80	6	0	123
45514	29120s (+0.9s)	4076	4076	256	92	223	15	0	330
45515	29121s (+0.7s)	3096	3096	256	59	186	10	0	255
45516	29121s (+0.6s)	2268	2268	128	41	161	12	0	214
45517	29123s (+1.3s)	6168	6168	512	130	288	30	1	449
45518	29123s (+0.7s)	3180	3180	256	69	176	18	0	263
45519	29124s (+0.3s)	1092	1092	128	26	88	4	0	118
45520	29124s (+0.4s)	1176	1176	64	34	99	8	0	141
45521	29125s (+0.6s)	2492	2492	256	52	154	8	0	214
45522	29125s (+0.5s)	1812	1812	128	32	143	7	0	182
45523	29126s (+0.5s)	1804	1804	128	51	124	11	0	186
45524	29127s (+0.9s)	3968	3968	256	78	240	12	0	330
45525	29128s (+0.9s)	3588	3588	256	90	203	17	0	310
45526	29128s (+0.6s)	1908	1908	128	51	139	7	0	197
45527	29129s (+0.5s)	1588	1588	128	37	120	4	0	161
45528	29129s (+0.7s)	2512	2512	128	76	147	19	0	242
45529	29130s (+1.1s)	5444	5444	512	96	273	21	1	391
45530	29131s (+0.7s)	2876	2876	256	71	170	10	0	251
45531	29132s (+0.6s)	2520	2520	256	45	163	13	0	221
45532	29132s (+0.7s)	2624	2624	128	67	167	16	0	250
45533	29133s (+0.5s)	1620	1620	128	34	129	0	9	172
45534	29133s (+0.4s)	1624	1624	128	33	128	1	0	162
45535	29134s (+0.4s)	1432	1432	128	30	111	6	0	147
45536	29135s (+0.6s)	2456	2456	256	37	173	4	0	214
45537	29135s (+0.3s)	916	916	64	22	83	6	0	111
45538	29135s (+0.5s)	2288	2288	256	45	146	5	0	196
45539	29136s (+0.9s)	3932	3932	256	94	209	19	0	322
45540	29137s (+0.8s)	3472	3472	256	77	196	14	0	287
45541	29138s (+0.4s)	1032	1032	64	37	82	7	0	126
45542	29138s (+0.6s)	2472	2472	256	46	155	11	0	212
45543	29139s (+1.0s)	4240	4240	256	98	233	19	0	350
45544	29140s (+0.4s)	1012	1012	64	25	93	4	0	122
45545	29140s (+0.6s)	2344	2344	256	42	146	8	0	196
45546	29141s (+0.7s)	2776	2776	256	65	165	11	0	241
45547	29141s (+0.4s)	1512	1512	128	40	107	8	0	155
45548	29142s (+0.6s)	2564	2564	256	52	161	10	0	223
45549	29142s (+0.5s)	1724	1724	128	43	128	7	0	178
45550	29143s (+0.4s)	1396	1396	128	28	111	4	0	143
45551	29143s (+0.6s)	2612	2612	256	50	169	9	0	228
45552	29144s (+1.0s)	5028	5028	512	96	240	16	0	352
45553	29145s (+0.6s)	2444	2444	256	48	162	8	0	218
45554	29146s (+0.7s)	2784	2784	256	49	182	11	0	242
45555	29146s (+0.5s)	1628	1628	128	53	112	9	0	174
45556	29147s (+0.8s)	3372	3372	256	90	186	13	0	289
45557	29148s (+1.0s)	4888	4888	512	97	235	16	1	349
45558	29149s (+0.9s)	3984	3984	256	76	237	16	1	330
45559	29150s (+0.9s)	3976	3976	256	80	232	16	0	328
45560	29151s (+0.7s)	2752	2752	256	53	172	11	0	236
45561	29151s (+0.7s)	2752	2752	256	58	164	9	0	231
45562	29152s (+0.5s)	1636	1636	128	44	126	6	0	176
45563	29152s (+0.5s)	1568	1568	128	29	132	3	0	164
45564	29153s (+0.4s)	1472	1472	128	35	110	6	1	152
45565	29153s (+0.7s)	2872	2872	256	59	173	12	1	245
45566	29154s (+0.5s)	1596	1596	128	35	120	11	0	166
45567	29155s (+0.6s)	2280	2280	256	52	131	9	2	194
45568	29155s (+0.8s)	3308	3308	256	94	160	21	0	275
45569	29156s (+0.8s)	3220	3220	256	64	193	12	0	269
45570	29156s (+0.4s)	1060	1060	64	27	98	3	0	128
45571	29157s (+0.7s)	2476	2476	128	64	162	11	0	237
45572	29158s (+1.0s)	4052	4052	256	83	230	21	1	335
45573	29159s (+0.9s)	3848	3848	256	72	231	14	0	317
45574	29159s (+0.5s)	1732	1732	128	36	130	6	0	172
45575	29160s (+0.5s)	1724	1724	128	37	119	4	1	161
45576	29161s (+0.6s)	1892	1892	128	47	137	10	2	196
45577	29161s (+0.6s)	2084	2084	128	51	139	7	0	197
45578	29162s (+0.7s)	2744	2744	256	60	164	10	0	234
45579	29163s (+0.8s)	3528	3528	256	75	207	14	0	296
45580	29163s (+0.2s)	412	412	64	13	47	0	0	60
45581	29163s (+0.4s)	1404	1404	128	33	103	9	1	146
45582	29164s (+0.4s)	1344	1344	128	34	100	4	0	138
45583	29164s (+0.4s)	1460	1460	128	33	113	8	0	154
45584	29165s (+0.8s)	3620	3620	256	70	208	16	0	294
45585	29166s (+0.7s)	2792	2792	256	66	163	11	1	241
45586	29166s (+0.7s)	2904	2904	256	72	166	14	0	252
45587	29167s (+0.6s)	1916	1916	128	50	130	14	0	194
45588	29167s (+0.6s)	1908	1908	128	52	137	6	0	195
45589	29168s (+0.5s)	1788	1788	128	43	128	10	0	181
45590	29168s (+0.5s)	1516	1516	128	33	122	7	0	162
45591	29170s (+1.1s)	5580	5580	512	103	267	22	1	393
45592	29170s (+0.3s)	860	860	64	30	76	5	0	111
45593	29171s (+0.8s)	3400	3400	256	66	200	14	0	280
45594	29171s (+0.3s)	776	776	64	22	77	3	0	102
45595	29172s (+0.6s)	2508	2508	128	60	159	9	0	228
45596	29172s (+0.7s)	3088	3088	256	64	180	12	0	256
45597	29173s (+1.0s)	4340	4340	256	93	246	19	0	358
45598	29174s (+0.5s)	1792	1792	128	43	130	10	0	183
45599	29174s (+0.4s)	1240	1240	128	37	94	6	0	137
Episode	Time	Reward	Score	Highest	L	U	R	D	Steps
45600	29175s (+0.3s)	752	752	64	17	80	3	0	100
45601	29175s (+0.4s)	1132	1132	128	28	89	3	0	120
45602	29176s (+0.6s)	2004	2004	128	50	147	6	0	203
45603	29176s (+0.8s)	3236	3236	256	66	193	0	13	272
45604	29177s (+0.7s)	3064	3064	256	54	182	1	14	251
45605	29178s (+0.9s)	3656	3656	256	57	227	0	13	297
45606	29178s (+0.4s)	1572	1572	128	34	117	0	6	157
45607	29179s (+0.6s)	2496	2496	256	49	153	0	9	211
45608	29179s (+0.4s)	1192	1192	128	21	96	0	9	126
45609	29180s (+0.5s)	2116	2116	256	46	123	0	9	178
45610	29181s (+0.8s)	3308	3308	256	75	189	14	0	278
45611	29182s (+0.9s)	4040	4040	256	101	216	11	1	329
45612	29183s (+0.9s)	4264	4264	256	80	253	15	0	348
45613	29183s (+0.4s)	1356	1356	128	29	105	7	0	141
45614	29183s (+0.5s)	1664	1664	128	51	122	5	0	178
45615	29184s (+0.3s)	912	912	64	25	88	6	0	119
45616	29184s (+0.5s)	1804	1804	128	53	116	12	0	181
45617	29185s (+0.7s)	3128	3128	256	62	177	19	0	258
45618	29185s (+0.4s)	1132	1132	64	30	96	5	0	131
45619	29186s (+0.5s)	1784	1784	128	50	123	7	1	181
45620	29187s (+0.7s)	3168	3168	256	75	176	13	0	264
45621	29187s (+0.4s)	1468	1468	128	37	111	3	0	151
45622	29188s (+0.5s)	1840	1840	128	46	130	12	0	188
45623	29188s (+0.3s)	748	748	64	32	66	2	0	100
45624	29188s (+0.5s)	1504	1504	128	48	106	5	0	159
45625	29189s (+0.8s)	3276	3276	256	57	203	0	17	277
45626	29190s (+0.6s)	2436	2436	256	47	144	0	14	205
45627	29191s (+0.8s)	3368	3368	256	51	215	0	12	278
45628	29191s (+0.4s)	1416	1416	128	25	119	0	6	150
45629	29192s (+0.8s)	3208	3208	256	57	197	0	11	265
45630	29192s (+0.6s)	2032	2032	128	42	161	0	7	210
45631	29193s (+0.8s)	3324	3324	256	52	219	0	9	280
45632	29194s (+0.9s)	4008	4008	256	101	209	20	0	330
45633	29195s (+1.1s)	4536	4536	256	100	258	18	0	376
45634	29196s (+0.8s)	2936	2936	256	78	172	10	0	260
45635	29196s (+0.4s)	1300	1300	128	23	107	5	0	135
45636	29197s (+0.5s)	2052	2052	256	38	128	5	0	171
45637	29197s (+0.3s)	1008	1008	64	31	82	4	0	117
45638	29198s (+0.5s)	1528	1528	128	27	129	5	0	161
45639	29199s (+1.1s)	4612	4612	256	125	236	18	1	380
45640	29199s (+0.3s)	580	580	32	18	67	0	4	89
45641	29200s (+0.4s)	1140	1140	64	25	103	0	8	136
45642	29200s (+0.6s)	2540	2540	256	51	161	0	10	222
45643	29201s (+0.8s)	3264	3264	256	49	222	0	7	278
45644	29202s (+1.0s)	4268	4268	256	77	257	0	20	354
45645	29203s (+0.7s)	3044	3044	256	59	175	11	0	245
45646	29204s (+0.9s)	3956	3956	256	82	227	10	0	319
45647	29205s (+1.0s)	4248	4248	256	84	248	16	0	348
45648	29205s (+0.3s)	688	688	32	23	73	4	0	100
45649	29205s (+0.5s)	1780	1780	128	42	132	6	0	180
45650	29206s (+0.7s)	2944	2944	256	58	192	7	0	257
45651	29207s (+0.4s)	1464	1464	128	28	116	9	0	153
45652	29207s (+0.4s)	1464	1464	128	35	113	3	0	151
45653	29207s (+0.3s)	924	924	64	33	83	5	0	121
45654	29208s (+0.6s)	2716	2716	256	58	160	9	0	227
45655	29209s (+0.6s)	1900	1900	128	57	130	11	0	198
45656	29209s (+0.6s)	2396	2396	128	66	146	13	0	225
45657	29209s (+0.2s)	616	616	64	13	68	3	0	84
45658	29210s (+0.5s)	1784	1784	128	38	135	8	0	181
45659	29211s (+0.5s)	2132	2132	256	45	132	8	0	185
45660	29211s (+0.5s)	1696	1696	128	38	127	5	0	170
45661	29212s (+0.6s)	2368	2368	128	59	147	14	0	220
45662	29212s (+0.4s)	1468	1468	128	32	106	7	0	145
45663	29213s (+0.8s)	3496	3496	256	72	203	15	0	290
45664	29213s (+0.4s)	1184	1184	64	33	97	8	0	138
45665	29214s (+0.6s)	2480	2480	256	49	154	8	0	211
45666	29214s (+0.4s)	1368	1368	128	36	101	5	1	143
45667	29215s (+0.4s)	1408	1408	128	31	107	7	1	146
45668	29215s (+0.4s)	1188	1188	64	34	102	8	0	144
45669	29216s (+0.9s)	3988	3988	256	98	215	18	0	331
45670	29217s (+0.8s)	3488	3488	256	71	199	21	0	291
45671	29217s (+0.5s)	1496	1496	128	30	120	6	1	157
45672	29218s (+0.4s)	1400	1400	128	25	110	0	5	140
45673	29218s (+0.2s)	564	564	64	16	59	0	2	77
45674	29218s (+0.4s)	1120	1120	64	31	92	6	0	129
45675	29219s (+0.9s)	3560	3560	256	63	221	13	0	297
45676	29220s (+0.6s)	2692	2692	256	47	177	8	0	232
45677	29221s (+0.5s)	1908	1908	128	47	129	6	0	182
45678	29221s (+0.7s)	2784	2784	256	61	171	11	0	243
45679	29222s (+0.7s)	2968	2968	256	43	185	10	2	240
45680	29222s (+0.4s)	1416	1416	128	31	103	9	1	144
45681	29223s (+0.8s)	3272	3272	256	70	195	12	0	277
45682	29223s (+0.2s)	632	632	64	20	60	2	0	82
45683	29224s (+0.7s)	2948	2948	256	58	180	10	0	248
45684	29225s (+0.7s)	2896	2896	256	52	182	6	0	240
45685	29226s (+0.7s)	3104	3104	256	72	169	14	0	255
45686	29226s (+0.6s)	2328	2328	128	63	147	15	0	225
45687	29227s (+0.5s)	1776	1776	128	41	134	4	0	179
45688	29228s (+1.2s)	6136	6136	512	105	304	21	0	430
45689	29228s (+0.3s)	756	756	64	19	77	5	0	101
45690	29229s (+0.6s)	2232	2232	128	44	161	8	0	213
45691	29230s (+0.7s)	3148	3148	256	45	206	9	0	260
45692	29231s (+0.9s)	4056	4056	256	87	237	12	0	336
45693	29231s (+0.9s)	3620	3620	256	76	220	11	0	307
45694	29232s (+0.4s)	1364	1364	128	33	103	0	5	141
45695	29232s (+0.3s)	1204	1204	128	21	92	0	8	121
45696	29233s (+0.5s)	1764	1764	128	39	131	6	0	176
45697	29233s (+0.4s)	1320	1320	128	40	85	9	0	134
45698	29234s (+0.5s)	1632	1632	128	39	122	3	0	164
45699	29234s (+0.7s)	2820	2820	256	65	169	13	0	247
Episode	Time	Reward	Score	Highest	L	U	R	D	Steps
45700	29235s (+0.7s)	2772	2772	256	58	166	12	0	236
45701	29236s (+0.9s)	3968	3968	256	88	214	17	0	319
45702	29237s (+0.9s)	3684	3684	256	81	206	16	0	303
45703	29237s (+0.7s)	2576	2576	128	64	166	13	0	243
45704	29239s (+1.3s)	6808	6808	512	118	331	26	1	476
45705	29240s (+0.8s)	3464	3464	256	80	192	14	1	287
45706	29240s (+0.6s)	2504	2504	256	49	151	17	0	217
45707	29241s (+0.7s)	2808	2808	256	60	178	7	0	245
45708	29241s (+0.5s)	1844	1844	128	39	139	7	0	185
45709	29242s (+0.7s)	2904	2904	256	50	197	6	0	253
45710	29243s (+0.4s)	1188	1188	64	38	100	6	0	144
45711	29244s (+1.0s)	4328	4328	256	94	237	20	0	351
45712	29244s (+0.7s)	2544	2544	128	66	156	14	0	236
45713	29245s (+0.8s)	3592	3592	256	83	206	16	0	305
45714	29246s (+0.6s)	2424	2424	256	49	148	0	6	203
45715	29246s (+0.5s)	1888	1888	128	35	150	0	7	192
45716	29247s (+0.3s)	1128	1128	128	24	88	0	8	120
45717	29247s (+0.2s)	472	472	64	15	52	0	3	70
45718	29248s (+0.9s)	4040	4040	256	83	244	12	0	339
45719	29248s (+0.4s)	1240	1240	128	36	89	12	0	137
45720	29249s (+0.7s)	2740	2740	256	56	169	15	0	240
45721	29249s (+0.6s)	2108	2108	128	49	138	11	0	198
45722	29250s (+0.7s)	3332	3332	256	72	184	13	0	269
45723	29251s (+0.6s)	2536	2536	256	51	160	7	0	218
45724	29251s (+0.6s)	1968	1968	128	45	142	8	0	195
45725	29252s (+0.7s)	2964	2964	256	58	180	10	0	248
45726	29253s (+1.0s)	4312	4312	256	79	264	13	0	356
45727	29254s (+0.6s)	1948	1948	128	47	150	8	0	205
45728	29254s (+0.7s)	2732	2732	256	51	174	7	0	232
45729	29255s (+0.9s)	4016	4016	256	99	215	16	1	331
45730	29256s (+0.8s)	3208	3208	256	59	197	9	0	265
45731	29257s (+0.5s)	2316	2316	256	44	146	3	0	193
45732	29257s (+0.4s)	1252	1252	128	19	112	3	0	134
45733	29258s (+0.8s)	3540	3540	256	83	196	20	0	299
45734	29259s (+0.6s)	2584	2584	256	68	144	13	0	225
45735	29259s (+0.5s)	1524	1524	128	41	113	5	0	159
45736	29260s (+0.7s)	2780	2780	256	60	169	10	0	239
45737	29260s (+0.4s)	1484	1484	128	35	110	10	0	155
45738	29261s (+0.4s)	1548	1548	128	31	113	5	1	150
45739	29261s (+0.6s)	1920	1920	128	40	153	5	0	198
45740	29262s (+0.8s)	3400	3400	256	70	200	11	0	281
45741	29263s (+0.6s)	2312	2312	128	54	155	12	0	221
45742	29263s (+0.5s)	1684	1684	128	47	113	12	0	172
45743	29264s (+0.7s)	2876	2876	256	55	185	10	0	250
45744	29264s (+0.5s)	1544	1544	128	31	123	11	0	165
45745	29265s (+1.0s)	4972	4972	512	82	246	16	1	345
45746	29266s (+0.4s)	1492	1492	128	32	119	5	0	156
45747	29266s (+0.7s)	2712	2712	256	39	186	0	8	233
45748	29267s (+0.5s)	1736	1736	128	38	134	0	3	175
45749	29268s (+0.9s)	4096	4096	256	68	250	0	15	333
45750	29269s (+1.0s)	4444	4444	256	69	282	0	15	366
45751	29269s (+0.5s)	1808	1808	128	32	143	0	6	181
45752	29270s (+0.2s)	560	560	64	12	63	0	5	80
45753	29270s (+0.6s)	1908	1908	128	40	149	0	6	195
45754	29271s (+0.5s)	1792	1792	128	42	111	0	15	168
45755	29271s (+0.6s)	2516	2516	256	54	152	14	0	220
45756	29272s (+0.7s)	2740	2740	256	62	167	8	0	237
45757	29273s (+0.7s)	3140	3140	256	56	197	9	0	262
45758	29273s (+0.6s)	2628	2628	256	60	160	12	0	232
45759	29274s (+1.0s)	4112	4112	256	88	245	12	0	345
45760	29275s (+0.5s)	1732	1732	128	41	128	10	0	179
45761	29276s (+0.8s)	3540	3540	256	68	208	17	0	293
45762	29276s (+0.6s)	1880	1880	128	54	133	6	0	193
45763	29277s (+0.4s)	1164	1164	64	38	90	10	0	138
45764	29278s (+0.7s)	3200	3200	256	66	191	12	0	269
45765	29278s (+0.3s)	1008	1008	64	23	95	2	0	120
45766	29279s (+0.8s)	3296	3296	256	77	182	17	0	276
45767	29279s (+0.4s)	1532	1532	128	32	120	4	0	156
45768	29280s (+0.5s)	1808	1808	128	49	131	7	0	187
45769	29280s (+0.5s)	1608	1608	128	45	108	6	0	159
45770	29281s (+0.5s)	1760	1760	128	39	135	6	0	180
45771	29281s (+0.5s)	1632	1632	128	45	112	8	0	165
45772	29282s (+0.9s)	3976	3976	256	101	206	16	0	323
45773	29282s (+0.4s)	1312	1312	64	42	95	11	0	148
45774	29283s (+0.8s)	3488	3488	256	73	202	17	0	292
45775	29284s (+0.9s)	3740	3740	256	79	207	17	0	303
45776	29285s (+0.8s)	2972	2972	256	72	185	7	0	264
45777	29286s (+1.0s)	4056	4056	256	96	229	18	0	343
45778	29287s (+0.8s)	3296	3296	256	71	192	0	9	272
45779	29287s (+0.7s)	3112	3112	256	47	200	0	15	262
45780	29288s (+0.5s)	1512	1512	64	29	128	0	5	162
45781	29288s (+0.4s)	1496	1496	128	33	115	9	0	157
45782	29289s (+0.4s)	1104	1104	64	35	91	7	0	133
45783	29289s (+0.6s)	2012	2012	128	59	129	11	0	199
45784	29290s (+0.6s)	1984	1984	128	52	142	10	0	204
45785	29291s (+0.6s)	2576	2576	256	62	151	7	0	220
45786	29291s (+0.5s)	1772	1772	128	38	132	9	0	179
45787	29292s (+0.6s)	2224	2224	128	40	153	0	18	211
45788	29293s (+1.0s)	4172	4172	256	88	231	18	1	338
45789	29293s (+0.6s)	2172	2172	128	55	151	12	0	218
45790	29294s (+1.2s)	5824	5824	512	103	287	25	0	415
45791	29295s (+0.7s)	2660	2660	128	67	179	9	0	255
45792	29296s (+0.4s)	1300	1300	128	42	96	3	0	141
45793	29296s (+0.8s)	3428	3428	256	77	189	18	0	284
45794	29297s (+0.5s)	1680	1680	128	32	132	9	0	173
45795	29297s (+0.5s)	1996	1996	128	47	128	12	0	187
45796	29298s (+0.5s)	1732	1732	128	43	121	8	0	172
45797	29299s (+0.7s)	3244	3244	256	69	195	9	1	274
45798	29299s (+0.4s)	1376	1376	128	33	104	6	1	144
45799	29300s (+0.4s)	1464	1464	128	21	124	0	5	150
Episode	Time	Reward	Score	Highest	L	U	R	D	Steps
45800	29300s (+0.8s)	3512	3512	256	54	213	0	16	283
45801	29301s (+0.5s)	2340	2340	256	43	142	9	0	194
45802	29301s (+0.5s)	2180	2180	256	44	133	9	0	186
45803	29303s (+1.1s)	5752	5752	512	105	267	24	0	396
45804	29303s (+0.6s)	2236	2236	128	52	158	10	1	221
45805	29304s (+0.8s)	3536	3536	256	69	216	13	0	298
45806	29305s (+0.6s)	2288	2288	256	45	154	4	0	203
45807	29305s (+0.7s)	3196	3196	256	58	189	15	1	263
45808	29306s (+1.0s)	4344	4344	256	97	246	17	0	360
45809	29307s (+0.5s)	1784	1784	128	50	120	11	0	181
45810	29307s (+0.5s)	1856	1856	128	39	142	6	0	187
45811	29308s (+0.8s)	3336	3336	256	72	200	12	0	284
45812	29309s (+0.9s)	3880	3880	256	68	229	13	0	310
45813	29310s (+0.5s)	1824	1824	128	44	131	8	0	183
45814	29310s (+0.7s)	3208	3208	256	71	184	10	0	265
45815	29312s (+1.3s)	6472	6472	512	123	320	22	0	465
45816	29312s (+0.4s)	1112	1112	64	38	81	10	1	130
45817	29313s (+0.5s)	1680	1680	128	51	113	7	0	171
45818	29313s (+0.6s)	2400	2400	128	60	149	14	0	223
45819	29314s (+0.5s)	1800	1800	128	43	134	8	0	185
45820	29314s (+0.5s)	1692	1692	128	49	119	7	0	175
45821	29315s (+0.7s)	2800	2800	256	68	159	13	0	240
45822	29315s (+0.5s)	1748	1748	128	46	126	5	0	177
45823	29316s (+0.7s)	2696	2696	256	49	172	12	0	233
45824	29317s (+0.4s)	1388	1388	128	38	99	6	0	143
45825	29318s (+1.0s)	4144	4144	256	82	238	18	0	338
45826	29318s (+0.4s)	1408	1408	128	31	111	3	0	145
45827	29318s (+0.3s)	868	868	64	36	69	5	0	110
45828	29319s (+0.4s)	1440	1440	128	38	103	8	0	149
45829	29319s (+0.5s)	1760	1760	128	31	141	8	0	180
45830	29320s (+0.9s)	3768	3768	256	77	223	9	0	309
45831	29321s (+0.7s)	2792	2792	256	84	147	14	0	245
45832	29322s (+0.8s)	3524	3524	256	78	204	13	0	295
45833	29322s (+0.7s)	2832	2832	256	55	182	9	0	246
45834	29323s (+0.8s)	3340	3340	256	72	193	16	0	281
45835	29324s (+0.6s)	2244	2244	128	49	153	10	0	212
45836	29324s (+0.4s)	1496	1496	128	41	108	8	0	157
45837	29325s (+0.6s)	2064	2064	128	51	148	7	0	206
45838	29325s (+0.6s)	2248	2248	128	50	148	12	0	210
45839	29326s (+0.8s)	3460	3460	256	67	208	13	0	288
45840	29327s (+0.9s)	3928	3928	256	88	215	17	0	320
45841	29327s (+0.3s)	1008	1008	128	32	74	4	0	110
45842	29328s (+0.5s)	1656	1656	128	30	131	6	0	167
45843	29329s (+0.6s)	2072	2072	128	64	130	12	0	206
45844	29329s (+0.3s)	888	888	64	28	85	5	0	118
45845	29329s (+0.5s)	2188	2188	256	48	133	7	0	188
45846	29330s (+0.6s)	2516	2516	128	55	164	17	0	236
45847	29331s (+0.5s)	1868	1868	128	48	133	8	0	189
45848	29331s (+0.8s)	3256	3256	256	69	196	0	12	277
45849	29333s (+1.1s)	5492	5492	512	98	269	0	22	389
45850	29333s (+0.5s)	1692	1692	128	36	131	0	8	175
45851	29334s (+0.6s)	2392	2392	256	43	150	0	7	200
45852	29334s (+0.5s)	1892	1892	128	39	147	0	6	192
45853	29335s (+0.6s)	2332	2332	128	55	158	0	9	222
45854	29335s (+0.5s)	1720	1720	128	39	128	6	0	173
45855	29336s (+0.7s)	2868	2868	256	54	183	11	0	248
45856	29337s (+0.5s)	1624	1624	128	39	122	5	0	166
45857	29337s (+0.5s)	1760	1760	128	30	139	7	0	176
45858	29338s (+0.7s)	2860	2860	256	65	166	14	1	246
45859	29338s (+0.7s)	2924	2924	256	45	184	13	1	243
45860	29339s (+0.4s)	1344	1344	64	44	101	7	0	152
45861	29340s (+0.9s)	3636	3636	256	73	221	17	0	311
45862	29340s (+0.4s)	976	976	64	31	86	1	6	124
45863	29341s (+0.5s)	1652	1652	128	37	133	0	5	175
45864	29341s (+0.6s)	2524	2524	256	42	169	0	7	218
45865	29342s (+0.8s)	3260	3260	256	50	220	0	8	278
45866	29343s (+0.7s)	2772	2772	256	43	186	0	8	237
45867	29343s (+0.3s)	1008	1008	64	23	92	0	6	121
45868	29344s (+0.7s)	2820	2820	256	63	173	7	0	243
45869	29344s (+0.5s)	1648	1648	128	49	108	6	0	163
45870	29345s (+0.5s)	1576	1576	128	38	116	8	0	162
45871	29345s (+0.6s)	1908	1908	128	45	143	7	0	195
45872	29346s (+0.5s)	2156	2156	256	38	137	8	1	184
45873	29347s (+1.0s)	4576	4576	256	93	241	20	1	355
45874	29347s (+0.5s)	1852	1852	128	58	119	10	0	187
45875	29349s (+1.2s)	5992	5992	512	112	297	18	1	428
45876	29349s (+0.4s)	1352	1352	128	34	99	5	0	138
45877	29350s (+0.5s)	1596	1596	128	45	114	8	0	167
45878	29350s (+0.6s)	2420	2420	256	51	145	7	1	204
45879	29351s (+0.7s)	3076	3076	256	59	181	0	14	254
45880	29352s (+1.0s)	4192	4192	256	75	257	0	17	349
45881	29353s (+0.8s)	3548	3548	256	73	219	0	9	301
45882	29353s (+0.3s)	772	772	64	16	80	0	6	102
45883	29354s (+0.7s)	2800	2800	256	56	175	0	12	243
45884	29354s (+0.7s)	2484	2484	128	59	158	15	0	232
45885	29355s (+1.1s)	5560	5560	512	106	279	15	0	400
45886	29356s (+0.5s)	1700	1700	128	44	123	5	0	172
45887	29357s (+0.7s)	2812	2812	256	59	178	10	0	247
45888	29357s (+0.7s)	2760	2760	256	41	193	4	0	238
45889	29358s (+0.5s)	2264	2264	256	43	138	9	1	191
45890	29358s (+0.4s)	1424	1424	64	38	106	11	1	156
45891	29359s (+0.5s)	1660	1660	128	40	131	6	0	177
45892	29360s (+0.8s)	3160	3160	256	55	196	13	1	265
45893	29360s (+0.7s)	2740	2740	256	67	156	10	0	233
45894	29361s (+0.9s)	3568	3568	256	71	210	17	1	299
45895	29362s (+0.5s)	1544	1544	128	37	122	6	0	165
45896	29362s (+0.7s)	3276	3276	256	61	191	18	0	270
45897	29363s (+0.4s)	1416	1416	128	28	118	3	0	149
45898	29364s (+0.7s)	2636	2636	256	47	176	11	0	234
45899	29364s (+0.6s)	2048	2048	128	56	135	15	0	206
Episode	Time	Reward	Score	Highest	L	U	R	D	Steps
45900	29365s (+0.5s)	1708	1708	128	38	127	9	0	174
45901	29365s (+0.5s)	1596	1596	128	33	128	5	0	166
45902	29366s (+0.8s)	3484	3484	256	74	207	8	1	290
45903	29368s (+1.6s)	7988	7988	512	155	366	34	0	555
45904	29368s (+0.4s)	1444	1444	128	23	121	6	0	150
45905	29369s (+0.6s)	2032	2032	128	56	132	7	0	195
45906	29369s (+0.5s)	1432	1432	64	46	104	11	0	161
45907	29370s (+0.9s)	3696	3696	256	65	227	14	0	306
45908	29371s (+0.4s)	1332	1332	64	40	106	7	0	153
45909	29371s (+0.2s)	576	576	64	15	60	4	0	79
45910	29372s (+0.8s)	3528	3528	256	57	228	0	12	297
45911	29372s (+0.7s)	2792	2792	256	38	193	0	8	239
45912	29373s (+0.6s)	2488	2488	256	39	167	0	8	214
45913	29373s (+0.6s)	1956	1956	128	39	157	0	6	202
45914	29374s (+0.8s)	3432	3432	256	55	221	0	13	289
45915	29375s (+0.9s)	3556	3556	256	58	228	0	17	303
45916	29376s (+0.4s)	1348	1348	128	23	111	0	8	142
45917	29376s (+0.8s)	3352	3352	256	56	204	0	14	274
45918	29377s (+0.7s)	2876	2876	256	42	200	0	9	251
45919	29377s (+0.3s)	752	752	64	16	78	0	4	98
45920	29378s (+0.9s)	4024	4024	256	86	228	11	0	325
45921	29379s (+0.8s)	3436	3436	256	71	205	14	0	290
45922	29379s (+0.4s)	1176	1176	128	30	93	4	0	127
45923	29380s (+0.8s)	3520	3520	256	86	196	15	1	298
45924	29381s (+0.7s)	2980	2980	256	67	173	12	0	252
45925	29382s (+0.6s)	2504	2504	256	55	155	8	0	218
45926	29382s (+0.6s)	2048	2048	128	45	150	8	0	203
45927	29383s (+0.8s)	3400	3400	256	62	207	12	0	281
45928	29384s (+0.5s)	1496	1496	128	34	115	9	0	158
45929	29384s (+0.4s)	1348	1348	128	30	115	3	0	148
45930	29385s (+0.9s)	4140	4140	256	75	246	16	0	337
45931	29386s (+0.8s)	3352	3352	256	57	215	12	0	284
45932	29386s (+0.5s)	1628	1628	128	44	117	6	0	167
45933	29387s (+0.8s)	3308	3308	256	85	172	16	1	274
45934	29388s (+0.7s)	2960	2960	256	58	166	16	1	241
45935	29389s (+1.1s)	5516	5516	512	102	265	25	1	393
45936	29389s (+0.6s)	2356	2356	256	56	135	8	0	199
45937	29390s (+0.5s)	1808	1808	128	42	135	9	0	186
45938	29390s (+0.5s)	1676	1676	128	39	123	8	0	170
45939	29391s (+0.6s)	2576	2576	256	69	139	16	0	224
45940	29391s (+0.4s)	1288	1288	64	39	96	8	0	143
45941	29393s (+1.5s)	7644	7644	512	151	352	26	0	529
45942	29394s (+0.7s)	3200	3200	256	65	184	13	0	262
45943	29394s (+0.4s)	1452	1452	128	27	116	7	0	150
45944	29395s (+1.0s)	4296	4296	256	98	242	19	0	359
45945	29396s (+0.5s)	1500	1500	128	35	117	7	0	159
45946	29396s (+0.8s)	3356	3356	256	72	203	10	0	285
45947	29397s (+0.7s)	2888	2888	256	56	184	13	0	253
45948	29398s (+0.9s)	3708	3708	256	93	204	16	1	314
45949	29399s (+0.7s)	2716	2716	256	65	164	9	0	238
45950	29399s (+0.5s)	1804	1804	128	46	128	12	0	186
45951	29399s (+0.2s)	544	544	64	17	50	5	0	72
45952	29400s (+0.8s)	3444	3444	256	67	214	11	0	292
45953	29401s (+0.7s)	3100	3100	256	61	188	11	0	260
45954	29402s (+0.8s)	3232	3232	256	65	192	12	1	270
45955	29403s (+0.8s)	3240	3240	256	63	198	11	0	272
45956	29404s (+0.9s)	3876	3876	256	99	202	17	1	319
45957	29405s (+1.1s)	5760	5760	512	92	293	22	0	407
45958	29405s (+0.5s)	2280	2280	256	40	139	5	0	184
45959	29406s (+0.6s)	2392	2392	256	37	165	5	0	207
45960	29406s (+0.2s)	480	480	32	21	52	4	0	77
45961	29406s (+0.3s)	800	800	64	23	70	8	0	101
45962	29407s (+0.6s)	2212	2212	256	59	125	9	0	193
45963	29407s (+0.3s)	672	672	64	27	63	2	0	92
45964	29408s (+0.6s)	2752	2752	256	49	164	9	0	222
45965	29408s (+0.5s)	1536	1536	128	37	118	8	0	163
45966	29409s (+0.7s)	3068	3068	256	57	186	9	0	252
45967	29410s (+0.6s)	1952	1952	128	49	143	8	1	201
45968	29410s (+0.5s)	1876	1876	128	50	135	7	0	192
45969	29411s (+0.8s)	3524	3524	256	80	188	13	0	281
45970	29412s (+0.6s)	1972	1972	128	54	150	2	0	206
45971	29412s (+0.8s)	3192	3192	256	69	186	11	0	266
45972	29413s (+0.6s)	2496	2496	256	52	157	7	0	216
45973	29414s (+0.7s)	2796	2796	256	54	179	8	2	243
45974	29414s (+0.5s)	1724	1724	128	34	134	4	0	172
45975	29414s (+0.3s)	700	700	64	26	65	2	0	93
45976	29415s (+0.6s)	2240	2240	128	41	163	0	11	215
45977	29416s (+1.2s)	5992	5992	512	86	322	0	13	421
45978	29417s (+0.6s)	1988	1988	128	45	160	0	5	210
45979	29417s (+0.4s)	1476	1476	128	33	113	0	7	153
45980	29418s (+0.5s)	1680	1680	128	48	116	6	2	172
45981	29419s (+1.0s)	5064	5064	512	99	238	17	1	355
45982	29419s (+0.5s)	1888	1888	128	49	132	8	0	189
45983	29420s (+1.0s)	5052	5052	512	96	236	12	0	344
45984	29421s (+0.4s)	1208	1208	128	35	90	5	0	130
45985	29421s (+0.7s)	2768	2768	256	58	163	14	0	235
45986	29422s (+0.5s)	1500	1500	128	34	117	8	0	159
45987	29423s (+0.8s)	3468	3468	256	64	215	12	0	291
45988	29423s (+0.8s)	3208	3208	256	64	189	13	1	267
45989	29424s (+0.3s)	908	908	64	26	88	3	0	117
45990	29424s (+0.5s)	1784	1784	128	41	132	8	0	181
45991	29425s (+0.7s)	2800	2800	256	59	164	0	15	238
45992	29425s (+0.6s)	2560	2560	256	42	173	0	5	220
45993	29426s (+0.6s)	2560	2560	256	39	175	0	10	224
45994	29427s (+0.5s)	1624	1624	128	42	116	0	8	166
45995	29427s (+0.5s)	1784	1784	128	41	127	0	13	181
45996	29428s (+0.6s)	2368	2368	256	34	155	0	6	195
45997	29428s (+0.3s)	1028	1028	64	25	89	0	7	121
45998	29429s (+0.6s)	2484	2484	256	41	164	0	8	213
45999	29429s (+0.5s)	1788	1788	128	32	137	0	7	176
Episode	Time	Reward	Score	Highest	L	U	R	D	Steps
46000	29430s (+0.4s)	1436	1436	128	37	105	6	0	148
46001	29430s (+0.4s)	1380	1380	64	38	109	7	0	154
46002	29431s (+1.0s)	4176	4176	256	102	220	17	0	339
46003	29432s (+0.5s)	1972	1972	128	50	133	12	0	195
46004	29432s (+0.9s)	3828	3828	256	93	206	13	0	312
46005	29433s (+0.7s)	2832	2832	256	68	163	13	0	244
46006	29434s (+0.8s)	3488	3488	256	67	212	12	0	291
46007	29435s (+0.6s)	2368	2368	256	46	149	9	0	204
46008	29435s (+0.7s)	2904	2904	256	78	166	13	0	257
46009	29436s (+0.7s)	2856	2856	256	55	192	5	0	252
46010	29436s (+0.4s)	1564	1564	128	32	123	7	0	162
46011	29437s (+0.8s)	3720	3720	256	77	221	10	0	308
46012	29438s (+0.6s)	2232	2232	128	54	149	10	0	213
46013	29438s (+0.5s)	1548	1548	128	31	123	5	0	159
46014	29439s (+0.9s)	4088	4088	256	104	208	17	1	330
46015	29440s (+0.8s)	3552	3552	256	71	210	11	0	292
46016	29441s (+0.7s)	2464	2464	128	63	152	12	0	227
46017	29442s (+0.7s)	2832	2832	256	59	180	11	0	250
46018	29442s (+0.3s)	944	944	64	30	76	10	0	116
46019	29442s (+0.5s)	1520	1520	128	41	114	4	0	159
46020	29443s (+0.3s)	656	656	64	18	72	2	0	92
46021	29444s (+0.8s)	3568	3568	256	66	223	14	0	303
46022	29444s (+0.7s)	3288	3288	256	64	196	13	0	273
46023	29445s (+1.0s)	4180	4180	256	92	239	16	0	347
46024	29446s (+0.5s)	1640	1640	128	39	120	7	0	166
46025	29447s (+1.2s)	5860	5860	512	111	285	24	0	420
46026	29448s (+0.7s)	2888	2888	256	59	177	12	0	248
46027	29448s (+0.7s)	2692	2692	256	56	164	13	0	233
46028	29449s (+0.8s)	3212	3212	256	78	179	13	0	270
46029	29450s (+0.4s)	1300	1300	128	35	101	5	0	141
46030	29451s (+1.0s)	4364	4364	256	79	272	18	0	369
46031	29451s (+0.7s)	3204	3204	256	61	196	7	0	264
46032	29452s (+0.7s)	2992	2992	256	62	173	13	0	248
46033	29453s (+0.9s)	3764	3764	256	75	219	13	0	307
46034	29454s (+1.2s)	5704	5704	512	108	279	22	0	409
46035	29455s (+0.9s)	3628	3628	256	77	209	19	1	306
46036	29456s (+0.8s)	3364	3364	256	60	209	10	0	279
46037	29456s (+0.7s)	2916	2916	256	51	196	8	0	255
46038	29457s (+0.5s)	1604	1604	128	42	118	8	0	168
46039	29458s (+0.8s)	3412	3412	256	81	186	17	0	284
46040	29459s (+0.9s)	3988	3988	256	68	247	0	15	330
46041	29459s (+0.3s)	668	668	64	16	70	0	6	92
46042	29460s (+0.6s)	2720	2720	256	49	175	4	0	228
46043	29460s (+0.6s)	2516	2516	256	54	154	8	0	216
46044	29461s (+0.7s)	2744	2744	256	54	167	12	0	233
46045	29462s (+0.9s)	3892	3892	256	87	220	12	0	319
46046	29463s (+0.8s)	3412	3412	256	83	183	18	0	284
46047	29463s (+0.5s)	2268	2268	256	41	143	7	0	191
46048	29464s (+0.8s)	3280	3280	256	80	185	17	0	282
46049	29465s (+0.5s)	1580	1580	128	44	109	9	0	162
46050	29465s (+0.6s)	2008	2008	128	47	150	8	0	205
46051	29466s (+0.6s)	2400	2400	128	60	144	19	0	223
46052	29466s (+0.3s)	1080	1080	128	29	80	9	0	118
46053	29467s (+0.6s)	2540	2540	256	55	165	6	0	226
46054	29467s (+0.6s)	2200	2200	128	44	153	8	1	206
46055	29468s (+0.5s)	1880	1880	128	52	133	8	0	193
46056	29469s (+0.7s)	2980	2980	256	57	198	11	0	266
46057	29469s (+0.5s)	1768	1768	128	38	137	3	0	178
46058	29470s (+0.7s)	2784	2784	128	67	183	13	0	263
46059	29471s (+0.8s)	3288	3288	256	62	199	13	0	274
46060	29471s (+0.4s)	928	928	64	30	89	4	0	123
46061	29472s (+0.7s)	2764	2764	256	64	159	16	0	239
46062	29472s (+0.5s)	1608	1608	128	39	121	9	0	169
46063	29473s (+0.8s)	3256	3256	256	53	214	0	5	272
46064	29474s (+0.6s)	2500	2500	256	44	165	0	8	217
46065	29474s (+0.7s)	2928	2928	256	60	165	0	15	240
46066	29475s (+0.9s)	3872	3872	256	65	237	0	13	315
46067	29476s (+0.5s)	1780	1780	128	34	138	0	9	181
46068	29477s (+0.9s)	3544	3544	256	50	238	0	12	300
46069	29477s (+0.7s)	2948	2948	256	39	198	0	11	248
46070	29478s (+0.6s)	2436	2436	256	40	158	0	8	206
46071	29479s (+0.8s)	3548	3548	256	77	211	13	0	301
46072	29479s (+0.5s)	1732	1732	128	38	127	8	0	173
46073	29480s (+0.6s)	1980	1980	128	47	152	9	0	208
46074	29481s (+0.6s)	2588	2588	256	41	176	5	0	222
46075	29482s (+1.0s)	4480	4480	256	99	249	18	0	366
46076	29482s (+0.4s)	1312	1312	128	33	97	9	0	139
46077	29483s (+0.6s)	1972	1972	128	59	127	10	0	196
46078	29483s (+0.7s)	2800	2800	256	74	159	10	0	243
46079	29484s (+0.4s)	932	932	64	37	83	3	0	123
46080	29484s (+0.8s)	3328	3328	256	84	184	10	0	278
46081	29485s (+0.4s)	1152	1152	64	34	91	9	1	135
46082	29485s (+0.4s)	1452	1452	128	37	110	5	0	152
46083	29486s (+0.4s)	1276	1276	128	35	89	3	0	127
46084	29487s (+0.9s)	3804	3804	256	85	218	14	0	317
46085	29487s (+0.6s)	2444	2444	256	58	138	11	1	208
46086	29488s (+0.5s)	1560	1560	64	48	120	8	0	176
46087	29488s (+0.4s)	1152	1152	64	31	96	0	6	133
46088	29488s (+0.3s)	1128	1128	128	24	90	1	3	118
46089	29490s (+1.2s)	6172	6172	512	85	336	0	15	436
46090	29490s (+0.6s)	2472	2472	256	45	156	0	9	210
46091	29491s (+0.5s)	1760	1760	128	39	134	0	7	180
46092	29492s (+0.7s)	3196	3196	256	60	187	0	16	263
46093	29492s (+0.6s)	2300	2300	256	44	145	0	10	199
46094	29493s (+0.8s)	3652	3652	256	73	213	0	17	303
46095	29494s (+0.9s)	3960	3960	256	75	231	0	18	324
46096	29495s (+0.7s)	3100	3100	256	67	176	0	11	254
46097	29495s (+0.5s)	1572	1572	128	34	124	0	5	163
46098	29496s (+0.9s)	3752	3752	256	67	237	0	16	320
46099	29497s (+0.7s)	2936	2936	256	53	184	1	13	251
Episode	Time	Reward	Score	Highest	L	U	R	D	Steps
46100	29497s (+0.3s)	1144	1144	128	22	99	3	0	124
46101	29498s (+0.5s)	1880	1880	128	52	132	9	0	193
46102	29498s (+0.7s)	2936	2936	256	53	178	9	0	240
46103	29499s (+0.6s)	2696	2696	256	60	159	14	0	233
46104	29500s (+1.1s)	5688	5688	512	96	276	23	0	395
46105	29501s (+0.8s)	3200	3200	256	62	187	19	0	268
46106	29501s (+0.4s)	1472	1472	128	35	114	5	0	154
46107	29502s (+0.5s)	1504	1504	128	45	105	9	0	159
46108	29502s (+0.8s)	3244	3244	256	61	199	14	0	274
46109	29503s (+0.4s)	1328	1328	128	30	101	6	0	137
46110	29504s (+0.8s)	3224	3224	256	67	197	6	0	270
46111	29504s (+0.6s)	1936	1936	128	47	139	8	1	195
46112	29504s (+0.2s)	536	536	32	13	65	3	0	81
46113	29505s (+0.7s)	2792	2792	256	63	167	11	0	241
46114	29506s (+0.6s)	1904	1904	128	48	139	8	0	195
46115	29506s (+0.3s)	872	872	64	21	85	7	0	113
46116	29507s (+0.8s)	3228	3228	256	64	198	0	9	271
46117	29507s (+0.6s)	2340	2340	256	33	160	0	5	198
46118	29508s (+0.2s)	608	608	64	13	61	0	5	79
46119	29508s (+0.6s)	2008	2008	128	51	140	0	7	198
46120	29509s (+0.5s)	1552	1552	128	31	121	0	6	158
46121	29510s (+0.9s)	3972	3972	256	64	243	0	20	327
46122	29510s (+0.5s)	1812	1812	128	31	145	0	12	188
46123	29511s (+1.0s)	4308	4308	256	87	251	17	0	355
46124	29512s (+0.7s)	2948	2948	256	57	182	9	1	249
46125	29512s (+0.7s)	2792	2792	256	46	189	6	0	241
46126	29513s (+0.8s)	3296	3296	256	86	182	14	0	282
46127	29514s (+0.3s)	1080	1080	128	21	88	4	0	113
46128	29514s (+0.3s)	988	988	64	36	82	4	0	122
46129	29515s (+0.5s)	2268	2268	256	39	139	8	0	186
46130	29515s (+0.5s)	1788	1788	128	45	127	10	0	182
46131	29516s (+0.5s)	1724	1724	128	43	122	6	0	171
46132	29516s (+0.7s)	2968	2968	256	68	189	6	0	263
46133	29517s (+0.7s)	3168	3168	256	72	170	17	1	260
46134	29517s (+0.4s)	1248	1248	128	31	91	9	1	132
46135	29518s (+0.8s)	3408	3408	256	83	185	14	1	283
46136	29519s (+0.5s)	1908	1908	128	50	131	14	0	195
46137	29519s (+0.4s)	1504	1504	128	43	105	10	1	159
46138	29520s (+0.5s)	1804	1804	128	56	119	11	0	186
46139	29520s (+0.5s)	1700	1700	128	49	114	14	0	177
46140	29521s (+0.3s)	784	784	64	20	79	3	0	102
46141	29521s (+0.5s)	1528	1528	128	42	109	10	0	161
46142	29522s (+0.5s)	1808	1808	128	42	132	3	0	177
46143	29522s (+0.3s)	1172	1172	128	26	94	6	0	126
46144	29522s (+0.5s)	2296	2296	256	48	134	0	12	194
46145	29523s (+0.7s)	2808	2808	256	50	179	0	11	240
46146	29524s (+0.4s)	1164	1164	64	26	100	0	8	134
46147	29524s (+0.5s)	1804	1804	128	40	135	0	11	186
46148	29525s (+0.6s)	2380	2380	256	34	158	0	11	203
46149	29525s (+0.5s)	1948	1948	128	38	142	0	5	185
46150	29526s (+0.6s)	2664	2664	256	48	168	0	11	227
46151	29527s (+0.7s)	2532	2532	128	53	174	0	17	244
46152	29527s (+0.5s)	1868	1868	128	41	144	0	3	188
46153	29528s (+0.8s)	3144	3144	256	57	191	13	0	261
46154	29528s (+0.4s)	1288	1288	128	30	96	3	0	129
46155	29529s (+0.8s)	3644	3644	256	63	222	13	0	298
46156	29530s (+1.0s)	4312	4312	256	90	248	18	0	356
46157	29531s (+0.4s)	1480	1480	128	36	112	6	0	154
46158	29531s (+0.8s)	3440	3440	256	82	192	10	0	284
46159	29532s (+0.5s)	2340	2340	256	42	145	8	0	195
46160	29533s (+0.7s)	3060	3060	256	65	176	19	0	260
46161	29533s (+0.4s)	1428	1428	128	35	105	6	0	146
46162	29534s (+1.1s)	5516	5516	512	107	267	20	0	394
46163	29535s (+1.0s)	4288	4288	256	82	254	15	0	351
46164	29536s (+0.5s)	1624	1624	128	36	121	6	0	163
46165	29536s (+0.5s)	1804	1804	128	50	130	6	0	186
46166	29537s (+0.5s)	1600	1600	128	35	128	4	0	167
46167	29537s (+0.6s)	2332	2332	128	48	159	9	0	216
46168	29538s (+0.5s)	1644	1644	128	36	116	11	0	163
46169	29539s (+0.9s)	4488	4488	512	80	211	17	1	309
46170	29540s (+1.0s)	5304	5304	512	87	277	14	0	378
46171	29540s (+0.5s)	2192	2192	256	42	136	11	0	189
46172	29541s (+0.4s)	1536	1536	128	38	111	7	0	156
46173	29541s (+0.6s)	2264	2264	128	64	145	15	0	224
46174	29542s (+0.7s)	3084	3084	256	56	184	11	0	251
46175	29543s (+0.9s)	3580	3580	256	73	212	13	0	298
46176	29543s (+0.5s)	1704	1704	128	49	112	10	0	171
46177	29544s (+0.5s)	2184	2184	256	40	133	0	15	188
46178	29545s (+0.6s)	2600	2600	256	49	168	0	8	225
46179	29545s (+0.8s)	3280	3280	256	61	207	0	14	282
46180	29546s (+0.4s)	1212	1212	64	38	98	0	9	145
46181	29546s (+0.5s)	1696	1696	128	30	138	0	10	178
46182	29547s (+0.8s)	3412	3412	256	64	209	0	12	285
46183	29548s (+0.7s)	2796	2796	256	48	180	0	14	242
46184	29548s (+0.6s)	2448	2448	256	37	160	0	9	206
46185	29549s (+0.5s)	1532	1532	128	36	117	0	9	162
46186	29549s (+0.3s)	852	852	64	28	74	7	0	109
46187	29550s (+0.5s)	1776	1776	128	44	126	9	0	179
46188	29550s (+0.6s)	2632	2632	256	55	170	8	0	233
46189	29551s (+0.6s)	1900	1900	128	41	145	7	0	193
46190	29552s (+0.7s)	2724	2724	256	64	161	12	0	237
46191	29552s (+0.4s)	1440	1440	128	33	112	4	0	149
46192	29553s (+0.5s)	1800	1800	128	38	137	0	10	185
46193	29554s (+1.0s)	4420	4420	256	114	225	24	0	363
46194	29555s (+1.0s)	4112	4112	256	84	248	13	0	345
46195	29556s (+1.0s)	4300	4300	256	87	247	19	0	353
46196	29556s (+0.7s)	3112	3112	256	58	189	11	0	258
46197	29557s (+1.1s)	4604	4604	256	93	272	16	0	381
46198	29558s (+0.5s)	1748	1748	128	38	132	7	0	177
46199	29559s (+0.9s)	3816	3816	256	78	223	16	0	317
Episode	Time	Reward	Score	Highest	L	U	R	D	Steps
46200	29560s (+0.7s)	2780	2780	256	61	169	8	0	238
46201	29561s (+1.0s)	4372	4372	256	96	254	12	1	363
46202	29561s (+0.7s)	2676	2676	256	43	178	7	0	228
46203	29562s (+0.4s)	1264	1264	128	32	99	6	0	137
46204	29562s (+0.5s)	1664	1664	128	50	107	10	1	168
46205	29563s (+0.9s)	4208	4208	256	83	248	15	0	346
46206	29564s (+0.6s)	2364	2364	256	28	166	6	0	200
46207	29564s (+0.5s)	1600	1600	128	45	112	10	0	167
46208	29565s (+0.8s)	3576	3576	256	75	196	11	0	282
46209	29566s (+0.8s)	3656	3656	256	71	215	11	0	297
46210	29566s (+0.6s)	2396	2396	256	48	144	10	0	202
46211	29567s (+0.5s)	1828	1828	128	51	128	7	0	186
46212	29568s (+0.5s)	1596	1596	128	38	126	0	6	170
46213	29568s (+0.8s)	3432	3432	256	55	222	0	12	289
46214	29569s (+0.8s)	3220	3220	256	57	203	0	8	268
46215	29570s (+0.4s)	1372	1372	128	25	118	0	2	145
46216	29570s (+0.5s)	2076	2076	256	31	140	0	5	176
46217	29571s (+0.8s)	3484	3484	256	56	228	0	11	295
46218	29571s (+0.6s)	2128	2128	128	40	144	0	12	196
46219	29572s (+0.4s)	1368	1368	128	31	109	3	0	143
46220	29573s (+0.7s)	3120	3120	256	49	200	11	0	260
46221	29573s (+0.9s)	3792	3792	256	80	210	14	0	304
46222	29574s (+0.6s)	2376	2376	128	60	140	22	0	222
46223	29575s (+0.9s)	4000	4000	256	96	210	22	0	328
46224	29576s (+0.8s)	3364	3364	256	69	200	12	1	282
46225	29576s (+0.5s)	1720	1720	128	29	145	7	0	181
46226	29577s (+0.3s)	776	776	64	32	68	5	1	106
46227	29578s (+1.0s)	4276	4276	256	89	244	19	0	352
46228	29578s (+0.6s)	1864	1864	128	40	140	11	0	191
46229	29579s (+0.5s)	1628	1628	128	40	112	10	1	163
46230	29579s (+0.5s)	2220	2220	256	48	135	8	0	191
46231	29580s (+0.3s)	1048	1048	64	32	86	7	1	126
46232	29581s (+0.9s)	4160	4160	256	87	237	19	0	343
46233	29581s (+0.4s)	1500	1500	128	33	110	6	0	149
46234	29581s (+0.4s)	1368	1368	128	35	102	5	0	142
46235	29582s (+0.7s)	2988	2988	256	49	192	7	0	248
46236	29583s (+0.9s)	3612	3612	256	83	208	14	0	305
46237	29584s (+1.4s)	6872	6872	512	142	315	23	0	480
46238	29585s (+0.6s)	2220	2220	128	40	165	8	1	214
46239	29586s (+0.7s)	2724	2724	256	55	165	10	0	230
46240	29587s (+1.0s)	4276	4276	256	106	235	13	0	354
46241	29587s (+0.4s)	1208	1208	128	34	93	4	0	131
46242	29588s (+0.5s)	1732	1732	128	48	115	10	1	174
46243	29588s (+0.9s)	3568	3568	256	86	198	17	0	301
46244	29589s (+0.6s)	2764	2764	256	59	166	14	0	239
46245	29590s (+0.8s)	3464	3464	256	65	215	16	0	296
46246	29591s (+0.6s)	2280	2280	128	58	149	13	0	220
46247	29592s (+1.0s)	4360	4360	256	91	253	20	0	364
46248	29592s (+0.2s)	424	424	32	12	55	1	0	68
46249	29592s (+0.4s)	1392	1392	128	30	109	0	4	143
46250	29593s (+0.7s)	3040	3040	256	56	189	0	10	255
46251	29593s (+0.4s)	1496	1496	128	35	113	0	9	157
46252	29594s (+0.3s)	1084	1084	128	21	91	0	3	115
46253	29594s (+0.5s)	1904	1904	128	52	126	13	0	191
46254	29595s (+0.7s)	3124	3124	256	59	190	11	0	260
46255	29595s (+0.4s)	1012	1012	64	28	92	2	0	122
46256	29596s (+0.3s)	668	668	32	20	71	4	0	95
46257	29596s (+0.6s)	2544	2544	256	51	161	11	0	223
46258	29597s (+0.8s)	3428	3428	256	63	205	0	19	287
46259	29598s (+0.9s)	3680	3680	256	57	235	0	15	307
46260	29599s (+1.0s)	4256	4256	256	89	248	17	0	354
46261	29600s (+0.8s)	3612	3612	256	79	197	16	0	292
46262	29601s (+0.8s)	3248	3248	256	70	189	15	0	274
46263	29601s (+0.4s)	1340	1340	128	22	114	5	0	141
46264	29602s (+0.8s)	3292	3292	256	83	187	12	0	282
46265	29602s (+0.3s)	844	844	64	26	81	5	0	112
46266	29603s (+0.8s)	3312	3312	256	73	195	13	0	281
46267	29604s (+0.8s)	3076	3076	256	74	184	10	0	268
46268	29604s (+0.5s)	1784	1784	128	48	128	5	0	181
46269	29605s (+0.9s)	3976	3976	256	74	237	17	0	328
46270	29606s (+0.9s)	4636	4636	512	73	230	10	0	313
46271	29607s (+0.5s)	1904	1904	128	45	131	8	0	184
46272	29607s (+0.4s)	1452	1452	128	29	114	8	0	151
46273	29607s (+0.4s)	1144	1144	128	28	90	4	1	123
46274	29608s (+0.5s)	1896	1896	128	48	134	5	0	187
46275	29609s (+0.7s)	3140	3140	256	57	191	6	0	254
46276	29609s (+0.3s)	800	800	64	20	85	3	0	108
46277	29610s (+0.7s)	2652	2652	256	69	153	11	0	233
46278	29611s (+1.1s)	4652	4652	256	106	260	19	0	385
46279	29611s (+0.7s)	2952	2952	256	63	177	13	0	253
46280	29612s (+0.5s)	1536	1536	128	37	120	5	0	162
46281	29613s (+0.7s)	3024	3024	256	69	165	17	0	251
46282	29613s (+0.8s)	3480	3480	256	65	209	14	1	289
46283	29614s (+0.4s)	1372	1372	128	35	107	2	0	144
46284	29615s (+0.7s)	3000	3000	256	60	177	0	8	245
46285	29615s (+0.4s)	1324	1324	128	29	102	0	6	137
46286	29616s (+0.9s)	4004	4004	256	68	252	0	15	335
46287	29616s (+0.4s)	1532	1532	128	33	119	0	5	157
46288	29617s (+0.5s)	1808	1808	128	39	140	8	0	187
46289	29618s (+0.7s)	3164	3164	256	80	174	11	0	265
46290	29618s (+0.7s)	2432	2432	128	62	158	11	0	231
46291	29619s (+0.6s)	1924	1924	128	44	152	3	0	199
46292	29619s (+0.4s)	1472	1472	128	33	117	6	0	156
46293	29620s (+0.5s)	2228	2228	256	48	136	8	0	192
46294	29620s (+0.2s)	488	488	64	17	52	3	0	72
46295	29621s (+0.7s)	3012	3012	256	67	185	7	0	259
46296	29622s (+0.8s)	3336	3336	256	69	198	14	0	281
46297	29622s (+0.5s)	1792	1792	128	43	133	7	0	183
46298	29622s (+0.4s)	1428	1428	128	40	110	6	0	156
46299	29623s (+0.7s)	2912	2912	256	72	173	9	0	254
Episode	Time	Reward	Score	Highest	L	U	R	D	Steps
46300	29624s (+0.6s)	2588	2588	256	51	155	0	15	221
46301	29624s (+0.5s)	2084	2084	128	47	139	0	7	193
46302	29625s (+0.5s)	1844	1844	128	37	145	0	9	191
46303	29625s (+0.3s)	920	920	64	23	84	0	6	113
46304	29626s (+0.7s)	2924	2924	256	59	163	0	11	233
46305	29626s (+0.3s)	808	808	64	22	79	0	8	109
46306	29627s (+0.7s)	2792	2792	256	51	185	7	0	243
46307	29628s (+0.7s)	2932	2932	256	62	188	9	0	259
46308	29628s (+0.3s)	1140	1140	128	29	86	8	0	123
46309	29628s (+0.4s)	1128	1128	64	31	99	4	0	134
46310	29629s (+0.7s)	2932	2932	256	70	175	14	0	259
46311	29629s (+0.3s)	1256	1256	128	23	96	7	0	126
46312	29630s (+1.0s)	3992	3992	256	100	216	16	0	332
46313	29631s (+0.5s)	1760	1760	128	34	135	10	0	179
46314	29632s (+1.2s)	6084	6084	512	111	294	22	1	428
46315	29632s (+0.3s)	688	688	64	22	71	3	0	96
46316	29633s (+0.4s)	1292	1292	128	31	101	6	0	138
46317	29634s (+0.8s)	3328	3328	256	68	198	12	0	278
46318	29634s (+0.5s)	1648	1648	128	49	112	7	0	168
46319	29635s (+1.0s)	5088	5088	512	84	255	18	0	357
46320	29636s (+0.5s)	1552	1552	128	44	107	8	0	159
46321	29636s (+0.5s)	1780	1780	128	36	137	6	1	180
46322	29637s (+0.6s)	2456	2456	256	51	150	10	0	211
46323	29637s (+0.7s)	2944	2944	256	67	184	6	0	257
46324	29638s (+0.3s)	708	708	64	19	71	4	0	94
46325	29638s (+0.5s)	1508	1508	128	46	106	8	0	160
46326	29639s (+0.4s)	1464	1464	128	32	112	5	0	149
46327	29639s (+0.7s)	2556	2556	128	75	146	14	0	235
46328	29640s (+0.5s)	1896	1896	128	53	129	10	0	192
46329	29641s (+0.8s)	3244	3244	256	59	204	0	11	274
46330	29641s (+0.6s)	2588	2588	256	45	171	0	8	224
46331	29642s (+0.6s)	2632	2632	256	48	164	0	12	224
46332	29642s (+0.5s)	1612	1612	128	40	116	0	5	161
46333	29643s (+0.9s)	3952	3952	256	66	244	0	13	323
46334	29644s (+0.7s)	3196	3196	256	52	199	0	16	267
46335	29645s (+0.7s)	2476	2476	128	47	170	0	14	231
46336	29645s (+0.4s)	1184	1184	64	29	104	0	10	143
46337	29646s (+0.4s)	1372	1372	128	20	119	0	5	144
46338	29647s (+0.9s)	4004	4004	256	87	231	12	0	330
46339	29647s (+0.5s)	1664	1664	128	47	115	5	0	167
46340	29648s (+0.8s)	3372	3372	256	61	213	15	0	289
46341	29648s (+0.4s)	1268	1268	128	39	98	7	0	144
46342	29649s (+0.6s)	2180	2180	128	67	137	15	0	219
46343	29649s (+0.6s)	2040	2040	128	48	141	8	0	197
46344	29651s (+1.0s)	4508	4508	256	110	237	26	0	373
46345	29652s (+1.0s)	5328	5328	512	95	243	24	1	363
46346	29652s (+0.5s)	1656	1656	128	45	113	7	1	166
46347	29653s (+0.5s)	1676	1676	128	51	112	7	1	171
46348	29654s (+1.0s)	4308	4308	256	89	247	19	0	355
46349	29654s (+0.9s)	3796	3796	256	77	214	14	0	305
46350	29655s (+0.3s)	952	952	64	28	85	5	0	118
46351	29655s (+0.7s)	2904	2904	256	60	173	11	0	244
46352	29656s (+0.5s)	1588	1588	128	48	103	10	0	161
46353	29656s (+0.5s)	1800	1800	128	43	136	6	0	185
46354	29657s (+0.8s)	3764	3764	256	80	213	11	0	304
46355	29658s (+0.9s)	3856	3856	256	92	202	21	0	315
46356	29659s (+0.5s)	1476	1476	128	30	123	3	0	156
46357	29659s (+0.7s)	2960	2960	256	55	198	8	0	261
46358	29660s (+0.5s)	1812	1812	128	52	127	9	0	188
46359	29661s (+0.7s)	2508	2508	128	57	167	13	0	237
46360	29661s (+0.5s)	1612	1612	128	34	130	6	0	170
46361	29662s (+0.4s)	1508	1508	128	27	126	4	0	157
46362	29662s (+0.7s)	2696	2696	256	54	173	7	0	234
46363	29663s (+1.1s)	4552	4552	256	105	253	22	0	380
46364	29664s (+0.4s)	1332	1332	128	35	105	5	0	145
46365	29664s (+0.6s)	2596	2596	256	42	177	5	0	224
46366	29665s (+0.8s)	3344	3344	256	56	212	13	1	282
46367	29666s (+0.7s)	3160	3160	256	56	191	12	0	259
46368	29666s (+0.5s)	1892	1892	128	44	138	9	0	191
46369	29667s (+0.4s)	1480	1480	128	34	108	5	0	147
46370	29668s (+0.6s)	2244	2244	128	51	152	12	1	216
46371	29668s (+0.6s)	1920	1920	128	41	151	6	0	198
46372	29669s (+0.9s)	3488	3488	256	90	190	15	0	295
46373	29670s (+0.7s)	2456	2456	128	72	149	15	0	236
46374	29670s (+0.8s)	3352	3352	256	67	197	10	1	275
46375	29671s (+0.6s)	2260	2260	128	54	147	11	1	213
46376	29672s (+0.5s)	1680	1680	128	48	118	9	0	175
46377	29672s (+0.3s)	896	896	64	31	80	8	0	119
46378	29673s (+0.8s)	3376	3376	256	76	196	12	0	284
46379	29673s (+0.3s)	1160	1160	128	31	87	5	0	123
46380	29674s (+0.6s)	2372	2372	256	52	138	11	0	201
46381	29675s (+1.0s)	4196	4196	256	94	242	15	0	351
46382	29676s (+1.0s)	4300	4300	256	90	260	10	0	360
46383	29676s (+0.7s)	2848	2848	256	59	178	6	0	243
46384	29677s (+0.5s)	1532	1532	128	36	119	7	0	162
46385	29678s (+1.3s)	6556	6556	512	138	316	22	0	476
46386	29679s (+0.6s)	2104	2104	128	55	149	8	0	212
46387	29679s (+0.5s)	1804	1804	128	45	127	13	0	185
46388	29680s (+0.5s)	1772	1772	128	41	134	7	0	182
46389	29681s (+0.7s)	3064	3064	256	64	182	13	1	260
46390	29681s (+0.5s)	1516	1516	128	44	109	8	0	161
46391	29682s (+0.9s)	3948	3948	256	81	224	21	0	326
46392	29683s (+0.7s)	2948	2948	256	64	173	11	0	248
46393	29684s (+0.8s)	3516	3516	256	71	211	12	0	294
46394	29684s (+0.7s)	2732	2732	256	53	169	0	9	231
46395	29685s (+0.3s)	1144	1144	128	18	99	0	3	120
46396	29685s (+0.7s)	3160	3160	256	59	185	0	15	259
46397	29686s (+1.0s)	5248	5248	512	75	275	0	15	365
46398	29687s (+0.1s)	272	272	32	7	41	0	3	51
46399	29687s (+0.5s)	2264	2264	256	35	146	0	7	188
Episode	Time	Reward	Score	Highest	L	U	R	D	Steps
46400	29688s (+0.5s)	1812	1812	128	47	130	0	11	188
46401	29688s (+0.5s)	2004	2004	256	30	131	0	6	167
46402	29689s (+0.6s)	2096	2096	128	58	139	10	0	207
46403	29689s (+0.7s)	2900	2900	256	64	178	9	0	251
46404	29690s (+0.3s)	1200	1200	128	35	81	6	0	122
46405	29690s (+0.6s)	2448	2448	256	35	161	10	0	206
46406	29691s (+0.7s)	3280	3280	256	69	193	10	0	272
46407	29692s (+0.6s)	2648	2648	256	44	171	7	0	222
46408	29692s (+0.7s)	2896	2896	256	54	175	13	0	242
46409	29693s (+0.6s)	1940	1940	128	52	139	12	0	203
46410	29694s (+0.9s)	3988	3988	256	80	236	15	0	331
46411	29694s (+0.5s)	1704	1704	128	46	122	10	0	178
46412	29695s (+0.8s)	3236	3236	256	55	205	12	0	272
46413	29696s (+0.7s)	2904	2904	256	62	182	8	0	252
46414	29697s (+0.8s)	3536	3536	256	81	204	13	0	298
46415	29697s (+0.6s)	2628	2628	256	50	160	10	1	221
46416	29698s (+0.6s)	2232	2232	128	50	151	15	0	216
46417	29699s (+0.8s)	3572	3572	256	78	202	18	1	299
46418	29700s (+0.8s)	3412	3412	256	79	195	14	0	288
46419	29700s (+0.4s)	1128	1128	64	31	98	5	0	134
46420	29701s (+0.6s)	2592	2592	256	53	160	11	1	225
46421	29702s (+1.0s)	4308	4308	256	94	240	18	0	352
46422	29703s (+0.7s)	2872	2872	256	69	163	17	0	249
46423	29703s (+0.4s)	1536	1536	128	49	94	17	0	160
46424	29703s (+0.5s)	1552	1552	128	37	118	5	0	160
46425	29704s (+0.5s)	2052	2052	128	51	137	11	1	200
46426	29705s (+0.8s)	3528	3528	256	68	215	13	0	296
46427	29706s (+0.8s)	3532	3532	256	86	195	16	1	298
46428	29706s (+0.5s)	1796	1796	128	34	140	0	10	184
46429	29707s (+0.5s)	1668	1668	128	40	123	6	0	169
46430	29708s (+0.9s)	3920	3920	256	70	230	14	0	314
46431	29708s (+0.5s)	1792	1792	128	41	136	6	0	183
46432	29709s (+0.5s)	1820	1820	128	44	135	10	0	189
46433	29709s (+0.5s)	1752	1752	128	41	133	5	0	179
46434	29710s (+0.5s)	1704	1704	128	39	130	7	0	176
46435	29711s (+0.8s)	3652	3652	256	61	223	0	13	297
46436	29711s (+0.7s)	2628	2628	256	47	172	0	12	231
46437	29712s (+0.7s)	2748	2748	256	47	170	0	9	226
46438	29712s (+0.3s)	1008	1008	128	32	79	0	2	113
46439	29713s (+0.9s)	4176	4176	256	103	213	23	0	339
46440	29714s (+0.5s)	1516	1516	128	38	116	8	0	162
46441	29714s (+0.7s)	3232	3232	256	68	194	8	1	271
46442	29715s (+0.5s)	1568	1568	128	41	113	6	0	160
46443	29716s (+1.3s)	6568	6568	512	128	314	30	0	472
46444	29717s (+0.5s)	1792	1792	128	43	128	11	0	182
46445	29717s (+0.4s)	1520	1520	128	46	107	6	0	159
46446	29718s (+0.6s)	2520	2520	128	67	150	13	1	231
46447	29719s (+0.8s)	3568	3568	256	70	217	12	0	299
46448	29719s (+0.5s)	1688	1688	128	37	131	6	0	174
46449	29720s (+0.7s)	2640	2640	256	62	161	7	0	230
46450	29720s (+0.4s)	1280	1280	128	27	102	0	8	137
46451	29721s (+0.4s)	1144	1144	128	27	89	0	7	123
46452	29721s (+0.5s)	2228	2228	256	44	138	0	5	187
46453	29722s (+0.3s)	1080	1080	128	21	97	0	2	120
46454	29723s (+1.0s)	4452	4452	256	108	240	23	0	371
46455	29723s (+0.4s)	1480	1480	128	44	100	10	0	154
46456	29723s (+0.4s)	1212	1212	64	38	93	8	0	139
46457	29724s (+0.2s)	644	644	64	14	65	5	0	84
46458	29725s (+1.3s)	6448	6448	512	122	305	28	0	455
46459	29726s (+0.7s)	2560	2560	128	55	175	11	0	241
46460	29727s (+1.0s)	4352	4352	256	80	270	16	0	366
46461	29727s (+0.7s)	3160	3160	256	65	181	13	0	259
46462	29728s (+0.2s)	400	400	32	11	50	0	2	63
46463	29728s (+0.5s)	1668	1668	128	27	134	0	10	171
46464	29729s (+0.4s)	1180	1180	128	25	100	3	0	128
46465	29729s (+0.4s)	1124	1124	64	32	96	5	0	133
46466	29729s (+0.5s)	1676	1676	64	51	119	8	1	179
46467	29730s (+0.3s)	1036	1036	128	24	82	3	0	109
46468	29730s (+0.6s)	2400	2400	256	49	140	10	0	199
46469	29732s (+1.3s)	6464	6464	512	106	331	25	0	462
46470	29732s (+0.7s)	2972	2972	256	68	168	14	0	250
46471	29733s (+0.9s)	3800	3800	256	73	238	14	0	325
46472	29734s (+0.5s)	1868	1868	128	46	135	9	0	190
46473	29734s (+0.6s)	2116	2116	128	48	150	9	0	207
46474	29735s (+0.9s)	3620	3620	256	72	219	0	13	304
46475	29736s (+0.5s)	1808	1808	128	36	142	0	9	187
46476	29736s (+0.4s)	1460	1460	128	36	108	5	0	149
46477	29737s (+0.6s)	2672	2672	256	60	156	12	0	228
46478	29737s (+0.3s)	1152	1152	128	21	99	2	0	122
46479	29738s (+1.1s)	4472	4472	256	118	232	26	0	376
46480	29739s (+0.5s)	1560	1560	128	42	112	8	0	162
46481	29740s (+0.9s)	3608	3608	256	69	217	20	0	306
46482	29740s (+0.3s)	876	876	64	35	72	8	0	115
46483	29740s (+0.3s)	1008	1008	64	21	96	4	0	121
46484	29741s (+0.8s)	3536	3536	256	60	217	14	0	291
46485	29742s (+0.4s)	1404	1404	128	34	103	5	0	142
46486	29742s (+0.4s)	1500	1500	128	33	117	8	1	159
46487	29743s (+0.6s)	2620	2620	256	48	167	5	0	220
46488	29743s (+0.5s)	2120	2120	256	24	149	6	0	179
46489	29744s (+0.6s)	2492	2492	256	36	165	0	14	215
46490	29745s (+0.9s)	3976	3976	256	85	222	21	0	328
46491	29746s (+0.7s)	3068	3068	256	65	188	14	0	267
46492	29746s (+0.6s)	2588	2588	256	45	174	4	0	223
46493	29747s (+0.8s)	3232	3232	256	69	193	9	0	271
46494	29748s (+0.7s)	2928	2928	256	51	201	6	0	258
46495	29748s (+0.5s)	1752	1752	128	35	141	6	0	182
46496	29749s (+0.7s)	2756	2756	256	48	181	8	0	237
46497	29750s (+0.6s)	2180	2180	128	44	149	12	0	205
46498	29750s (+0.2s)	600	600	64	17	65	3	0	85
46499	29751s (+0.7s)	2836	2836	256	69	171	7	0	247
Episode	Time	Reward	Score	Highest	L	U	R	D	Steps
46500	29751s (+0.4s)	1352	1352	128	42	102	4	0	148
46501	29752s (+0.8s)	3680	3680	256	80	197	16	0	293
46502	29752s (+0.5s)	1892	1892	128	49	138	5	0	192
46503	29753s (+0.8s)	3644	3644	256	78	206	15	0	299
46504	29754s (+0.6s)	2516	2516	256	53	157	10	0	220
46505	29754s (+0.5s)	1712	1712	128	47	117	7	1	172
46506	29755s (+0.5s)	1532	1532	128	47	109	5	0	161
46507	29755s (+0.7s)	2780	2780	256	58	172	8	1	239
46508	29756s (+0.6s)	1864	1864	128	46	145	5	0	196
46509	29757s (+0.7s)	2920	2920	256	74	162	17	0	253
46510	29757s (+0.7s)	2908	2908	256	49	195	9	0	253
46511	29758s (+0.9s)	4064	4064	256	73	238	14	0	325
46512	29759s (+0.5s)	1792	1792	128	38	139	6	0	183
46513	29759s (+0.4s)	1504	1504	128	32	117	8	0	157
46514	29760s (+0.2s)	596	596	64	15	62	5	0	82
46515	29760s (+0.8s)	3308	3308	256	77	187	14	0	278
46516	29761s (+0.8s)	3368	3368	256	88	168	18	0	274
46517	29762s (+0.4s)	1356	1356	128	32	104	4	0	140
46518	29762s (+0.3s)	976	976	64	25	79	9	1	114
46519	29762s (+0.4s)	1380	1380	128	41	94	9	1	145
46520	29763s (+0.6s)	2060	2060	128	63	132	11	0	206
46521	29764s (+0.6s)	2328	2328	256	40	159	6	0	205
46522	29764s (+0.6s)	2184	2184	128	45	147	0	11	203
46523	29765s (+0.9s)	4072	4072	256	78	234	0	17	329
46524	29766s (+0.5s)	1780	1780	128	41	129	10	0	180
46525	29767s (+1.0s)	4204	4204	256	69	255	0	17	341
46526	29767s (+0.3s)	900	900	64	25	79	0	7	111
46527	29768s (+0.8s)	3248	3248	256	73	189	13	0	275
46528	29769s (+0.9s)	4092	4092	256	77	240	13	0	330
46529	29769s (+0.4s)	1260	1260	128	22	105	4	0	131
46530	29769s (+0.5s)	1576	1576	128	34	125	3	0	162
46531	29770s (+0.6s)	2424	2424	128	58	155	10	0	223
46532	29771s (+0.8s)	3204	3204	256	61	188	15	1	265
46533	29771s (+0.6s)	2400	2400	256	52	139	8	0	199
46534	29772s (+0.5s)	1808	1808	128	54	119	13	0	186
46535	29773s (+0.7s)	3108	3108	256	66	180	10	0	256
46536	29773s (+0.5s)	1684	1684	128	51	117	10	0	178
46537	29774s (+0.3s)	932	932	64	30	84	3	0	117
46538	29774s (+0.9s)	3892	3892	256	87	225	12	0	324
46539	29775s (+0.5s)	1768	1768	128	38	136	6	0	180
46540	29775s (+0.4s)	1436	1436	128	25	118	5	0	148
46541	29776s (+1.0s)	4028	4028	256	94	225	17	0	336
46542	29777s (+0.4s)	1328	1328	128	39	101	7	0	147
46543	29777s (+0.5s)	1772	1772	128	38	136	5	0	179
46544	29778s (+0.3s)	816	816	64	20	86	5	0	111
46545	29778s (+0.4s)	1516	1516	128	34	113	8	1	156
46546	29778s (+0.3s)	892	892	64	31	79	5	0	115
46547	29779s (+0.4s)	1448	1448	128	31	114	6	0	151
46548	29780s (+1.1s)	5860	5860	512	130	251	22	0	403
46549	29781s (+0.8s)	2968	2968	128	95	169	16	0	280
46550	29781s (+0.7s)	2736	2736	256	56	164	13	0	233
46551	29782s (+0.7s)	3140	3140	256	71	177	16	0	264
46552	29783s (+1.0s)	4204	4204	256	80	250	16	0	346
46553	29784s (+0.4s)	1344	1344	128	29	107	5	0	141
46554	29784s (+0.8s)	3544	3544	256	79	208	13	0	300
46555	29785s (+0.5s)	1888	1888	128	40	146	4	0	190
46556	29786s (+0.5s)	1540	1540	128	36	125	3	0	164
46557	29786s (+0.3s)	1020	1020	128	15	92	0	4	111
46558	29786s (+0.5s)	1552	1552	128	28	125	0	7	160
46559	29787s (+0.2s)	620	620	64	14	63	0	4	81
46560	29787s (+0.5s)	1784	1784	128	45	129	8	0	182
46561	29788s (+1.0s)	4188	4188	256	85	253	11	0	349
46562	29789s (+0.5s)	1836	1836	128	51	133	5	0	189
46563	29789s (+0.6s)	2464	2464	256	40	164	4	0	208
46564	29790s (+0.5s)	2112	2112	128	54	130	9	0	193
46565	29790s (+0.6s)	2604	2604	256	51	164	11	0	226
46566	29791s (+0.8s)	3528	3528	256	78	202	14	0	294
46567	29792s (+0.8s)	3512	3512	256	70	213	14	0	297
46568	29793s (+0.5s)	1700	1700	128	47	117	8	0	172
46569	29794s (+1.2s)	5920	5920	512	111	283	19	2	415
46570	29794s (+0.7s)	2632	2632	256	47	177	9	0	233
46571	29795s (+0.9s)	4612	4612	512	74	232	13	0	319
46572	29796s (+0.8s)	3244	3244	256	69	192	12	0	273
46573	29797s (+0.7s)	2916	2916	256	62	181	12	0	255
46574	29797s (+0.4s)	1320	1320	128	33	107	5	0	145
46575	29798s (+0.5s)	1804	1804	128	31	152	4	0	187
46576	29798s (+0.7s)	2724	2724	256	52	167	10	0	229
46577	29799s (+0.6s)	2580	2580	256	57	155	8	0	220
46578	29800s (+0.5s)	2432	2432	256	47	141	10	1	199
46579	29800s (+0.4s)	1436	1436	128	30	117	7	0	154
46580	29801s (+1.0s)	4232	4232	256	81	247	20	0	348
46581	29802s (+0.8s)	3276	3276	256	66	199	9	0	274
46582	29802s (+0.6s)	2324	2324	128	55	146	12	0	213
46583	29803s (+0.8s)	3404	3404	256	65	206	0	13	284
46584	29804s (+0.8s)	3496	3496	256	68	212	0	9	289
46585	29804s (+0.2s)	684	684	64	10	75	0	4	89
46586	29805s (+0.8s)	3252	3252	256	64	200	0	11	275
46587	29806s (+0.7s)	3004	3004	256	46	195	0	13	254
46588	29806s (+0.4s)	1040	1040	64	25	91	0	8	124
46589	29807s (+0.7s)	2624	2624	128	62	175	10	0	247
46590	29807s (+0.4s)	1232	1232	128	35	88	7	0	130
46591	29808s (+0.5s)	1816	1816	128	35	145	8	0	188
46592	29808s (+0.5s)	1540	1540	128	42	117	5	0	164
46593	29809s (+0.8s)	3232	3232	256	71	186	13	1	271
46594	29809s (+0.3s)	968	968	64	20	84	7	1	112
46595	29810s (+0.5s)	1624	1624	128	36	128	4	0	168
46596	29810s (+0.5s)	1856	1856	128	38	135	0	7	180
46597	29811s (+0.7s)	2664	2664	256	46	185	0	5	236
46598	29812s (+0.6s)	2656	2656	256	41	175	0	7	223
46599	29812s (+0.7s)	2800	2800	256	60	173	0	11	244
Episode	Time	Reward	Score	Highest	L	U	R	D	Steps
46600	29813s (+0.6s)	2516	2516	256	42	158	0	14	214
46601	29814s (+0.8s)	3420	3420	256	54	221	0	11	286
46602	29815s (+0.8s)	3276	3276	256	83	175	19	0	277
46603	29815s (+0.4s)	1236	1236	64	38	94	8	0	140
46604	29816s (+0.8s)	3300	3300	256	62	205	10	0	277
46605	29816s (+0.5s)	1508	1508	128	39	108	10	0	157
46606	29817s (+0.9s)	3856	3856	256	109	204	17	0	330
46607	29818s (+0.7s)	2800	2800	256	58	164	10	0	232
46608	29819s (+0.6s)	2452	2452	256	50	148	7	0	205
46609	29819s (+0.7s)	2988	2988	256	61	182	11	0	254
46610	29820s (+1.0s)	4220	4220	256	96	233	16	0	345
46611	29821s (+0.6s)	2608	2608	256	50	166	0	11	227
46612	29822s (+1.0s)	4296	4296	256	106	234	17	0	357
46613	29823s (+0.8s)	3592	3592	256	69	210	12	0	291
46614	29823s (+0.3s)	1072	1072	128	25	89	3	0	117
46615	29824s (+0.7s)	3116	3116	256	62	183	13	0	258
46616	29824s (+0.5s)	1768	1768	128	49	121	8	0	178
46617	29825s (+0.6s)	2504	2504	256	41	169	6	0	216
46618	29826s (+0.5s)	1832	1832	128	45	133	5	0	183
46619	29826s (+0.7s)	2908	2908	256	65	177	12	0	254
46620	29827s (+0.7s)	2968	2968	256	54	184	11	0	249
46621	29828s (+0.7s)	2936	2936	256	52	182	12	0	246
46622	29828s (+0.7s)	2820	2820	256	64	166	11	0	241
46623	29829s (+0.7s)	3348	3348	256	67	188	18	0	273
46624	29830s (+0.5s)	2188	2188	256	43	127	9	0	179
46625	29830s (+0.5s)	1628	1628	128	48	117	6	0	171
46626	29831s (+0.4s)	1324	1324	128	42	99	5	0	146
46627	29831s (+0.4s)	1376	1376	128	33	108	3	0	144
46628	29832s (+0.8s)	3716	3716	256	65	227	8	0	300
46629	29832s (+0.4s)	1508	1508	128	38	118	4	0	160
46630	29833s (+1.2s)	5980	5980	512	116	291	22	0	429
46631	29834s (+0.5s)	1504	1504	128	36	112	11	0	159
46632	29835s (+0.7s)	2916	2916	256	69	184	7	0	260
46633	29836s (+1.1s)	5436	5436	512	94	275	14	1	384
46634	29836s (+0.6s)	2548	2548	256	50	160	0	14	224
46635	29837s (+0.8s)	3400	3400	256	50	221	0	10	281
46636	29838s (+0.8s)	3768	3768	256	73	211	0	15	299
46637	29839s (+1.4s)	6832	6832	512	148	316	26	0	490
46638	29841s (+1.3s)	6332	6332	512	115	309	23	0	447
46639	29841s (+0.6s)	1932	1932	128	58	132	6	0	196
46640	29842s (+0.6s)	1948	1948	128	46	141	11	0	198
46641	29843s (+0.8s)	3416	3416	256	84	196	19	1	300
46642	29844s (+1.1s)	5692	5692	512	100	275	15	0	390
46643	29845s (+0.7s)	3132	3132	256	62	181	12	1	256
46644	29845s (+0.4s)	1428	1428	128	39	111	5	0	155
46645	29845s (+0.5s)	1752	1752	128	42	125	11	0	178
46646	29846s (+0.4s)	1452	1452	128	33	109	10	0	152
46647	29847s (+0.6s)	2464	2464	256	60	140	12	1	213
46648	29847s (+0.8s)	3492	3492	256	74	204	14	0	292
46649	29848s (+0.3s)	972	972	64	36	76	4	0	116
46650	29849s (+1.0s)	4116	4116	256	81	253	12	0	346
46651	29849s (+0.6s)	2488	2488	256	50	154	8	1	213
46652	29850s (+0.4s)	1520	1520	128	28	118	0	4	150
46653	29851s (+0.8s)	3496	3496	256	58	223	0	12	293
46654	29851s (+0.7s)	2796	2796	256	60	168	0	15	243
46655	29852s (+0.7s)	3032	3032	256	56	183	10	1	250
46656	29852s (+0.4s)	1296	1296	128	35	102	3	0	140
46657	29853s (+0.5s)	1876	1876	128	46	137	9	0	192
46658	29854s (+0.7s)	2644	2644	256	68	143	18	0	229
46659	29854s (+0.6s)	2492	2492	256	57	145	9	0	211
46660	29855s (+0.3s)	736	736	64	21	74	3	0	98
46661	29855s (+0.4s)	1156	1156	64	38	89	9	0	136
46662	29855s (+0.4s)	1220	1220	128	34	93	6	0	133
46663	29856s (+0.8s)	3080	3080	256	60	195	10	0	265
46664	29857s (+0.9s)	4072	4072	256	93	222	17	0	332
46665	29857s (+0.5s)	1540	1540	128	40	113	10	0	163
46666	29858s (+0.8s)	3432	3432	256	85	192	11	1	289
46667	29859s (+0.5s)	1896	1896	128	41	143	9	0	193
46668	29860s (+0.7s)	3316	3316	256	73	182	11	0	266
46669	29860s (+0.5s)	1632	1632	128	39	131	0	5	175
46670	29860s (+0.2s)	588	588	64	12	69	0	1	82
46671	29861s (+0.9s)	3956	3956	256	92	217	20	0	329
46672	29862s (+0.5s)	1836	1836	128	34	144	9	0	187
46673	29862s (+0.5s)	1628	1628	128	35	124	5	0	164
46674	29863s (+0.4s)	1272	1272	128	28	98	3	0	129
46675	29863s (+0.7s)	2856	2856	256	54	179	16	0	249
46676	29864s (+0.5s)	1512	1512	128	38	115	7	1	161
46677	29865s (+0.8s)	2924	2924	128	95	168	10	0	273
46678	29865s (+0.5s)	1812	1812	128	46	132	9	0	187
46679	29866s (+1.0s)	4576	4576	256	98	237	18	2	355
46680	29867s (+0.9s)	3576	3576	256	74	220	9	0	303
46681	29868s (+0.7s)	3108	3108	256	59	188	11	0	258
46682	29868s (+0.3s)	1044	1044	128	23	86	5	0	114
46683	29869s (+0.5s)	1800	1800	128	43	136	6	0	185
46684	29869s (+0.7s)	3216	3216	256	75	181	13	0	269
46685	29870s (+0.6s)	2040	2040	128	59	136	11	1	207
46686	29870s (+0.5s)	1624	1624	128	31	125	5	1	162
46687	29871s (+1.0s)	4288	4288	256	82	260	19	1	362
46688	29872s (+0.6s)	2588	2588	256	62	150	11	0	223
46689	29873s (+0.7s)	2956	2956	256	69	184	7	0	260
46690	29874s (+1.0s)	4328	4328	256	90	253	17	0	360
46691	29875s (+0.8s)	3504	3504	256	65	209	17	0	291
46692	29875s (+0.7s)	3212	3212	256	68	180	15	0	263
46693	29876s (+0.3s)	872	872	64	24	86	4	0	114
46694	29876s (+0.5s)	1668	1668	128	28	133	8	0	169
46695	29877s (+0.4s)	1412	1412	128	40	106	7	0	153
46696	29877s (+0.8s)	3340	3340	256	60	208	11	0	279
46697	29878s (+0.5s)	1720	1720	128	35	131	5	0	171
46698	29879s (+1.0s)	4544	4544	256	90	265	22	0	377
46699	29880s (+0.6s)	2736	2736	256	37	177	8	0	222
Episode	Time	Reward	Score	Highest	L	U	R	D	Steps
46700	29880s (+0.5s)	1692	1692	128	40	119	8	0	167
46701	29881s (+0.6s)	1944	1944	128	34	158	0	8	200
46702	29881s (+0.7s)	3032	3032	256	54	174	0	16	244
46703	29882s (+0.8s)	3456	3456	256	67	213	0	14	294
46704	29883s (+1.0s)	4168	4168	256	78	249	0	17	344
46705	29884s (+0.8s)	3248	3248	256	74	186	15	0	275
46706	29885s (+0.8s)	3212	3212	256	67	191	13	0	271
46707	29885s (+0.6s)	2336	2336	256	41	151	5	0	197
46708	29886s (+0.2s)	416	416	32	14	51	3	0	68
46709	29886s (+0.4s)	1024	1024	64	34	87	6	0	127
46710	29887s (+0.7s)	2864	2864	256	72	164	11	0	247
46711	29888s (+1.1s)	4660	4660	256	117	254	19	0	390
46712	29888s (+0.4s)	1496	1496	128	39	102	10	0	151
46713	29889s (+0.5s)	1536	1536	128	42	112	9	0	163
46714	29890s (+0.8s)	3332	3332	256	78	179	17	0	274
46715	29890s (+0.5s)	1604	1604	128	36	122	11	0	169
46716	29890s (+0.4s)	1480	1480	128	34	115	4	0	153
46717	29891s (+0.7s)	2828	2828	256	73	156	14	0	243
46718	29892s (+0.5s)	1684	1684	128	42	122	8	0	172
46719	29893s (+1.1s)	5536	5536	512	97	271	20	0	388
46720	29893s (+0.4s)	1320	1320	128	37	102	6	0	145
46721	29894s (+0.3s)	1112	1112	128	29	80	7	0	116
46722	29894s (+0.5s)	1680	1680	128	51	110	8	0	169
46723	29895s (+0.6s)	1888	1888	128	46	131	14	0	191
46724	29895s (+0.5s)	1800	1800	128	45	124	7	0	176
46725	29896s (+0.8s)	2900	2900	128	80	174	17	1	272
46726	29897s (+0.7s)	3004	3004	256	52	186	13	0	251
46727	29898s (+1.0s)	4508	4508	256	106	243	20	0	369
46728	29898s (+0.6s)	2200	2200	256	35	150	5	1	191
46729	29899s (+0.4s)	1416	1416	128	33	112	5	1	151
46730	29899s (+0.3s)	672	672	64	15	71	0	7	93
46731	29900s (+0.6s)	2408	2408	256	40	162	0	5	207
46732	29900s (+0.8s)	3228	3228	256	51	209	0	11	271
46733	29901s (+0.6s)	2100	2100	128	41	146	0	14	201
46734	29901s (+0.4s)	1156	1156	128	23	96	0	4	123
46735	29902s (+0.3s)	692	692	64	14	73	0	4	91
46736	29902s (+0.6s)	2064	2064	128	45	148	0	10	203
46737	29903s (+0.5s)	1500	1500	128	39	111	8	0	158
46738	29903s (+0.6s)	1932	1932	128	45	145	11	0	201
46739	29904s (+0.3s)	820	820	64	29	74	5	0	108
46740	29904s (+0.6s)	2368	2368	128	56	154	10	1	221
46741	29905s (+0.8s)	3216	3216	256	63	193	10	0	266
46742	29906s (+0.9s)	2928	2928	256	79	166	13	0	258
46743	29907s (+1.0s)	4920	4920	512	97	224	19	0	340
46744	29907s (+0.5s)	1484	1484	128	35	111	8	0	154
46745	29908s (+0.9s)	3268	3268	256	71	197	12	0	280
46746	29909s (+0.5s)	1288	1288	64	42	101	6	0	149
46747	29909s (+0.7s)	2508	2508	256	73	132	13	1	219
46748	29910s (+0.6s)	1908	1908	128	50	138	7	0	195
46749	29911s (+0.7s)	1760	1760	128	41	129	9	0	179
46750	29911s (+0.4s)	1056	1056	64	28	94	5	0	127
46751	29912s (+0.6s)	1760	1760	128	40	130	6	0	176
46752	29912s (+0.3s)	660	660	64	13	72	4	1	90
46753	29912s (+0.5s)	1460	1460	128	28	117	4	1	150
46754	29913s (+0.5s)	1484	1484	128	39	111	6	0	156
46755	29914s (+0.9s)	3588	3588	256	80	203	18	0	301
46756	29914s (+0.3s)	888	888	64	21	85	7	0	113
46757	29915s (+0.5s)	1396	1396	128	42	100	7	0	149
46758	29915s (+0.7s)	2220	2220	128	59	151	12	0	222
46759	29916s (+0.4s)	1028	1028	128	20	89	3	0	112
46760	29916s (+0.5s)	1740	1740	128	43	119	13	0	175
46761	29917s (+0.8s)	2712	2712	256	50	170	11	0	231
46762	29918s (+0.8s)	2604	2604	128	51	184	0	11	246
46763	29919s (+0.7s)	1640	1640	128	29	139	0	9	177
46764	29919s (+0.4s)	1040	1040	128	21	89	0	3	113
46765	29920s (+0.5s)	1608	1608	128	40	120	0	9	169
46766	29920s (+0.8s)	3228	3228	256	49	210	0	10	269
46767	29921s (+0.8s)	2988	2988	256	59	201	0	8	268
46768	29922s (+0.4s)	1540	1540	128	31	118	0	8	157
46769	29922s (+0.4s)	1112	1112	64	28	94	0	8	130
46770	29923s (+0.7s)	2764	2764	256	49	176	0	10	235
46771	29923s (+0.7s)	2692	2692	256	46	172	0	11	229
46772	29924s (+0.3s)	732	732	64	24	67	0	5	96
46773	29924s (+0.5s)	1476	1476	128	36	111	0	6	153
46774	29925s (+0.9s)	3644	3644	256	78	218	17	0	313
46775	29926s (+0.4s)	1284	1284	128	30	109	3	0	142
46776	29927s (+1.2s)	4468	4468	256	113	225	25	0	363
46777	29928s (+0.7s)	2484	2484	256	43	159	9	1	212
46778	29928s (+0.6s)	1800	1800	128	40	134	11	0	185
46779	29929s (+0.7s)	1936	1936	128	49	143	10	0	202
46780	29929s (+0.5s)	1612	1612	128	32	127	3	0	162
46781	29930s (+0.9s)	3796	3796	256	81	223	11	0	315
46782	29931s (+1.2s)	5888	5888	512	112	294	15	0	421
46783	29932s (+0.8s)	2936	2936	256	58	192	10	0	260
46784	29933s (+0.7s)	2732	2732	256	49	169	13	0	231
46785	29933s (+0.4s)	1376	1376	128	46	88	10	0	144
46786	29934s (+1.1s)	4448	4448	256	109	243	18	0	370
46787	29935s (+0.6s)	2448	2448	256	50	145	13	0	208
46788	29936s (+0.5s)	1524	1524	128	40	114	6	0	160
46789	29936s (+0.7s)	2996	2996	256	65	171	14	1	251
46790	29937s (+0.5s)	1680	1680	128	54	108	9	0	171
46791	29937s (+0.5s)	1804	1804	128	42	136	8	0	186
46792	29938s (+0.7s)	2408	2408	128	64	152	9	0	225
46793	29938s (+0.5s)	1556	1556	128	32	122	0	7	161
46794	29939s (+0.4s)	1244	1244	128	28	107	0	4	139
46795	29939s (+0.5s)	1792	1792	128	38	135	0	14	187
46796	29940s (+0.3s)	796	796	64	16	83	0	3	102
46797	29940s (+0.6s)	2352	2352	128	48	158	0	10	216
46798	29941s (+0.8s)	3376	3376	256	52	212	0	14	278
46799	29942s (+0.7s)	2992	2992	256	56	173	15	0	244
Episode	Time	Reward	Score	Highest	L	U	R	D	Steps
46800	29943s (+0.8s)	3652	3652	256	74	198	17	0	289
46801	29943s (+0.5s)	1660	1660	128	51	104	11	1	167
46802	29944s (+0.5s)	1536	1536	128	36	122	5	0	163
46803	29944s (+0.5s)	1820	1820	128	46	126	11	0	183
46804	29945s (+0.6s)	2328	2328	256	40	149	8	0	197
46805	29945s (+0.5s)	1804	1804	128	44	135	3	0	182
46806	29946s (+0.4s)	1248	1248	128	29	97	7	0	133
46807	29946s (+0.3s)	900	900	64	37	73	6	0	116
46808	29947s (+0.6s)	1948	1948	128	51	144	5	0	200
46809	29947s (+0.6s)	2324	2324	256	37	153	5	0	195
46810	29948s (+0.5s)	1680	1680	128	44	116	11	1	172
46811	29948s (+0.6s)	1980	1980	128	54	137	10	0	201
46812	29949s (+0.4s)	1344	1344	128	29	107	11	0	147
46813	29949s (+0.6s)	2568	2568	256	57	158	9	0	224
46814	29950s (+1.1s)	4528	4528	256	90	262	22	0	374
46815	29951s (+0.7s)	2552	2552	128	62	158	15	0	235
46816	29952s (+0.9s)	3768	3768	256	70	237	16	0	323
46817	29952s (+0.3s)	868	868	64	26	81	6	0	113
46818	29953s (+0.6s)	2244	2244	128	64	140	12	0	216
46819	29954s (+0.6s)	2184	2184	128	50	156	10	0	216
46820	29954s (+0.4s)	1268	1268	64	41	100	8	0	149
46821	29955s (+0.5s)	1688	1688	128	32	136	5	0	173
46822	29955s (+0.8s)	3532	3532	256	54	219	0	14	287
46823	29956s (+0.3s)	924	924	64	19	90	0	4	113
46824	29956s (+0.3s)	1120	1120	128	24	89	0	5	118
46825	29957s (+0.5s)	1804	1804	128	41	132	0	13	186
46826	29957s (+0.6s)	2048	2048	128	60	131	12	0	203
46827	29958s (+0.7s)	2624	2624	256	61	157	13	0	231
46828	29958s (+0.4s)	1480	1480	128	38	109	7	0	154
46829	29959s (+0.8s)	3176	3176	256	68	187	14	0	269
46830	29960s (+0.8s)	3264	3264	256	63	192	13	1	269
46831	29961s (+0.9s)	3728	3728	256	70	237	12	0	319
46832	29962s (+0.8s)	3280	3280	256	65	190	13	0	268
46833	29962s (+0.9s)	3944	3944	256	90	219	15	1	325
46834	29963s (+0.8s)	3352	3352	256	68	197	10	0	275
46835	29964s (+0.7s)	2820	2820	256	61	157	14	1	233
46836	29965s (+0.7s)	2816	2816	256	60	169	17	1	247
46837	29966s (+1.1s)	5580	5580	512	111	262	25	0	398
46838	29966s (+0.7s)	2696	2696	256	60	164	10	0	234
46839	29967s (+0.7s)	2924	2924	256	57	176	10	0	243
46840	29968s (+0.5s)	1472	1472	128	30	122	4	0	156
46841	29968s (+0.5s)	1532	1532	128	52	103	7	0	162
46842	29969s (+0.7s)	2620	2620	256	52	167	11	0	230
46843	29969s (+0.5s)	1668	1668	128	57	105	11	0	173
46844	29970s (+0.8s)	3528	3528	256	71	213	12	0	296
46845	29971s (+0.5s)	1820	1820	128	60	123	7	0	190
46846	29971s (+0.6s)	1952	1952	128	47	152	7	0	206
46847	29972s (+0.9s)	4008	4008	256	81	231	19	0	331
46848	29973s (+0.7s)	3208	3208	256	67	179	10	0	256
46849	29973s (+0.4s)	1492	1492	128	34	115	7	0	156
46850	29974s (+0.5s)	1608	1608	128	48	113	8	0	169
46851	29974s (+0.5s)	1856	1856	128	49	136	9	0	194
46852	29975s (+0.6s)	1924	1924	128	46	145	0	8	199
46853	29975s (+0.3s)	676	676	64	24	60	0	2	86
46854	29976s (+0.7s)	2584	2584	256	46	177	0	9	232
46855	29976s (+0.3s)	728	728	64	11	85	0	3	99
46856	29977s (+0.7s)	2812	2812	256	44	189	0	13	246
46857	29978s (+0.6s)	2364	2364	128	59	151	9	0	219
46858	29978s (+0.6s)	2472	2472	128	50	169	10	1	230
46859	29979s (+0.7s)	2592	2592	128	71	158	15	0	244
46860	29980s (+0.8s)	3336	3336	256	72	198	12	0	282
46861	29980s (+0.5s)	1728	1728	128	54	109	10	0	173
46862	29981s (+0.4s)	1488	1488	128	30	121	5	0	156
46863	29981s (+0.9s)	3904	3904	256	87	216	16	0	319
46864	29982s (+0.4s)	1428	1428	128	35	111	6	0	152
46865	29982s (+0.3s)	924	924	64	37	80	5	0	122
46866	29983s (+0.4s)	1464	1464	128	29	119	6	0	154
46867	29983s (+0.8s)	3380	3380	256	64	201	16	0	281
46868	29985s (+1.6s)	7940	7940	512	168	361	26	0	555
46869	29986s (+0.4s)	1444	1444	128	36	106	7	1	150
46870	29986s (+0.5s)	1924	1924	128	52	137	10	0	199
46871	29987s (+0.7s)	2608	2608	128	69	163	10	0	242
46872	29987s (+0.7s)	2744	2744	256	57	171	6	0	234
46873	29988s (+0.7s)	2968	2968	256	55	180	12	0	247
46874	29989s (+1.1s)	5712	5712	512	106	283	21	0	410
46875	29990s (+0.7s)	2816	2816	256	58	170	11	0	239
46876	29990s (+0.3s)	604	604	32	19	67	5	0	91
46877	29991s (+0.9s)	3688	3688	256	74	214	16	1	305
46878	29992s (+0.5s)	1556	1556	128	33	124	4	0	161
46879	29992s (+0.5s)	1596	1596	128	45	110	5	0	160
46880	29992s (+0.4s)	1052	1052	64	39	80	8	0	127
46881	29993s (+0.6s)	2496	2496	256	63	143	10	0	216
46882	29994s (+0.7s)	2868	2868	256	62	172	15	0	249
46883	29994s (+0.5s)	1568	1568	128	37	126	7	0	170
46884	29995s (+0.7s)	3156	3156	256	62	185	10	0	257
46885	29996s (+0.6s)	2480	2480	128	59	151	12	0	222
46886	29996s (+0.8s)	3440	3440	256	70	205	15	0	290
46887	29997s (+0.7s)	2760	2760	256	62	161	15	0	238
46888	29998s (+0.7s)	2892	2892	256	53	192	9	0	254
46889	29999s (+1.2s)	5936	5936	512	138	265	23	0	426
46890	30000s (+0.8s)	3252	3252	256	68	195	13	0	276
46891	30000s (+0.5s)	1804	1804	128	41	134	10	0	185
46892	30001s (+0.7s)	2648	2648	256	56	161	14	0	231
46893	30002s (+0.5s)	1784	1784	128	49	124	8	0	181
46894	30002s (+0.4s)	1232	1232	128	33	97	7	0	137
46895	30002s (+0.4s)	1456	1456	64	42	104	10	0	156
46896	30003s (+0.7s)	2692	2692	256	53	169	9	1	232
46897	30004s (+0.5s)	1996	1996	128	42	143	9	0	194
46898	30004s (+0.4s)	1184	1184	128	33	83	7	0	123
46899	30005s (+0.7s)	3092	3092	256	54	191	9	0	254
Episode	Time	Reward	Score	Highest	L	U	R	D	Steps
46900	30005s (+0.7s)	2800	2800	256	67	160	10	0	237
46901	30006s (+0.6s)	1976	1976	128	60	139	8	0	207
46902	30007s (+0.5s)	1696	1696	128	45	117	6	0	168
46903	30007s (+0.7s)	3024	3024	256	79	162	10	0	251
46904	30008s (+1.0s)	4148	4148	256	86	239	14	0	339
46905	30009s (+0.4s)	1228	1228	64	29	104	6	0	139
46906	30009s (+0.3s)	640	640	64	28	57	4	0	89
46907	30010s (+0.8s)	3224	3224	256	63	189	17	0	269
46908	30011s (+0.9s)	3928	3928	256	83	223	15	0	321
46909	30011s (+0.6s)	1928	1928	128	46	150	4	0	200
46910	30012s (+0.8s)	3344	3344	256	69	197	17	0	283
46911	30013s (+0.7s)	2932	2932	256	57	180	8	0	245
46912	30013s (+0.3s)	872	872	64	30	77	6	0	113
46913	30014s (+0.5s)	1756	1756	128	38	129	8	0	175
46914	30014s (+0.9s)	4968	4968	512	79	239	14	0	332
46915	30015s (+0.8s)	3480	3480	256	73	201	15	0	289
46916	30016s (+0.5s)	1804	1804	128	38	138	9	0	185
46917	30016s (+0.6s)	2408	2408	128	66	145	14	0	225
46918	30017s (+0.6s)	1968	1968	128	61	128	11	0	200
46919	30017s (+0.5s)	1576	1576	128	43	108	10	0	161
46920	30018s (+0.5s)	1856	1856	128	39	142	7	0	188
46921	30019s (+0.5s)	1908	1908	128	51	137	7	0	195
46922	30019s (+0.7s)	2760	2760	256	45	184	10	0	239
46923	30020s (+0.5s)	1916	1916	128	47	141	8	1	197
46924	30021s (+0.8s)	3296	3296	256	59	207	0	10	276
46925	30021s (+0.5s)	1968	1968	128	41	134	0	9	184
46926	30022s (+0.5s)	1572	1572	128	38	116	0	8	162
46927	30022s (+0.8s)	3448	3448	256	54	211	0	18	283
46928	30023s (+0.5s)	1620	1620	128	39	127	0	6	172
46929	30023s (+0.4s)	1060	1060	64	26	91	0	12	129
46930	30024s (+0.6s)	2224	2224	128	41	160	0	11	212
46931	30025s (+0.7s)	3176	3176	256	56	189	0	17	262
46932	30025s (+0.6s)	2384	2384	256	59	135	6	0	200
46933	30026s (+0.5s)	1476	1476	128	42	113	5	0	160
46934	30027s (+0.8s)	3520	3520	256	84	193	15	0	292
46935	30027s (+0.8s)	3432	3432	256	74	204	10	0	288
46936	30028s (+0.7s)	2764	2764	256	60	164	9	1	234
46937	30029s (+0.7s)	3144	3144	256	61	182	11	0	254
46938	30029s (+0.5s)	1608	1608	128	38	121	9	1	169
46939	30030s (+0.5s)	1788	1788	128	45	128	9	0	182
46940	30030s (+0.7s)	3012	3012	256	63	170	16	0	249
46941	30031s (+0.7s)	3116	3116	256	68	167	13	0	248
46942	30032s (+0.5s)	1860	1860	128	50	129	10	0	189
46943	30032s (+0.8s)	3576	3576	256	76	199	18	0	293
46944	30033s (+0.3s)	896	896	64	28	80	5	0	113
46945	30033s (+0.5s)	1760	1760	128	45	124	9	1	179
46946	30034s (+0.8s)	3408	3408	256	54	222	11	0	287
46947	30035s (+0.4s)	1436	1436	128	39	109	10	0	158
46948	30035s (+0.7s)	3104	3104	256	64	183	9	0	256
46949	30036s (+0.5s)	1656	1656	128	36	132	0	8	176
46950	30036s (+0.2s)	696	696	64	17	70	0	4	91
46951	30037s (+0.6s)	2624	2624	256	45	169	0	8	222
46952	30037s (+0.8s)	3364	3364	256	61	207	0	15	283
46953	30038s (+0.7s)	2816	2816	256	71	163	13	0	247
46954	30039s (+0.5s)	1504	1504	128	36	113	10	0	159
46955	30039s (+0.7s)	3012	3012	256	59	183	6	0	248
46956	30040s (+0.7s)	2940	2940	256	54	178	14	0	246
46957	30041s (+0.5s)	1872	1872	128	43	141	7	1	192
46958	30041s (+0.4s)	1380	1380	128	24	111	9	1	145
46959	30041s (+0.2s)	620	620	64	14	70	2	0	86
46960	30042s (+0.4s)	1496	1496	128	38	112	7	0	157
46961	30042s (+0.5s)	1900	1900	128	45	142	0	6	193
46962	30043s (+0.6s)	2356	2356	256	43	151	7	0	201
46963	30044s (+1.0s)	4216	4216	256	90	242	12	0	344
46964	30045s (+0.8s)	3248	3248	256	69	192	14	1	276
46965	30045s (+0.6s)	2604	2604	256	52	165	9	0	226
46966	30046s (+1.0s)	4256	4256	256	83	245	15	0	343
46967	30047s (+0.9s)	3652	3652	256	88	199	13	0	300
46968	30048s (+0.6s)	2740	2740	256	47	160	12	0	219
46969	30048s (+0.6s)	1916	1916	128	44	148	5	0	197
46970	30049s (+0.7s)	2716	2716	256	53	163	11	1	228
46971	30050s (+0.5s)	1700	1700	128	44	114	11	0	169
46972	30050s (+0.5s)	1620	1620	128	37	122	4	0	163
46973	30051s (+0.6s)	2608	2608	256	56	162	12	1	231
46974	30051s (+0.7s)	2820	2820	256	49	190	9	0	248
46975	30052s (+0.3s)	772	772	64	19	82	4	0	105
46976	30052s (+0.6s)	2564	2564	256	54	156	11	0	221
46977	30053s (+0.4s)	1420	1420	128	37	102	5	0	144
46978	30053s (+0.4s)	1240	1240	128	30	97	4	0	131
46979	30054s (+0.4s)	1516	1516	128	39	114	9	0	162
46980	30054s (+0.5s)	1504	1504	128	31	127	1	0	159
46981	30055s (+0.5s)	1812	1812	128	43	141	4	0	188
46982	30055s (+0.5s)	1788	1788	128	36	138	8	0	182
46983	30056s (+0.5s)	1536	1536	128	34	120	0	8	162
46984	30056s (+0.5s)	1680	1680	128	34	127	0	10	171
46985	30057s (+0.7s)	2484	2484	128	62	156	14	0	232
46986	30057s (+0.5s)	1892	1892	128	54	130	11	0	195
46987	30058s (+0.3s)	1100	1100	128	31	81	5	0	117
46988	30058s (+0.4s)	1224	1224	128	26	93	5	0	124
46989	30058s (+0.5s)	1596	1596	128	43	114	9	0	166
46990	30059s (+0.4s)	1444	1444	128	36	110	4	0	150
46991	30060s (+1.0s)	4288	4288	256	79	255	17	0	351
46992	30061s (+0.6s)	2456	2456	256	53	148	9	0	210
46993	30061s (+0.9s)	4468	4468	512	80	213	16	0	309
46994	30062s (+0.5s)	1492	1492	128	42	110	4	1	157
46995	30062s (+0.4s)	1484	1484	128	34	115	6	0	155
46996	30063s (+0.8s)	3400	3400	256	68	203	10	0	281
46997	30064s (+0.8s)	3160	3160	256	57	194	12	0	263
46998	30065s (+1.1s)	4600	4600	256	105	266	16	0	387
46999	30066s (+0.5s)	1596	1596	128	46	115	5	0	166
Episode	Time	Reward	Score	Highest	L	U	R	D	Steps
47000	30066s (+0.8s)	3204	3204	256	57	193	14	0	264
47001	30067s (+0.8s)	3628	3628	256	73	212	20	0	305
47002	30068s (+0.5s)	1796	1796	128	40	136	8	0	184
47003	30069s (+1.1s)	5500	5500	512	82	289	19	0	390
47004	30069s (+0.4s)	1256	1256	128	42	91	8	0	141
47005	30070s (+1.1s)	4544	4544	256	107	250	25	0	382
47006	30071s (+0.5s)	1876	1876	128	40	143	4	0	187
47007	30071s (+0.4s)	1492	1492	128	34	114	8	1	157
47008	30072s (+0.5s)	1552	1552	128	40	119	7	0	166
47009	30073s (+0.7s)	2784	2784	256	56	172	11	0	239
47010	30073s (+0.4s)	1464	1464	128	34	109	7	0	150
47011	30074s (+0.8s)	3592	3592	256	105	178	18	0	301
47012	30075s (+0.7s)	2924	2924	256	53	196	8	0	257
47013	30075s (+0.6s)	1980	1980	128	42	149	11	0	202
47014	30076s (+0.5s)	1628	1628	128	42	125	7	0	174
47015	30076s (+0.4s)	1384	1384	128	39	98	0	7	144
47016	30077s (+0.8s)	3304	3304	256	72	195	0	10	277
47017	30077s (+0.5s)	2148	2148	256	31	145	0	6	182
47018	30078s (+0.7s)	3216	3216	256	58	198	0	11	267
47019	30079s (+0.7s)	3136	3136	256	50	203	0	10	263
47020	30079s (+0.3s)	952	952	64	25	89	0	4	118
47021	30080s (+0.5s)	1840	1840	128	48	131	9	0	188
47022	30081s (+0.8s)	3528	3528	256	67	214	15	0	296
47023	30081s (+0.7s)	2956	2956	256	72	175	13	0	260
47024	30082s (+0.8s)	3312	3312	256	83	182	14	0	279
47025	30083s (+0.7s)	2904	2904	256	64	177	11	0	252
47026	30084s (+0.6s)	2584	2584	256	58	158	10	0	226
47027	30084s (+0.4s)	1420	1420	128	37	106	10	0	153
47028	30085s (+0.6s)	2292	2292	256	43	148	7	0	198
47029	30085s (+0.7s)	2928	2928	256	66	169	13	0	248
47030	30086s (+0.4s)	1212	1212	64	31	100	5	0	136
47031	30086s (+0.8s)	3512	3512	256	67	217	12	1	297
47032	30087s (+0.3s)	884	884	64	25	85	5	1	116
47033	30087s (+0.4s)	1616	1616	128	38	116	7	0	161
47034	30088s (+0.5s)	1608	1608	128	38	124	7	0	169
47035	30089s (+0.8s)	3340	3340	256	55	207	13	0	275
47036	30089s (+0.5s)	2004	2004	128	40	136	7	0	183
47037	30089s (+0.4s)	1112	1112	64	24	110	0	3	137
47038	30090s (+0.6s)	2624	2624	256	47	166	0	8	221
47039	30091s (+0.9s)	3692	3692	256	58	234	0	10	302
47040	30092s (+0.7s)	3148	3148	256	54	194	0	12	260
47041	30092s (+0.4s)	1244	1244	128	31	99	0	8	138
47042	30093s (+0.5s)	1788	1788	128	47	130	0	5	182
47043	30093s (+0.6s)	2068	2068	128	47	145	0	12	204
47044	30094s (+0.4s)	1104	1104	64	27	97	0	4	128
47045	30094s (+0.9s)	3924	3924	256	88	220	0	12	320
47046	30095s (+0.7s)	2972	2972	256	58	181	0	16	255
47047	30096s (+0.5s)	1804	1804	128	39	135	0	12	186
47048	30096s (+0.4s)	1488	1488	128	32	118	5	0	155
47049	30097s (+0.5s)	1668	1668	128	38	132	9	0	179
47050	30097s (+0.6s)	2608	2608	256	58	161	8	0	227
47051	30098s (+0.4s)	1088	1088	64	35	90	5	2	132
47052	30098s (+0.5s)	2116	2116	256	42	125	10	1	178
47053	30099s (+0.5s)	1668	1668	128	31	133	4	0	168
47054	30099s (+0.4s)	1508	1508	128	30	126	4	0	160
47055	30100s (+0.5s)	1608	1608	128	30	122	8	2	162
47056	30101s (+1.0s)	5140	5140	512	101	242	25	0	368
47057	30101s (+0.4s)	1272	1272	128	18	107	4	0	129
47058	30102s (+1.1s)	5380	5380	512	101	258	18	0	377
47059	30103s (+0.7s)	3172	3172	256	58	189	14	0	261
47060	30103s (+0.4s)	1212	1212	128	27	99	4	0	130
47061	30104s (+0.8s)	3276	3276	256	76	188	13	0	277
47062	30105s (+0.8s)	3312	3312	256	59	208	12	0	279
47063	30105s (+0.5s)	1804	1804	128	42	136	8	0	186
47064	30106s (+1.0s)	4260	4260	256	86	248	21	0	355
47065	30107s (+0.6s)	2396	2396	256	37	162	8	0	207
47066	30108s (+0.9s)	4128	4128	256	82	236	21	0	339
47067	30109s (+1.0s)	4408	4408	256	100	247	18	0	365
47068	30110s (+0.7s)	2924	2924	256	67	180	10	0	257
47069	30110s (+0.7s)	2888	2888	256	67	174	12	0	253
47070	30111s (+1.1s)	4376	4376	256	96	247	21	0	364
47071	30112s (+0.7s)	2688	2688	256	57	164	10	1	232
47072	30112s (+0.3s)	992	992	64	33	77	8	0	118
47073	30113s (+0.9s)	4184	4184	256	89	229	19	0	337
47074	30114s (+0.5s)	1764	1764	128	45	124	11	0	180
47075	30115s (+0.9s)	3916	3916	256	79	224	15	0	318
47076	30116s (+0.7s)	3148	3148	256	70	184	8	0	262
47077	30116s (+0.8s)	3256	3256	256	72	190	14	0	276
47078	30117s (+0.2s)	588	588	64	15	67	2	0	84
47079	30118s (+1.2s)	5932	5932	512	117	291	24	0	432
47080	30118s (+0.5s)	1652	1652	128	66	103	6	0	175
47081	30119s (+0.6s)	2172	2172	128	52	146	20	0	218
47082	30119s (+0.3s)	692	692	64	18	71	2	0	91
47083	30120s (+1.0s)	4364	4364	256	91	247	27	0	365
47084	30121s (+0.7s)	3004	3004	256	70	167	14	0	251
47085	30122s (+0.6s)	2608	2608	256	58	160	9	0	227
47086	30122s (+0.4s)	1528	1528	128	40	114	6	0	160
47087	30122s (+0.4s)	904	904	64	26	91	4	0	121
47088	30123s (+0.6s)	2592	2592	256	45	171	0	12	228
47089	30124s (+0.8s)	3228	3228	256	53	204	0	13	270
47090	30124s (+0.6s)	2104	2104	128	33	156	0	10	199
47091	30125s (+0.8s)	3212	3212	256	62	191	0	12	265
47092	30126s (+0.5s)	2208	2208	256	35	140	0	7	182
47093	30126s (+0.5s)	1708	1708	128	27	137	0	8	172
47094	30127s (+0.5s)	1640	1640	128	27	132	0	7	166
47095	30127s (+0.3s)	988	988	128	17	87	0	2	106
47096	30128s (+0.5s)	2036	2036	128	38	140	0	8	186
47097	30128s (+0.4s)	1320	1320	128	32	107	6	0	145
47098	30129s (+0.9s)	3936	3936	256	73	235	15	0	323
47099	30129s (+0.5s)	1824	1824	128	54	127	10	0	191
Episode	Time	Reward	Score	Highest	L	U	R	D	Steps
47100	30130s (+0.4s)	928	928	64	32	84	7	0	123
47101	30131s (+0.7s)	3152	3152	256	71	179	11	0	261
47102	30132s (+1.1s)	5196	5196	512	106	248	23	0	377
47103	30132s (+0.4s)	1272	1272	128	34	92	10	0	136
47104	30133s (+0.8s)	3348	3348	256	63	204	16	0	283
47105	30134s (+0.7s)	2620	2620	128	64	168	16	1	249
47106	30134s (+0.8s)	3216	3216	256	66	191	10	0	267
47107	30135s (+0.7s)	2944	2944	256	72	164	11	0	247
47108	30136s (+0.6s)	2476	2476	256	56	144	12	0	212
47109	30136s (+0.5s)	1760	1760	128	35	140	5	0	180
47110	30137s (+0.9s)	3740	3740	256	77	221	19	0	317
47111	30137s (+0.3s)	1116	1116	128	28	85	5	0	118
47112	30138s (+0.6s)	1924	1924	128	45	146	8	0	199
47113	30139s (+0.7s)	2908	2908	256	54	186	14	0	254
47114	30139s (+0.5s)	2220	2220	256	34	142	0	10	186
47115	30140s (+0.8s)	3356	3356	256	54	216	0	16	286
47116	30141s (+0.9s)	3764	3764	256	64	233	0	15	312
47117	30141s (+0.4s)	1048	1048	64	31	91	0	4	126
47118	30142s (+0.6s)	1924	1924	128	43	146	0	10	199
47119	30143s (+0.7s)	3212	3212	256	71	187	8	0	266
47120	30144s (+1.0s)	5076	5076	512	94	241	20	2	357
47121	30145s (+1.0s)	4232	4232	256	90	243	15	0	348
47122	30146s (+1.1s)	5720	5720	512	96	295	14	0	405
47123	30146s (+0.6s)	1912	1912	128	42	145	9	0	196
47124	30147s (+0.8s)	3252	3252	256	87	162	19	1	269
47125	30148s (+0.4s)	1260	1260	128	26	98	8	0	132
47126	30148s (+0.5s)	1700	1700	128	49	117	13	0	179
47127	30149s (+0.8s)	3396	3396	256	66	198	13	0	277
47128	30149s (+0.4s)	1456	1456	128	33	108	7	0	148
47129	30150s (+0.4s)	1432	1432	128	25	121	7	0	153
47130	30150s (+0.6s)	2692	2692	256	57	164	11	0	232
47131	30151s (+0.5s)	1604	1604	128	44	117	7	0	168
47132	30152s (+0.7s)	2800	2800	256	51	179	12	0	242
47133	30152s (+0.6s)	1908	1908	128	51	138	6	0	195
47134	30153s (+0.4s)	1348	1348	128	29	112	7	0	148
47135	30153s (+0.6s)	1896	1896	128	58	125	14	0	197
47136	30154s (+0.5s)	1588	1588	128	41	115	9	0	165
47137	30154s (+0.7s)	2872	2872	256	38	205	0	12	255
47138	30155s (+0.6s)	2608	2608	256	53	161	0	13	227
47139	30155s (+0.4s)	1420	1420	128	33	107	0	5	145
47140	30156s (+0.6s)	2508	2508	256	42	169	0	8	219
47141	30156s (+0.4s)	1184	1184	128	29	96	0	4	129
47142	30157s (+0.9s)	3972	3972	256	75	243	9	0	327
47143	30158s (+0.4s)	1380	1380	128	42	91	8	0	141
47144	30158s (+0.7s)	2892	2892	256	52	197	6	0	255
47145	30159s (+0.5s)	1816	1816	128	36	149	4	0	189
47146	30160s (+0.5s)	1968	1968	128	51	137	11	0	199
47147	30160s (+0.3s)	744	744	64	22	67	3	0	92
47148	30160s (+0.6s)	2540	2540	256	43	158	10	1	212
47149	30161s (+0.4s)	1448	1448	128	44	99	7	0	150
47150	30161s (+0.5s)	1800	1800	128	42	138	5	0	185
47151	30162s (+0.7s)	3084	3084	256	62	172	15	0	249
47152	30163s (+0.5s)	1732	1732	128	53	113	7	0	173
47153	30164s (+1.0s)	4244	4244	256	97	235	19	0	351
47154	30164s (+0.4s)	1472	1472	128	47	98	7	0	152
47155	30165s (+1.0s)	3992	3992	256	80	238	14	0	332
47156	30166s (+0.7s)	2576	2576	128	74	156	13	0	243
47157	30166s (+0.5s)	1656	1656	128	46	110	10	0	166
47158	30167s (+0.8s)	3476	3476	256	73	209	12	1	295
47159	30168s (+1.0s)	5040	5040	512	79	257	18	1	355
47160	30169s (+0.9s)	3768	3768	256	95	208	20	0	323
47161	30169s (+0.4s)	1344	1344	128	27	112	8	0	147
47162	30170s (+0.4s)	1200	1200	128	37	85	10	0	132
47163	30170s (+0.6s)	2316	2316	256	38	150	5	0	193
47164	30171s (+0.2s)	556	556	64	15	56	3	0	74
47165	30171s (+0.6s)	2640	2640	256	62	152	10	0	224
47166	30172s (+0.3s)	1112	1112	128	26	85	8	0	119
47167	30172s (+0.9s)	3936	3936	256	80	233	10	0	323
47168	30173s (+0.5s)	1724	1724	128	46	112	14	0	172
47169	30174s (+0.6s)	1916	1916	128	52	135	10	0	197
47170	30174s (+0.4s)	1412	1412	128	42	102	5	0	149
47171	30175s (+0.8s)	3436	3436	256	74	200	16	0	290
47172	30175s (+0.6s)	2524	2524	256	40	171	0	7	218
47173	30176s (+0.8s)	3432	3432	256	61	217	0	11	289
47174	30177s (+0.6s)	2344	2344	128	44	172	0	11	227
47175	30177s (+0.4s)	1424	1424	128	26	117	0	2	145
47176	30178s (+0.7s)	3176	3176	256	61	191	0	10	262
47177	30179s (+0.8s)	3344	3344	256	55	209	0	11	275
47178	30179s (+0.5s)	1984	1984	128	38	140	0	10	188
47179	30180s (+0.5s)	1836	1836	128	42	140	0	5	187
47180	30181s (+0.9s)	3956	3956	256	55	256	0	12	323
47181	30182s (+0.6s)	2720	2720	256	41	181	0	11	233
47182	30182s (+0.6s)	2588	2588	256	43	173	0	8	224
47183	30183s (+0.6s)	2492	2492	256	40	165	0	11	216
47184	30183s (+0.5s)	1712	1712	128	39	125	0	8	172
47185	30183s (+0.2s)	384	384	32	11	50	0	2	63
47186	30184s (+0.8s)	3468	3468	256	58	216	12	1	287
47187	30185s (+0.6s)	2448	2448	256	46	157	5	0	208
47188	30186s (+1.1s)	5352	5352	512	96	265	13	0	374
47189	30187s (+0.8s)	3348	3348	256	64	199	9	0	272
47190	30187s (+0.5s)	1848	1848	128	36	141	8	0	185
47191	30188s (+0.4s)	1308	1308	128	35	89	8	1	133
47192	30188s (+0.6s)	2696	2696	256	70	151	9	0	230
47193	30189s (+0.7s)	2968	2968	256	61	184	9	0	254
47194	30190s (+0.8s)	3216	3216	256	79	171	17	0	267
47195	30190s (+0.7s)	2792	2792	256	59	170	12	0	241
47196	30191s (+0.8s)	3544	3544	256	88	188	16	2	294
47197	30193s (+1.3s)	6660	6660	512	146	287	33	0	466
47198	30193s (+0.6s)	2568	2568	256	72	139	12	1	224
47199	30194s (+0.8s)	3624	3624	256	93	199	17	0	309
Episode	Time	Reward	Score	Highest	L	U	R	D	Steps
47200	30195s (+0.7s)	3176	3176	256	71	177	14	0	262
47201	30196s (+0.7s)	3112	3112	256	49	198	11	0	258
47202	30196s (+0.6s)	2484	2484	256	62	139	11	0	212
47203	30197s (+0.7s)	3172	3172	256	67	181	14	0	262
47204	30197s (+0.3s)	836	836	64	24	81	4	0	109
47205	30198s (+0.8s)	3324	3324	256	66	200	16	0	282
47206	30199s (+0.7s)	2916	2916	256	63	186	6	0	255
47207	30200s (+0.8s)	3300	3300	256	64	203	10	0	277
47208	30201s (+1.0s)	4192	4192	256	74	257	14	0	345
47209	30202s (+0.9s)	3776	3776	256	71	231	13	0	315
47210	30202s (+0.5s)	1708	1708	128	46	112	10	0	168
47211	30202s (+0.4s)	1424	1424	128	30	112	4	0	146
47212	30203s (+0.8s)	3344	3344	256	67	207	12	0	286
47213	30204s (+0.4s)	1428	1428	128	28	113	4	0	145
47214	30204s (+0.5s)	1628	1628	128	42	108	9	1	160
47215	30205s (+0.3s)	944	944	64	26	85	5	0	116
47216	30205s (+0.7s)	2552	2552	128	67	159	13	0	239
47217	30206s (+0.7s)	3068	3068	256	68	187	11	0	266
47218	30206s (+0.3s)	1152	1152	128	23	101	2	0	126
47219	30207s (+0.9s)	4028	4028	256	89	233	14	0	336
47220	30208s (+0.8s)	3344	3344	256	82	182	17	1	282
47221	30209s (+0.8s)	3508	3508	256	67	214	15	0	296
47222	30210s (+0.9s)	3992	3992	256	82	233	16	1	332
47223	30210s (+0.6s)	2504	2504	256	71	139	8	0	218
47224	30211s (+0.4s)	1352	1352	128	22	112	5	0	139
47225	30212s (+0.8s)	3232	3232	256	61	196	15	0	272
47226	30212s (+0.5s)	1696	1696	128	44	121	10	0	175
47227	30213s (+0.9s)	4144	4144	256	76	247	15	0	338
47228	30214s (+0.9s)	4064	4064	256	78	245	10	0	333
47229	30215s (+0.7s)	2728	2728	256	46	181	7	0	234
47230	30215s (+0.7s)	2720	2720	256	80	133	16	0	229
47231	30216s (+0.4s)	1492	1492	128	36	112	8	0	156
47232	30217s (+0.8s)	3612	3612	256	66	212	12	0	290
47233	30217s (+0.7s)	2608	2608	128	62	174	10	0	246
47234	30218s (+0.7s)	2504	2504	128	70	152	15	0	237
47235	30219s (+0.8s)	3248	3248	256	69	190	15	0	274
47236	30219s (+0.6s)	2708	2708	256	48	156	6	1	211
47237	30220s (+0.7s)	2568	2568	128	70	159	16	0	245
47238	30220s (+0.5s)	1572	1572	128	42	115	7	0	164
47239	30221s (+0.8s)	3372	3372	256	73	191	15	0	279
47240	30222s (+0.8s)	3500	3500	256	73	211	10	0	294
47241	30223s (+0.7s)	3192	3192	256	60	192	9	0	261
47242	30224s (+0.8s)	3548	3548	256	74	217	10	0	301
47243	30224s (+0.6s)	2096	2096	128	57	134	7	1	199
47244	30225s (+0.6s)	2336	2336	256	52	129	13	0	194
47245	30225s (+0.6s)	2464	2464	256	55	148	9	1	213
47246	30226s (+0.6s)	2388	2388	256	57	136	11	1	205
47247	30227s (+0.8s)	3372	3372	256	73	200	14	2	289
47248	30227s (+0.5s)	1792	1792	128	44	128	11	0	183
47249	30228s (+0.3s)	632	632	32	22	67	4	1	94
47250	30228s (+0.4s)	1440	1440	128	36	104	6	0	146
47251	30229s (+0.5s)	1956	1956	128	55	129	9	0	193
47252	30229s (+0.7s)	2960	2960	256	70	166	11	0	247
47253	30230s (+0.5s)	1856	1856	128	41	143	7	0	191
47254	30231s (+0.7s)	2920	2920	256	60	182	14	0	256
47255	30231s (+0.3s)	720	720	64	20	73	4	0	97
47256	30231s (+0.4s)	1476	1476	128	43	105	4	1	153
47257	30232s (+0.5s)	1684	1684	128	33	128	12	0	173
47258	30232s (+0.6s)	2472	2472	256	52	151	5	1	209
47259	30233s (+0.5s)	1612	1612	128	38	120	8	1	167
47260	30234s (+0.7s)	2612	2612	128	51	185	12	0	248
47261	30235s (+0.9s)	3996	3996	256	117	185	24	0	326
47262	30235s (+0.5s)	1800	1800	128	51	126	8	0	185
47263	30236s (+0.7s)	2976	2976	256	72	173	14	0	259
47264	30236s (+0.5s)	2188	2188	256	35	148	4	0	187
47265	30237s (+0.3s)	980	980	128	22	79	0	3	104
47266	30237s (+0.3s)	680	680	64	21	66	0	7	94
47267	30237s (+0.5s)	1588	1588	128	34	123	0	8	165
47268	30238s (+0.5s)	1796	1796	128	40	136	0	9	185
47269	30239s (+0.7s)	2948	2948	256	70	183	10	0	263
47270	30239s (+0.8s)	2984	2984	256	64	193	9	1	267
47271	30240s (+0.6s)	2248	2248	128	60	138	9	0	207
47272	30240s (+0.4s)	1476	1476	128	41	102	10	0	153
47273	30241s (+0.8s)	3416	3416	256	73	184	20	0	277
47274	30242s (+0.5s)	2196	2196	256	57	129	4	0	190
47275	30243s (+1.1s)	5464	5464	512	85	284	17	0	386
47276	30244s (+0.6s)	1920	1920	128	47	142	8	1	198
47277	30244s (+1.0s)	3996	3996	256	74	244	15	0	333
47278	30245s (+0.6s)	2420	2420	128	63	151	14	0	228
47279	30246s (+0.6s)	2068	2068	128	55	144	9	0	208
47280	30247s (+0.8s)	3560	3560	256	62	224	11	0	297
47281	30248s (+1.0s)	4296	4296	256	91	242	20	0	353
47282	30248s (+0.5s)	1536	1536	64	43	119	9	0	171
47283	30249s (+0.9s)	3540	3540	256	65	218	17	0	300
47284	30250s (+0.8s)	3192	3192	256	76	180	12	1	269
47285	30250s (+0.7s)	2792	2792	256	56	175	9	1	241
47286	30251s (+0.5s)	1564	1564	128	36	120	3	0	159
47287	30252s (+0.8s)	3240	3240	256	67	186	15	0	268
47288	30252s (+0.5s)	1536	1536	128	37	122	3	0	162
47289	30253s (+0.6s)	2372	2372	256	34	160	0	7	201
47290	30253s (+0.7s)	3080	3080	256	41	191	0	19	251
47291	30254s (+0.4s)	1260	1260	128	36	92	0	9	137
47292	30255s (+0.8s)	3244	3244	256	60	199	0	14	273
47293	30255s (+0.6s)	2868	2868	256	49	172	0	12	233
47294	30256s (+0.5s)	1496	1496	128	36	119	3	0	158
47295	30256s (+0.4s)	1444	1444	128	31	110	8	0	149
47296	30257s (+0.6s)	1980	1980	128	42	148	8	0	198
47297	30257s (+0.8s)	3148	3148	256	64	186	15	1	266
47298	30258s (+0.5s)	1524	1524	128	40	115	5	0	160
47299	30258s (+0.6s)	2464	2464	256	50	150	9	0	209
Episode	Time	Reward	Score	Highest	L	U	R	D	Steps
47300	30259s (+0.5s)	1432	1432	64	43	107	11	0	161
47301	30260s (+0.7s)	2876	2876	256	62	161	13	0	236
47302	30260s (+0.4s)	992	992	64	22	95	6	0	123
47303	30261s (+1.0s)	4368	4368	256	85	258	19	0	362
47304	30262s (+0.8s)	3360	3360	256	51	216	9	0	276
47305	30263s (+0.9s)	3692	3692	256	93	210	18	0	321
47306	30263s (+0.3s)	660	660	64	23	64	6	0	93
47307	30264s (+0.9s)	3596	3596	256	74	214	14	0	302
47308	30264s (+0.3s)	1136	1136	128	24	92	3	0	119
47309	30265s (+0.5s)	1512	1512	128	33	119	9	0	161
47310	30265s (+0.5s)	1792	1792	128	47	130	7	0	184
47311	30266s (+0.8s)	3220	3220	256	52	208	8	0	268
47312	30267s (+0.7s)	2800	2800	256	49	183	11	0	243
47313	30267s (+0.6s)	2508	2508	256	58	152	10	0	220
47314	30268s (+1.0s)	4284	4284	256	89	252	15	0	356
47315	30269s (+0.8s)	3192	3192	256	55	195	11	1	262
47316	30270s (+1.0s)	5144	5144	512	87	263	14	0	364
47317	30271s (+0.7s)	3016	3016	256	46	190	11	2	249
47318	30272s (+0.8s)	3396	3396	256	59	210	15	0	284
47319	30272s (+0.6s)	2288	2288	256	36	153	7	0	196
47320	30273s (+0.8s)	3448	3448	256	81	197	15	0	293
47321	30274s (+1.0s)	4324	4324	256	99	236	23	1	359
47322	30275s (+0.9s)	3792	3792	256	75	232	16	0	323
47323	30276s (+0.6s)	1968	1968	128	52	147	6	0	205
47324	30276s (+0.7s)	2772	2772	256	56	173	12	0	241
47325	30277s (+0.6s)	2464	2464	256	52	148	8	0	208
47326	30278s (+0.7s)	2804	2804	256	62	172	10	0	244
47327	30278s (+0.7s)	2628	2628	256	53	169	10	0	232
47328	30279s (+0.6s)	1944	1944	128	51	142	6	0	199
47329	30279s (+0.4s)	1108	1108	64	39	87	5	2	133
47330	30280s (+0.8s)	3380	3380	256	75	189	16	0	280
47331	30281s (+0.7s)	2740	2740	256	46	178	6	0	230
47332	30281s (+0.4s)	1352	1352	128	38	98	6	0	142
47333	30282s (+0.6s)	2580	2580	256	41	176	8	0	225
47334	30282s (+0.6s)	2504	2504	256	56	148	9	0	213
47335	30283s (+0.8s)	3500	3500	256	50	234	0	10	294
47336	30284s (+0.4s)	1028	1028	64	22	94	0	6	122
47337	30284s (+0.6s)	2444	2444	256	34	165	0	9	208
47338	30285s (+0.6s)	2392	2392	256	39	156	0	9	204
47339	30285s (+0.7s)	2616	2616	256	48	165	0	16	229
47340	30286s (+0.6s)	2492	2492	256	42	164	0	9	215
47341	30287s (+0.5s)	1516	1516	128	32	118	0	9	159
47342	30287s (+0.6s)	2244	2244	128	35	167	0	14	216
47343	30288s (+0.4s)	1432	1432	128	43	90	10	0	143
47344	30288s (+0.8s)	3572	3572	256	78	205	12	1	296
47345	30289s (+1.0s)	4244	4244	256	83	250	18	0	351
47346	30290s (+0.5s)	1580	1580	128	29	129	4	0	162
47347	30290s (+0.6s)	2448	2448	256	51	150	9	0	210
47348	30291s (+0.5s)	1756	1756	128	46	119	13	0	178
47349	30292s (+0.8s)	3176	3176	256	85	177	14	0	276
47350	30293s (+0.9s)	3632	3632	256	87	197	20	0	304
47351	30293s (+0.4s)	1320	1320	128	33	107	5	0	145
47352	30294s (+0.9s)	3684	3684	256	69	225	10	0	304
47353	30295s (+0.6s)	2468	2468	256	46	159	4	0	209
47354	30295s (+0.5s)	1648	1648	128	39	123	7	0	169
47355	30296s (+0.5s)	1744	1744	128	45	124	8	0	177
47356	30296s (+0.5s)	1632	1632	128	42	124	9	0	175
47357	30297s (+0.7s)	2900	2900	256	60	179	12	0	251
47358	30297s (+0.5s)	1620	1620	128	47	118	6	1	172
47359	30298s (+0.5s)	1820	1820	128	39	138	7	0	184
47360	30298s (+0.4s)	1160	1160	128	26	95	0	3	124
47361	30299s (+0.5s)	1604	1604	128	35	126	0	7	168
47362	30299s (+0.5s)	1588	1588	128	36	119	0	9	164
47363	30300s (+0.9s)	3760	3760	256	80	225	0	18	323
47364	30301s (+0.5s)	1616	1616	128	31	136	0	5	172
47365	30301s (+0.5s)	1796	1796	128	36	139	0	9	184
47366	30302s (+1.3s)	6396	6396	512	91	342	0	19	452
47367	30303s (+1.1s)	5444	5444	512	98	266	17	0	381
47368	30304s (+0.6s)	2592	2592	256	39	177	7	0	223
47369	30305s (+1.2s)	6212	6212	512	98	315	26	0	439
47370	30306s (+0.7s)	2920	2920	256	56	189	11	0	256
47371	30307s (+0.9s)	3560	3560	256	70	219	15	0	304
47372	30307s (+0.3s)	1004	1004	64	29	84	6	0	119
47373	30308s (+0.7s)	3084	3084	256	50	194	8	0	252
47374	30309s (+0.7s)	2676	2676	256	49	176	5	0	230
47375	30309s (+0.6s)	2780	2780	256	51	167	7	0	225
47376	30310s (+0.6s)	1888	1888	128	46	141	8	0	195
47377	30310s (+0.5s)	1600	1600	128	36	127	4	0	167
47378	30311s (+0.7s)	2872	2872	256	62	174	13	0	249
47379	30311s (+0.3s)	1008	1008	128	27	77	5	0	109
47380	30312s (+0.4s)	1616	1616	128	37	115	8	0	160
47381	30312s (+0.5s)	1840	1840	128	55	127	9	0	191
47382	30313s (+0.7s)	2752	2752	256	55	174	6	0	235
47383	30314s (+0.5s)	1756	1756	128	53	113	13	0	179
47384	30314s (+0.7s)	2920	2920	256	58	170	13	0	241
47385	30315s (+0.6s)	2592	2592	256	52	161	10	0	223
47386	30316s (+0.8s)	3508	3508	256	83	195	14	0	292
47387	30316s (+0.5s)	1776	1776	128	39	132	8	0	179
47388	30317s (+0.9s)	4876	4876	512	70	247	14	1	332
47389	30318s (+0.4s)	1040	1040	64	31	84	9	0	124
47390	30318s (+0.7s)	2776	2776	256	63	163	13	0	239
47391	30319s (+0.3s)	992	992	64	25	91	2	0	118
47392	30319s (+0.7s)	2236	2236	128	58	158	12	0	228
47393	30320s (+0.5s)	1564	1564	128	44	112	7	0	163
47394	30321s (+0.9s)	3624	3624	256	82	207	19	0	308
47395	30321s (+0.2s)	516	516	32	14	61	3	0	78
47396	30321s (+0.4s)	1504	1504	128	34	119	6	0	159
47397	30322s (+0.3s)	748	748	64	16	78	0	5	99
47398	30322s (+0.7s)	2928	2928	256	41	196	0	11	248
47399	30323s (+0.9s)	4196	4196	256	68	261	0	15	344
Episode	Time	Reward	Score	Highest	L	U	R	D	Steps
47400	30324s (+0.6s)	2336	2336	128	43	160	0	9	212
47401	30324s (+0.3s)	876	876	64	32	74	8	0	114
47402	30325s (+0.6s)	2064	2064	128	36	159	0	8	203
47403	30325s (+0.5s)	1576	1576	128	40	111	10	0	161
47404	30326s (+0.4s)	1184	1184	64	29	107	0	7	143
47405	30327s (+0.9s)	4004	4004	256	69	239	0	14	322
47406	30327s (+0.3s)	808	808	64	28	77	0	4	109
47407	30327s (+0.5s)	1888	1888	128	46	137	0	9	192
47408	30328s (+0.4s)	1356	1356	128	29	105	0	7	141
47409	30328s (+0.5s)	1616	1616	128	45	117	8	0	170
47410	30329s (+0.5s)	1748	1748	128	33	135	9	0	177
47411	30330s (+0.8s)	3276	3276	256	68	188	14	0	270
47412	30331s (+1.0s)	4536	4536	256	95	235	23	0	353
47413	30331s (+0.3s)	912	912	64	30	72	5	2	109
47414	30331s (+0.3s)	896	896	64	22	82	5	0	109
47415	30332s (+0.6s)	2376	2376	256	56	135	10	1	202
47416	30333s (+0.9s)	3828	3828	256	81	211	20	0	312
47417	30334s (+0.8s)	3556	3556	256	86	198	13	0	297
47418	30335s (+0.9s)	3680	3680	256	81	213	13	0	307
47419	30335s (+0.9s)	3960	3960	256	94	218	13	0	325
47420	30336s (+0.6s)	2004	2004	128	49	151	7	0	207
47421	30337s (+0.7s)	2776	2776	256	55	174	8	0	237
47422	30337s (+0.4s)	1468	1468	128	41	105	5	0	151
47423	30338s (+0.8s)	3216	3216	256	48	209	11	0	268
47424	30339s (+0.8s)	3452	3452	256	69	205	9	1	284
47425	30339s (+0.4s)	1452	1452	128	31	109	7	0	147
47426	30340s (+0.5s)	1632	1632	128	46	111	8	0	165
47427	30340s (+0.4s)	1380	1380	128	32	108	4	0	144
47428	30341s (+0.9s)	3540	3540	256	74	219	6	0	299
47429	30341s (+0.3s)	1124	1124	128	19	100	0	1	120
47430	30342s (+0.7s)	3256	3256	256	47	213	0	6	266
47431	30343s (+0.7s)	2612	2612	256	46	174	0	8	228
47432	30343s (+0.3s)	912	912	64	22	79	0	8	109
47433	30343s (+0.3s)	832	832	64	25	74	0	6	105
47434	30344s (+0.7s)	3084	3084	256	59	186	0	11	256
47435	30345s (+1.2s)	6272	6272	512	84	334	0	21	439
47436	30346s (+0.3s)	696	696	64	16	73	0	3	92
47437	30346s (+0.4s)	1308	1308	64	31	108	0	8	147
47438	30346s (+0.4s)	1152	1152	64	30	96	9	0	135
47439	30347s (+0.6s)	2132	2132	128	45	147	11	1	204
47440	30348s (+0.9s)	3876	3876	256	88	215	21	0	324
47441	30349s (+0.6s)	2640	2640	256	72	141	12	0	225
47442	30350s (+1.3s)	6624	6624	512	121	321	20	0	462
47443	30351s (+0.7s)	3160	3160	256	70	174	14	0	258
47444	30351s (+0.2s)	524	524	32	18	59	3	0	80
47445	30351s (+0.5s)	1716	1716	128	38	134	4	0	176
47446	30352s (+0.9s)	3620	3620	256	68	225	14	0	307
47447	30353s (+0.4s)	1408	1408	128	25	114	8	0	147
47448	30353s (+0.7s)	3172	3172	256	73	175	16	1	265
47449	30354s (+0.4s)	1480	1480	128	34	113	6	0	153
47450	30355s (+0.6s)	2632	2632	256	65	150	17	0	232
47451	30355s (+0.7s)	2964	2964	256	52	183	11	1	247
47452	30356s (+0.7s)	2676	2676	128	82	151	16	0	249
47453	30357s (+0.7s)	2744	2744	256	60	173	11	0	244
47454	30357s (+0.7s)	2856	2856	256	59	176	14	0	249
47455	30358s (+0.4s)	1088	1088	64	34	90	6	0	130
47456	30358s (+0.6s)	2016	2016	128	57	139	10	0	206
47457	30359s (+0.6s)	2164	2164	128	59	146	12	0	217
47458	30359s (+0.3s)	844	844	64	29	76	3	0	108
47459	30360s (+0.5s)	1860	1860	128	36	146	6	0	188
47460	30361s (+0.8s)	3248	3248	256	62	199	14	0	275
47461	30361s (+0.6s)	2180	2180	128	55	136	11	0	202
47462	30362s (+0.7s)	2920	2920	256	70	173	13	0	256
47463	30363s (+0.8s)	3212	3212	256	63	202	8	0	273
47464	30363s (+0.3s)	928	928	64	27	90	5	0	122
47465	30364s (+0.5s)	1656	1656	128	31	133	2	0	166
47466	30365s (+1.1s)	5496	5496	512	85	286	0	18	389
47467	30365s (+0.5s)	1812	1812	128	32	126	0	14	172
47468	30365s (+0.3s)	700	700	64	18	74	0	3	95
47469	30366s (+0.7s)	2832	2832	256	49	189	0	8	246
47470	30367s (+0.6s)	2552	2552	256	50	165	0	9	224
47471	30367s (+0.5s)	1804	1804	128	37	124	0	12	173
47472	30368s (+0.7s)	2892	2892	256	49	191	0	9	249
47473	30369s (+0.8s)	3516	3516	256	86	195	0	13	294
47474	30370s (+0.8s)	3220	3220	256	53	205	0	14	272
47475	30370s (+0.5s)	1860	1860	128	31	148	0	10	189
47476	30371s (+0.5s)	1904	1904	128	41	145	0	9	195
47477	30371s (+0.8s)	3240	3240	256	70	194	9	0	273
47478	30372s (+0.7s)	2620	2620	256	50	172	7	0	229
47479	30373s (+0.4s)	1448	1448	128	42	100	8	0	150
47480	30373s (+0.8s)	3532	3532	256	66	218	10	1	295
47481	30374s (+0.4s)	1432	1432	128	31	113	9	0	153
47482	30375s (+0.7s)	3028	3028	256	62	177	12	2	253
47483	30375s (+0.6s)	2580	2580	256	52	160	10	0	222
47484	30376s (+0.7s)	3108	3108	256	66	175	16	0	257
47485	30377s (+0.7s)	2508	2508	128	65	163	10	0	238
47486	30378s (+0.9s)	3664	3664	256	81	212	10	1	304
47487	30378s (+0.5s)	1936	1936	128	48	131	12	0	191
47488	30379s (+0.8s)	3548	3548	256	79	199	15	2	295
47489	30380s (+0.8s)	3580	3580	256	68	218	16	0	302
47490	30380s (+0.6s)	2428	2428	256	43	155	7	0	205
47491	30381s (+1.1s)	5480	5480	512	119	251	16	0	386
47492	30382s (+1.0s)	4144	4144	256	92	238	14	0	344
47493	30383s (+0.8s)	3432	3432	256	68	221	10	0	299
47494	30384s (+0.4s)	1412	1412	128	32	102	8	0	142
47495	30384s (+0.4s)	1128	1128	64	35	95	4	0	134
47496	30385s (+0.4s)	1364	1364	128	28	113	1	0	142
47497	30386s (+1.0s)	5052	5052	512	99	241	18	0	358
47498	30386s (+0.5s)	1508	1508	128	33	120	7	0	160
47499	30387s (+0.5s)	1752	1752	128	37	137	4	0	178
Episode	Time	Reward	Score	Highest	L	U	R	D	Steps
47500	30387s (+0.5s)	1824	1824	128	40	137	6	1	184
47501	30388s (+0.6s)	2460	2460	256	51	143	13	1	208
47502	30388s (+0.5s)	1808	1808	128	46	131	9	0	186
47503	30389s (+0.6s)	2380	2380	128	57	152	14	0	223
47504	30389s (+0.5s)	1748	1748	128	38	131	7	0	176
47505	30390s (+0.5s)	1528	1528	128	39	112	10	0	161
47506	30391s (+0.7s)	3012	3012	256	64	181	11	0	256
47507	30392s (+1.0s)	4376	4376	256	101	247	19	0	367
47508	30392s (+0.8s)	3292	3292	256	73	187	14	0	274
47509	30393s (+0.8s)	3436	3436	256	81	190	17	1	289
47510	30394s (+0.4s)	1200	1200	64	36	99	11	0	146
47511	30394s (+0.7s)	3016	3016	256	65	166	12	0	243
47512	30395s (+0.3s)	752	752	64	19	67	0	6	92
47513	30395s (+0.5s)	1756	1756	128	35	134	0	7	176
47514	30395s (+0.3s)	704	704	64	19	71	0	1	91
47515	30396s (+0.6s)	2668	2668	256	46	170	0	11	227
47516	30396s (+0.4s)	1384	1384	128	23	117	0	4	144
47517	30397s (+0.7s)	3168	3168	256	63	187	0	10	260
47518	30398s (+0.8s)	3484	3484	256	78	210	9	0	297
47519	30399s (+0.6s)	2604	2604	256	45	173	8	0	226
47520	30399s (+0.6s)	2052	2052	128	68	121	15	1	205
47521	30400s (+0.5s)	1916	1916	128	59	127	9	0	195
47522	30400s (+0.5s)	1776	1776	128	36	141	6	0	183
47523	30401s (+0.9s)	3960	3960	256	83	231	10	0	324
47524	30402s (+0.3s)	812	812	64	20	82	2	0	104
47525	30402s (+0.8s)	3232	3232	256	73	185	13	0	271
47526	30403s (+0.5s)	1676	1676	128	33	134	4	0	171
47527	30403s (+0.5s)	1636	1636	128	45	116	9	0	170
47528	30404s (+0.5s)	1512	1512	128	38	119	5	0	162
47529	30404s (+0.5s)	1736	1736	128	37	133	4	0	174
47530	30405s (+0.9s)	3564	3564	256	89	195	14	0	298
47531	30406s (+0.6s)	2088	2088	128	43	144	8	0	195
47532	30406s (+0.8s)	3304	3304	256	70	192	15	0	277
47533	30407s (+0.7s)	3108	3108	256	63	183	11	1	258
47534	30408s (+0.8s)	3172	3172	256	64	190	9	0	263
47535	30409s (+1.0s)	4308	4308	256	93	246	16	0	355
47536	30410s (+1.0s)	4172	4172	256	65	264	16	0	345
47537	30411s (+1.0s)	4292	4292	256	86	248	17	0	351
47538	30411s (+0.3s)	800	800	64	18	86	3	0	107
47539	30412s (+0.4s)	1544	1544	128	41	104	10	0	155
47540	30412s (+0.4s)	1448	1448	128	40	105	5	0	150
47541	30413s (+0.4s)	1072	1072	64	34	92	5	0	131
47542	30414s (+0.9s)	3960	3960	256	94	213	18	0	325
47543	30414s (+0.5s)	1700	1700	128	55	107	9	1	172
47544	30415s (+1.2s)	6116	6116	512	109	297	26	0	432
47545	30416s (+0.6s)	2424	2424	256	54	143	11	0	208
47546	30417s (+0.9s)	3688	3688	256	73	219	17	0	309
47547	30418s (+0.8s)	3484	3484	256	87	180	18	1	286
47548	30418s (+0.5s)	1452	1452	128	35	118	9	0	162
47549	30419s (+0.8s)	3496	3496	256	80	196	16	1	293
47550	30420s (+0.9s)	3976	3976	256	89	213	20	0	322
47551	30420s (+0.6s)	2480	2480	256	50	156	10	0	216
47552	30421s (+0.5s)	1696	1696	128	34	134	7	1	176
47553	30422s (+0.8s)	3228	3228	256	52	209	9	0	270
47554	30422s (+0.4s)	1248	1248	128	38	90	3	1	132
47555	30423s (+0.8s)	3240	3240	256	65	197	10	1	273
47556	30424s (+0.8s)	3400	3400	256	59	213	13	0	285
47557	30424s (+0.7s)	3080	3080	256	70	174	20	0	264
47558	30425s (+0.4s)	1472	1472	128	35	114	4	0	153
47559	30426s (+0.7s)	2608	2608	128	73	163	10	0	246
47560	30426s (+0.7s)	3064	3064	256	77	167	17	0	261
47561	30427s (+0.4s)	1332	1332	128	31	114	3	0	148
47562	30428s (+1.3s)	6420	6420	512	144	289	22	1	456
47563	30429s (+1.0s)	4356	4356	256	87	255	21	0	363
47564	30430s (+0.4s)	1348	1348	64	35	111	7	0	153
47565	30430s (+0.5s)	1900	1900	128	49	136	8	0	193
47566	30431s (+0.5s)	1512	1512	128	41	111	9	0	161
47567	30432s (+1.0s)	4112	4112	256	95	219	20	1	335
47568	30432s (+0.8s)	3532	3532	256	75	212	10	0	297
47569	30433s (+0.7s)	3076	3076	256	52	188	1	9	250
47570	30434s (+0.5s)	1856	1856	128	42	128	0	9	179
47571	30435s (+0.8s)	3484	3484	256	52	224	0	15	291
47572	30435s (+0.6s)	1880	1880	128	36	154	0	3	193
47573	30436s (+0.6s)	2516	2516	256	48	165	0	7	220
47574	30437s (+1.3s)	6848	6848	512	114	335	0	22	471
47575	30438s (+0.7s)	3172	3172	256	72	176	13	0	261
47576	30438s (+0.5s)	1544	1544	128	36	112	6	0	154
47577	30439s (+0.5s)	1788	1788	128	40	135	7	0	182
47578	30439s (+0.4s)	1256	1256	64	32	98	0	9	139
47579	30440s (+0.5s)	2180	2180	256	39	134	1	12	186
47580	30440s (+0.6s)	2432	2432	256	53	144	8	0	205
47581	30441s (+0.3s)	696	696	64	16	73	3	0	92
47582	30441s (+0.5s)	1692	1692	128	43	119	10	2	174
47583	30442s (+0.5s)	1788	1788	128	41	133	8	0	182
47584	30442s (+0.9s)	3824	3824	256	55	237	0	16	308
47585	30443s (+0.3s)	804	804	64	19	83	0	3	105
47586	30443s (+0.5s)	1840	1840	128	33	148	0	7	188
47587	30444s (+1.0s)	4164	4164	256	105	213	24	0	342
47588	30445s (+0.8s)	3560	3560	256	80	206	12	0	298
47589	30446s (+1.0s)	4304	4304	256	98	238	19	0	355
47590	30447s (+0.3s)	896	896	64	32	78	5	0	115
47591	30447s (+0.5s)	1792	1792	128	49	124	10	0	183
47592	30448s (+0.8s)	3252	3252	256	66	199	11	0	276
47593	30449s (+1.3s)	6532	6532	512	128	319	25	0	472
47594	30450s (+0.8s)	3240	3240	256	72	193	8	0	273
47595	30450s (+0.4s)	1276	1276	128	26	100	4	0	130
47596	30451s (+0.9s)	3596	3596	256	75	214	12	0	301
47597	30452s (+0.6s)	2056	2056	128	55	135	10	1	201
47598	30453s (+1.0s)	4144	4144	256	86	233	19	0	338
47599	30453s (+0.3s)	748	748	64	26	67	6	1	100
Episode	Time	Reward	Score	Highest	L	U	R	D	Steps
47600	30454s (+0.6s)	2212	2212	256	43	142	7	1	193
47601	30454s (+0.7s)	2884	2884	256	60	174	12	1	247
47602	30455s (+0.7s)	2924	2924	256	67	170	9	0	246
47603	30456s (+0.5s)	1840	1840	128	49	135	6	0	190
47604	30456s (+0.7s)	2728	2728	256	67	155	8	0	230
47605	30457s (+0.6s)	2496	2496	256	54	153	8	0	215
47606	30457s (+0.5s)	1696	1696	128	47	117	10	0	174
47607	30458s (+1.0s)	4292	4292	256	92	243	16	1	352
47608	30459s (+0.7s)	2844	2844	256	55	186	8	0	249
47609	30460s (+0.5s)	1660	1660	128	52	104	11	0	167
47610	30460s (+0.5s)	1612	1612	128	44	122	4	0	170
47611	30461s (+0.5s)	1892	1892	128	38	149	4	0	191
47612	30462s (+1.0s)	4056	4056	256	90	232	19	0	341
47613	30462s (+0.4s)	1312	1312	64	42	98	8	0	148
47614	30463s (+0.5s)	1712	1712	128	51	113	10	1	175
47615	30463s (+0.9s)	3548	3548	256	76	212	14	0	302
47616	30464s (+0.7s)	2684	2684	128	68	171	10	0	249
47617	30465s (+0.5s)	1800	1800	128	37	143	5	0	185
47618	30465s (+0.4s)	1348	1348	128	39	94	5	0	138
47619	30466s (+0.9s)	3588	3588	256	73	217	9	0	299
47620	30467s (+0.7s)	2752	2752	256	48	178	9	0	235
47621	30467s (+0.4s)	1256	1256	128	30	100	5	0	135
47622	30468s (+0.8s)	3344	3344	256	62	210	0	10	282
47623	30469s (+0.9s)	4028	4028	256	61	258	0	12	331
47624	30469s (+0.5s)	1620	1620	128	36	127	0	9	172
47625	30470s (+0.6s)	2616	2616	256	50	160	0	9	219
47626	30470s (+0.5s)	1752	1752	128	31	125	0	7	163
47627	30471s (+0.7s)	3160	3160	256	58	190	0	13	261
47628	30472s (+0.5s)	1736	1736	128	40	127	0	7	174
47629	30472s (+0.4s)	1580	1580	128	27	124	0	6	157
47630	30473s (+0.5s)	1604	1604	128	35	128	0	5	168
47631	30473s (+0.8s)	3212	3212	256	50	207	0	11	268
47632	30474s (+0.4s)	1552	1552	128	40	104	0	7	151
47633	30475s (+0.8s)	3356	3356	256	61	210	0	14	285
47634	30475s (+0.7s)	2652	2652	128	55	182	0	20	257
47635	30476s (+0.5s)	1852	1852	128	47	131	9	0	187
47636	30477s (+0.9s)	3620	3620	256	86	200	22	0	308
47637	30477s (+0.5s)	1760	1760	128	34	142	5	0	181
47638	30478s (+1.1s)	5396	5396	512	111	240	25	1	377
47639	30479s (+0.8s)	3504	3504	256	82	196	17	1	296
47640	30480s (+0.4s)	1416	1416	128	33	106	10	0	149
47641	30480s (+0.7s)	3008	3008	256	56	174	11	1	242
47642	30481s (+0.6s)	2512	2512	256	58	150	8	0	216
47643	30481s (+0.5s)	1836	1836	128	42	130	10	0	182
47644	30482s (+0.7s)	2864	2864	256	56	180	11	0	247
47645	30483s (+0.6s)	2252	2252	128	55	141	12	0	208
47646	30484s (+0.9s)	4128	4128	256	88	236	15	0	339
47647	30485s (+1.3s)	6516	6516	512	120	327	22	2	471
47648	30486s (+0.9s)	3620	3620	256	75	210	23	0	308
47649	30487s (+0.7s)	2572	2572	256	48	175	7	0	230
47650	30488s (+1.0s)	5196	5196	512	82	266	14	0	362
47651	30488s (+0.6s)	2672	2672	256	54	168	7	0	229
47652	30489s (+0.9s)	3588	3588	256	89	201	16	0	306
47653	30490s (+0.9s)	3816	3816	256	84	223	16	1	324
47654	30491s (+0.3s)	888	888	64	24	89	4	0	117
47655	30491s (+0.3s)	912	912	64	29	84	6	0	119
47656	30492s (+1.0s)	4336	4336	256	89	252	16	0	357
47657	30493s (+0.9s)	3588	3588	256	81	204	19	0	304
47658	30494s (+0.9s)	3588	3588	256	80	202	18	0	300
47659	30494s (+0.7s)	2460	2460	128	71	146	14	0	231
47660	30495s (+0.5s)	1896	1896	128	55	131	11	0	197
47661	30496s (+0.9s)	3688	3688	256	91	200	14	0	305
47662	30497s (+1.1s)	4612	4612	256	91	274	18	0	383
47663	30497s (+0.5s)	1604	1604	128	39	122	7	0	168
47664	30498s (+0.6s)	2316	2316	256	40	147	9	0	196
47665	30498s (+0.4s)	1480	1480	128	34	118	3	0	155
47666	30499s (+0.6s)	2008	2008	128	45	138	14	1	198
47667	30499s (+0.4s)	1448	1448	128	34	109	8	0	151
47668	30500s (+0.4s)	1172	1172	64	34	99	6	1	140
47669	30500s (+0.7s)	2644	2644	256	68	152	12	0	232
47670	30501s (+0.8s)	3448	3448	256	74	205	10	0	289
47671	30502s (+0.8s)	3296	3296	256	72	195	12	1	280
47672	30503s (+0.9s)	3984	3984	256	73	230	17	1	321
47673	30504s (+0.8s)	3308	3308	256	73	190	15	0	278
47674	30505s (+1.0s)	4168	4168	256	95	221	20	1	337
47675	30505s (+0.5s)	1596	1596	128	36	127	0	4	167
47676	30506s (+1.0s)	4196	4196	256	79	248	0	19	346
47677	30507s (+0.3s)	1064	1064	128	20	93	0	2	115
47678	30507s (+0.5s)	1868	1868	128	29	158	0	3	190
47679	30508s (+0.7s)	2772	2772	256	50	164	13	0	227
47680	30508s (+0.4s)	1028	1028	64	37	87	7	0	131
47681	30509s (+0.4s)	1052	1052	64	33	89	5	0	127
47682	30510s (+1.1s)	5624	5624	512	108	268	27	1	404
47683	30510s (+0.7s)	2796	2796	256	55	177	10	0	242
47684	30511s (+0.4s)	1488	1488	128	35	117	4	0	156
47685	30511s (+0.5s)	1856	1856	128	47	127	13	0	187
47686	30512s (+1.0s)	5148	5148	512	81	257	14	0	352
47687	30513s (+0.5s)	1788	1788	128	49	128	5	0	182
47688	30513s (+0.4s)	1480	1480	128	42	105	7	0	154
47689	30514s (+0.6s)	2484	2484	256	51	143	9	0	203
47690	30514s (+0.3s)	868	868	64	27	81	5	0	113
47691	30515s (+0.3s)	944	944	64	38	80	4	0	122
47692	30515s (+0.5s)	1496	1496	128	35	116	7	0	158
47693	30516s (+0.6s)	1960	1960	128	60	120	13	0	193
47694	30517s (+1.0s)	4324	4324	256	107	236	23	0	366
47695	30517s (+0.5s)	1628	1628	128	41	124	10	0	175
47696	30518s (+0.3s)	864	864	64	26	82	4	0	112
47697	30518s (+0.4s)	1168	1168	128	24	97	4	0	125
47698	30519s (+0.6s)	2208	2208	128	42	155	0	10	207
47699	30519s (+0.5s)	1812	1812	128	43	133	0	11	187
Episode	Time	Reward	Score	Highest	L	U	R	D	Steps
47700	30520s (+0.8s)	3320	3320	256	48	210	0	17	275
47701	30521s (+1.2s)	5748	5748	512	95	293	20	0	408
47702	30522s (+0.8s)	3168	3168	256	78	182	11	0	271
47703	30522s (+0.5s)	1788	1788	128	56	112	12	0	180
47704	30523s (+0.8s)	3548	3548	256	76	208	12	0	296
47705	30524s (+0.3s)	764	764	64	24	74	5	0	103
47706	30524s (+0.6s)	2044	2044	128	50	139	13	0	202
47707	30525s (+0.8s)	3324	3324	256	72	196	15	0	283
47708	30525s (+0.5s)	1596	1596	128	43	112	11	0	166
47709	30526s (+0.3s)	724	724	64	20	75	1	0	96
47710	30526s (+0.6s)	2096	2096	128	72	119	16	0	207
47711	30527s (+0.2s)	652	652	64	16	66	0	4	86
47712	30527s (+0.8s)	3592	3592	256	58	221	1	17	297
47713	30528s (+0.6s)	2520	2520	256	53	149	0	14	216
47714	30529s (+0.8s)	3404	3404	256	58	221	0	13	292
47715	30530s (+0.8s)	3336	3336	256	73	198	0	10	281
47716	30530s (+0.2s)	464	464	64	14	52	0	2	68
47717	30530s (+0.5s)	1576	1576	128	31	128	0	8	167
47718	30531s (+0.3s)	904	904	64	25	81	5	0	111
47719	30531s (+0.5s)	1792	1792	128	35	143	6	0	184
47720	30532s (+0.4s)	1436	1436	128	38	101	9	0	148
47721	30532s (+0.7s)	3016	3016	256	71	170	12	0	253
47722	30533s (+0.6s)	2580	2580	256	40	174	0	6	220
47723	30533s (+0.5s)	1772	1772	128	38	139	5	0	182
47724	30534s (+0.7s)	3064	3064	256	66	188	7	0	261
47725	30535s (+0.5s)	1776	1776	128	49	119	8	3	179
47726	30536s (+0.8s)	3280	3280	256	77	188	11	0	276
47727	30536s (+0.7s)	2604	2604	128	80	149	17	0	246
47728	30537s (+0.5s)	1820	1820	128	33	141	10	0	184
47729	30537s (+0.6s)	2364	2364	256	43	149	7	1	200
47730	30538s (+0.5s)	1780	1780	128	44	130	8	0	182
47731	30539s (+1.1s)	4560	4560	256	108	250	24	0	382
47732	30540s (+0.6s)	1948	1948	128	60	131	9	0	200
47733	30540s (+0.5s)	1684	1684	128	35	124	0	9	168
47734	30541s (+0.7s)	2476	2476	128	54	164	12	0	230
47735	30541s (+0.4s)	1444	1444	128	27	113	0	6	146
47736	30542s (+0.4s)	1488	1488	128	40	111	6	0	157
47737	30542s (+0.5s)	1700	1700	128	38	124	0	9	171
47738	30543s (+0.7s)	3060	3060	256	63	176	10	0	249
47739	30543s (+0.3s)	904	904	64	21	94	2	0	117
47740	30543s (+0.3s)	812	812	64	27	71	5	1	104
47741	30544s (+0.5s)	1488	1488	128	33	115	0	8	156
47742	30544s (+0.6s)	2392	2392	256	34	153	0	11	198
47743	30545s (+0.4s)	1568	1568	128	33	114	0	7	154
47744	30546s (+0.7s)	3104	3104	256	55	189	0	12	256
47745	30546s (+0.8s)	3084	3084	256	50	203	0	12	265
47746	30547s (+0.9s)	4604	4604	512	70	225	0	18	313
47747	30548s (+0.5s)	1756	1756	128	40	129	0	9	178
47748	30549s (+0.8s)	3236	3236	256	57	205	0	10	272
47749	30550s (+0.9s)	3676	3676	256	45	251	0	7	303
47750	30550s (+0.8s)	3296	3296	256	64	206	0	17	287
47751	30551s (+0.3s)	760	760	64	20	73	0	4	97
47752	30551s (+0.4s)	1180	1180	64	23	117	0	2	142
47753	30551s (+0.2s)	544	544	64	10	63	0	2	75
47754	30552s (+0.8s)	3476	3476	256	70	208	10	0	288
47755	30553s (+0.8s)	3288	3288	256	88	172	13	0	273
47756	30553s (+0.5s)	1784	1784	128	40	134	6	0	180
47757	30554s (+0.9s)	4704	4704	512	67	245	10	0	322
47758	30555s (+0.7s)	2640	2640	256	53	169	9	0	231
47759	30555s (+0.5s)	1552	1552	128	34	119	7	0	160
47760	30556s (+1.0s)	5188	5188	512	82	253	14	1	350
47761	30557s (+0.9s)	3524	3524	256	94	185	16	1	296
47762	30558s (+0.7s)	3192	3192	256	63	179	17	2	261
47763	30559s (+0.5s)	1712	1712	128	45	123	5	0	173
47764	30559s (+0.6s)	2440	2440	256	49	150	8	0	207
47765	30560s (+0.8s)	3224	3224	256	63	192	14	0	269
47766	30560s (+0.2s)	584	584	64	16	64	1	0	81
47767	30561s (+0.7s)	2800	2800	256	65	169	9	0	243
47768	30561s (+0.5s)	2228	2228	256	38	150	5	0	193
47769	30562s (+0.8s)	3548	3548	256	73	211	17	0	301
47770	30563s (+0.6s)	2420	2420	256	48	143	14	0	205
47771	30563s (+0.5s)	1500	1500	128	35	115	8	1	159
47772	30564s (+0.9s)	3800	3800	256	87	201	19	0	307
47773	30565s (+1.0s)	4344	4344	256	88	246	16	0	350
47774	30566s (+0.3s)	1156	1156	128	34	81	6	1	122
47775	30566s (+0.5s)	1728	1728	128	36	140	3	0	179
47776	30567s (+0.8s)	2892	2892	128	76	178	16	0	270
47777	30568s (+0.6s)	2628	2628	256	57	155	11	0	223
47778	30568s (+0.4s)	1400	1400	128	40	98	9	0	147
47779	30568s (+0.4s)	1428	1428	128	30	117	2	0	149
47780	30569s (+0.5s)	1736	1736	128	37	128	9	0	174
47781	30570s (+0.7s)	3032	3032	256	52	189	7	0	248
47782	30571s (+1.0s)	4224	4224	256	93	230	23	0	346
47783	30571s (+0.7s)	2548	2548	128	75	154	14	0	243
47784	30572s (+0.8s)	3744	3744	256	81	211	18	1	311
47785	30573s (+0.7s)	2556	2556	128	63	160	15	0	238
47786	30574s (+0.8s)	3448	3448	256	72	196	17	0	285
47787	30574s (+0.4s)	1308	1308	128	27	98	9	0	134
47788	30575s (+0.6s)	2480	2480	256	42	164	10	0	216
47789	30575s (+0.7s)	2820	2820	256	51	184	0	12	247
47790	30576s (+0.8s)	3216	3216	256	67	195	0	6	268
47791	30577s (+0.5s)	1756	1756	128	31	141	0	8	180
47792	30577s (+0.4s)	1320	1320	128	40	99	5	1	145
47793	30577s (+0.4s)	1504	1504	128	37	114	4	0	155
47794	30578s (+0.5s)	1612	1612	128	32	130	8	0	170
47795	30579s (+0.7s)	2792	2792	128	78	155	15	1	249
47796	30579s (+0.3s)	744	744	64	24	64	10	0	98
47797	30580s (+0.9s)	3868	3868	256	71	233	0	21	325
47798	30580s (+0.4s)	1044	1044	64	29	91	0	5	125
47799	30581s (+0.6s)	2232	2232	128	40	159	0	14	213
Episode	Time	Reward	Score	Highest	L	U	R	D	Steps
47800	30582s (+0.8s)	3272	3272	256	60	202	0	14	276
47801	30582s (+0.8s)	3356	3356	256	77	187	14	1	279
47802	30583s (+0.9s)	4096	4096	256	89	220	21	1	331
47803	30584s (+0.8s)	3372	3372	256	83	197	9	0	289
47804	30585s (+0.4s)	1252	1252	128	41	89	6	0	136
47805	30585s (+0.6s)	1884	1884	128	45	144	5	0	194
47806	30586s (+0.4s)	1328	1328	64	37	110	5	0	152
47807	30587s (+0.9s)	4012	4012	256	82	229	15	0	326
47808	30587s (+0.4s)	1520	1520	128	37	115	5	0	157
47809	30588s (+0.7s)	3140	3140	256	67	174	16	0	257
47810	30588s (+0.4s)	1472	1472	128	36	107	9	0	152
47811	30589s (+0.4s)	1132	1132	64	35	89	7	0	131
47812	30589s (+0.6s)	2560	2560	256	57	151	7	2	217
47813	30590s (+0.9s)	3956	3956	256	100	214	13	1	328
47814	30591s (+0.6s)	1968	1968	128	49	153	3	0	205
47815	30591s (+0.4s)	1284	1284	128	22	105	5	0	132
47816	30592s (+0.5s)	1868	1868	128	35	151	5	0	191
47817	30592s (+0.4s)	1072	1072	64	24	103	5	0	132
47818	30592s (+0.4s)	1560	1560	128	35	120	6	0	161
47819	30593s (+0.8s)	3448	3448	256	83	202	16	0	301
47820	30594s (+0.5s)	1772	1772	128	45	130	8	0	183
47821	30594s (+0.5s)	1612	1612	128	43	120	7	0	170
47822	30595s (+0.4s)	1068	1068	64	24	100	0	7	131
47823	30595s (+0.5s)	1624	1624	128	42	123	0	8	173
47824	30596s (+0.4s)	1548	1548	128	35	112	0	12	159
47825	30596s (+0.5s)	1840	1840	128	42	143	0	5	190
47826	30597s (+0.7s)	2832	2832	256	46	184	0	13	243
47827	30597s (+0.6s)	2132	2132	128	47	154	0	13	214
47828	30598s (+0.4s)	1348	1348	128	37	94	0	7	138
47829	30598s (+0.6s)	1972	1972	128	48	151	0	7	206
47830	30599s (+0.4s)	1304	1304	128	33	96	0	3	132
47831	30599s (+0.4s)	1460	1460	128	29	120	0	5	154
47832	30600s (+0.8s)	3316	3316	256	53	219	0	9	281
47833	30601s (+0.6s)	2108	2108	128	49	142	0	15	206
47834	30601s (+0.4s)	1156	1156	64	33	97	0	6	136
47835	30601s (+0.4s)	1188	1188	128	26	98	4	0	128
47836	30602s (+0.3s)	916	916	64	33	82	4	0	119
47837	30602s (+0.5s)	1688	1688	128	48	114	7	0	169
47838	30604s (+1.4s)	6616	6616	512	133	314	33	0	480
47839	30604s (+0.5s)	1552	1552	128	39	113	10	0	162
47840	30605s (+0.5s)	1752	1752	128	36	132	10	0	178
47841	30605s (+0.7s)	2860	2860	256	61	182	10	0	253
47842	30606s (+0.7s)	3156	3156	256	64	185	11	0	260
47843	30607s (+0.8s)	3192	3192	256	56	203	6	0	265
47844	30607s (+0.5s)	1900	1900	128	59	127	11	0	197
47845	30608s (+0.7s)	2804	2804	256	66	167	11	0	244
47846	30609s (+0.5s)	1580	1580	128	35	128	1	0	164
47847	30609s (+0.8s)	3328	3328	256	54	215	9	0	278
47848	30610s (+0.3s)	912	912	64	26	78	4	1	109
47849	30610s (+0.4s)	1212	1212	64	42	100	3	0	145
47850	30611s (+0.7s)	2744	2744	256	56	165	14	0	235
47851	30611s (+0.5s)	1836	1836	128	57	124	6	0	187
47852	30612s (+0.9s)	3932	3932	256	76	231	14	0	321
47853	30613s (+0.6s)	2500	2500	256	50	156	9	1	216
47854	30614s (+0.9s)	3600	3600	256	68	222	16	0	306
47855	30614s (+0.4s)	1156	1156	64	30	94	6	0	130
47856	30615s (+0.7s)	2784	2784	256	56	177	7	0	240
47857	30615s (+0.5s)	1708	1708	128	43	125	6	0	174
47858	30616s (+0.7s)	2668	2668	256	73	154	10	0	237
47859	30617s (+0.9s)	3584	3584	256	80	199	19	0	298
47860	30617s (+0.5s)	1552	1552	128	45	111	10	0	166
47861	30618s (+0.9s)	4088	4088	256	87	229	18	0	334
47862	30619s (+0.7s)	2776	2776	256	41	192	9	0	242
47863	30620s (+0.7s)	2924	2924	256	57	185	11	0	253
47864	30620s (+0.8s)	3492	3492	256	84	194	14	0	292
47865	30621s (+0.5s)	1776	1776	128	37	129	9	0	175
47866	30622s (+0.8s)	3492	3492	256	70	207	15	0	292
47867	30623s (+0.9s)	3996	3996	256	63	249	9	0	321
47868	30623s (+0.5s)	1828	1828	128	47	133	7	1	188
47869	30624s (+0.8s)	3268	3268	256	77	187	10	1	275
47870	30625s (+1.0s)	4964	4964	512	97	222	23	0	342
47871	30626s (+0.5s)	1660	1660	128	43	123	5	0	171
47872	30626s (+0.5s)	1904	1904	128	38	149	7	0	194
47873	30627s (+0.6s)	2700	2700	256	47	172	9	0	228
47874	30627s (+0.7s)	2920	2920	256	63	181	12	0	256
47875	30628s (+0.6s)	2072	2072	128	61	134	10	0	205
47876	30629s (+0.7s)	3136	3136	256	54	193	10	1	258
47877	30630s (+1.0s)	4312	4312	256	93	243	20	0	356
47878	30630s (+0.4s)	1004	1004	64	33	80	6	0	119
47879	30631s (+0.5s)	2252	2252	256	65	117	10	0	192
47880	30631s (+0.6s)	1944	1944	128	55	131	11	0	197
47881	30632s (+0.5s)	1608	1608	128	31	131	7	0	169
47882	30632s (+0.7s)	2924	2924	256	60	183	14	0	257
47883	30633s (+0.8s)	3496	3496	256	84	195	14	0	293
47884	30634s (+0.5s)	1768	1768	128	47	123	7	0	177
47885	30634s (+0.4s)	1504	1504	128	43	109	7	0	159
47886	30635s (+0.7s)	3148	3148	256	53	197	0	9	259
47887	30636s (+0.5s)	2324	2324	256	39	143	0	9	191
47888	30636s (+0.1s)	252	252	32	9	38	0	1	48
47889	30636s (+0.2s)	624	624	64	14	65	0	6	85
47890	30637s (+0.5s)	1868	1868	128	36	130	0	11	177
47891	30638s (+1.0s)	4144	4144	256	76	242	0	21	339
47892	30638s (+0.9s)	3952	3952	256	70	231	0	22	323
47893	30639s (+0.5s)	1668	1668	128	30	132	0	7	169
47894	30640s (+1.1s)	4524	4524	256	97	260	16	0	373
47895	30641s (+0.5s)	1424	1424	64	37	110	8	1	156
47896	30641s (+0.7s)	2892	2892	256	69	168	13	0	250
47897	30642s (+0.8s)	3552	3552	256	90	197	13	0	300
47898	30643s (+0.5s)	1888	1888	128	47	132	12	0	191
47899	30643s (+0.3s)	912	912	64	29	85	5	0	119
Episode	Time	Reward	Score	Highest	L	U	R	D	Steps
47900	30644s (+0.9s)	3552	3552	256	62	224	0	16	302
47901	30644s (+0.5s)	1812	1812	128	40	139	0	8	187
47902	30645s (+0.3s)	900	900	64	25	88	3	0	116
47903	30646s (+1.2s)	6112	6112	512	104	303	20	0	427
47904	30646s (+0.4s)	1428	1428	128	25	118	4	0	147
47905	30647s (+0.4s)	1172	1172	64	36	87	6	1	130
47906	30647s (+0.7s)	2808	2808	256	50	188	7	0	245
47907	30648s (+0.9s)	4016	4016	256	72	247	14	0	333
47908	30649s (+0.3s)	1032	1032	128	22	86	3	0	111
47909	30649s (+0.7s)	2840	2840	256	70	164	12	0	246
47910	30650s (+0.5s)	1620	1620	128	40	122	9	1	172
47911	30650s (+0.4s)	1328	1328	128	24	107	6	0	137
47912	30651s (+0.9s)	4748	4748	512	73	240	18	0	331
47913	30652s (+0.9s)	3856	3856	256	87	209	18	0	314
47914	30653s (+0.4s)	1488	1488	128	41	107	8	0	156
47915	30653s (+0.5s)	1528	1528	128	41	111	8	1	161
47916	30654s (+0.8s)	3572	3572	256	83	200	14	0	297
47917	30655s (+0.6s)	2608	2608	256	52	166	9	0	227
47918	30656s (+1.0s)	4348	4348	256	92	256	17	0	365
47919	30656s (+0.5s)	1812	1812	128	38	144	0	5	187
47920	30657s (+0.6s)	2292	2292	128	57	147	13	0	217
47921	30657s (+0.3s)	748	748	64	14	80	0	6	100
47922	30658s (+0.6s)	2476	2476	256	57	145	12	0	214
47923	30658s (+0.4s)	1300	1300	128	34	87	10	0	131
47924	30659s (+0.5s)	1660	1660	128	39	120	9	0	168
47925	30659s (+0.7s)	2504	2504	128	59	167	11	0	237
47926	30660s (+0.7s)	2800	2800	256	52	183	8	0	243
47927	30661s (+0.7s)	2768	2768	256	59	169	12	0	240
47928	30661s (+0.5s)	1616	1616	128	36	126	9	0	171
47929	30662s (+0.7s)	3208	3208	256	71	181	13	0	265
47930	30663s (+1.4s)	7224	7224	512	143	325	32	0	500
47931	30664s (+1.0s)	4064	4064	256	89	232	12	0	333
47932	30665s (+0.4s)	1368	1368	128	31	100	6	0	137
47933	30665s (+0.6s)	1860	1860	128	52	136	7	0	195
47934	30666s (+0.8s)	2900	2900	128	83	171	18	0	272
47935	30667s (+0.8s)	3528	3528	256	77	208	11	0	296
47936	30668s (+0.8s)	3380	3380	256	82	186	13	0	281
47937	30668s (+0.6s)	2696	2696	256	55	163	9	0	227
47938	30669s (+0.8s)	3588	3588	256	57	218	11	0	286
47939	30669s (+0.4s)	1264	1264	128	30	98	5	0	133
47940	30670s (+0.7s)	2896	2896	256	74	167	9	0	250
47941	30671s (+0.6s)	2360	2360	256	50	141	15	2	208
47942	30671s (+0.5s)	1600	1600	128	38	121	8	0	167
47943	30672s (+0.8s)	3544	3544	256	74	212	14	0	300
47944	30673s (+0.5s)	1904	1904	128	38	146	11	0	195
47945	30673s (+0.3s)	1064	1064	128	17	93	3	0	113
47946	30674s (+0.6s)	2384	2384	256	50	145	9	0	204
47947	30674s (+0.5s)	1892	1892	128	48	139	6	0	193
47948	30675s (+0.8s)	3336	3336	256	67	197	16	0	280
47949	30675s (+0.4s)	1516	1516	128	44	109	5	0	158
47950	30676s (+1.0s)	4332	4332	256	96	243	18	0	357
47951	30677s (+0.4s)	1304	1304	128	45	92	5	0	142
47952	30677s (+0.4s)	1188	1188	128	29	94	6	0	129
47953	30678s (+0.9s)	3796	3796	256	95	210	15	0	320
47954	30679s (+0.7s)	2764	2764	256	50	181	9	0	240
47955	30680s (+0.7s)	2856	2856	256	70	174	8	0	252
47956	30680s (+0.9s)	3588	3588	256	82	204	18	0	304
47957	30681s (+0.8s)	3496	3496	256	64	219	10	0	293
47958	30682s (+0.5s)	1752	1752	128	33	133	0	12	178
47959	30682s (+0.2s)	364	364	32	11	47	0	4	62
47960	30683s (+0.5s)	1712	1712	128	34	128	0	7	169
47961	30683s (+0.5s)	1784	1784	128	37	139	6	0	182
47962	30684s (+0.6s)	2368	2368	256	61	130	10	0	201
47963	30684s (+0.8s)	3304	3304	256	71	191	15	0	277
47964	30685s (+0.7s)	2756	2756	256	63	165	9	0	237
47965	30686s (+0.8s)	3068	3068	256	66	188	19	0	273
47966	30686s (+0.4s)	1452	1452	128	34	115	3	0	152
47967	30687s (+0.4s)	1352	1352	64	40	110	7	0	157
47968	30687s (+0.5s)	1876	1876	128	49	135	8	0	192
47969	30688s (+0.8s)	2844	2844	128	77	174	15	0	266
47970	30689s (+0.8s)	3552	3552	256	78	195	22	0	295
47971	30690s (+1.0s)	4180	4180	256	103	212	25	0	340
47972	30690s (+0.4s)	1524	1524	128	29	126	4	1	160
47973	30691s (+0.5s)	1900	1900	128	46	139	8	0	193
47974	30692s (+0.8s)	3344	3344	256	66	204	12	0	282
47975	30692s (+0.5s)	1988	1988	128	53	132	15	0	200
47976	30693s (+0.5s)	1744	1744	128	38	136	2	0	176
47977	30693s (+0.4s)	1580	1580	128	31	121	0	10	162
47978	30694s (+0.7s)	3188	3188	256	44	208	0	14	266
47979	30695s (+1.0s)	4084	4084	256	67	254	0	18	339
47980	30695s (+0.5s)	1648	1648	128	37	131	0	5	173
47981	30696s (+0.4s)	1400	1400	128	27	111	0	7	145
47982	30696s (+0.6s)	2584	2584	256	63	147	13	2	225
47983	30697s (+0.2s)	368	368	32	15	50	0	0	65
47984	30697s (+0.4s)	1488	1488	128	37	112	6	0	155
47985	30698s (+0.8s)	3284	3284	256	86	177	14	0	277
47986	30698s (+0.5s)	1592	1592	128	41	116	8	0	165
47987	30699s (+0.3s)	724	724	64	29	70	2	0	101
47988	30700s (+0.8s)	3252	3252	256	73	187	16	0	276
47989	30700s (+0.8s)	3392	3392	256	68	203	9	0	280
47990	30701s (+0.9s)	3792	3792	256	82	208	15	0	305
47991	30702s (+0.6s)	2352	2352	256	41	154	6	0	201
47992	30703s (+0.9s)	3828	3828	256	76	220	12	0	308
47993	30703s (+0.4s)	1312	1312	128	33	98	8	1	140
47994	30704s (+0.6s)	2520	2520	256	54	161	6	0	221
47995	30704s (+0.6s)	2560	2560	256	49	159	8	0	216
47996	30705s (+0.7s)	3088	3088	256	58	179	13	0	250
47997	30705s (+0.2s)	568	568	64	23	56	4	0	83
47998	30706s (+0.4s)	1152	1152	64	28	108	1	0	137
47999	30707s (+1.0s)	5164	5164	512	85	269	15	0	369
Episode	Time	Reward	Score	Highest	L	U	R	D	Steps
48000	30707s (+0.6s)	1936	1936	128	49	131	14	0	194
48001	30708s (+0.7s)	2636	2636	256	66	159	9	0	234
48002	30708s (+0.6s)	1916	1916	128	45	146	6	0	197
48003	30709s (+0.5s)	1740	1740	128	30	141	4	0	175
48004	30710s (+0.6s)	2028	2028	128	61	138	11	0	210
48005	30710s (+0.7s)	3100	3100	256	55	189	10	0	254
48006	30711s (+0.3s)	820	820	64	21	80	5	0	106
48007	30712s (+1.1s)	4512	4512	256	91	258	25	0	374
48008	30712s (+0.6s)	2168	2168	128	51	156	11	0	218
48009	30713s (+0.3s)	1084	1084	128	23	92	0	5	120
48010	30713s (+0.8s)	3264	3264	256	59	204	0	8	271
48011	30714s (+0.6s)	2604	2604	256	46	169	0	11	226
48012	30715s (+0.7s)	3124	3124	256	42	213	0	6	261
48013	30716s (+0.7s)	2924	2924	256	41	185	1	7	234
48014	30716s (+0.5s)	1884	1884	128	49	135	0	6	190
48015	30717s (+0.9s)	3708	3708	256	63	223	0	19	305
48016	30717s (+0.3s)	1004	1004	128	15	90	0	2	107
48017	30718s (+0.7s)	3044	3044	256	54	191	0	10	255
48018	30719s (+0.8s)	3676	3676	256	68	222	0	12	302
48019	30720s (+0.6s)	2696	2696	256	47	169	0	10	226
48020	30720s (+0.3s)	724	724	64	20	72	3	0	95
48021	30721s (+0.7s)	2560	2560	128	50	173	16	1	240
48022	30721s (+0.5s)	1760	1760	128	42	128	10	0	180
48023	30722s (+1.2s)	5768	5768	512	113	278	18	0	409
48024	30723s (+0.7s)	2328	2328	128	52	163	10	0	225
48025	30724s (+0.7s)	2868	2868	256	66	172	10	0	248
48026	30724s (+0.4s)	1472	1472	128	48	97	7	0	152
48027	30724s (+0.5s)	1588	1588	128	38	121	6	0	165
48028	30725s (+0.5s)	1800	1800	128	49	130	5	1	185
48029	30725s (+0.3s)	772	772	64	36	65	3	0	104
48030	30726s (+0.7s)	2912	2912	256	58	172	10	0	240
48031	30726s (+0.4s)	1580	1580	128	42	113	7	0	162
48032	30727s (+0.6s)	2652	2652	256	64	150	10	0	224
48033	30728s (+0.7s)	3196	3196	256	63	186	13	0	262
48034	30729s (+1.2s)	5884	5884	512	124	269	25	0	418
48035	30730s (+0.8s)	3352	3352	256	63	203	8	0	274
48036	30730s (+0.5s)	1772	1772	128	41	136	6	0	183
48037	30731s (+0.4s)	1196	1196	64	34	105	6	0	145
48038	30731s (+0.3s)	632	632	64	29	51	7	0	87
48039	30732s (+0.6s)	2432	2432	256	68	130	7	0	205
48040	30732s (+0.3s)	728	728	64	24	69	2	0	95
48041	30732s (+0.6s)	1984	1984	128	49	144	9	0	202
48042	30733s (+0.6s)	2576	2576	256	57	158	0	9	224
48043	30734s (+0.8s)	3508	3508	256	60	221	0	11	292
48044	30734s (+0.4s)	1152	1152	64	33	98	0	5	136
48045	30735s (+0.9s)	4004	4004	256	65	241	0	13	319
48046	30736s (+0.7s)	2692	2692	256	52	180	0	11	243
48047	30737s (+0.7s)	2752	2752	256	49	173	0	11	233
48048	30737s (+0.5s)	1792	1792	128	38	134	0	12	184
48049	30738s (+0.6s)	2492	2492	256	56	153	7	0	216
48050	30739s (+0.7s)	2912	2912	256	64	177	13	0	254
48051	30739s (+0.8s)	3256	3256	256	55	203	15	0	273
48052	30740s (+0.8s)	3336	3336	256	62	208	13	1	284
48053	30741s (+0.8s)	3236	3236	256	76	183	13	0	272
48054	30742s (+0.8s)	3220	3220	256	58	199	9	1	267
48055	30742s (+0.3s)	956	956	128	16	87	1	0	104
48056	30743s (+0.9s)	3976	3976	256	87	230	11	0	328
48057	30744s (+1.3s)	6256	6256	512	101	332	17	0	450
48058	30745s (+0.4s)	1052	1052	64	19	103	4	1	127
48059	30745s (+0.7s)	3016	3016	256	50	189	10	0	249
48060	30746s (+0.3s)	1128	1128	128	20	99	1	0	120
48061	30746s (+0.8s)	3504	3504	256	94	181	15	0	290
48062	30747s (+0.6s)	1980	1980	128	51	149	8	0	208
48063	30748s (+1.0s)	4160	4160	256	76	253	13	0	342
48064	30748s (+0.4s)	1236	1236	64	40	95	6	0	141
48065	30749s (+0.5s)	1616	1616	128	40	126	5	0	171
48066	30750s (+0.8s)	3368	3368	256	72	204	12	0	288
48067	30751s (+1.0s)	4292	4292	256	101	235	20	0	356
48068	30751s (+0.5s)	1628	1628	128	55	103	9	0	167
48069	30752s (+0.6s)	2412	2412	128	75	134	15	2	226
48070	30753s (+0.7s)	3212	3212	256	68	189	9	0	266
48071	30753s (+0.5s)	1836	1836	128	43	136	9	1	189
48072	30754s (+0.8s)	3220	3220	256	71	190	12	0	273
48073	30755s (+1.0s)	4312	4312	256	92	256	15	0	363
48074	30756s (+0.7s)	3104	3104	256	74	165	18	0	257
48075	30756s (+0.5s)	1504	1504	128	38	114	7	0	159
48076	30757s (+0.8s)	3376	3376	256	85	190	14	0	289
48077	30758s (+0.6s)	2628	2628	256	62	158	7	0	227
48078	30759s (+1.0s)	4336	4336	256	95	241	18	0	354
48079	30760s (+1.0s)	4168	4168	256	87	236	16	0	339
48080	30760s (+0.8s)	3548	3548	256	56	235	10	0	301
48081	30761s (+0.5s)	1720	1720	128	31	135	10	0	176
48082	30762s (+0.9s)	3596	3596	256	78	217	13	0	308
48083	30762s (+0.7s)	2800	2800	256	64	165	14	0	243
48084	30763s (+0.6s)	2596	2596	256	46	164	9	0	219
48085	30764s (+0.5s)	1548	1548	128	42	119	5	0	166
48086	30764s (+0.8s)	3600	3600	256	94	188	21	0	303
48087	30765s (+0.7s)	2616	2616	256	55	166	8	0	229
48088	30766s (+0.6s)	2208	2208	128	51	146	10	0	207
48089	30766s (+0.7s)	2860	2860	256	66	167	9	0	242
48090	30767s (+0.4s)	1056	1056	64	21	102	4	1	128
48091	30767s (+0.7s)	2920	2920	256	62	177	14	0	253
48092	30768s (+0.7s)	3156	3156	256	56	192	12	0	260
48093	30769s (+0.4s)	1244	1244	64	38	96	6	2	142
48094	30769s (+0.5s)	1848	1848	128	49	130	6	0	185
48095	30770s (+0.9s)	3812	3812	256	99	205	14	0	318
48096	30771s (+0.7s)	2872	2872	256	54	177	10	0	241
48097	30772s (+1.0s)	4252	4252	256	87	243	18	0	348
48098	30772s (+0.5s)	1784	1784	128	41	133	6	1	181
48099	30773s (+0.5s)	1912	1912	128	60	125	11	1	197
Episode	Time	Reward	Score	Highest	L	U	R	D	Steps
48100	30773s (+0.5s)	1672	1672	128	29	136	6	0	171
48101	30774s (+0.5s)	1828	1828	128	58	120	8	0	186
48102	30775s (+1.2s)	5820	5820	512	83	318	0	20	421
48103	30776s (+0.6s)	2656	2656	256	46	170	0	9	225
48104	30777s (+0.8s)	3420	3420	256	54	210	0	13	277
48105	30777s (+0.4s)	1304	1304	128	33	102	0	6	141
48106	30778s (+0.7s)	2908	2908	256	57	183	0	14	254
48107	30778s (+0.8s)	3232	3232	256	55	204	0	12	271
48108	30779s (+0.7s)	2868	2868	256	50	192	0	7	249
48109	30780s (+0.5s)	1672	1672	128	35	128	0	7	170
48110	30780s (+0.6s)	2352	2352	256	34	158	0	6	198
48111	30780s (+0.2s)	532	532	32	20	53	5	0	78
48112	30781s (+0.9s)	3996	3996	256	61	254	0	13	328
48113	30782s (+0.7s)	3168	3168	256	56	192	0	11	259
48114	30783s (+0.4s)	1320	1320	128	22	117	0	4	143
48115	30783s (+0.4s)	1484	1484	128	25	125	0	5	155
48116	30784s (+0.7s)	2828	2828	256	48	188	0	9	245
48117	30784s (+0.3s)	792	792	64	21	79	0	6	106
48118	30785s (+0.7s)	2868	2868	256	49	187	0	12	248
48119	30785s (+0.4s)	1280	1280	128	24	103	0	3	130
48120	30786s (+1.0s)	4188	4188	256	86	244	13	0	343
48121	30787s (+0.5s)	2284	2284	256	47	131	8	0	186
48122	30788s (+0.9s)	3868	3868	256	76	231	15	0	322
48123	30788s (+0.5s)	1600	1600	128	35	126	6	0	167
48124	30789s (+0.9s)	4616	4616	512	86	208	19	1	314
48125	30789s (+0.4s)	1384	1384	128	32	103	6	0	141
48126	30790s (+0.6s)	2460	2460	256	36	166	9	0	211
48127	30791s (+0.5s)	1788	1788	128	44	128	10	0	182
48128	30791s (+0.2s)	644	644	64	18	67	5	0	90
48129	30791s (+0.3s)	872	872	64	27	81	6	0	114
48130	30792s (+0.5s)	1784	1784	128	40	131	9	1	181
48131	30792s (+0.6s)	2552	2552	256	46	173	5	0	224
48132	30793s (+0.4s)	1304	1304	128	34	99	9	0	142
48133	30794s (+1.0s)	4320	4320	256	99	235	25	0	359
48134	30794s (+0.4s)	1196	1196	64	38	88	9	0	135
48135	30795s (+0.6s)	2412	2412	128	52	164	0	9	225
48136	30795s (+0.4s)	1328	1328	128	24	106	0	7	137
48137	30796s (+0.7s)	2676	2676	256	52	161	0	13	226
48138	30796s (+0.6s)	2416	2416	256	44	150	0	8	202
48139	30797s (+0.5s)	1452	1452	64	38	117	0	11	166
48140	30798s (+1.5s)	7768	7768	512	105	415	0	23	543
48141	30799s (+0.4s)	1040	1040	64	23	91	0	7	121
48142	30800s (+1.0s)	4140	4140	256	67	253	0	18	338
48143	30801s (+1.0s)	4360	4360	256	118	223	22	0	363
48144	30802s (+0.7s)	3124	3124	256	55	199	4	0	258
48145	30802s (+0.7s)	2772	2772	256	57	172	11	0	240
48146	30803s (+0.6s)	2624	2624	256	54	159	14	0	227
48147	30803s (+0.5s)	2268	2268	256	37	141	9	0	187
48148	30805s (+1.3s)	6368	6368	512	124	303	25	0	452
48149	30805s (+0.7s)	2772	2772	256	54	171	10	0	235
48150	30806s (+0.5s)	1852	1852	128	42	140	5	0	187
48151	30807s (+0.7s)	2772	2772	256	54	172	10	0	236
48152	30807s (+0.7s)	2976	2976	256	58	176	15	2	251
48153	30808s (+0.3s)	752	752	64	26	70	5	0	101
48154	30808s (+0.6s)	2300	2300	128	63	145	10	0	218
48155	30809s (+1.1s)	5644	5644	512	109	268	21	0	398
48156	30810s (+0.9s)	3928	3928	256	79	224	13	0	316
48157	30811s (+0.5s)	1812	1812	128	36	146	6	0	188
48158	30811s (+0.6s)	2056	2056	128	58	132	12	0	202
48159	30812s (+0.6s)	2464	2464	256	49	148	12	0	209
48160	30813s (+0.5s)	1824	1824	128	40	144	6	0	190
48161	30813s (+0.6s)	2500	2500	256	52	153	11	0	216
48162	30814s (+0.8s)	3224	3224	256	74	182	13	0	269
48163	30814s (+0.5s)	1412	1412	128	53	101	5	0	159
48164	30815s (+0.9s)	3772	3772	256	87	206	16	0	309
48165	30816s (+0.4s)	1200	1200	128	31	94	6	0	131
48166	30817s (+0.9s)	3956	3956	256	92	211	21	0	324
48167	30817s (+0.5s)	1496	1496	128	44	106	8	0	158
48168	30818s (+0.7s)	3096	3096	256	59	185	12	1	257
48169	30818s (+0.7s)	2980	2980	256	48	205	7	0	260
48170	30819s (+0.4s)	1296	1296	128	38	88	10	0	136
48171	30819s (+0.6s)	2460	2460	256	49	148	11	0	208
48172	30820s (+0.5s)	1676	1676	128	34	127	9	0	170
48173	30821s (+0.6s)	1912	1912	128	52	136	8	0	196
48174	30821s (+0.4s)	1472	1472	128	31	113	7	1	152
48175	30822s (+0.8s)	3244	3244	256	71	187	15	1	274
48176	30823s (+0.8s)	3512	3512	256	68	215	14	0	297
48177	30823s (+0.7s)	2888	2888	256	65	168	8	0	241
48178	30824s (+0.7s)	2572	2572	256	48	174	8	0	230
48179	30824s (+0.3s)	1028	1028	64	30	82	8	1	121
48180	30825s (+0.5s)	1620	1620	128	36	123	13	0	172
48181	30825s (+0.5s)	1628	1628	128	28	124	0	11	163
48182	30826s (+0.4s)	1476	1476	128	38	114	5	0	157
48183	30826s (+0.6s)	2360	2360	128	49	164	6	0	219
48184	30827s (+1.1s)	5616	5616	512	101	273	27	1	402
48185	30828s (+0.7s)	2636	2636	256	40	185	0	9	234
48186	30829s (+0.6s)	2292	2292	256	46	141	0	6	193
48187	30830s (+0.8s)	3384	3384	256	69	203	8	1	281
48188	30830s (+0.8s)	3352	3352	256	71	203	10	0	284
48189	30831s (+0.3s)	872	872	64	24	82	7	0	113
48190	30831s (+0.3s)	628	628	64	12	72	0	3	87
48191	30832s (+0.6s)	2216	2216	128	40	158	0	12	210
48192	30833s (+1.1s)	5332	5332	512	75	285	0	19	379
48193	30833s (+0.7s)	2616	2616	256	41	177	0	11	229
48194	30834s (+0.4s)	1000	1000	64	26	100	0	3	129
48195	30834s (+0.7s)	3004	3004	256	49	190	0	8	247
48196	30835s (+0.6s)	2216	2216	128	52	145	0	12	209
48197	30836s (+0.9s)	3716	3716	256	66	232	0	18	316
48198	30836s (+0.6s)	1824	1824	128	39	142	0	10	191
48199	30837s (+0.5s)	1548	1548	128	37	116	0	7	160
Episode	Time	Reward	Score	Highest	L	U	R	D	Steps
48200	30838s (+0.7s)	2784	2784	256	47	180	0	12	239
48201	30838s (+0.7s)	2616	2616	256	52	167	0	10	229
48202	30839s (+1.0s)	4160	4160	256	65	262	15	0	342
48203	30840s (+0.9s)	3860	3860	256	83	216	17	0	316
48204	30840s (+0.2s)	564	564	32	18	62	5	0	85
48205	30841s (+0.7s)	2476	2476	128	62	156	13	0	231
48206	30841s (+0.3s)	788	788	64	18	74	6	0	98
48207	30842s (+0.8s)	3472	3472	256	82	191	14	0	287
48208	30843s (+0.4s)	1320	1320	128	24	110	2	0	136
48209	30843s (+0.5s)	2040	2040	256	46	116	9	0	171
48210	30844s (+0.5s)	1820	1820	128	38	147	4	0	189
48211	30844s (+0.7s)	2904	2904	256	69	173	10	0	252
48212	30845s (+0.9s)	4048	4048	256	72	246	16	0	334
48213	30846s (+0.8s)	3540	3540	256	87	192	13	1	293
48214	30847s (+0.6s)	1924	1924	128	52	138	9	0	199
48215	30847s (+0.7s)	2812	2812	256	62	166	12	0	240
48216	30848s (+0.6s)	1888	1888	128	62	120	13	0	195
48217	30849s (+0.9s)	3776	3776	256	84	220	15	0	319
48218	30849s (+0.4s)	1316	1316	128	27	103	0	6	136
48219	30850s (+1.0s)	5092	5092	512	86	267	0	15	368
48220	30851s (+0.6s)	2496	2496	256	48	151	0	12	211
48221	30852s (+0.6s)	2580	2580	256	52	159	0	9	220
48222	30852s (+0.7s)	2956	2956	256	62	172	0	12	246
48223	30853s (+0.5s)	1972	1972	128	34	140	0	8	182
48224	30853s (+0.4s)	1200	1200	64	27	114	0	6	147
48225	30854s (+0.9s)	3540	3540	256	53	233	0	13	299
48226	30855s (+0.7s)	3076	3076	256	53	190	0	7	250
48227	30855s (+0.4s)	1196	1196	128	17	112	0	4	133
48228	30856s (+0.5s)	1668	1668	128	35	138	0	5	178
48229	30857s (+0.8s)	3444	3444	256	49	226	0	12	287
48230	30857s (+0.5s)	1656	1656	128	25	136	0	5	166
48231	30858s (+1.3s)	6448	6448	512	129	318	24	0	471
48232	30859s (+0.6s)	2084	2084	128	56	144	8	0	208
48233	30860s (+1.0s)	4332	4332	256	102	232	23	1	358
48234	30860s (+0.5s)	1560	1560	128	43	113	7	1	164
48235	30861s (+1.0s)	4256	4256	256	88	237	21	1	347
48236	30862s (+0.5s)	1808	1808	128	40	140	7	0	187
48237	30862s (+0.4s)	1252	1252	128	19	101	5	0	125
48238	30863s (+0.5s)	1780	1780	128	33	142	5	1	181
48239	30864s (+0.9s)	4000	4000	256	81	219	20	0	320
48240	30864s (+0.6s)	2716	2716	256	50	171	10	0	231
48241	30865s (+0.8s)	3208	3208	256	76	180	13	0	269
48242	30866s (+0.5s)	1796	1796	128	50	126	7	1	184
48243	30866s (+0.7s)	3032	3032	256	57	194	7	0	258
48244	30867s (+0.9s)	4044	4044	256	89	225	19	0	333
48245	30868s (+0.7s)	3108	3108	256	53	186	14	1	254
48246	30869s (+0.7s)	2556	2556	128	62	171	11	0	244
48247	30869s (+0.4s)	1520	1520	128	37	111	5	0	153
48248	30870s (+0.6s)	2260	2260	128	52	143	14	0	209
48249	30871s (+0.9s)	3612	3612	256	96	193	13	0	302
48250	30871s (+0.7s)	3240	3240	256	67	188	11	0	266
48251	30872s (+0.6s)	2332	2332	128	54	155	17	0	226
48252	30873s (+0.6s)	2556	2556	256	53	160	6	0	219
48253	30874s (+0.8s)	3644	3644	256	84	207	17	1	309
48254	30874s (+0.8s)	3212	3212	256	58	193	16	0	267
48255	30875s (+0.4s)	1316	1316	128	22	108	4	0	134
48256	30876s (+0.7s)	3172	3172	256	70	177	14	0	261
48257	30876s (+0.5s)	1504	1504	128	30	123	6	0	159
48258	30876s (+0.5s)	1572	1572	128	36	122	7	0	165
48259	30877s (+0.8s)	3212	3212	256	55	206	10	0	271
48260	30878s (+0.6s)	2220	2220	128	51	150	9	1	211
48261	30878s (+0.6s)	2124	2124	128	59	133	10	0	202
48262	30879s (+0.6s)	2556	2556	256	55	157	7	0	219
48263	30879s (+0.3s)	728	728	64	30	65	4	0	99
48264	30880s (+0.8s)	3496	3496	256	63	211	20	0	294
48265	30881s (+0.3s)	920	920	64	24	81	5	0	110
48266	30881s (+0.5s)	1900	1900	128	52	132	9	0	193
48267	30882s (+1.3s)	6536	6536	512	108	336	21	0	465
48268	30883s (+0.5s)	1772	1772	128	43	125	10	0	178
48269	30883s (+0.4s)	1504	1504	128	34	115	0	8	157
48270	30884s (+0.7s)	2768	2768	256	48	178	0	14	240
48271	30884s (+0.4s)	1056	1056	64	19	99	0	4	122
48272	30885s (+0.3s)	704	704	64	19	69	0	2	90
48273	30885s (+0.7s)	2860	2860	256	45	199	0	9	253
48274	30886s (+0.5s)	1744	1744	128	47	117	0	12	176
48275	30886s (+0.5s)	2244	2244	256	41	140	0	6	187
48276	30887s (+0.5s)	1712	1712	128	34	139	6	0	179
48277	30887s (+0.5s)	1652	1652	128	38	122	9	0	169
48278	30888s (+0.5s)	1788	1788	128	33	142	0	7	182
48279	30889s (+0.5s)	1624	1624	128	33	129	7	0	169
48280	30889s (+0.5s)	1604	1604	128	43	115	9	0	167
48281	30890s (+0.6s)	2064	2064	128	48	147	11	0	206
48282	30890s (+0.8s)	3208	3208	256	60	194	11	0	265
48283	30891s (+0.7s)	3112	3112	256	60	181	16	0	257
48284	30892s (+1.0s)	4344	4344	256	93	246	21	0	360
48285	30893s (+0.8s)	3760	3760	256	56	235	10	0	301
48286	30893s (+0.6s)	2212	2212	128	55	144	10	0	209
48287	30894s (+0.4s)	1048	1048	64	36	81	9	0	126
48288	30895s (+0.7s)	3092	3092	256	56	186	11	0	253
48289	30895s (+0.9s)	4640	4640	512	83	221	16	0	320
48290	30896s (+0.8s)	3352	3352	256	82	186	16	0	284
48291	30897s (+1.0s)	4052	4052	256	82	241	12	0	335
48292	30898s (+0.5s)	1624	1624	128	37	130	6	0	173
48293	30899s (+0.8s)	3272	3272	256	73	179	17	0	269
48294	30899s (+0.6s)	2684	2684	256	61	151	12	0	224
48295	30900s (+0.6s)	2128	2128	128	58	144	9	0	211
48296	30901s (+0.9s)	4192	4192	256	99	230	10	0	339
48297	30901s (+0.7s)	2812	2812	256	52	182	7	0	241
48298	30903s (+1.3s)	6492	6492	512	123	313	26	0	462
48299	30904s (+1.3s)	6844	6844	512	124	311	24	0	459
Episode	Time	Reward	Score	Highest	L	U	R	D	Steps
48300	30905s (+0.9s)	3940	3940	256	76	233	15	0	324
48301	30905s (+0.4s)	1036	1036	64	33	86	4	0	123
48302	30906s (+0.9s)	3632	3632	256	76	224	10	0	310
48303	30907s (+0.2s)	628	628	64	23	59	4	0	86
48304	30907s (+0.5s)	1732	1732	128	44	124	6	0	174
48305	30908s (+0.7s)	2676	2676	256	67	151	10	1	229
48306	30909s (+0.9s)	3608	3608	256	75	213	17	0	305
48307	30909s (+0.5s)	1512	1512	128	45	108	5	0	158
48308	30910s (+0.8s)	3520	3520	256	77	195	15	0	287
48309	30910s (+0.5s)	1664	1664	128	51	108	9	0	168
48310	30911s (+0.4s)	1484	1484	128	38	110	6	0	154
48311	30912s (+0.7s)	3136	3136	256	59	185	13	0	257
48312	30912s (+0.7s)	2472	2472	128	69	147	13	0	229
48313	30913s (+1.0s)	4224	4224	256	82	254	10	0	346
48314	30914s (+0.5s)	1764	1764	128	39	133	8	0	180
48315	30914s (+0.7s)	2796	2796	256	67	166	9	1	243
48316	30915s (+0.3s)	872	872	64	30	83	1	0	114
48317	30916s (+0.7s)	2852	2852	128	66	182	16	0	264
48318	30916s (+0.8s)	3296	3296	256	67	192	17	0	276
48319	30917s (+0.6s)	2516	2516	256	59	149	10	0	218
48320	30917s (+0.5s)	1908	1908	128	42	144	9	0	195
48321	30918s (+0.4s)	1380	1380	128	37	103	5	0	145
48322	30919s (+0.7s)	2676	2676	256	60	162	8	0	230
48323	30919s (+0.5s)	1688	1688	128	38	129	7	0	174
48324	30920s (+0.4s)	1436	1436	128	32	110	0	5	147
48325	30920s (+0.3s)	672	672	64	18	68	0	6	92
48326	30920s (+0.4s)	1252	1252	128	24	99	0	9	132
48327	30921s (+0.5s)	1608	1608	128	40	121	0	8	169
48328	30921s (+0.4s)	1164	1164	64	35	97	6	0	138
48329	30922s (+0.8s)	3376	3376	256	84	180	16	0	280
48330	30922s (+0.6s)	1976	1976	128	55	146	6	0	207
48331	30923s (+0.7s)	3104	3104	256	63	178	14	0	255
48332	30924s (+0.9s)	3548	3548	256	83	203	14	1	301
48333	30925s (+0.5s)	1544	1544	128	33	126	5	0	164
48334	30925s (+0.7s)	3044	3044	256	73	173	15	0	261
48335	30926s (+0.4s)	1488	1488	128	33	114	5	0	152
48336	30927s (+0.9s)	3972	3972	256	59	255	0	13	327
48337	30927s (+0.5s)	1852	1852	128	31	151	0	6	188
48338	30928s (+1.0s)	4228	4228	256	81	252	18	0	351
48339	30929s (+0.6s)	2196	2196	128	65	131	13	0	209
48340	30929s (+0.2s)	564	564	64	16	60	1	0	77
48341	30930s (+0.6s)	2344	2344	256	66	119	10	0	195
48342	30930s (+0.8s)	3484	3484	256	86	190	15	0	291
48343	30931s (+0.4s)	1032	1032	64	35	80	7	0	122
48344	30931s (+0.3s)	1024	1024	128	20	81	5	0	106
48345	30932s (+0.3s)	924	924	64	33	85	3	0	121
48346	30932s (+0.5s)	1688	1688	128	45	123	6	0	174
48347	30932s (+0.3s)	736	736	64	24	71	2	0	97
48348	30933s (+0.5s)	1512	1512	128	46	108	7	0	161
48349	30934s (+0.9s)	3516	3516	256	71	209	18	0	298
48350	30934s (+0.7s)	2692	2692	256	69	166	8	0	243
48351	30935s (+1.0s)	4292	4292	256	83	248	17	0	348
48352	30936s (+0.7s)	2804	2804	256	54	177	11	0	242
48353	30936s (+0.4s)	1240	1240	128	32	96	7	0	135
48354	30937s (+0.7s)	2648	2648	256	54	169	0	10	233
48355	30938s (+0.7s)	2908	2908	256	44	202	0	12	258
48356	30938s (+0.4s)	1040	1040	64	26	91	0	7	124
48357	30939s (+0.6s)	2376	2376	256	41	155	0	7	203
48358	30939s (+0.5s)	1784	1784	128	42	132	0	8	182
48359	30940s (+0.5s)	1888	1888	128	43	134	11	0	188
48360	30940s (+0.3s)	1008	1008	64	28	88	5	0	121
48361	30941s (+0.9s)	3732	3732	256	93	198	17	0	308
48362	30942s (+0.6s)	2544	2544	256	49	166	8	0	223
48363	30942s (+0.4s)	1436	1436	128	36	104	8	0	148
48364	30943s (+0.9s)	3784	3784	256	73	218	15	0	306
48365	30944s (+1.4s)	6800	6800	512	146	327	25	0	498
48366	30945s (+0.6s)	1884	1884	128	43	142	8	0	193
48367	30946s (+0.9s)	4324	4324	256	77	234	18	0	329
48368	30947s (+1.1s)	4384	4384	256	103	249	14	0	366
48369	30948s (+0.5s)	1796	1796	128	47	134	3	0	184
48370	30948s (+0.5s)	1740	1740	128	33	138	4	0	175
48371	30948s (+0.2s)	484	484	32	12	61	0	5	78
48372	30949s (+0.5s)	1636	1636	128	34	128	0	10	172
48373	30949s (+0.4s)	1304	1304	128	30	108	0	4	142
48374	30950s (+0.5s)	1696	1696	128	42	123	10	1	176
48375	30950s (+0.3s)	900	900	128	14	79	2	0	95
48376	30951s (+0.8s)	3296	3296	256	63	196	12	0	271
48377	30951s (+0.7s)	2808	2808	256	54	177	14	0	245
48378	30952s (+0.7s)	3212	3212	256	67	191	13	0	271
48379	30953s (+0.7s)	2872	2872	256	66	171	13	0	250
48380	30954s (+0.7s)	3132	3132	256	68	180	14	0	262
48381	30955s (+0.8s)	3464	3464	256	62	213	14	0	289
48382	30955s (+0.8s)	3244	3244	256	64	195	14	1	274
48383	30956s (+0.7s)	2844	2844	256	67	162	13	0	242
48384	30956s (+0.3s)	864	864	64	22	84	5	0	111
48385	30957s (+0.7s)	2976	2976	256	58	198	9	0	265
48386	30958s (+0.7s)	3076	3076	256	59	186	15	1	261
48387	30959s (+0.7s)	2972	2972	256	58	175	11	0	244
48388	30959s (+0.6s)	1952	1952	128	60	121	14	0	195
48389	30960s (+0.7s)	2856	2856	256	61	174	11	0	246
48390	30961s (+0.8s)	3312	3312	256	60	202	9	0	271
48391	30962s (+0.9s)	3868	3868	256	70	225	23	0	318
48392	30962s (+0.6s)	2612	2612	256	57	158	12	1	228
48393	30962s (+0.3s)	708	708	64	20	67	4	1	92
48394	30963s (+0.5s)	1568	1568	128	31	122	10	0	163
48395	30964s (+0.7s)	2768	2768	256	64	157	15	0	236
48396	30964s (+0.6s)	1948	1948	128	51	134	10	0	195
48397	30964s (+0.3s)	716	716	64	23	67	2	0	92
48398	30965s (+1.0s)	4184	4184	256	88	233	21	0	342
48399	30966s (+1.0s)	4376	4376	256	94	259	10	0	363
Episode	Time	Reward	Score	Highest	L	U	R	D	Steps
48400	30967s (+0.6s)	2472	2472	256	39	169	6	0	214
48401	30968s (+0.6s)	2540	2540	256	46	169	6	0	221
48402	30968s (+0.6s)	2600	2600	256	43	165	7	0	215
48403	30969s (+0.9s)	4056	4056	256	75	244	17	0	336
48404	30970s (+0.4s)	1268	1268	128	47	85	7	0	139
48405	30971s (+0.8s)	3404	3404	256	78	189	16	0	283
48406	30971s (+0.3s)	984	984	64	30	90	5	0	125
48407	30972s (+0.9s)	3960	3960	256	77	231	16	0	324
48408	30972s (+0.4s)	1476	1476	128	33	111	8	1	153
48409	30973s (+0.4s)	1396	1396	128	24	111	1	7	143
48410	30974s (+0.9s)	3784	3784	256	56	237	0	19	312
48411	30974s (+0.4s)	1400	1400	128	26	112	0	3	141
48412	30975s (+1.0s)	4244	4244	256	59	276	0	16	351
48413	30975s (+0.2s)	568	568	64	24	48	0	4	76
48414	30976s (+0.5s)	1816	1816	128	41	141	0	2	184
48415	30977s (+0.8s)	3184	3184	256	58	196	0	13	267
48416	30977s (+0.5s)	1624	1624	128	45	119	0	9	173
48417	30978s (+0.5s)	2052	2052	256	39	124	0	6	169
48418	30978s (+0.6s)	2432	2432	256	55	143	0	7	205
48419	30979s (+0.4s)	1472	1472	128	26	121	0	4	151
48420	30980s (+1.0s)	4136	4136	256	68	257	0	16	341
48421	30980s (+0.6s)	1900	1900	128	32	155	0	7	194
48422	30981s (+0.7s)	2428	2428	128	48	173	0	9	230
48423	30981s (+0.7s)	2776	2776	256	45	182	0	10	237
48424	30982s (+0.5s)	2044	2044	256	32	133	0	5	170
48425	30983s (+0.7s)	3148	3148	256	57	189	0	15	261
48426	30984s (+0.8s)	3288	3288	256	55	214	0	11	280
48427	30984s (+0.4s)	1484	1484	128	38	107	0	10	155
48428	30985s (+0.9s)	4176	4176	256	86	237	17	0	340
48429	30986s (+0.8s)	3232	3232	256	76	180	15	0	271
48430	30986s (+0.6s)	2236	2236	128	57	149	8	0	214
48431	30987s (+0.9s)	3624	3624	256	78	217	12	0	307
48432	30988s (+0.4s)	1488	1488	128	36	113	6	0	155
48433	30988s (+0.5s)	1888	1888	128	45	139	7	0	191
48434	30989s (+0.5s)	1784	1784	128	45	130	6	0	181
48435	30990s (+0.8s)	3256	3256	256	74	188	15	0	277
48436	30990s (+0.7s)	2756	2756	256	58	167	7	0	232
48437	30991s (+0.7s)	3120	3120	256	59	192	8	0	259
48438	30991s (+0.5s)	1676	1676	128	46	113	11	0	170
48439	30992s (+0.7s)	2928	2928	256	58	183	18	0	259
48440	30993s (+0.8s)	3476	3476	256	75	197	15	0	287
48441	30994s (+1.3s)	6216	6216	512	116	292	28	0	436
48442	30995s (+0.8s)	3548	3548	256	68	212	14	0	294
48443	30996s (+0.6s)	2124	2124	128	49	140	12	1	202
48444	30996s (+0.4s)	1444	1444	128	35	112	3	0	150
48445	30997s (+0.5s)	1720	1720	128	32	123	7	0	162
48446	30998s (+1.1s)	4644	4644	256	116	245	25	0	386
48447	30999s (+0.7s)	3272	3272	256	75	181	14	0	270
48448	30999s (+0.9s)	4020	4020	256	77	234	13	0	324
48449	31000s (+0.5s)	1680	1680	128	44	119	9	0	172
48450	31001s (+0.8s)	3260	3260	256	65	200	13	0	278
48451	31001s (+0.6s)	2564	2564	256	44	170	0	7	221
48452	31002s (+0.5s)	1844	1844	128	32	155	0	4	191
48453	31002s (+0.5s)	1800	1800	128	29	150	0	6	185
48454	31003s (+1.0s)	5196	5196	512	93	269	1	15	378
48455	31004s (+0.4s)	1380	1380	128	25	108	0	7	140
48456	31004s (+0.4s)	1480	1480	128	36	116	0	3	155
48457	31005s (+0.3s)	620	620	64	15	64	0	6	85
48458	31005s (+0.5s)	1836	1836	128	47	132	8	0	187
48459	31006s (+0.9s)	4812	4812	512	83	235	13	0	331
48460	31007s (+0.5s)	1540	1540	128	30	132	2	0	164
48461	31007s (+0.5s)	1872	1872	128	48	131	5	0	184
48462	31008s (+1.1s)	5648	5648	512	108	273	19	0	400
48463	31009s (+0.6s)	2432	2432	256	47	149	9	0	205
48464	31009s (+0.5s)	1552	1552	128	44	118	5	0	167
48465	31010s (+0.4s)	1308	1308	128	37	101	5	0	143
48466	31010s (+0.6s)	1992	1992	128	39	146	5	0	190
48467	31011s (+0.3s)	664	664	32	20	72	2	0	94
48468	31012s (+1.0s)	4252	4252	256	87	244	22	0	353
48469	31012s (+0.4s)	1344	1344	128	32	108	7	0	147
48470	31012s (+0.4s)	1552	1552	128	47	103	7	0	157
48471	31013s (+1.0s)	4004	4004	256	76	236	22	1	335
48472	31014s (+0.4s)	1432	1432	128	40	99	7	0	146
48473	31015s (+0.8s)	3284	3284	256	66	199	0	18	283
48474	31015s (+0.5s)	2152	2152	256	38	134	0	9	181
48475	31016s (+0.7s)	2756	2756	256	55	170	0	12	237
48476	31017s (+0.7s)	2828	2828	256	54	178	0	13	245
48477	31017s (+0.5s)	1860	1860	128	43	139	0	7	189
48478	31018s (+1.0s)	4008	4008	256	64	250	0	22	336
48479	31019s (+0.8s)	3532	3532	256	69	215	0	13	297
48480	31019s (+0.4s)	1168	1168	128	21	99	0	5	125
48481	31020s (+0.6s)	2584	2584	256	50	158	0	13	221
48482	31021s (+0.6s)	2508	2508	256	49	159	0	10	218
48483	31021s (+0.4s)	1284	1284	64	31	105	0	6	142
48484	31022s (+0.6s)	2088	2088	128	48	151	10	0	209
48485	31023s (+1.0s)	4852	4852	512	84	242	14	0	340
48486	31023s (+0.6s)	2008	2008	128	47	147	9	1	204
48487	31024s (+0.7s)	3164	3164	256	62	184	13	0	259
48488	31025s (+0.8s)	3524	3524	256	65	216	13	0	294
48489	31025s (+0.6s)	1916	1916	128	50	136	11	0	197
48490	31026s (+0.6s)	2524	2524	256	56	151	8	0	215
48491	31027s (+0.7s)	2524	2524	128	76	147	15	0	238
48492	31027s (+0.6s)	2016	2016	128	47	143	9	0	199
48493	31028s (+0.7s)	2800	2800	256	67	163	13	0	243
48494	31029s (+0.9s)	3952	3952	256	76	236	15	0	327
48495	31029s (+0.5s)	1604	1604	128	39	123	6	0	168
48496	31030s (+0.5s)	1864	1864	128	42	139	7	1	189
48497	31031s (+1.0s)	4208	4208	256	90	234	18	0	342
48498	31031s (+0.4s)	1360	1360	128	30	105	7	0	142
48499	31032s (+0.4s)	1344	1344	128	38	97	12	0	147
Episode	Time	Reward	Score	Highest	L	U	R	D	Steps
48500	31032s (+0.5s)	1760	1760	128	35	131	13	1	180
48501	31033s (+0.9s)	3912	3912	256	63	238	0	16	317
48502	31034s (+0.4s)	1432	1432	128	28	114	0	4	146
48503	31034s (+0.5s)	2200	2200	256	27	146	0	7	180
48504	31035s (+0.4s)	1364	1364	128	21	117	0	4	142
48505	31035s (+0.4s)	1416	1416	128	28	108	0	10	146
48506	31036s (+0.8s)	3436	3436	256	52	225	0	12	289
48507	31037s (+1.2s)	5812	5812	512	76	308	0	21	405
48508	31037s (+0.5s)	1640	1640	128	48	104	0	10	162
48509	31038s (+0.7s)	2896	2896	256	56	173	0	12	241
48510	31039s (+0.5s)	1912	1912	128	41	139	0	10	190
48511	31040s (+1.0s)	4400	4400	256	67	286	0	12	365
48512	31040s (+0.2s)	632	632	64	15	69	0	3	87
48513	31041s (+0.7s)	2856	2856	256	57	182	0	12	251
48514	31041s (+0.8s)	3140	3140	256	58	194	0	12	264
48515	31042s (+0.5s)	1704	1704	128	32	133	0	9	174
48516	31042s (+0.4s)	1424	1424	128	34	108	0	4	146
48517	31043s (+0.8s)	3640	3640	256	70	213	0	14	297
48518	31044s (+0.5s)	1612	1612	128	40	121	0	8	169
48519	31044s (+0.6s)	1932	1932	128	38	153	0	10	201
48520	31045s (+1.0s)	4152	4152	256	68	259	0	13	340
48521	31046s (+0.5s)	1696	1696	128	46	123	6	0	175
48522	31046s (+0.5s)	1704	1704	128	39	124	7	0	170
48523	31047s (+0.6s)	1916	1916	128	51	139	7	0	197
48524	31047s (+0.4s)	1360	1360	128	40	89	5	0	134
48525	31048s (+0.4s)	1416	1416	128	41	103	6	0	150
48526	31048s (+0.6s)	2664	2664	256	56	164	6	0	226
48527	31049s (+0.8s)	3492	3492	256	71	204	17	0	292
48528	31049s (+0.2s)	596	596	64	19	59	4	0	82
48529	31050s (+0.4s)	1108	1108	64	29	103	4	0	136
48530	31050s (+0.3s)	936	936	64	38	71	6	0	115
48531	31051s (+0.8s)	3488	3488	256	70	204	16	0	290
48532	31051s (+0.5s)	1888	1888	128	44	139	7	0	190
48533	31052s (+0.4s)	1284	1284	128	38	90	9	0	137
48534	31052s (+0.6s)	1896	1896	128	44	141	7	0	192
48535	31054s (+1.2s)	5672	5672	512	128	250	23	0	401
48536	31054s (+0.5s)	2136	2136	256	34	140	6	0	180
48537	31055s (+0.9s)	3908	3908	256	95	202	20	0	317
48538	31055s (+0.5s)	1720	1720	128	50	119	8	0	177
48539	31056s (+0.4s)	1308	1308	128	27	100	0	7	134
48540	31056s (+0.4s)	1336	1336	128	33	106	9	0	148
48541	31057s (+1.0s)	4472	4472	256	72	279	0	20	371
48542	31058s (+0.5s)	1600	1600	128	40	116	0	11	167
48543	31058s (+0.6s)	2092	2092	128	44	139	0	12	195
48544	31059s (+0.5s)	1764	1764	128	45	125	0	6	176
48545	31060s (+0.7s)	2912	2912	256	52	167	12	0	231
48546	31060s (+0.6s)	2440	2440	256	57	151	5	0	213
48547	31061s (+1.1s)	4492	4492	256	94	259	16	0	369
48548	31062s (+0.8s)	3364	3364	256	63	201	12	0	276
48549	31062s (+0.4s)	1248	1248	128	32	91	7	0	130
48550	31063s (+0.4s)	1480	1480	128	34	113	7	0	154
48551	31064s (+1.1s)	5300	5300	512	97	248	22	0	367
48552	31065s (+0.6s)	1952	1952	128	54	141	11	0	206
48553	31065s (+0.8s)	3244	3244	256	79	182	13	0	274
48554	31066s (+0.6s)	2252	2252	128	55	141	11	1	208
48555	31067s (+1.0s)	4140	4140	256	88	232	17	0	337
48556	31067s (+0.6s)	2352	2352	256	41	150	9	0	200
48557	31068s (+0.4s)	1272	1272	128	33	98	4	0	135
48558	31069s (+0.8s)	3240	3240	256	78	181	14	0	273
48559	31069s (+0.7s)	2908	2908	256	63	166	11	0	240
48560	31070s (+0.8s)	3208	3208	256	71	183	11	0	265
48561	31071s (+0.5s)	1640	1640	128	37	126	3	0	166
48562	31071s (+0.9s)	3716	3716	256	76	213	25	1	315
48563	31072s (+0.9s)	3712	3712	256	88	208	17	0	313
48564	31073s (+0.8s)	3376	3376	256	87	176	17	0	280
48565	31074s (+0.8s)	3244	3244	256	74	180	13	0	267
48566	31075s (+1.0s)	4900	4900	512	93	228	24	0	345
48567	31076s (+0.8s)	3168	3168	256	67	180	15	0	262
48568	31077s (+1.0s)	5104	5104	512	98	247	14	0	359
48569	31077s (+0.4s)	1012	1012	64	37	76	8	1	122
48570	31078s (+0.7s)	2780	2780	256	61	175	7	0	243
48571	31078s (+0.6s)	2328	2328	256	44	140	11	0	195
48572	31079s (+0.8s)	3416	3416	256	69	198	18	0	285
48573	31080s (+0.6s)	2608	2608	256	56	148	14	0	218
48574	31080s (+0.3s)	776	776	64	21	74	7	0	102
48575	31081s (+0.8s)	3160	3160	256	63	190	15	0	268
48576	31081s (+0.4s)	1364	1364	128	31	105	6	0	142
48577	31082s (+0.8s)	3492	3492	256	75	200	16	0	291
48578	31082s (+0.4s)	1352	1352	128	31	101	10	0	142
48579	31083s (+0.5s)	1784	1784	128	46	129	6	0	181
48580	31084s (+0.6s)	2528	2528	256	54	162	7	0	223
48581	31084s (+0.4s)	1340	1340	128	32	111	6	0	149
48582	31085s (+0.5s)	1680	1680	128	36	126	8	1	171
48583	31085s (+0.8s)	3276	3276	256	65	202	9	0	276
48584	31086s (+0.2s)	408	408	32	14	53	2	0	69
48585	31086s (+0.5s)	1828	1828	128	60	119	6	0	185
48586	31087s (+0.7s)	2904	2904	256	58	184	10	0	252
48587	31088s (+0.8s)	3232	3232	256	67	191	13	0	271
48588	31088s (+0.2s)	584	584	64	18	57	0	5	80
48589	31088s (+0.7s)	2940	2940	256	65	168	13	0	246
48590	31089s (+0.9s)	3872	3872	256	85	215	12	0	312
48591	31090s (+0.7s)	2792	2792	256	62	167	12	0	241
48592	31091s (+0.8s)	3328	3328	256	61	200	13	1	275
48593	31091s (+0.6s)	2404	2404	256	44	151	6	0	201
48594	31092s (+0.7s)	2904	2904	256	65	174	13	0	252
48595	31093s (+0.5s)	1776	1776	128	47	127	6	0	180
48596	31093s (+0.7s)	2952	2952	256	60	178	11	0	249
48597	31094s (+0.5s)	1588	1588	128	44	112	9	0	165
48598	31094s (+0.5s)	1568	1568	128	33	135	2	0	170
48599	31095s (+0.5s)	1776	1776	128	38	138	7	0	183
Episode	Time	Reward	Score	Highest	L	U	R	D	Steps
48600	31096s (+0.9s)	3764	3764	256	76	225	14	0	315
48601	31097s (+0.7s)	2776	2776	256	48	183	11	0	242
48602	31097s (+0.3s)	896	896	64	23	81	0	5	109
48603	31098s (+0.8s)	3256	3256	256	55	210	0	11	276
48604	31098s (+0.6s)	2472	2472	128	50	178	0	8	236
48605	31100s (+1.3s)	6296	6296	512	88	351	0	21	460
48606	31100s (+0.3s)	648	648	64	16	67	0	5	88
48607	31101s (+1.0s)	4352	4352	256	75	267	0	16	358
48608	31102s (+0.7s)	2828	2828	256	47	189	0	14	250
48609	31102s (+0.5s)	1800	1800	128	40	138	0	8	186
48610	31103s (+0.7s)	2956	2956	256	68	164	14	0	246
48611	31104s (+0.9s)	3880	3880	256	95	210	17	0	322
48612	31104s (+0.4s)	1084	1084	64	34	94	3	0	131
48613	31105s (+0.5s)	1708	1708	128	38	129	5	0	172
48614	31105s (+0.5s)	1800	1800	128	38	144	3	0	185
48615	31106s (+0.8s)	3364	3364	256	67	204	16	0	287
48616	31107s (+1.1s)	4492	4492	256	86	266	17	0	369
48617	31108s (+0.9s)	3600	3600	256	68	218	17	0	303
48618	31109s (+0.7s)	3228	3228	256	70	177	13	1	261
48619	31109s (+0.5s)	1768	1768	128	40	134	8	0	182
48620	31110s (+0.7s)	2948	2948	256	56	180	0	9	245
48621	31110s (+0.4s)	1172	1172	64	28	108	0	4	140
48622	31112s (+1.1s)	5492	5492	512	87	278	0	22	387
48623	31112s (+0.8s)	3232	3232	256	59	202	0	9	270
48624	31113s (+0.7s)	3244	3244	256	66	184	13	0	263
48625	31114s (+0.6s)	2288	2288	256	60	124	12	0	196
48626	31114s (+0.8s)	3148	3148	256	72	182	13	0	267
48627	31115s (+0.5s)	1696	1696	128	50	108	10	0	168
48628	31116s (+0.6s)	2496	2496	256	62	144	9	1	216
48629	31116s (+0.7s)	2796	2796	256	62	169	11	0	242
48630	31117s (+0.6s)	1900	1900	128	45	144	4	0	193
48631	31117s (+0.5s)	1828	1828	128	42	144	5	0	191
48632	31118s (+0.4s)	1160	1160	64	33	97	7	0	137
48633	31118s (+0.7s)	2716	2716	256	49	180	10	0	239
48634	31119s (+0.5s)	1556	1556	128	40	114	6	1	161
48635	31119s (+0.5s)	1604	1604	128	43	108	8	0	159
48636	31120s (+0.5s)	1932	1932	128	45	145	11	0	201
48637	31120s (+0.4s)	1272	1272	128	19	109	1	0	129
48638	31121s (+0.5s)	1528	1528	128	43	107	10	0	160
48639	31121s (+0.6s)	1928	1928	128	54	141	5	0	200
48640	31122s (+0.5s)	1556	1556	128	37	118	5	1	161
48641	31122s (+0.5s)	1816	1816	128	31	147	0	7	185
48642	31124s (+1.2s)	5812	5812	512	79	321	0	19	419
48643	31124s (+0.4s)	1328	1328	128	24	108	0	6	138
48644	31125s (+0.6s)	2552	2552	256	38	165	0	12	215
48645	31125s (+0.4s)	1156	1156	128	20	100	0	3	123
48646	31126s (+1.0s)	4296	4296	256	94	245	15	0	354
48647	31127s (+1.0s)	4228	4228	256	96	234	17	0	347
48648	31128s (+0.8s)	3236	3236	256	73	186	12	1	272
48649	31129s (+0.8s)	3424	3424	256	74	200	13	0	287
48650	31129s (+0.4s)	1316	1316	128	30	99	6	0	135
48651	31130s (+0.7s)	2892	2892	256	47	189	10	0	246
48652	31130s (+0.3s)	980	980	64	29	81	5	0	115
48653	31131s (+1.1s)	5432	5432	512	84	276	17	1	378
48654	31131s (+0.4s)	1364	1364	128	32	108	2	0	142
48655	31132s (+0.4s)	1068	1068	64	37	88	6	0	131
48656	31133s (+0.8s)	3260	3260	256	90	160	20	1	271
48657	31133s (+0.4s)	1464	1464	128	29	119	6	0	154
48658	31134s (+0.5s)	1556	1556	128	33	126	7	1	167
48659	31134s (+0.5s)	1596	1596	128	45	112	9	0	166
48660	31134s (+0.4s)	1476	1476	128	37	107	8	0	152
48661	31135s (+0.4s)	1520	1520	128	31	123	6	0	160
48662	31136s (+1.1s)	4652	4652	256	107	261	16	0	384
48663	31136s (+0.3s)	1084	1084	128	28	85	1	0	114
48664	31137s (+0.9s)	3844	3844	256	102	203	16	1	322
48665	31138s (+0.4s)	1452	1452	128	41	109	4	0	154
48666	31138s (+0.2s)	608	608	64	17	65	3	0	85
48667	31139s (+1.0s)	4360	4360	256	84	262	18	0	364
48668	31140s (+0.4s)	1524	1524	128	32	123	9	0	164
48669	31140s (+0.2s)	276	276	32	12	37	3	0	52
48670	31140s (+0.7s)	3176	3176	256	49	208	0	11	268
48671	31141s (+0.7s)	2812	2812	256	41	195	0	10	246
48672	31142s (+0.6s)	1864	1864	128	41	140	0	10	191
48673	31142s (+0.7s)	3000	3000	256	50	192	1	14	257
48674	31143s (+0.6s)	2688	2688	256	49	150	0	13	212
48675	31144s (+0.5s)	1836	1836	128	49	132	0	7	188
48676	31144s (+0.5s)	2248	2248	256	41	136	0	10	187
48677	31145s (+0.6s)	1856	1856	128	45	143	0	6	194
48678	31146s (+0.9s)	3572	3572	256	75	218	0	11	304
48679	31146s (+0.6s)	1864	1864	128	32	158	0	5	195
48680	31147s (+0.5s)	1852	1852	128	41	141	0	12	194
48681	31147s (+0.8s)	3232	3232	256	52	205	0	14	271
48682	31148s (+0.4s)	1444	1444	128	20	122	0	5	147
48683	31149s (+0.7s)	2932	2932	256	46	202	0	8	256
48684	31149s (+0.5s)	1984	1984	128	33	144	0	9	186
48685	31150s (+0.3s)	1116	1116	128	20	94	0	4	118
48686	31150s (+0.6s)	2500	2500	256	52	157	0	8	217
48687	31151s (+0.4s)	1516	1516	128	40	109	7	0	156
48688	31152s (+1.0s)	4176	4176	256	76	246	17	0	339
48689	31152s (+0.3s)	1032	1032	128	21	85	6	0	112
48690	31153s (+0.6s)	2540	2540	256	57	142	14	0	213
48691	31153s (+0.4s)	1328	1328	128	33	111	3	0	147
48692	31153s (+0.5s)	1436	1436	128	41	112	5	0	158
48693	31154s (+0.5s)	1788	1788	128	38	136	7	0	181
48694	31155s (+0.8s)	3528	3528	256	80	201	15	0	296
48695	31155s (+0.6s)	1920	1920	128	38	156	4	0	198
48696	31156s (+0.4s)	1492	1492	128	40	111	6	0	157
48697	31157s (+0.8s)	3388	3388	256	74	194	14	1	283
48698	31157s (+0.7s)	2852	2852	256	56	178	10	0	244
48699	31158s (+0.3s)	772	772	64	22	74	5	0	101
Episode	Time	Reward	Score	Highest	L	U	R	D	Steps
48700	31158s (+0.7s)	2924	2924	256	61	180	16	0	257
48701	31159s (+0.5s)	1748	1748	128	43	129	5	0	177
48702	31159s (+0.4s)	1512	1512	128	46	107	8	0	161
48703	31160s (+0.5s)	1680	1680	128	46	120	6	0	172
48704	31161s (+0.7s)	3004	3004	256	64	189	9	0	262
48705	31161s (+0.7s)	2668	2668	256	49	169	9	0	227
48706	31162s (+0.8s)	3244	3244	256	63	198	13	0	274
48707	31162s (+0.4s)	1248	1248	128	26	104	4	0	134
48708	31163s (+0.5s)	1796	1796	128	35	137	0	12	184
48709	31164s (+0.6s)	2584	2584	256	46	164	0	9	219
48710	31164s (+0.9s)	3756	3756	256	70	223	0	14	307
48711	31165s (+0.7s)	3096	3096	256	49	205	0	8	262
48712	31166s (+0.8s)	3236	3236	256	58	201	0	12	271
48713	31166s (+0.4s)	1448	1448	128	26	117	0	8	151
48714	31167s (+0.9s)	3948	3948	256	67	238	16	0	321
48715	31168s (+0.8s)	3344	3344	256	71	193	14	0	278
48716	31169s (+0.9s)	3648	3648	256	74	209	16	0	299
48717	31170s (+0.6s)	2588	2588	256	56	155	12	0	223
48718	31170s (+0.7s)	2896	2896	256	45	185	6	0	236
48719	31171s (+0.6s)	2576	2576	256	52	162	10	0	224
48720	31172s (+0.6s)	2464	2464	256	49	149	11	0	209
48721	31172s (+0.3s)	876	876	64	27	81	6	0	114
48722	31172s (+0.5s)	1624	1624	128	42	124	7	0	173
48723	31173s (+0.5s)	1916	1916	128	49	140	5	0	194
48724	31174s (+1.0s)	4364	4364	256	116	223	25	0	364
48725	31174s (+0.4s)	1140	1140	128	27	92	4	0	123
48726	31176s (+1.2s)	5916	5916	512	124	289	20	0	433
48727	31176s (+0.7s)	3048	3048	256	76	171	11	0	258
48728	31177s (+0.7s)	3184	3184	256	66	187	8	2	263
48729	31178s (+1.0s)	4384	4384	256	99	256	14	0	369
48730	31179s (+0.4s)	1472	1472	128	28	119	5	0	152
48731	31180s (+1.0s)	4044	4044	256	100	214	21	0	335
48732	31180s (+0.5s)	1684	1684	128	38	126	8	0	172
48733	31181s (+0.8s)	3368	3368	256	64	198	15	1	278
48734	31181s (+0.3s)	1132	1132	128	34	84	3	0	121
48735	31182s (+0.5s)	1792	1792	128	44	129	10	0	183
48736	31182s (+0.5s)	1836	1836	128	44	141	5	0	190
48737	31183s (+0.5s)	1808	1808	128	37	145	5	0	187
48738	31183s (+0.5s)	1516	1516	128	34	119	5	0	158
48739	31184s (+0.8s)	3632	3632	256	71	208	16	0	295
48740	31185s (+0.8s)	3236	3236	256	72	191	9	0	272
48741	31186s (+1.0s)	5056	5056	512	78	250	17	0	345
48742	31187s (+0.6s)	1964	1964	128	52	146	6	0	204
48743	31187s (+0.5s)	1752	1752	128	53	119	6	0	178
48744	31188s (+0.6s)	2500	2500	256	49	155	12	0	216
48745	31188s (+0.6s)	1936	1936	128	33	162	7	0	202
48746	31189s (+0.7s)	2732	2732	256	56	166	10	0	232
48747	31190s (+0.6s)	2760	2760	256	68	156	10	0	234
48748	31190s (+0.3s)	1008	1008	64	25	91	4	0	120
48749	31191s (+0.7s)	2820	2820	256	64	172	7	0	243
48750	31191s (+0.6s)	2592	2592	256	43	176	6	0	225
48751	31192s (+0.2s)	648	648	64	19	61	5	0	85
48752	31192s (+0.6s)	1928	1928	128	57	133	10	0	200
48753	31193s (+0.6s)	1912	1912	128	53	135	8	0	196
48754	31193s (+0.4s)	1260	1260	128	22	107	2	0	131
48755	31194s (+0.7s)	2740	2740	256	54	170	9	0	233
48756	31194s (+0.5s)	2264	2264	256	50	132	13	0	195
48757	31195s (+0.5s)	1604	1604	128	37	125	6	0	168
48758	31196s (+0.7s)	2812	2812	256	46	192	0	8	246
48759	31196s (+0.4s)	1288	1288	128	27	100	0	5	132
48760	31196s (+0.3s)	800	800	64	16	82	0	0	98
48761	31197s (+0.7s)	2888	2888	256	47	192	0	14	253
48762	31197s (+0.5s)	1812	1812	128	42	141	0	5	188
48763	31198s (+0.7s)	3088	3088	256	55	186	0	11	252
48764	31199s (+0.8s)	3400	3400	256	53	228	0	10	291
48765	31200s (+0.5s)	2064	2064	128	40	144	0	9	193
48766	31200s (+0.4s)	1508	1508	128	40	113	8	0	161
48767	31201s (+1.0s)	4280	4280	256	90	243	17	0	350
48768	31201s (+0.3s)	868	868	64	31	75	7	0	113
48769	31202s (+0.2s)	592	592	64	19	54	3	0	76
48770	31202s (+0.6s)	2464	2464	128	67	145	15	0	227
48771	31203s (+0.8s)	3568	3568	256	92	190	18	0	300
48772	31204s (+0.9s)	3764	3764	256	94	193	25	0	312
48773	31204s (+0.4s)	1400	1400	128	25	117	7	1	150
48774	31205s (+0.4s)	1420	1420	128	28	116	0	6	150
48775	31205s (+0.4s)	1408	1408	128	33	101	0	8	142
48776	31206s (+0.9s)	3972	3972	256	62	251	0	14	327
48777	31206s (+0.2s)	424	424	32	13	53	0	2	68
48778	31207s (+0.6s)	2372	2372	128	52	154	0	15	221
48779	31207s (+0.4s)	1468	1468	128	40	99	0	12	151
48780	31208s (+0.3s)	884	884	64	15	87	0	6	108
48781	31208s (+0.7s)	2632	2632	256	42	173	0	13	228
48782	31209s (+0.8s)	3252	3252	256	58	207	0	10	275
48783	31210s (+0.7s)	3152	3152	256	59	191	0	11	261
48784	31210s (+0.4s)	1512	1512	128	45	108	8	0	161
48785	31211s (+0.5s)	1536	1536	128	40	118	5	0	163
48786	31212s (+0.8s)	3556	3556	256	73	208	14	0	295
48787	31213s (+0.9s)	3960	3960	256	86	226	12	0	324
48788	31213s (+0.3s)	836	836	64	29	76	5	0	110
48789	31214s (+0.7s)	3172	3172	256	75	176	11	0	262
48790	31214s (+0.3s)	1112	1112	128	22	96	2	0	120
48791	31215s (+0.8s)	3212	3212	256	75	189	6	0	270
48792	31215s (+0.5s)	1840	1840	128	47	139	8	0	194
48793	31216s (+0.5s)	1816	1816	128	43	135	8	0	186
48794	31217s (+0.7s)	3144	3144	256	68	181	12	0	261
48795	31217s (+0.4s)	1344	1344	128	31	97	0	10	138
48796	31218s (+0.6s)	2540	2540	256	44	172	1	6	223
48797	31218s (+0.5s)	1864	1864	128	36	132	0	7	175
48798	31219s (+0.7s)	2792	2792	256	38	197	0	6	241
48799	31220s (+0.7s)	2956	2956	256	45	208	0	9	262
Episode	Time	Reward	Score	Highest	L	U	R	D	Steps
48800	31220s (+0.5s)	1536	1536	128	31	122	0	10	163
48801	31220s (+0.4s)	1220	1220	64	26	103	0	10	139
48802	31221s (+0.6s)	2232	2232	128	44	163	0	7	214
48803	31222s (+0.6s)	2708	2708	256	49	169	0	12	230
48804	31222s (+0.4s)	1060	1060	64	24	99	0	6	129
48805	31223s (+0.6s)	1924	1924	128	37	154	0	9	200
48806	31223s (+0.7s)	3040	3040	256	54	188	0	9	251
48807	31224s (+0.5s)	1784	1784	128	43	115	13	0	171
48808	31225s (+1.0s)	4196	4196	256	83	250	10	0	343
48809	31225s (+0.5s)	1600	1600	128	39	120	8	0	167
48810	31226s (+0.6s)	2136	2136	128	61	143	8	1	213
48811	31226s (+0.5s)	1620	1620	128	42	125	5	0	172
48812	31227s (+0.3s)	1036	1036	64	37	82	4	0	123
48813	31227s (+0.7s)	2852	2852	256	58	158	13	0	229
48814	31228s (+0.5s)	1652	1652	128	26	138	0	1	165
48815	31228s (+0.5s)	1900	1900	128	43	124	0	13	180
48816	31229s (+0.6s)	2272	2272	256	46	134	0	11	191
48817	31230s (+0.5s)	1796	1796	128	45	118	0	7	170
48818	31230s (+0.4s)	1056	1056	64	28	90	0	10	128
48819	31231s (+0.7s)	2792	2792	256	41	189	0	11	241
48820	31232s (+0.9s)	4800	4800	512	71	240	0	22	333
48821	31232s (+1.0s)	4232	4232	256	87	245	20	0	352
48822	31233s (+0.5s)	1776	1776	128	47	133	4	0	184
48823	31234s (+0.7s)	2504	2504	128	74	165	13	0	252
48824	31234s (+0.5s)	1640	1640	128	42	125	10	0	177
48825	31235s (+0.7s)	2792	2792	256	60	165	17	0	242
48826	31235s (+0.4s)	1460	1460	128	44	100	6	0	150
48827	31236s (+0.4s)	1460	1460	128	41	101	7	0	149
48828	31237s (+1.5s)	7536	7536	512	158	343	28	1	530
48829	31238s (+0.5s)	1644	1644	128	50	107	10	0	167
48830	31238s (+0.6s)	2512	2512	256	33	178	10	0	221
48831	31239s (+0.4s)	1340	1340	128	33	102	5	0	140
48832	31239s (+0.4s)	1280	1280	128	33	104	5	0	142
48833	31240s (+0.5s)	1524	1524	128	33	123	5	0	161
48834	31241s (+1.0s)	5248	5248	512	90	255	15	0	360
48835	31242s (+0.9s)	3668	3668	256	90	212	12	0	314
48836	31242s (+0.8s)	3440	3440	256	70	204	17	0	291
48837	31243s (+0.8s)	3492	3492	256	61	220	11	0	292
48838	31244s (+0.6s)	2640	2640	256	54	161	9	1	225
48839	31245s (+0.5s)	1952	1952	128	60	131	10	0	201
48840	31246s (+1.2s)	6248	6248	512	101	322	18	0	441
48841	31246s (+0.3s)	788	788	64	21	79	4	0	104
48842	31247s (+0.5s)	1656	1656	128	43	111	12	0	166
48843	31247s (+0.4s)	1456	1456	128	34	110	8	0	152
48844	31248s (+1.0s)	4068	4068	256	89	228	19	0	336
48845	31248s (+0.5s)	1956	1956	128	49	136	11	0	196
48846	31249s (+0.5s)	1904	1904	128	53	127	14	0	194
48847	31250s (+0.6s)	2484	2484	256	50	151	12	0	213
48848	31250s (+0.2s)	596	596	64	17	63	2	0	82
48849	31251s (+0.7s)	3040	3040	256	70	179	10	0	259
48850	31252s (+1.0s)	4352	4352	256	81	265	16	0	362
48851	31252s (+0.6s)	2336	2336	256	54	135	8	0	197
48852	31253s (+0.6s)	2436	2436	256	36	165	0	6	207
48853	31254s (+0.6s)	2676	2676	256	53	160	0	10	223
48854	31254s (+0.4s)	1420	1420	128	31	109	0	9	149
48855	31255s (+0.8s)	3544	3544	256	60	226	0	16	302
48856	31256s (+1.0s)	4532	4532	256	78	273	0	23	374
48857	31256s (+0.5s)	1708	1708	128	25	140	0	7	172
48858	31257s (+0.8s)	3228	3228	256	66	187	0	16	269
48859	31258s (+0.5s)	1488	1488	128	32	116	0	8	156
48860	31258s (+0.6s)	2340	2340	128	44	159	0	12	215
48861	31259s (+0.6s)	2172	2172	128	59	139	6	1	205
48862	31259s (+0.3s)	1112	1112	128	26	85	4	0	115
48863	31259s (+0.2s)	544	544	32	12	67	2	0	81
48864	31260s (+0.5s)	1820	1820	128	51	121	7	0	179
48865	31260s (+0.6s)	2220	2220	128	51	154	8	1	214
48866	31261s (+0.4s)	1344	1344	128	33	108	6	0	147
48867	31262s (+0.8s)	3488	3488	256	71	201	19	0	291
48868	31262s (+0.4s)	1184	1184	64	36	101	6	0	143
48869	31263s (+0.3s)	888	888	64	30	73	9	0	112
48870	31263s (+0.8s)	3360	3360	256	64	206	0	16	286
48871	31264s (+0.6s)	2636	2636	256	46	173	0	5	224
48872	31265s (+0.5s)	1888	1888	128	31	138	0	11	180
48873	31265s (+0.3s)	1088	1088	128	17	95	3	0	115
48874	31265s (+0.4s)	1384	1384	128	42	100	4	1	147
48875	31266s (+0.7s)	2812	2812	256	67	165	10	0	242
48876	31267s (+0.9s)	3620	3620	256	94	196	18	0	308
48877	31267s (+0.4s)	1492	1492	128	37	112	7	0	156
48878	31268s (+0.8s)	3252	3252	256	69	198	9	0	276
48879	31268s (+0.4s)	968	968	64	39	84	5	0	128
48880	31269s (+0.7s)	2856	2856	128	75	177	13	0	265
48881	31270s (+0.6s)	2720	2720	256	49	175	10	1	235
48882	31270s (+0.6s)	2384	2384	256	49	150	5	0	204
48883	31271s (+0.3s)	904	904	64	26	84	7	0	117
48884	31272s (+0.8s)	3336	3336	256	55	218	0	8	281
48885	31272s (+0.7s)	3196	3196	256	48	209	0	10	267
48886	31273s (+0.5s)	2164	2164	256	27	150	0	7	184
48887	31273s (+0.5s)	1624	1624	128	39	117	0	8	164
48888	31274s (+0.8s)	3584	3584	256	67	216	0	15	298
48889	31275s (+0.5s)	1580	1580	128	29	125	0	8	162
48890	31275s (+0.5s)	1588	1588	128	33	124	0	8	165
48891	31276s (+0.6s)	2584	2584	256	42	171	0	8	221
48892	31277s (+1.0s)	4368	4368	256	96	248	17	0	361
48893	31278s (+0.7s)	2860	2860	256	51	173	15	0	239
48894	31278s (+0.6s)	2752	2752	256	50	174	10	1	235
48895	31279s (+0.7s)	2476	2476	128	77	145	12	0	234
48896	31279s (+0.5s)	1760	1760	128	51	117	8	0	176
48897	31280s (+0.5s)	1828	1828	128	40	135	10	0	185
48898	31280s (+0.6s)	1908	1908	128	46	141	8	0	195
48899	31282s (+1.1s)	4624	4624	256	94	274	18	0	386
Episode	Time	Reward	Score	Highest	L	U	R	D	Steps
48900	31282s (+0.9s)	4100	4100	256	96	225	12	0	333
48901	31283s (+0.8s)	3456	3456	256	70	210	16	0	296
48902	31284s (+0.7s)	2752	2752	256	61	159	14	1	235
48903	31285s (+0.5s)	1844	1844	128	47	129	11	0	187
48904	31285s (+0.5s)	1988	1988	256	29	130	8	0	167
48905	31286s (+1.3s)	6284	6284	512	118	307	20	0	445
48906	31287s (+0.8s)	3208	3208	256	78	175	16	0	269
48907	31288s (+0.9s)	3596	3596	256	65	225	11	0	301
48908	31289s (+0.7s)	3044	3044	256	54	187	12	0	253
48909	31289s (+0.5s)	1808	1808	128	47	127	6	0	180
48910	31290s (+0.9s)	3764	3764	256	68	235	9	0	312
48911	31291s (+0.7s)	3040	3040	256	57	181	11	0	249
48912	31291s (+0.4s)	1160	1160	128	31	88	4	0	123
48913	31292s (+0.3s)	1004	1004	128	19	86	0	0	105
48914	31292s (+0.5s)	1788	1788	128	45	132	5	0	182
48915	31293s (+0.6s)	2500	2500	256	42	167	7	0	216
48916	31293s (+0.5s)	1616	1616	128	39	124	8	0	171
48917	31294s (+0.5s)	1600	1600	128	34	125	8	0	167
48918	31294s (+0.7s)	2612	2612	128	73	162	11	1	247
48919	31295s (+0.6s)	2132	2132	128	53	142	10	0	205
48920	31295s (+0.4s)	1172	1172	128	25	96	4	0	125
48921	31296s (+0.7s)	3284	3284	256	56	204	9	0	269
48922	31297s (+1.0s)	4400	4400	256	86	253	14	0	353
48923	31298s (+0.5s)	1800	1800	128	44	137	8	0	189
48924	31298s (+0.7s)	2980	2980	256	60	175	10	0	245
48925	31299s (+0.9s)	3736	3736	256	81	213	12	0	306
48926	31300s (+0.7s)	2912	2912	256	59	184	10	1	254
48927	31300s (+0.2s)	492	492	64	12	53	6	0	71
48928	31300s (+0.3s)	736	736	64	30	63	4	0	97
48929	31301s (+0.4s)	1432	1432	128	30	112	6	0	148
48930	31301s (+0.5s)	1692	1692	128	32	126	10	2	170
48931	31302s (+0.8s)	3440	3440	256	67	196	20	0	283
48932	31303s (+0.8s)	3632	3632	256	69	221	20	0	310
48933	31303s (+0.4s)	1068	1068	64	41	82	0	7	130
48934	31304s (+0.5s)	1512	1512	128	41	110	0	6	157
48935	31305s (+0.7s)	2684	2684	128	74	174	12	0	260
48936	31306s (+0.9s)	3940	3940	256	76	234	9	0	319
48937	31306s (+0.4s)	1184	1184	128	24	99	5	0	128
48938	31307s (+0.7s)	2912	2912	256	65	185	9	0	259
48939	31308s (+0.8s)	3660	3660	256	73	206	12	1	292
48940	31308s (+0.7s)	3144	3144	256	69	181	11	0	261
48941	31309s (+0.5s)	1664	1664	128	39	122	7	0	168
48942	31310s (+0.9s)	3824	3824	256	78	219	16	0	313
48943	31310s (+0.4s)	1416	1416	128	24	120	4	0	148
48944	31311s (+0.6s)	2024	2024	128	59	131	11	0	201
48945	31312s (+0.9s)	3868	3868	256	82	222	14	0	318
48946	31313s (+1.4s)	7188	7188	512	150	316	30	0	496
48947	31314s (+0.7s)	2596	2596	128	63	165	16	0	244
48948	31314s (+0.5s)	1752	1752	128	41	133	10	0	184
48949	31315s (+0.9s)	3952	3952	256	80	230	12	0	322
48950	31316s (+0.5s)	1588	1588	128	46	111	7	0	164
48951	31316s (+0.7s)	2920	2920	256	57	171	19	0	247
48952	31317s (+0.7s)	2656	2656	256	40	186	0	8	234
48953	31318s (+1.0s)	4336	4336	256	75	264	0	15	354
48954	31319s (+1.1s)	5368	5368	512	82	274	0	18	374
48955	31320s (+0.4s)	1484	1484	128	31	119	0	5	155
48956	31320s (+0.9s)	3936	3936	256	85	225	14	0	324
48957	31321s (+0.4s)	1052	1052	64	37	84	6	0	127
48958	31321s (+0.5s)	1748	1748	128	49	113	14	1	177
48959	31322s (+1.0s)	4172	4172	256	105	223	15	0	343
48960	31323s (+0.4s)	1204	1204	128	22	107	4	0	133
48961	31324s (+1.0s)	4204	4204	256	67	256	0	19	342
48962	31324s (+0.7s)	2944	2944	256	41	195	0	11	247
48963	31325s (+0.4s)	1076	1076	64	36	88	0	5	129
48964	31326s (+0.9s)	3832	3832	256	61	233	0	15	309
48965	31326s (+0.5s)	1508	1508	128	31	121	0	9	161
48966	31327s (+0.5s)	1624	1624	128	29	135	0	9	173
48967	31327s (+0.8s)	3240	3240	256	45	221	0	7	273
48968	31328s (+0.7s)	2672	2672	256	41	190	0	6	237
48969	31329s (+1.0s)	4128	4128	256	76	239	0	20	335
48970	31330s (+0.5s)	1796	1796	128	43	127	0	14	184
48971	31330s (+0.6s)	1884	1884	128	55	133	7	0	195
48972	31331s (+0.8s)	3416	3416	256	64	202	15	0	281
48973	31332s (+1.0s)	4456	4456	256	94	246	21	0	361
48974	31333s (+0.9s)	3776	3776	256	85	211	14	0	310
48975	31334s (+1.0s)	4476	4476	256	92	259	15	0	366
48976	31334s (+0.3s)	1092	1092	128	16	98	4	0	118
48977	31335s (+0.4s)	1416	1416	128	43	100	10	0	153
48978	31335s (+0.7s)	3304	3304	256	53	203	11	0	267
48979	31336s (+0.7s)	2688	2688	256	46	177	9	0	232
48980	31337s (+0.6s)	1972	1972	128	49	150	6	1	206
48981	31337s (+0.7s)	2440	2440	128	81	146	14	0	241
48982	31338s (+0.6s)	2452	2452	128	48	167	13	1	229
48983	31339s (+1.0s)	4352	4352	256	100	241	16	0	357
48984	31340s (+0.5s)	1596	1596	128	40	119	7	0	166
48985	31340s (+0.4s)	1468	1468	128	34	110	7	0	151
48986	31341s (+0.5s)	1812	1812	128	50	118	9	0	177
48987	31342s (+0.9s)	3888	3888	256	85	221	15	1	322
48988	31342s (+0.5s)	1708	1708	128	47	118	9	0	174
48989	31343s (+0.5s)	1648	1648	128	46	122	6	0	174
48990	31343s (+0.4s)	1204	1204	128	41	84	8	0	133
48991	31344s (+0.8s)	3328	3328	256	65	198	13	0	276
48992	31344s (+0.4s)	1168	1168	64	29	105	4	0	138
48993	31345s (+0.5s)	1840	1840	128	42	134	8	0	184
48994	31345s (+0.7s)	3008	3008	256	60	171	12	0	243
48995	31346s (+0.7s)	2572	2572	128	68	163	11	0	242
48996	31347s (+1.0s)	3920	3920	256	105	210	19	1	335
48997	31348s (+0.6s)	2592	2592	256	51	159	8	0	218
48998	31349s (+1.3s)	6388	6388	512	117	314	20	0	451
48999	31349s (+0.5s)	1628	1628	128	35	123	7	0	165
Episode	Time	Reward	Score	Highest	L	U	R	D	Steps
49000	31350s (+0.6s)	1948	1948	128	61	126	13	1	201
49001	31351s (+0.7s)	2804	2804	256	44	189	0	11	244
49002	31351s (+0.6s)	2240	2240	128	60	133	12	0	205
49003	31352s (+0.6s)	2688	2688	256	51	169	11	0	231
49004	31353s (+0.8s)	3456	3456	256	73	201	10	1	285
49005	31353s (+0.6s)	1904	1904	128	45	138	11	0	194
49006	31354s (+0.7s)	2856	2856	256	51	176	11	0	238
49007	31354s (+0.4s)	1336	1336	128	38	101	6	0	145
49008	31355s (+0.4s)	1412	1412	128	30	108	8	0	146
49009	31356s (+1.0s)	4236	4236	256	86	241	21	1	349
49010	31356s (+0.5s)	2060	2060	256	34	128	9	0	171
49011	31357s (+0.4s)	1420	1420	128	46	97	7	1	151
49012	31357s (+0.4s)	1200	1200	128	27	98	0	4	129
49013	31358s (+0.5s)	1624	1624	128	33	131	0	8	172
49014	31358s (+0.5s)	1792	1792	128	53	122	0	8	183
49015	31359s (+0.5s)	1572	1572	128	34	123	0	8	165
49016	31359s (+0.5s)	1768	1768	128	46	122	0	9	177
49017	31359s (+0.2s)	320	320	32	11	44	0	4	59
49018	31360s (+0.9s)	3800	3800	256	65	237	0	15	317
49019	31361s (+0.5s)	1852	1852	128	48	127	11	0	186
49020	31362s (+1.1s)	5640	5640	512	136	237	23	1	397
49021	31363s (+0.7s)	2860	2860	128	60	180	13	0	253
49022	31363s (+0.5s)	1704	1704	128	52	113	5	1	171
49023	31364s (+0.8s)	3200	3200	256	76	179	12	0	267
49024	31365s (+0.8s)	3356	3356	256	74	188	14	0	276
49025	31366s (+1.0s)	4160	4160	256	85	233	17	0	335
49026	31366s (+0.5s)	1632	1632	128	35	135	5	0	175
49027	31367s (+0.6s)	2600	2600	256	50	152	13	1	216
49028	31367s (+0.4s)	1536	1536	128	37	115	5	0	157
49029	31368s (+0.6s)	2368	2368	128	53	155	12	0	220
49030	31368s (+0.6s)	2508	2508	256	59	148	11	0	218
49031	31369s (+0.7s)	3080	3080	256	61	183	11	0	255
49032	31370s (+0.6s)	2488	2488	256	64	136	13	1	214
49033	31371s (+0.8s)	3304	3304	256	58	203	12	0	273
49034	31371s (+0.3s)	928	928	64	28	80	4	0	112
49035	31371s (+0.6s)	1920	1920	128	41	150	7	0	198
49036	31372s (+0.3s)	784	784	64	23	76	5	0	104
49037	31372s (+0.5s)	1788	1788	128	43	127	12	0	182
49038	31373s (+0.6s)	2516	2516	256	56	153	8	0	217
49039	31374s (+0.7s)	2748	2748	256	41	185	11	0	237
49040	31375s (+1.3s)	6292	6292	512	86	347	14	0	447
49041	31376s (+0.8s)	3324	3324	256	68	194	15	0	277
49042	31376s (+0.5s)	1732	1732	128	45	123	9	0	177
49043	31377s (+0.7s)	2732	2732	256	56	165	10	0	231
49044	31378s (+0.6s)	2804	2804	256	60	154	9	0	223
49045	31378s (+0.8s)	3248	3248	256	76	174	14	0	264
49046	31379s (+0.5s)	1844	1844	128	47	136	8	0	191
49047	31380s (+0.8s)	3488	3488	256	76	194	15	0	285
49048	31380s (+0.5s)	1664	1664	128	33	128	7	0	168
49049	31381s (+0.9s)	4104	4104	256	80	218	15	1	314
49050	31382s (+0.9s)	4180	4180	256	83	234	19	0	336
49051	31382s (+0.4s)	1304	1304	128	26	103	5	0	134
49052	31383s (+0.7s)	2928	2928	256	58	189	11	0	258
49053	31384s (+1.0s)	4248	4248	256	76	254	14	0	344
49054	31385s (+0.4s)	1488	1488	128	37	111	8	0	156
49055	31385s (+0.5s)	1900	1900	128	47	133	9	0	189
49056	31386s (+0.7s)	3092	3092	256	54	188	15	0	257
49057	31387s (+1.0s)	4236	4236	256	92	237	21	0	350
49058	31388s (+1.5s)	7476	7476	512	131	361	27	0	519
49059	31389s (+0.9s)	3860	3860	256	89	220	15	0	324
49060	31391s (+1.3s)	6148	6148	512	123	295	28	2	448
49061	31391s (+0.6s)	2644	2644	256	40	179	3	0	222
49062	31392s (+0.8s)	3268	3268	256	70	184	14	0	268
49063	31393s (+0.7s)	2876	2876	256	68	172	10	0	250
49064	31393s (+0.6s)	1884	1884	128	41	139	10	0	190
49065	31394s (+0.8s)	3320	3320	256	69	195	17	0	281
49066	31395s (+0.9s)	3572	3572	256	76	215	13	0	304
49067	31395s (+0.3s)	808	808	64	33	72	4	0	109
49068	31396s (+0.6s)	1928	1928	128	48	144	8	0	200
49069	31397s (+1.2s)	6176	6176	512	133	282	20	0	435
49070	31398s (+0.5s)	1792	1792	128	48	122	13	0	183
49071	31398s (+0.7s)	2808	2808	256	49	184	5	0	238
49072	31399s (+0.5s)	1788	1788	128	44	130	8	0	182
49073	31399s (+0.4s)	1500	1500	128	32	117	9	0	158
49074	31400s (+0.5s)	1808	1808	128	39	140	8	0	187
49075	31400s (+0.3s)	940	940	128	27	71	4	0	102
49076	31401s (+0.7s)	3160	3160	256	64	181	14	0	259
49077	31402s (+0.8s)	3452	3452	256	73	199	13	1	286
49078	31402s (+0.8s)	3220	3220	256	76	173	19	0	268
49079	31403s (+0.6s)	2764	2764	256	57	154	14	0	225
49080	31404s (+0.6s)	2056	2056	128	36	158	6	1	201
49081	31404s (+0.5s)	1612	1612	128	41	121	7	1	170
49082	31405s (+0.4s)	1488	1488	128	36	107	3	0	146
49083	31405s (+0.7s)	3108	3108	256	52	195	10	0	257
49084	31406s (+0.7s)	2764	2764	256	64	161	12	1	238
49085	31407s (+0.5s)	1652	1652	128	54	115	6	1	176
49086	31407s (+0.8s)	4404	4404	512	75	204	16	0	295
49087	31408s (+0.5s)	1752	1752	128	49	124	4	1	178
49088	31408s (+0.4s)	1472	1472	128	41	107	7	0	155
49089	31409s (+0.6s)	1952	1952	128	44	149	8	0	201
49090	31409s (+0.4s)	1376	1376	128	34	102	0	8	144
49091	31410s (+0.4s)	1632	1632	128	38	122	0	4	164
49092	31411s (+0.7s)	3080	3080	256	61	188	0	10	259
49093	31411s (+0.3s)	892	892	64	21	85	0	3	109
49094	31412s (+0.8s)	3300	3300	256	55	212	0	11	278
49095	31412s (+0.3s)	900	900	64	25	88	0	7	120
49096	31413s (+1.0s)	5188	5188	512	76	276	0	13	365
49097	31413s (+0.4s)	1088	1088	128	20	101	0	0	121
49098	31414s (+0.7s)	2800	2800	256	36	196	0	11	243
49099	31415s (+0.8s)	3224	3224	256	63	196	10	0	269
Episode	Time	Reward	Score	Highest	L	U	R	D	Steps
49100	31416s (+1.0s)	4112	4112	256	104	206	24	0	334
49101	31416s (+0.4s)	1116	1116	64	32	88	10	0	130
49102	31417s (+0.5s)	1716	1716	128	41	125	10	0	176
49103	31417s (+0.7s)	2804	2804	256	64	168	12	0	244
49104	31418s (+0.4s)	1460	1460	128	25	119	4	0	148
49105	31418s (+0.5s)	1912	1912	128	47	135	11	0	193
49106	31419s (+0.5s)	1752	1752	128	54	113	10	0	177
49107	31419s (+0.4s)	1476	1476	128	37	112	4	0	153
49108	31420s (+0.4s)	1472	1472	128	27	111	4	0	142
49109	31420s (+0.4s)	1316	1316	128	31	107	6	0	144
49110	31421s (+0.5s)	1712	1712	128	30	133	7	0	170
49111	31421s (+0.5s)	1772	1772	128	50	122	6	0	178
49112	31422s (+0.9s)	3864	3864	256	89	212	16	0	317
49113	31423s (+0.6s)	1904	1904	128	53	130	12	1	196
49114	31423s (+0.4s)	1396	1396	128	28	115	6	0	149
49115	31424s (+1.0s)	4324	4324	256	91	246	17	1	355
49116	31425s (+0.9s)	3652	3652	256	96	179	25	0	300
49117	31426s (+0.8s)	3308	3308	256	65	191	19	0	275
49118	31426s (+0.6s)	2140	2140	128	66	136	12	0	214
49119	31427s (+0.7s)	2912	2912	256	83	159	13	0	255
49120	31427s (+0.4s)	1164	1164	64	35	94	9	0	138
49121	31428s (+0.5s)	1496	1496	128	26	124	0	8	158
49122	31428s (+0.5s)	1508	1508	128	40	112	0	9	161
49123	31429s (+0.6s)	2724	2724	256	58	168	3	0	229
49124	31430s (+0.5s)	2096	2096	256	40	121	10	0	171
49125	31430s (+0.8s)	3360	3360	256	70	205	11	0	286
49126	31431s (+0.8s)	3704	3704	256	61	226	7	0	294
49127	31432s (+0.9s)	3672	3672	256	78	212	15	0	305
49128	31433s (+0.7s)	2828	2828	256	72	157	16	0	245
49129	31433s (+0.4s)	1420	1420	128	28	105	5	0	138
49130	31434s (+0.5s)	1608	1608	128	39	124	6	0	169
49131	31434s (+0.5s)	1760	1760	128	44	129	7	0	180
49132	31435s (+0.7s)	2824	2824	256	64	164	14	0	242
49133	31436s (+0.7s)	2696	2696	256	58	161	14	0	233
49134	31436s (+0.4s)	1536	1536	128	46	98	14	0	158
49135	31437s (+0.8s)	3412	3412	256	75	195	14	0	284
49136	31437s (+0.4s)	1324	1324	128	31	103	3	0	137
49137	31438s (+0.6s)	2100	2100	128	59	142	10	0	211
49138	31439s (+0.8s)	3352	3352	256	65	209	10	0	284
49139	31440s (+0.9s)	3844	3844	256	96	208	19	1	324
49140	31440s (+0.6s)	2608	2608	256	67	151	7	0	225
49141	31441s (+0.4s)	1188	1188	128	31	95	3	0	129
49142	31441s (+0.5s)	1696	1696	128	37	124	8	0	169
49143	31441s (+0.3s)	916	916	64	25	91	4	0	120
49144	31442s (+0.9s)	3620	3620	256	89	204	15	0	308
49145	31443s (+0.4s)	1600	1600	128	38	117	3	0	158
49146	31443s (+0.4s)	1440	1440	128	36	105	8	0	149
49147	31443s (+0.2s)	448	448	64	8	53	0	3	64
49148	31444s (+0.5s)	1800	1800	128	38	140	0	7	185
49149	31444s (+0.5s)	1748	1748	128	37	130	0	6	173
49150	31445s (+0.4s)	984	984	64	27	88	0	7	122
49151	31445s (+0.4s)	1168	1168	128	27	92	4	1	124
49152	31446s (+0.4s)	1444	1444	128	35	111	3	0	149
49153	31446s (+0.5s)	1812	1812	128	48	128	12	0	188
49154	31447s (+0.8s)	3256	3256	256	63	199	10	0	272
49155	31447s (+0.4s)	1440	1440	128	36	109	4	0	149
49156	31448s (+0.6s)	1868	1868	128	59	129	9	0	197
49157	31449s (+0.6s)	2604	2604	256	40	169	0	8	217
49158	31449s (+0.7s)	2708	2708	256	48	170	0	9	227
49159	31450s (+0.8s)	3616	3616	256	60	212	0	19	291
49160	31451s (+0.9s)	3760	3760	256	65	233	0	14	312
49161	31452s (+0.5s)	1716	1716	128	36	132	0	8	176
49162	31452s (+0.4s)	1400	1400	128	23	116	0	7	146
49163	31452s (+0.4s)	1464	1464	128	24	123	0	7	154
49164	31453s (+0.6s)	2508	2508	256	42	161	0	10	213
49165	31454s (+0.8s)	3476	3476	256	63	215	14	0	292
49166	31454s (+0.5s)	1824	1824	128	49	113	9	0	171
49167	31455s (+0.4s)	1308	1308	128	31	107	5	0	143
49168	31455s (+0.6s)	2020	2020	128	51	138	11	0	200
49169	31456s (+0.5s)	1748	1748	128	40	131	6	0	177
49170	31457s (+0.8s)	3480	3480	256	77	196	16	0	289
49171	31457s (+0.6s)	2064	2064	128	39	155	13	0	207
49172	31458s (+0.5s)	1784	1784	128	42	128	0	11	181
49173	31458s (+0.6s)	2140	2140	128	41	153	0	13	207
49174	31459s (+0.5s)	1524	1524	128	30	128	0	7	165
49175	31459s (+0.5s)	2076	2076	128	49	133	9	0	191
49176	31460s (+0.9s)	3608	3608	256	78	211	19	0	308
49177	31461s (+0.6s)	2040	2040	128	44	143	10	0	197
49178	31461s (+0.4s)	1444	1444	128	27	121	3	0	151
49179	31462s (+0.8s)	3472	3472	256	63	204	10	0	277
49180	31463s (+0.9s)	4736	4736	512	88	221	19	0	328
49181	31464s (+0.7s)	2684	2684	256	45	177	10	0	232
49182	31465s (+0.8s)	3472	3472	256	57	211	6	0	274
49183	31465s (+0.3s)	944	944	64	29	84	7	0	120
49184	31466s (+0.7s)	2856	2856	256	55	182	10	0	247
49185	31466s (+0.5s)	1892	1892	128	46	140	5	0	191
49186	31467s (+0.8s)	3220	3220	256	60	194	14	0	268
49187	31468s (+0.6s)	2364	2364	128	52	154	12	1	219
49188	31468s (+0.2s)	580	580	32	21	63	1	0	85
49189	31468s (+0.5s)	1852	1852	128	53	123	11	0	187
49190	31469s (+0.5s)	1812	1812	128	48	134	6	0	188
49191	31470s (+1.0s)	4148	4148	256	103	222	19	0	344
49192	31470s (+0.5s)	1816	1816	128	46	135	7	0	188
49193	31471s (+0.5s)	2232	2232	256	44	140	3	0	187
49194	31471s (+0.4s)	1148	1148	64	29	97	8	0	134
49195	31472s (+0.5s)	1772	1772	128	43	131	5	0	179
49196	31472s (+0.4s)	1456	1456	128	43	102	7	0	152
49197	31473s (+0.7s)	3052	3052	256	62	184	12	0	258
49198	31473s (+0.3s)	808	808	64	22	72	0	5	99
49199	31474s (+0.8s)	3212	3212	256	47	212	0	12	271
Episode	Time	Reward	Score	Highest	L	U	R	D	Steps
49200	31475s (+0.6s)	2360	2360	128	44	159	0	16	219
49201	31476s (+0.8s)	3332	3332	256	64	202	0	13	279
49202	31476s (+0.7s)	2936	2936	256	54	197	0	9	260
49203	31477s (+0.5s)	1800	1800	128	26	153	0	7	186
49204	31477s (+0.4s)	1492	1492	128	37	101	11	1	150
49205	31478s (+0.7s)	2748	2748	256	49	180	5	0	234
49206	31479s (+0.9s)	4428	4428	512	65	222	12	0	299
49207	31479s (+0.4s)	1300	1300	128	30	106	4	0	140
49208	31480s (+0.6s)	2276	2276	128	65	135	12	0	212
49209	31480s (+0.3s)	1036	1036	64	32	84	7	0	123
49210	31480s (+0.2s)	516	516	32	28	48	3	0	79
49211	31481s (+0.2s)	568	568	64	14	61	1	1	77
49212	31481s (+0.8s)	3236	3236	256	67	192	13	0	272
49213	31482s (+0.5s)	1676	1676	128	43	117	10	0	170
49214	31482s (+0.6s)	2112	2112	128	50	140	10	0	200
49215	31483s (+0.4s)	1436	1436	128	27	116	6	0	149
49216	31484s (+0.7s)	2820	2820	256	70	162	11	0	243
49217	31485s (+1.4s)	6884	6884	512	126	332	22	0	480
49218	31485s (+0.3s)	716	716	64	23	68	5	0	96
49219	31486s (+0.6s)	2100	2100	128	55	151	9	1	216
49220	31487s (+0.7s)	3036	3036	256	66	185	7	0	258
49221	31487s (+0.5s)	1576	1576	128	41	114	7	0	162
49222	31488s (+0.6s)	2404	2404	256	42	158	9	0	209
49223	31488s (+0.6s)	1852	1852	128	58	125	10	0	193
49224	31489s (+0.9s)	4004	4004	256	76	232	16	0	324
49225	31490s (+0.6s)	2736	2736	256	61	162	9	0	232
49226	31490s (+0.5s)	1656	1656	128	43	122	10	1	176
49227	31491s (+0.8s)	3136	3136	256	57	192	15	0	264
49228	31492s (+0.5s)	1680	1680	128	38	123	10	0	171
49229	31492s (+0.7s)	3140	3140	256	62	189	10	0	261
49230	31493s (+0.5s)	2084	2084	128	37	147	1	8	193
49231	31494s (+0.7s)	2692	2692	256	53	181	0	9	243
49232	31494s (+0.8s)	3232	3232	256	55	205	0	11	271
49233	31495s (+0.6s)	2664	2664	256	57	156	0	13	226
49234	31495s (+0.4s)	1500	1500	128	31	119	0	8	158
49235	31496s (+0.4s)	1176	1176	64	30	103	0	8	141
49236	31497s (+0.7s)	3080	3080	256	47	192	0	11	250
49237	31498s (+0.9s)	4024	4024	256	92	225	16	0	333
49238	31498s (+0.8s)	3552	3552	256	70	210	14	1	295
49239	31499s (+0.7s)	3040	3040	256	62	176	12	0	250
49240	31500s (+0.7s)	3160	3160	256	70	179	9	0	258
49241	31500s (+0.4s)	1196	1196	128	25	101	6	0	132
49242	31500s (+0.3s)	596	596	32	23	63	3	1	90
49243	31502s (+1.1s)	4372	4372	256	100	249	17	0	366
49244	31503s (+1.0s)	4320	4320	256	84	255	19	0	358
49245	31503s (+0.8s)	3360	3360	256	74	188	14	0	276
49246	31504s (+0.6s)	2276	2276	256	54	139	7	0	200
49247	31504s (+0.5s)	1592	1592	128	43	121	7	1	172
49248	31505s (+0.7s)	2568	2568	128	67	161	13	0	241
49249	31506s (+0.7s)	2828	2828	256	54	184	13	0	251
49250	31506s (+0.5s)	1660	1660	128	41	116	9	0	166
49251	31507s (+0.7s)	3020	3020	256	62	181	12	0	255
49252	31508s (+0.8s)	3320	3320	256	92	171	18	0	281
49253	31509s (+0.8s)	3276	3276	256	65	205	11	1	282
49254	31510s (+0.9s)	3896	3896	256	96	219	16	0	331
49255	31510s (+0.4s)	1196	1196	128	39	88	4	0	131
49256	31511s (+1.0s)	4196	4196	256	92	234	16	1	343
49257	31512s (+0.8s)	3272	3272	256	73	182	15	0	270
49258	31512s (+0.5s)	1900	1900	128	33	155	0	5	193
49259	31513s (+0.8s)	3224	3224	256	64	198	0	11	273
49260	31513s (+0.3s)	772	772	64	21	70	4	0	95
49261	31514s (+0.3s)	1104	1104	128	28	87	0	3	118
49262	31515s (+0.8s)	3396	3396	256	68	205	10	0	283
49263	31515s (+0.6s)	2348	2348	256	44	149	8	0	201
49264	31516s (+0.6s)	1976	1976	128	73	109	15	0	197
49265	31516s (+0.5s)	1760	1760	128	36	137	6	0	179
49266	31517s (+0.8s)	3344	3344	256	79	200	12	0	291
49267	31518s (+0.5s)	1820	1820	128	35	137	11	0	183
49268	31518s (+0.7s)	3048	3048	256	52	190	15	0	257
49269	31519s (+0.6s)	2412	2412	256	41	159	7	0	207
49270	31520s (+0.9s)	4032	4032	256	92	220	18	0	330
49271	31521s (+0.7s)	2720	2720	256	47	176	10	0	233
49272	31521s (+0.5s)	1684	1684	128	41	123	8	0	172
49273	31522s (+0.5s)	1716	1716	128	39	125	11	1	176
49274	31522s (+0.7s)	2928	2928	256	69	173	13	0	255
49275	31522s (+0.2s)	428	428	32	9	53	0	7	69
49276	31523s (+0.5s)	1652	1652	128	42	122	5	0	169
49277	31524s (+0.6s)	2484	2484	128	67	151	14	0	232
49278	31524s (+0.8s)	3348	3348	256	60	202	11	0	273
49279	31525s (+0.7s)	3108	3108	256	72	174	11	0	257
49280	31526s (+0.4s)	1408	1408	128	36	101	8	0	145
49281	31527s (+1.1s)	5636	5636	512	103	277	17	0	397
49282	31527s (+0.6s)	1812	1812	128	41	134	12	0	187
49283	31528s (+0.4s)	1432	1432	128	40	100	6	0	146
49284	31529s (+0.9s)	3520	3520	256	95	191	12	0	298
49285	31529s (+0.4s)	1388	1388	128	28	113	6	0	147
49286	31529s (+0.4s)	1480	1480	128	40	101	12	1	154
49287	31530s (+0.7s)	2824	2824	256	51	181	0	13	245
49288	31531s (+0.7s)	2828	2828	256	55	187	0	8	250
49289	31531s (+0.1s)	132	132	16	7	27	0	1	35
49290	31532s (+0.6s)	2464	2464	256	44	157	0	8	209
49291	31532s (+0.7s)	3224	3224	256	51	202	0	15	268
49292	31533s (+0.8s)	3284	3284	256	58	202	8	0	268
49293	31534s (+0.7s)	3240	3240	256	59	203	10	1	273
49294	31534s (+0.4s)	1184	1184	64	38	99	6	0	143
49295	31535s (+0.5s)	1880	1880	128	45	140	8	0	193
49296	31536s (+1.0s)	4216	4216	256	84	240	20	0	344
49297	31536s (+0.4s)	1452	1452	128	34	109	5	0	148
49298	31537s (+0.8s)	3540	3540	256	81	194	13	1	289
49299	31538s (+0.5s)	1812	1812	128	48	126	14	0	188
Episode	Time	Reward	Score	Highest	L	U	R	D	Steps
49300	31538s (+0.5s)	1760	1760	128	41	132	6	0	179
49301	31538s (+0.4s)	1272	1272	128	33	90	6	0	129
49302	31539s (+0.6s)	2380	2380	256	44	149	9	1	203
49303	31540s (+0.6s)	2216	2216	128	41	155	9	4	209
49304	31540s (+0.7s)	2864	2864	256	61	162	10	0	233
49305	31541s (+0.8s)	3276	3276	256	74	182	15	0	271
49306	31542s (+1.1s)	4636	4636	256	105	265	15	0	385
49307	31543s (+0.7s)	2868	2868	256	62	177	10	1	250
49308	31544s (+1.0s)	4152	4152	256	79	243	18	0	340
49309	31545s (+0.9s)	3912	3912	256	102	211	20	0	333
49310	31546s (+0.8s)	3492	3492	256	48	232	0	12	292
49311	31546s (+0.6s)	2644	2644	256	54	162	0	10	226
49312	31547s (+0.4s)	1044	1044	64	27	99	0	5	131
49313	31547s (+0.3s)	828	828	64	24	77	0	7	108
49314	31548s (+0.5s)	1824	1824	128	53	118	6	0	177
49315	31548s (+0.8s)	3388	3388	256	55	217	10	0	282
49316	31549s (+0.6s)	2408	2408	128	56	146	15	1	218
49317	31550s (+0.7s)	2896	2896	256	70	160	14	0	244
49318	31550s (+0.6s)	2600	2600	256	45	164	8	0	217
49319	31551s (+0.6s)	2260	2260	256	48	137	9	0	194
49320	31552s (+0.7s)	2804	2804	256	58	175	10	0	243
49321	31552s (+0.8s)	3356	3356	256	79	191	15	0	285
49322	31553s (+0.5s)	1760	1760	128	40	129	8	2	179
49323	31554s (+1.1s)	6140	6140	512	113	268	26	0	407
49324	31555s (+0.6s)	2288	2288	256	54	134	7	1	196
49325	31555s (+0.6s)	2136	2136	128	53	136	8	1	198
49326	31556s (+0.7s)	2908	2908	256	62	181	10	0	253
49327	31556s (+0.5s)	1852	1852	128	59	119	9	0	187
49328	31557s (+0.8s)	3260	3260	256	68	194	10	0	272
49329	31558s (+0.5s)	1840	1840	128	50	134	7	0	191
49330	31559s (+0.7s)	3216	3216	256	63	195	8	0	266
49331	31559s (+0.6s)	2568	2568	256	63	148	10	0	221
49332	31560s (+0.7s)	3044	3044	256	57	174	15	0	246
49333	31561s (+0.7s)	2968	2968	256	56	172	11	0	239
49334	31561s (+0.4s)	1280	1280	128	23	109	5	0	137
49335	31561s (+0.4s)	1112	1112	128	23	95	3	0	121
49336	31562s (+0.5s)	1648	1648	128	46	121	6	1	174
49337	31563s (+0.9s)	3584	3584	256	74	206	18	0	298
49338	31563s (+0.5s)	1736	1736	128	38	126	9	0	173
49339	31564s (+0.4s)	1492	1492	128	32	113	8	0	153
49340	31564s (+0.5s)	1604	1604	128	39	121	7	0	167
49341	31565s (+0.7s)	2788	2788	256	44	187	9	0	240
49342	31565s (+0.4s)	1440	1440	128	28	112	6	0	146
49343	31566s (+0.6s)	2260	2260	128	55	135	9	0	199
49344	31566s (+0.3s)	876	876	64	28	81	5	0	114
49345	31567s (+0.7s)	2768	2768	256	58	169	10	0	237
49346	31567s (+0.3s)	980	980	64	31	81	9	0	121
49347	31567s (+0.2s)	608	608	64	18	62	5	0	85
49348	31568s (+0.3s)	724	724	64	23	73	4	0	100
49349	31568s (+0.5s)	1604	1604	128	37	125	6	0	168
49350	31569s (+0.7s)	2920	2920	256	48	188	7	0	243
49351	31569s (+0.4s)	1484	1484	128	42	106	7	0	155
49352	31570s (+0.5s)	2052	2052	256	32	128	8	0	168
49353	31570s (+0.6s)	2600	2600	256	40	168	9	1	218
49354	31571s (+0.5s)	1556	1556	128	45	106	10	0	161
49355	31572s (+1.0s)	4076	4076	256	94	229	13	0	336
49356	31573s (+0.6s)	2364	2364	256	41	154	9	0	204
49357	31573s (+0.6s)	2480	2480	256	54	149	9	0	212
49358	31574s (+0.5s)	1740	1740	128	37	139	5	0	181
49359	31574s (+0.5s)	1692	1692	128	43	123	9	0	175
49360	31575s (+0.7s)	2848	2848	256	62	177	11	0	250
49361	31576s (+1.0s)	4628	4628	256	114	215	20	0	349
49362	31576s (+0.4s)	1332	1332	128	32	97	7	2	138
49363	31577s (+0.7s)	2912	2912	256	57	186	11	0	254
49364	31577s (+0.4s)	1504	1504	128	40	104	6	0	150
49365	31578s (+0.7s)	2768	2768	256	51	175	10	0	236
49366	31578s (+0.3s)	716	716	64	27	62	4	0	93
49367	31579s (+0.3s)	956	956	64	27	82	6	0	115
49368	31579s (+0.5s)	1576	1576	128	45	113	8	0	166
49369	31580s (+0.5s)	1892	1892	128	45	136	10	0	191
49370	31580s (+0.4s)	1348	1348	128	25	111	0	6	142
49371	31581s (+0.8s)	3224	3224	256	72	205	0	7	284
49372	31581s (+0.3s)	1084	1084	128	27	88	0	5	120
49373	31582s (+0.5s)	1584	1584	128	27	128	0	9	164
49374	31582s (+0.5s)	1612	1612	128	33	123	0	10	166
49375	31583s (+0.7s)	2912	2912	256	68	173	13	0	254
49376	31584s (+0.7s)	2796	2796	256	65	168	8	0	241
49377	31584s (+0.4s)	1192	1192	128	36	85	5	1	127
49378	31585s (+1.0s)	4544	4544	256	109	238	19	0	366
49379	31585s (+0.3s)	672	672	32	28	62	6	0	96
49380	31586s (+0.6s)	2536	2536	256	52	147	12	0	211
49381	31587s (+0.9s)	3556	3556	256	75	208	20	0	303
49382	31587s (+0.3s)	944	944	64	31	82	3	0	116
49383	31588s (+0.6s)	2748	2748	256	48	161	13	0	222
49384	31588s (+0.6s)	1944	1944	128	43	153	8	0	204
49385	31589s (+0.5s)	1648	1648	128	42	128	0	4	174
49386	31589s (+0.5s)	1604	1604	128	32	125	0	11	168
49387	31590s (+0.6s)	2436	2436	256	41	157	0	9	207
49388	31591s (+0.5s)	1868	1868	128	36	137	0	10	183
49389	31591s (+0.4s)	1300	1300	64	36	99	0	10	145
49390	31592s (+0.9s)	3632	3632	256	62	231	0	14	307
49391	31593s (+0.7s)	2904	2904	256	59	171	0	12	242
49392	31593s (+0.6s)	2752	2752	256	62	160	9	0	231
49393	31594s (+0.8s)	3492	3492	256	88	189	15	0	292
49394	31595s (+1.2s)	6012	6012	512	112	290	24	0	426
49395	31596s (+0.8s)	3292	3292	256	65	193	13	0	271
49396	31597s (+1.0s)	4488	4488	256	92	239	17	1	349
49397	31598s (+0.8s)	3652	3652	256	90	199	21	0	310
49398	31598s (+0.5s)	1664	1664	128	36	134	5	0	175
49399	31599s (+0.8s)	3300	3300	256	73	195	22	1	291
Episode	Time	Reward	Score	Highest	L	U	R	D	Steps
49400	31600s (+0.9s)	3860	3860	256	77	222	17	0	316
49401	31600s (+0.2s)	528	528	64	12	57	2	0	71
49402	31601s (+0.4s)	1468	1468	128	27	122	3	1	153
49403	31601s (+0.7s)	3124	3124	256	65	184	10	0	259
49404	31602s (+0.2s)	612	612	64	21	62	3	0	86
49405	31603s (+0.8s)	3252	3252	256	74	186	15	0	275
49406	31603s (+0.5s)	1792	1792	128	43	131	9	0	183
49407	31603s (+0.3s)	1040	1040	64	34	82	8	0	124
49408	31604s (+0.4s)	1276	1276	128	25	106	5	0	136
49409	31604s (+0.5s)	1568	1568	128	38	118	7	1	164
49410	31605s (+0.9s)	3648	3648	256	89	205	17	0	311
49411	31606s (+0.7s)	2924	2924	256	65	163	13	1	242
49412	31607s (+0.9s)	3984	3984	256	86	229	15	0	330
49413	31608s (+0.9s)	3684	3684	256	53	236	0	15	304
49414	31608s (+0.6s)	2672	2672	256	38	177	0	11	226
49415	31609s (+0.5s)	1844	1844	128	43	135	0	7	185
49416	31609s (+0.5s)	1792	1792	128	36	141	0	6	183
49417	31610s (+0.9s)	4080	4080	256	86	225	17	0	328
49418	31611s (+0.7s)	3020	3020	256	72	166	12	0	250
49419	31611s (+0.4s)	1412	1412	128	33	114	5	0	152
49420	31612s (+0.7s)	2896	2896	256	56	187	7	0	250
49421	31613s (+1.0s)	5264	5264	512	87	260	16	0	363
49422	31614s (+0.3s)	936	936	64	30	77	4	0	111
49423	31614s (+0.7s)	2616	2616	128	83	158	8	0	249
49424	31615s (+0.3s)	864	864	64	30	79	3	0	112
49425	31615s (+0.7s)	3068	3068	256	76	172	14	0	262
49426	31616s (+1.0s)	4320	4320	256	95	245	19	0	359
49427	31617s (+0.4s)	1472	1472	128	35	111	6	0	152
49428	31618s (+1.0s)	5208	5208	512	90	258	16	0	364
49429	31618s (+0.5s)	1620	1620	128	49	116	6	1	172
49430	31619s (+0.8s)	3284	3284	256	93	163	20	0	276
49431	31620s (+0.6s)	2648	2648	256	54	160	9	0	223
49432	31620s (+0.5s)	1872	1872	128	41	140	10	0	191
49433	31621s (+0.6s)	2116	2116	128	54	151	10	0	215
49434	31621s (+0.3s)	832	832	64	23	78	5	0	106
49435	31622s (+0.7s)	2564	2564	128	66	164	11	0	241
49436	31623s (+0.7s)	2796	2796	256	69	157	12	1	239
49437	31624s (+0.7s)	3056	3056	256	48	204	7	0	259
49438	31624s (+0.3s)	620	620	64	27	60	3	0	90
49439	31624s (+0.5s)	1740	1740	128	55	116	11	0	182
49440	31625s (+0.8s)	3316	3316	256	88	178	13	0	279
49441	31626s (+0.7s)	2944	2944	256	61	172	14	1	248
49442	31626s (+0.4s)	1172	1172	64	41	89	10	0	140
49443	31627s (+0.7s)	3084	3084	256	59	180	13	0	252
49444	31627s (+0.5s)	1568	1568	128	40	114	0	6	160
49445	31628s (+0.7s)	2440	2440	128	48	166	0	19	233
49446	31628s (+0.3s)	820	820	64	19	83	0	4	106
49447	31629s (+0.8s)	3344	3344	256	55	216	0	11	282
49448	31630s (+0.4s)	1332	1332	128	27	107	0	3	137
49449	31630s (+0.5s)	1580	1580	128	37	117	8	0	162
49450	31631s (+0.4s)	1444	1444	128	23	124	0	3	150
49451	31631s (+0.2s)	512	512	64	11	57	0	1	69
49452	31631s (+0.6s)	2728	2728	256	54	171	0	7	232
49453	31632s (+0.4s)	1464	1464	128	30	118	0	7	155
49454	31632s (+0.3s)	892	892	64	25	85	0	5	115
49455	31633s (+0.5s)	1796	1796	128	43	133	8	0	184
49456	31633s (+0.7s)	3132	3132	256	65	183	14	0	262
49457	31634s (+0.9s)	4680	4680	512	86	217	14	1	318
49458	31636s (+1.6s)	8040	8040	512	157	375	32	0	564
49459	31637s (+0.6s)	2036	2036	128	50	140	9	0	199
49460	31637s (+0.4s)	1280	1280	128	31	93	5	0	129
49461	31638s (+0.8s)	3044	3044	256	57	201	12	0	270
49462	31638s (+0.4s)	1364	1364	128	35	100	6	0	141
49463	31639s (+0.4s)	1480	1480	128	30	119	5	0	154
49464	31639s (+0.6s)	2624	2624	256	67	154	5	0	226
49465	31640s (+0.8s)	3308	3308	256	71	190	13	0	274
49466	31641s (+0.5s)	1532	1532	128	55	100	7	0	162
49467	31642s (+1.2s)	6104	6104	512	112	287	24	0	423
49468	31643s (+0.9s)	3804	3804	256	67	230	10	0	307
49469	31643s (+0.6s)	2240	2240	128	53	148	14	0	215
49470	31644s (+0.9s)	3556	3556	256	75	206	16	0	297
49471	31645s (+0.8s)	3396	3396	256	69	205	10	0	284
49472	31646s (+0.7s)	2800	2800	256	48	191	6	0	245
49473	31646s (+0.5s)	2240	2240	256	38	142	9	0	189
49474	31647s (+0.3s)	792	792	64	21	81	4	0	106
49475	31648s (+1.1s)	5216	5216	512	81	285	15	1	382
49476	31648s (+0.4s)	1492	1492	128	55	92	6	0	153
49477	31649s (+0.4s)	1220	1220	64	41	101	5	0	147
49478	31649s (+0.3s)	908	908	64	23	89	6	0	118
49479	31650s (+0.5s)	2052	2052	256	45	118	8	0	171
49480	31650s (+0.2s)	580	580	64	17	58	5	0	80
49481	31650s (+0.7s)	2276	2276	128	46	170	11	0	227
49482	31651s (+0.8s)	3520	3520	256	88	197	12	2	299
49483	31652s (+0.4s)	1492	1492	128	34	114	8	0	156
49484	31652s (+0.4s)	1152	1152	128	24	96	0	2	122
49485	31652s (+0.3s)	884	884	64	20	89	0	7	116
49486	31653s (+0.3s)	1088	1088	128	14	98	0	3	115
49487	31653s (+0.5s)	1808	1808	128	41	138	8	0	187
49488	31654s (+1.0s)	5072	5072	512	84	262	17	0	363
49489	31655s (+0.8s)	3392	3392	256	72	201	10	0	283
49490	31656s (+0.8s)	3356	3356	256	67	196	11	0	274
49491	31657s (+0.8s)	3424	3424	256	78	197	0	13	288
49492	31658s (+0.8s)	3412	3412	256	81	184	0	19	284
49493	31658s (+0.4s)	1416	1416	128	30	111	0	8	149
49494	31658s (+0.3s)	688	688	64	19	65	0	6	90
49495	31659s (+0.6s)	1960	1960	128	52	131	10	0	193
49496	31659s (+0.6s)	2040	2040	128	44	147	11	0	202
49497	31660s (+0.5s)	1784	1784	128	42	128	11	0	181
49498	31661s (+0.6s)	2492	2492	256	54	147	9	1	211
49499	31661s (+0.9s)	3668	3668	256	79	207	14	0	300
Episode	Time	Reward	Score	Highest	L	U	R	D	Steps
49500	31662s (+0.5s)	1800	1800	128	44	133	9	0	186
49501	31662s (+0.4s)	1032	1032	64	30	91	0	1	122
49502	31663s (+0.6s)	1920	1920	128	39	153	6	0	198
49503	31663s (+0.5s)	1752	1752	128	46	125	6	0	177
49504	31664s (+0.5s)	1676	1676	128	43	121	7	0	171
49505	31664s (+0.5s)	2076	2076	256	29	141	5	0	175
49506	31665s (+0.8s)	3476	3476	256	55	216	0	18	289
49507	31666s (+0.4s)	1164	1164	64	29	106	0	4	139
49508	31667s (+0.9s)	3696	3696	256	58	223	0	18	299
49509	31667s (+0.4s)	1424	1424	128	30	114	0	5	149
49510	31668s (+0.8s)	3308	3308	256	59	210	0	10	279
49511	31669s (+0.8s)	3304	3304	256	65	197	12	0	274
49512	31669s (+0.4s)	1484	1484	128	32	121	2	0	155
49513	31670s (+0.7s)	2944	2944	256	47	183	4	0	234
49514	31670s (+0.6s)	2552	2552	256	60	147	11	0	218
49515	31671s (+0.7s)	2916	2916	256	69	171	15	0	255
49516	31671s (+0.3s)	932	932	64	28	80	5	0	113
49517	31672s (+0.7s)	2800	2800	256	60	170	7	0	237
49518	31673s (+0.5s)	1644	1644	128	40	120	7	0	167
49519	31673s (+0.7s)	3100	3100	256	63	187	9	0	259
49520	31674s (+0.6s)	2316	2316	256	40	146	7	0	193
49521	31674s (+0.4s)	1312	1312	128	35	97	2	0	134
49522	31675s (+0.9s)	3660	3660	256	85	205	11	1	302
49523	31676s (+0.4s)	1316	1316	128	36	102	6	0	144
49524	31676s (+0.7s)	3188	3188	256	70	182	12	1	265
49525	31677s (+0.8s)	3224	3224	256	61	195	12	1	269
49526	31677s (+0.3s)	708	708	64	19	73	3	0	95
49527	31678s (+1.0s)	4212	4212	256	94	234	17	1	346
49528	31679s (+1.0s)	3992	3992	256	86	230	15	1	332
49529	31680s (+0.7s)	2748	2748	256	57	169	9	0	235
49530	31681s (+0.9s)	3920	3920	256	93	211	15	0	319
49531	31682s (+1.0s)	4320	4320	256	114	225	19	0	358
49532	31683s (+0.9s)	3536	3536	256	84	203	11	0	298
49533	31684s (+1.0s)	5000	5000	512	76	255	17	1	349
49534	31684s (+0.4s)	1448	1448	128	32	112	7	0	151
49535	31685s (+0.4s)	1484	1484	128	45	105	6	0	156
49536	31685s (+0.3s)	928	928	64	27	82	4	0	113
49537	31686s (+0.5s)	1840	1840	128	44	131	8	0	183
49538	31686s (+0.8s)	3160	3160	256	62	184	0	17	263
49539	31687s (+0.9s)	3840	3840	256	59	252	0	10	321
49540	31688s (+0.5s)	1680	1680	128	37	131	0	4	172
49541	31688s (+0.3s)	1028	1028	64	27	84	0	10	121
49542	31689s (+1.0s)	5004	5004	512	76	257	0	18	351
49543	31689s (+0.3s)	912	912	64	22	90	0	7	119
49544	31690s (+0.4s)	1392	1392	128	35	105	0	5	145
49545	31691s (+0.7s)	2764	2764	128	62	178	0	14	254
49546	31691s (+0.4s)	1340	1340	128	31	100	0	6	137
49547	31692s (+0.8s)	3256	3256	256	62	197	0	13	272
49548	31692s (+0.7s)	2880	2880	256	57	168	0	12	237
49549	31693s (+0.5s)	1712	1712	128	28	140	0	5	173
49550	31693s (+0.5s)	1660	1660	128	25	134	0	7	166
49551	31694s (+0.4s)	1312	1312	128	29	98	8	0	135
49552	31694s (+0.5s)	1876	1876	128	46	139	7	0	192
49553	31695s (+0.7s)	2740	2740	256	78	147	15	0	240
49554	31696s (+0.8s)	3316	3316	256	66	198	12	0	276
49555	31696s (+0.5s)	1808	1808	128	48	132	7	0	187
49556	31697s (+0.8s)	3464	3464	256	70	208	14	0	292
49557	31698s (+1.1s)	5168	5168	512	105	245	19	1	370
49558	31699s (+1.1s)	5568	5568	512	94	275	22	0	391
49559	31700s (+0.4s)	1428	1428	128	35	112	7	1	155
49560	31700s (+0.5s)	1744	1744	128	51	116	9	0	176
49561	31701s (+0.9s)	3872	3872	256	88	210	15	0	313
49562	31702s (+0.7s)	2816	2816	256	63	167	12	0	242
49563	31703s (+0.8s)	3440	3440	256	75	202	13	0	290
49564	31703s (+0.5s)	1816	1816	128	40	133	9	0	182
49565	31704s (+0.4s)	1340	1340	128	26	107	4	0	137
49566	31704s (+0.5s)	1596	1596	128	25	133	5	0	163
49567	31705s (+0.4s)	1368	1368	128	37	100	9	0	146
49568	31705s (+0.7s)	2852	2852	256	63	156	10	1	230
49569	31706s (+0.5s)	1612	1612	128	27	132	1	0	160
49570	31706s (+0.4s)	1364	1364	128	26	115	1	0	142
49571	31707s (+0.7s)	2728	2728	256	73	155	9	0	237
49572	31708s (+0.9s)	3604	3604	256	78	212	13	0	303
49573	31708s (+0.7s)	2748	2748	256	49	183	7	0	239
49574	31709s (+0.5s)	1720	1720	128	41	127	6	0	174
49575	31710s (+0.7s)	3000	3000	256	50	180	10	0	240
49576	31710s (+0.5s)	1612	1612	128	43	116	11	0	170
49577	31711s (+0.8s)	3460	3460	256	83	189	11	1	284
49578	31712s (+0.9s)	3784	3784	256	75	231	6	0	312
49579	31712s (+0.3s)	740	740	64	20	76	2	0	98
49580	31713s (+0.5s)	1632	1632	128	27	133	5	0	165
49581	31714s (+1.1s)	4512	4512	256	97	264	13	0	374
49582	31714s (+0.5s)	1500	1500	128	29	125	5	0	159
49583	31714s (+0.3s)	700	700	64	21	67	2	0	90
49584	31715s (+0.3s)	896	896	64	22	93	4	0	119
49585	31715s (+0.6s)	2412	2412	256	46	149	6	0	201
49586	31716s (+0.8s)	3504	3504	256	58	211	10	0	279
49587	31717s (+0.4s)	1432	1432	128	34	107	6	0	147
49588	31717s (+0.9s)	3572	3572	256	72	213	15	0	300
49589	31718s (+0.5s)	1708	1708	128	31	135	3	0	169
49590	31718s (+0.4s)	1252	1252	64	45	91	8	0	144
49591	31719s (+0.4s)	1064	1064	64	32	94	3	0	129
49592	31720s (+1.0s)	4952	4952	512	104	229	17	0	350
49593	31720s (+0.5s)	1556	1556	128	38	119	10	0	167
49594	31721s (+0.8s)	3436	3436	256	59	212	12	0	283
49595	31722s (+0.5s)	1796	1796	128	48	126	9	0	183
49596	31722s (+0.3s)	968	968	64	30	82	6	0	118
49597	31723s (+0.8s)	3460	3460	256	56	223	0	12	291
49598	31723s (+0.7s)	2632	2632	256	38	184	0	10	232
49599	31724s (+1.0s)	4200	4200	256	60	274	0	18	352
Episode	Time	Reward	Score	Highest	L	U	R	D	Steps
49600	31725s (+0.9s)	3720	3720	256	59	236	0	11	306
49601	31726s (+0.5s)	1712	1712	128	40	129	0	5	174
49602	31726s (+0.2s)	560	560	64	11	60	0	4	75
49603	31727s (+0.6s)	1908	1908	128	48	136	0	11	195
49604	31727s (+0.6s)	1928	1928	128	42	149	0	8	199
49605	31728s (+0.7s)	2788	2788	256	57	164	0	13	234
49606	31728s (+0.5s)	1556	1556	128	34	119	0	9	162
49607	31729s (+0.5s)	1788	1788	128	40	133	9	0	182
49608	31730s (+0.7s)	2828	2828	256	57	168	11	0	236
49609	31730s (+0.7s)	2928	2928	256	88	143	20	0	251
49610	31731s (+0.6s)	1980	1980	128	43	143	11	0	197
49611	31731s (+0.6s)	2112	2112	128	63	131	13	0	207
49612	31732s (+0.6s)	2588	2588	256	53	153	12	0	218
49613	31733s (+0.6s)	2720	2720	256	60	165	10	0	235
49614	31733s (+0.8s)	3008	3008	256	69	183	15	0	267
49615	31734s (+0.4s)	1456	1456	128	37	105	7	0	149
49616	31735s (+0.7s)	2788	2788	256	72	157	6	0	235
49617	31735s (+0.4s)	1008	1008	64	30	87	5	0	122
49618	31736s (+0.8s)	3388	3388	256	70	197	15	0	282
49619	31737s (+0.8s)	3024	3024	256	71	181	13	1	266
49620	31737s (+0.2s)	596	596	64	23	56	4	0	83
49621	31737s (+0.5s)	1660	1660	128	43	127	6	1	177
49622	31738s (+0.9s)	3736	3736	256	79	208	19	0	306
49623	31739s (+0.4s)	1520	1520	128	41	104	10	1	156
49624	31739s (+0.6s)	2500	2500	256	51	151	11	0	213
49625	31740s (+0.4s)	1456	1456	128	42	104	8	0	154
49626	31740s (+0.7s)	2928	2928	256	72	173	13	0	258
49627	31741s (+0.5s)	1640	1640	128	42	120	8	0	170
49628	31742s (+0.9s)	3520	3520	256	85	195	18	1	299
49629	31742s (+0.5s)	1616	1616	128	50	112	9	0	171
49630	31743s (+0.5s)	2184	2184	256	42	140	0	6	188
49631	31743s (+0.4s)	1476	1476	128	33	118	0	6	157
49632	31744s (+0.7s)	2912	2912	256	47	179	0	14	240
49633	31744s (+0.4s)	1464	1464	128	36	105	0	10	151
49634	31745s (+0.9s)	3748	3748	256	55	230	0	14	299
49635	31746s (+0.9s)	3932	3932	256	66	246	0	11	323
49636	31747s (+0.6s)	1948	1948	128	47	151	0	7	205
49637	31747s (+0.6s)	2732	2732	256	40	171	0	11	222
49638	31748s (+0.6s)	2116	2116	128	37	148	0	10	195
49639	31749s (+0.9s)	3944	3944	256	74	234	0	13	321
49640	31750s (+0.9s)	4028	4028	256	57	238	0	15	310
49641	31750s (+0.5s)	1576	1576	128	27	126	0	6	159
49642	31751s (+0.5s)	1552	1552	128	27	133	0	7	167
49643	31752s (+1.3s)	6260	6260	512	121	295	29	1	446
49644	31753s (+0.6s)	2484	2484	256	60	143	10	0	213
49645	31754s (+1.2s)	5788	5788	512	123	271	19	0	413
49646	31755s (+0.7s)	3160	3160	256	71	176	11	0	258
49647	31755s (+0.8s)	3284	3284	256	82	191	6	0	279
49648	31756s (+0.8s)	3256	3256	256	62	201	14	0	277
49649	31757s (+0.4s)	1444	1444	128	46	96	8	0	150
49650	31757s (+0.7s)	2584	2584	128	59	167	15	0	241
49651	31758s (+0.5s)	1800	1800	128	29	152	5	0	186
49652	31759s (+0.8s)	3376	3376	256	66	213	11	0	290
49653	31760s (+1.0s)	4332	4332	256	98	244	19	0	361
49654	31760s (+0.7s)	3108	3108	256	68	171	18	0	257
49655	31761s (+0.4s)	1156	1156	64	40	92	3	1	136
49656	31761s (+0.3s)	800	800	64	25	77	6	0	108
49657	31762s (+0.4s)	1292	1292	64	40	98	6	0	144
49658	31762s (+0.4s)	1376	1376	128	35	102	7	0	144
49659	31763s (+0.5s)	1852	1852	128	39	143	0	6	188
49660	31763s (+0.9s)	3960	3960	256	63	248	0	14	325
49661	31764s (+0.6s)	2004	2004	128	38	140	0	15	193
49662	31765s (+0.7s)	2628	2628	256	45	176	0	11	232
49663	31765s (+0.4s)	1520	1520	128	27	127	0	4	158
49664	31766s (+0.7s)	3020	3020	256	50	186	0	12	248
49665	31767s (+0.8s)	3408	3408	256	60	211	0	12	283
49666	31767s (+0.3s)	788	788	64	20	81	4	0	105
49667	31768s (+0.7s)	2624	2624	256	69	150	12	0	231
49668	31768s (+0.3s)	1080	1080	128	34	82	3	0	119
49669	31769s (+0.7s)	2768	2768	256	38	190	10	1	239
49670	31770s (+0.9s)	3608	3608	256	79	216	14	0	309
49671	31770s (+0.8s)	3480	3480	256	69	212	12	0	293
49672	31771s (+0.6s)	2620	2620	256	57	160	8	1	226
49673	31772s (+0.5s)	1796	1796	128	44	131	9	0	184
49674	31772s (+0.6s)	1940	1940	128	46	149	8	0	203
49675	31773s (+0.8s)	3424	3424	256	61	214	8	0	283
49676	31774s (+0.5s)	1836	1836	128	43	137	8	0	188
49677	31774s (+0.5s)	1872	1872	128	46	138	8	0	192
49678	31775s (+0.8s)	3532	3532	256	73	203	14	0	290
49679	31775s (+0.6s)	2188	2188	128	44	151	7	0	202
49680	31776s (+0.8s)	3384	3384	256	76	200	16	0	292
49681	31777s (+0.7s)	2812	2812	256	63	170	12	0	245
49682	31778s (+0.9s)	3568	3568	256	62	229	13	2	306
49683	31778s (+0.4s)	1324	1324	128	27	113	6	0	146
49684	31779s (+0.5s)	1900	1900	128	44	136	13	0	193
49685	31780s (+0.7s)	2904	2904	256	42	200	0	10	252
49686	31780s (+0.8s)	3344	3344	256	57	213	0	13	283
49687	31781s (+0.8s)	3360	3360	256	59	214	0	13	286
49688	31782s (+0.5s)	1612	1612	128	40	113	0	8	161
49689	31783s (+0.8s)	3440	3440	256	59	219	0	13	291
49690	31783s (+0.6s)	2504	2504	256	45	150	0	9	204
49691	31784s (+0.9s)	3600	3600	256	58	239	0	12	309
49692	31785s (+0.6s)	2604	2604	256	41	179	0	7	227
49693	31785s (+0.5s)	1488	1488	128	27	121	0	8	156
49694	31786s (+0.7s)	2796	2796	256	48	184	0	11	243
49695	31786s (+0.4s)	1344	1344	64	28	117	0	6	151
49696	31787s (+0.5s)	1796	1796	128	46	129	0	9	184
49697	31787s (+0.2s)	592	592	64	14	64	0	1	79
49698	31788s (+0.5s)	1600	1600	128	36	120	0	11	167
49699	31788s (+0.5s)	1904	1904	128	56	133	9	0	198
Episode	Time	Reward	Score	Highest	L	U	R	D	Steps
49700	31789s (+0.5s)	1780	1780	128	46	126	9	0	181
49701	31789s (+0.7s)	3204	3204	256	62	185	17	0	264
49702	31790s (+0.5s)	1668	1668	128	45	117	7	0	169
49703	31791s (+0.8s)	3212	3212	256	56	207	7	0	270
49704	31792s (+0.9s)	3796	3796	256	82	223	10	0	315
49705	31792s (+0.6s)	2356	2356	256	47	147	8	0	202
49706	31793s (+0.7s)	2464	2464	128	47	168	0	16	231
49707	31793s (+0.3s)	872	872	64	23	86	0	4	113
49708	31794s (+0.5s)	1496	1496	128	51	100	5	1	157
49709	31794s (+0.4s)	1448	1448	128	31	113	6	0	150
49710	31795s (+0.8s)	3572	3572	256	76	206	19	0	301
49711	31796s (+0.8s)	3360	3360	256	71	200	15	0	286
49712	31796s (+0.7s)	3036	3036	256	66	171	17	0	254
49713	31797s (+0.7s)	2904	2904	256	63	181	8	0	252
49714	31798s (+0.4s)	1356	1356	64	33	113	11	0	157
49715	31798s (+0.3s)	708	708	64	22	70	2	0	94
49716	31799s (+0.7s)	2492	2492	128	57	166	11	0	234
49717	31799s (+0.6s)	2100	2100	128	47	147	11	0	205
49718	31800s (+0.8s)	3368	3368	256	76	199	13	0	288
49719	31800s (+0.3s)	888	888	64	22	82	4	0	108
49720	31801s (+0.5s)	1612	1612	128	33	118	0	10	161
49721	31801s (+0.7s)	2620	2620	128	57	172	0	13	242
49722	31802s (+0.7s)	3240	3240	256	66	196	0	11	273
49723	31803s (+0.4s)	1284	1284	128	32	95	0	3	130
49724	31803s (+0.8s)	3748	3748	256	54	235	0	16	305
49725	31804s (+0.9s)	3516	3516	256	85	198	15	1	299
49726	31805s (+0.5s)	1668	1668	128	32	128	6	0	166
49727	31806s (+0.8s)	3388	3388	256	70	199	13	0	282
49728	31807s (+1.0s)	4184	4184	256	92	228	21	0	341
49729	31807s (+0.5s)	1848	1848	128	45	143	4	0	192
49730	31808s (+0.8s)	3580	3580	256	70	199	18	0	287
49731	31808s (+0.4s)	1216	1216	64	36	102	6	0	144
49732	31809s (+0.3s)	928	928	64	24	89	10	0	123
49733	31809s (+0.7s)	2940	2940	256	78	171	12	0	261
49734	31810s (+0.3s)	788	788	64	25	75	0	5	105
49735	31810s (+0.5s)	1668	1668	128	34	130	0	6	170
49736	31811s (+0.4s)	1460	1460	128	25	119	0	6	150
49737	31811s (+0.5s)	1496	1496	128	24	128	0	5	157
49738	31812s (+0.6s)	2792	2792	256	40	175	0	12	227
49739	31813s (+0.8s)	3592	3592	256	71	213	0	13	297
49740	31814s (+0.9s)	3544	3544	256	68	222	0	10	300
49741	31814s (+0.7s)	2900	2900	256	44	196	0	12	252
49742	31815s (+0.6s)	2168	2168	128	47	144	0	11	202
49743	31815s (+0.4s)	1284	1284	128	31	93	0	5	129
49744	31816s (+0.6s)	2512	2512	256	53	152	0	11	216
49745	31816s (+0.4s)	1428	1428	128	22	123	0	2	147
49746	31817s (+0.3s)	1096	1096	128	20	85	0	9	114
49747	31817s (+0.2s)	548	548	64	11	59	0	3	73
49748	31818s (+0.8s)	3236	3236	256	92	163	16	1	272
49749	31818s (+0.5s)	1820	1820	128	40	139	10	0	189
49750	31819s (+0.9s)	4740	4740	512	79	226	18	0	323
49751	31820s (+0.7s)	2860	2860	256	65	165	8	0	238
49752	31820s (+0.3s)	672	672	32	22	71	3	0	96
49753	31821s (+1.2s)	5816	5816	512	86	318	16	0	420
49754	31822s (+0.8s)	3340	3340	256	71	198	12	0	281
49755	31822s (+0.3s)	908	908	64	33	79	5	0	117
49756	31823s (+0.9s)	3964	3964	256	72	247	11	0	330
49757	31824s (+1.1s)	5564	5564	512	88	273	22	0	383
49758	31825s (+0.8s)	3364	3364	256	72	202	13	0	287
49759	31826s (+0.6s)	1920	1920	128	42	152	4	0	198
49760	31826s (+0.5s)	1580	1580	128	39	117	6	0	162
49761	31827s (+0.4s)	1172	1172	64	35	94	6	0	135
49762	31827s (+0.7s)	2680	2680	256	60	162	11	0	233
49763	31828s (+0.5s)	1824	1824	128	52	120	11	0	183
49764	31828s (+0.5s)	1748	1748	128	51	114	11	0	176
49765	31829s (+1.0s)	4256	4256	256	89	243	15	0	347
49766	31830s (+0.7s)	2852	2852	256	61	164	18	1	244
49767	31831s (+0.5s)	1860	1860	128	41	136	11	0	188
49768	31831s (+0.5s)	1772	1772	128	35	135	8	0	178
49769	31832s (+0.5s)	1624	1624	128	37	127	8	0	172
49770	31832s (+0.4s)	1348	1348	128	28	110	10	0	148
49771	31833s (+0.4s)	1444	1444	128	30	112	5	0	147
49772	31833s (+0.9s)	3960	3960	256	86	217	20	0	323
49773	31834s (+0.5s)	1776	1776	128	39	136	9	0	184
49774	31835s (+0.7s)	2976	2976	256	56	181	10	0	247
49775	31835s (+0.5s)	1776	1776	128	49	124	6	0	179
49776	31836s (+0.3s)	1064	1064	64	39	72	10	0	121
49777	31836s (+0.4s)	1448	1448	128	30	113	6	1	150
49778	31837s (+0.5s)	1872	1872	128	45	127	6	0	178
49779	31837s (+0.5s)	1788	1788	128	44	129	9	0	182
49780	31838s (+0.9s)	3940	3940	256	100	208	17	0	325
49781	31839s (+0.9s)	3964	3964	256	87	205	25	1	318
49782	31840s (+0.6s)	2208	2208	128	56	146	10	0	212
49783	31840s (+0.7s)	3356	3356	256	75	181	18	0	274
49784	31841s (+0.5s)	1748	1748	128	44	118	14	0	176
49785	31841s (+0.6s)	2348	2348	256	39	150	0	8	197
49786	31842s (+0.3s)	1000	1000	128	24	80	0	2	106
49787	31842s (+0.7s)	3124	3124	256	58	190	0	14	262
49788	31843s (+0.9s)	3796	3796	256	58	242	0	15	315
49789	31844s (+0.8s)	3572	3572	256	72	200	0	15	287
49790	31845s (+0.8s)	3392	3392	256	60	208	0	16	284
49791	31846s (+0.8s)	3428	3428	256	64	212	0	12	288
49792	31846s (+0.5s)	1608	1608	128	41	119	0	9	169
49793	31847s (+0.6s)	2520	2520	256	42	171	0	8	221
49794	31848s (+0.9s)	3596	3596	256	50	246	0	12	308
49795	31848s (+0.4s)	1436	1436	128	28	113	0	7	148
49796	31849s (+0.2s)	608	608	64	18	66	0	3	87
49797	31849s (+0.3s)	1020	1020	64	29	86	0	8	123
49798	31850s (+0.9s)	3940	3940	256	81	227	16	0	324
49799	31850s (+0.6s)	2444	2444	128	71	143	12	1	227
Episode	Time	Reward	Score	Highest	L	U	R	D	Steps
49800	31851s (+0.6s)	1924	1924	128	58	137	4	0	199
49801	31852s (+0.7s)	2484	2484	128	60	161	12	0	233
49802	31853s (+1.0s)	4232	4232	256	93	240	19	0	352
49803	31853s (+0.6s)	2044	2044	128	53	130	10	0	193
49804	31854s (+0.4s)	1452	1452	128	37	112	5	0	154
49805	31854s (+0.6s)	2456	2456	256	45	163	4	0	212
49806	31855s (+0.8s)	3188	3188	256	71	180	13	0	264
49807	31855s (+0.3s)	736	736	64	30	62	5	0	97
49808	31856s (+0.7s)	2488	2488	128	68	152	13	0	233
49809	31857s (+0.6s)	2444	2444	256	48	151	9	0	208
49810	31857s (+0.3s)	872	872	64	23	86	5	0	114
49811	31858s (+0.6s)	2604	2604	256	52	156	9	0	217
49812	31858s (+0.3s)	880	880	64	27	85	4	0	116
49813	31859s (+0.9s)	3828	3828	256	89	212	18	1	320
49814	31859s (+0.6s)	2320	2320	128	60	151	12	0	223
49815	31860s (+0.4s)	1304	1304	128	24	103	6	0	133
49816	31861s (+0.8s)	3792	3792	256	86	200	18	0	304
49817	31861s (+0.5s)	1844	1844	128	42	138	8	0	188
49818	31862s (+0.7s)	2840	2840	256	54	179	9	0	242
49819	31862s (+0.5s)	1512	1512	128	35	116	10	0	161
49820	31863s (+0.3s)	864	864	64	30	75	7	0	112
49821	31863s (+0.5s)	1744	1744	128	42	132	9	0	183
49822	31864s (+0.3s)	848	848	64	24	79	4	0	107
49823	31864s (+0.6s)	2676	2676	256	59	161	9	0	229
49824	31865s (+0.9s)	3724	3724	256	87	208	21	0	316
49825	31866s (+0.8s)	3412	3412	256	63	207	14	0	284
49826	31867s (+0.6s)	2780	2780	256	54	156	12	0	222
49827	31867s (+0.6s)	2428	2428	256	52	140	11	0	203
49828	31868s (+0.4s)	1336	1336	128	33	104	8	0	145
49829	31868s (+0.3s)	864	864	64	27	79	6	0	112
49830	31869s (+0.8s)	3516	3516	256	81	192	14	0	287
49831	31869s (+0.7s)	2920	2920	256	60	188	8	0	256
49832	31870s (+0.7s)	3120	3120	256	64	178	12	0	254
49833	31871s (+0.6s)	2196	2196	128	51	148	10	0	209
49834	31872s (+0.8s)	3332	3332	256	83	180	17	0	280
49835	31872s (+0.7s)	2928	2928	256	70	179	9	0	258
49836	31873s (+0.5s)	1512	1512	128	41	113	0	7	161
49837	31873s (+0.6s)	1920	1920	128	36	154	0	8	198
49838	31874s (+0.5s)	1872	1872	128	53	123	11	0	187
49839	31875s (+0.7s)	2824	2824	256	57	182	10	0	249
49840	31875s (+0.7s)	2780	2780	256	56	174	9	1	240
49841	31876s (+0.5s)	1792	1792	128	36	139	8	0	183
49842	31877s (+1.0s)	4252	4252	256	94	235	23	1	353
49843	31877s (+0.6s)	2328	2328	256	43	152	6	0	201
49844	31879s (+1.2s)	5976	5976	512	110	297	21	0	428
49845	31879s (+0.7s)	2808	2808	256	41	194	8	1	244
49846	31880s (+1.0s)	4304	4304	256	95	242	21	0	358
49847	31881s (+0.6s)	1904	1904	128	46	142	6	0	194
49848	31882s (+0.7s)	3124	3124	256	59	188	13	0	260
49849	31882s (+0.3s)	940	940	64	20	83	8	0	111
49850	31883s (+0.8s)	3492	3492	256	77	200	15	0	292
49851	31884s (+0.6s)	2572	2572	256	67	140	15	0	222
49852	31885s (+1.0s)	5136	5136	512	67	269	0	17	353
49853	31885s (+0.5s)	1844	1844	128	35	142	0	14	191
49854	31886s (+0.5s)	1564	1564	128	45	118	6	0	169
49855	31886s (+0.8s)	3344	3344	256	52	223	7	0	282
49856	31888s (+1.1s)	5504	5504	512	100	271	20	0	391
49857	31888s (+0.5s)	1556	1556	128	37	117	4	0	158
49858	31889s (+0.7s)	2692	2692	256	53	169	7	0	229
49859	31889s (+0.4s)	1416	1416	128	32	112	5	0	149
49860	31889s (+0.2s)	624	624	64	25	53	6	0	84
49861	31890s (+0.7s)	2824	2824	256	59	180	9	0	248
49862	31891s (+0.4s)	1576	1576	128	41	107	8	0	156
49863	31892s (+1.1s)	4572	4572	256	88	270	19	0	377
49864	31893s (+1.1s)	5200	5200	512	88	270	0	20	378
49865	31894s (+0.8s)	2976	2976	256	49	208	0	8	265
49866	31894s (+0.7s)	2696	2696	128	57	180	0	15	252
49867	31895s (+0.3s)	764	764	64	27	73	0	3	103
49868	31895s (+0.4s)	1440	1440	128	25	118	0	6	149
49869	31895s (+0.4s)	1156	1156	64	33	102	2	0	137
49870	31896s (+0.8s)	3592	3592	256	71	217	12	0	300
49871	31897s (+0.5s)	1856	1856	128	53	122	9	0	184
49872	31897s (+0.5s)	1828	1828	128	42	143	6	0	191
49873	31898s (+0.4s)	1160	1160	64	38	95	3	1	137
49874	31899s (+0.9s)	4144	4144	256	72	232	12	1	317
49875	31899s (+0.7s)	2912	2912	256	68	177	9	0	254
49876	31900s (+0.8s)	3300	3300	256	66	201	10	0	277
49877	31901s (+0.4s)	1492	1492	128	34	114	7	1	156
49878	31901s (+0.4s)	1408	1408	128	38	96	7	0	141
49879	31902s (+0.7s)	2812	2812	256	58	156	18	0	232
49880	31902s (+0.7s)	2584	2584	128	59	178	8	0	245
49881	31903s (+0.6s)	2240	2240	256	53	133	9	0	195
49882	31904s (+1.2s)	5844	5844	512	104	286	25	0	415
49883	31905s (+0.6s)	2448	2448	256	49	148	8	0	205
49884	31905s (+0.5s)	1804	1804	128	31	151	4	0	186
49885	31906s (+0.3s)	872	872	64	28	81	5	0	114
49886	31906s (+0.3s)	664	664	32	33	64	3	0	100
49887	31906s (+0.5s)	1388	1388	64	36	111	8	0	155
49888	31907s (+0.6s)	2420	2420	128	60	160	9	0	229
49889	31908s (+0.6s)	2584	2584	256	57	150	15	0	222
49890	31908s (+0.8s)	3212	3212	256	73	177	15	0	265
49891	31909s (+0.9s)	3804	3804	256	68	224	15	0	307
49892	31910s (+0.8s)	3468	3468	256	84	191	12	0	287
49893	31911s (+0.5s)	1796	1796	128	47	129	8	0	184
49894	31912s (+0.8s)	3444	3444	256	73	204	10	0	287
49895	31912s (+0.5s)	1824	1824	128	37	147	6	0	190
49896	31913s (+1.1s)	4628	4628	256	110	254	22	0	386
49897	31914s (+0.6s)	2340	2340	128	66	134	18	0	218
49898	31914s (+0.5s)	1608	1608	128	34	118	7	0	159
49899	31915s (+0.7s)	3140	3140	256	69	187	12	0	268
Episode	Time	Reward	Score	Highest	L	U	R	D	Steps
49900	31916s (+0.5s)	1656	1656	128	45	123	9	0	177
49901	31916s (+0.6s)	2540	2540	256	48	157	0	11	216
49902	31917s (+0.6s)	2252	2252	128	41	165	0	12	218
49903	31917s (+0.5s)	1764	1764	128	25	149	0	4	178
49904	31918s (+0.8s)	3344	3344	256	53	204	0	16	273
49905	31919s (+0.5s)	1732	1732	128	27	142	0	4	173
49906	31920s (+1.4s)	6676	6676	512	136	331	23	0	490
49907	31920s (+0.4s)	1480	1480	128	33	115	6	0	154
49908	31922s (+1.0s)	5280	5280	512	84	268	15	0	367
49909	31922s (+0.5s)	2132	2132	256	34	134	6	0	174
49910	31923s (+0.5s)	1764	1764	128	45	120	11	0	176
49911	31923s (+0.5s)	1528	1528	128	44	114	3	0	161
49912	31924s (+0.5s)	1796	1796	128	61	115	8	0	184
49913	31925s (+1.0s)	4312	4312	256	91	248	18	0	357
49914	31926s (+1.0s)	4316	4316	256	96	246	15	0	357
49915	31927s (+0.9s)	3592	3592	256	72	221	15	0	308
49916	31927s (+0.7s)	3096	3096	256	57	181	10	0	248
49917	31928s (+0.6s)	1956	1956	128	50	137	10	0	197
49918	31929s (+0.9s)	3876	3876	256	76	218	19	0	313
49919	31930s (+0.9s)	3880	3880	256	107	202	20	0	329
49920	31930s (+0.6s)	2452	2452	256	55	145	5	1	206
49921	31931s (+1.0s)	4212	4212	256	76	251	21	0	348
49922	31932s (+0.6s)	2440	2440	256	32	168	7	1	208
49923	31932s (+0.3s)	1068	1068	128	27	82	6	0	115
49924	31933s (+0.4s)	1272	1272	128	36	96	6	0	138
49925	31933s (+0.5s)	1788	1788	128	36	142	5	0	183
49926	31934s (+0.6s)	2284	2284	128	58	147	9	1	215
49927	31935s (+0.7s)	3176	3176	256	62	189	10	0	261
49928	31935s (+0.8s)	3376	3376	256	75	205	10	0	290
49929	31936s (+0.6s)	2224	2224	128	51	149	11	0	211
49930	31937s (+0.7s)	2700	2700	256	52	172	4	0	228
49931	31937s (+0.6s)	2664	2664	256	54	164	8	0	226
49932	31938s (+0.6s)	1960	1960	128	60	132	11	0	203
49933	31938s (+0.5s)	1752	1752	128	40	131	7	0	178
49934	31939s (+1.0s)	4068	4068	256	83	233	18	0	334
49935	31940s (+1.1s)	5548	5548	512	118	258	14	0	390
49936	31941s (+0.3s)	1032	1032	128	24	82	5	0	111
49937	31942s (+0.8s)	3360	3360	256	69	204	13	0	286
49938	31942s (+0.3s)	1088	1088	128	29	86	5	0	120
49939	31943s (+0.7s)	2572	2572	128	58	170	14	0	242
49940	31943s (+0.7s)	2784	2784	256	57	172	10	0	239
49941	31944s (+0.9s)	4056	4056	256	98	227	11	0	336
49942	31945s (+0.7s)	2884	2884	256	45	179	12	1	237
49943	31946s (+0.7s)	3108	3108	256	51	192	8	0	251
49944	31947s (+0.9s)	3924	3924	256	80	227	13	0	320
49945	31947s (+0.4s)	1608	1608	128	46	104	9	0	159
49946	31948s (+0.6s)	2600	2600	256	46	148	11	0	205
49947	31948s (+0.6s)	2308	2308	128	54	156	10	0	220
49948	31949s (+0.9s)	4152	4152	256	76	239	18	0	333
49949	31950s (+0.7s)	2884	2884	256	74	167	11	0	252
49950	31951s (+1.1s)	5416	5416	512	86	271	24	0	381
49951	31952s (+0.6s)	2208	2208	128	42	157	17	0	216
49952	31952s (+0.5s)	2316	2316	256	43	145	5	0	193
49953	31952s (+0.2s)	460	460	32	14	59	2	1	76
49954	31953s (+1.0s)	4344	4344	256	82	259	19	0	360
49955	31954s (+0.5s)	1736	1736	128	38	131	6	0	175
49956	31954s (+0.4s)	1328	1328	128	30	105	3	0	138
49957	31955s (+0.4s)	1056	1056	64	29	92	6	0	127
49958	31955s (+0.6s)	2032	2032	128	66	125	13	0	204
49959	31956s (+0.5s)	1588	1588	128	40	120	4	0	164
49960	31957s (+1.0s)	4120	4120	256	88	229	19	0	336
49961	31958s (+0.9s)	3996	3996	256	88	230	15	0	333
49962	31959s (+0.8s)	3444	3444	256	73	195	17	0	285
49963	31959s (+0.6s)	1884	1884	128	42	142	10	0	194
49964	31960s (+0.7s)	2792	2792	256	63	156	16	0	235
49965	31961s (+0.7s)	2916	2916	256	57	170	14	0	241
49966	31961s (+0.5s)	2296	2296	256	47	141	4	0	192
49967	31962s (+0.7s)	2752	2752	256	60	169	8	0	237
49968	31962s (+0.5s)	1520	1520	128	39	109	9	0	157
49969	31963s (+0.4s)	1456	1456	128	36	108	6	0	150
49970	31963s (+0.7s)	3092	3092	256	66	179	8	0	253
49971	31964s (+0.7s)	3024	3024	256	66	180	14	0	260
49972	31965s (+0.8s)	3508	3508	256	78	200	13	0	291
49973	31966s (+0.6s)	2536	2536	256	50	162	9	0	221
49974	31966s (+0.5s)	1596	1596	128	32	121	7	0	160
49975	31967s (+0.6s)	2480	2480	256	51	143	17	1	212
49976	31968s (+1.0s)	4916	4916	512	92	234	15	0	341
49977	31968s (+0.7s)	2772	2772	256	57	164	8	0	229
49978	31969s (+0.7s)	3088	3088	256	64	179	10	0	253
49979	31970s (+0.6s)	2472	2472	256	55	148	7	0	210
49980	31970s (+0.4s)	1504	1504	128	36	106	0	8	150
49981	31971s (+0.8s)	3172	3172	256	55	195	11	1	262
49982	31972s (+0.7s)	2780	2780	256	54	179	6	0	239
49983	31972s (+0.5s)	1568	1568	128	35	123	10	0	168
49984	31973s (+0.4s)	1520	1520	128	39	112	8	0	159
49985	31973s (+0.7s)	3164	3164	256	58	191	10	0	259
49986	31974s (+0.3s)	1012	1012	128	24	78	0	5	107
49987	31974s (+0.6s)	2208	2208	128	46	160	0	6	212
49988	31975s (+0.7s)	2940	2940	256	49	183	0	16	248
49989	31976s (+0.9s)	3960	3960	256	66	246	0	13	325
49990	31976s (+0.5s)	2164	2164	256	43	129	0	10	182
49991	31977s (+0.3s)	924	924	64	26	81	0	5	112
49992	31978s (+0.8s)	3436	3436	256	67	210	0	13	290
49993	31978s (+0.8s)	3160	3160	256	48	204	0	10	262
49994	31979s (+0.8s)	3184	3184	256	49	210	0	12	271
49995	31980s (+0.5s)	1804	1804	128	43	138	0	5	186
49996	31980s (+0.6s)	2592	2592	256	42	172	0	9	223
49997	31981s (+0.6s)	2592	2592	256	51	167	0	6	224
49998	31981s (+0.3s)	1008	1008	128	18	89	0	1	108
49999	31982s (+0.7s)	3072	3072	256	50	193	0	10	253
